file,url,toClicksLink,toClicksExternal,toClicksOther,toClicks,fromClicks
hdfs://spark-nn.eemcs.utwente.nl/user/s1934538/clickstream/clickstream-enwiki-2018-01.tsv.gz,List_of_FIFA_World_Cup_finals,1136,60067,45,61248,11895
hdfs://spark-nn.eemcs.utwente.nl/user/s1934538/clickstream/clickstream-enwiki-2018-01.tsv.gz,The_Witcher_(TV_series),2858,5230,69,8157,1818
hdfs://spark-nn.eemcs.utwente.nl/user/s1934538/clickstream/clickstream-enwiki-2018-01.tsv.gz,Lists_of_deaths_by_year,65244,529931,1881,597056,397191
hdfs://spark-nn.eemcs.utwente.nl/user/s1934538/clickstream/clickstream-enwiki-2018-01.tsv.gz,Richard_Ramirez,7588,118484,543,126615,15335
hdfs://spark-nn.eemcs.utwente.nl/user/s1934538/clickstream/clickstream-enwiki-2018-01.tsv.gz,Nipsey_Hussle,9227,60495,213,69935,16979
hdfs://spark-nn.eemcs.utwente.nl/user/s1934538/clickstream/clickstream-enwiki-2018-01.tsv.gz,Royal_Rumble_(2018),305371,3132259,61736,3499366,1063670
hdfs://spark-nn.eemcs.utwente.nl/user/s1934538/clickstream/clickstream-enwiki-2018-01.tsv.gz,Death_of_Elisa_Lam,8011,78458,164,86633,14169
hdfs://spark-nn.eemcs.utwente.nl/user/s1934538/clickstream/clickstream-enwiki-2018-01.tsv.gz,21_Savage,30094,235515,6844,272453,71170
hdfs://spark-nn.eemcs.utwente.nl/user/s1934538/clickstream/clickstream-enwiki-2018-01.tsv.gz,Luke_Perry,15364,67573,394,83331,7949
hdfs://spark-nn.eemcs.utwente.nl/user/s1934538/clickstream/clickstream-enwiki-2018-01.tsv.gz,Game_of_Thrones,66695,635182,14536,716413,352686
hdfs://spark-nn.eemcs.utwente.nl/user/s1934538/clickstream/clickstream-enwiki-2018-01.tsv.gz,XHamster,7762,8139193,11120,8158075,34834
hdfs://spark-nn.eemcs.utwente.nl/user/s1934538/clickstream/clickstream-enwiki-2018-01.tsv.gz,Ray_Liotta,25974,92126,362,118462,24042
hdfs://spark-nn.eemcs.utwente.nl/user/s1934538/clickstream/clickstream-enwiki-2018-01.tsv.gz,Christopher_Scarver,33247,48775,126,82148,15205
hdfs://spark-nn.eemcs.utwente.nl/user/s1934538/clickstream/clickstream-enwiki-2018-01.tsv.gz,Ruth_Bader_Ginsburg,20128,393424,696,414248,45668
hdfs://spark-nn.eemcs.utwente.nl/user/s1934538/clickstream/clickstream-enwiki-2018-01.tsv.gz,JSON_Web_Token,28407,5812664,23,5841094,7433
hdfs://spark-nn.eemcs.utwente.nl/user/s1934538/clickstream/clickstream-enwiki-2018-01.tsv.gz,Michael_Jordan,46337,508822,3107,558266,108614
hdfs://spark-nn.eemcs.utwente.nl/user/s1934538/clickstream/clickstream-enwiki-2018-01.tsv.gz,Afghanistan,42621,183387,2221,228229,142491
hdfs://spark-nn.eemcs.utwente.nl/user/s1934538/clickstream/clickstream-enwiki-2018-01.tsv.gz,Crazy_Rich_Asians_(film),17221,29193,136,46550,40705
hdfs://spark-nn.eemcs.utwente.nl/user/s1934538/clickstream/clickstream-enwiki-2018-01.tsv.gz,Juneteenth,2736,135789,58,138583,2690
hdfs://spark-nn.eemcs.utwente.nl/user/s1934538/clickstream/clickstream-enwiki-2018-01.tsv.gz,Cricket_World_Cup,6559,71022,368,77949,23364
hdfs://spark-nn.eemcs.utwente.nl/user/s1934538/clickstream/clickstream-enwiki-2018-01.tsv.gz,Jimmy_Buffett,5169,48237,357,53763,11704
hdfs://spark-nn.eemcs.utwente.nl/user/s1934538/clickstream/clickstream-enwiki-2018-01.tsv.gz,Roe_v._Wade,8731,107236,463,116430,18342
hdfs://spark-nn.eemcs.utwente.nl/user/s1934538/clickstream/clickstream-enwiki-2018-01.tsv.gz,Bipin_Rawat,6567,32204,39,38810,9489
hdfs://spark-nn.eemcs.utwente.nl/user/s1934538/clickstream/clickstream-enwiki-2018-01.tsv.gz,2022_FIFA_World_Cup,36110,60615,396,97121,41448
hdfs://spark-nn.eemcs.utwente.nl/user/s1934538/clickstream/clickstream-enwiki-2018-01.tsv.gz,The_Irishman_(2019_film),46750,104768,507,152025,87493
hdfs://spark-nn.eemcs.utwente.nl/user/s1934538/clickstream/clickstream-enwiki-2018-01.tsv.gz,Olivia_Newton-John,15080,118257,918,134255,31868
hdfs://spark-nn.eemcs.utwente.nl/user/s1934538/clickstream/clickstream-enwiki-2018-01.tsv.gz,September_11_attacks,48949,303080,2195,354224,102070
hdfs://spark-nn.eemcs.utwente.nl/user/s1934538/clickstream/clickstream-enwiki-2018-01.tsv.gz,Key_frame,965,6157,16,7138,642
hdfs://spark-nn.eemcs.utwente.nl/user/s1934538/clickstream/clickstream-enwiki-2018-01.tsv.gz,Donald_Trump,228888,1595328,19267,1843483,693099
hdfs://spark-nn.eemcs.utwente.nl/user/s1934538/clickstream/clickstream-enwiki-2018-01.tsv.gz,Alexander_Hamilton,50733,449929,1931,502593,114112
hdfs://spark-nn.eemcs.utwente.nl/user/s1934538/clickstream/clickstream-enwiki-2018-01.tsv.gz,Henry_V_of_England,31226,48839,154,80219,35017
hdfs://spark-nn.eemcs.utwente.nl/user/s1934538/clickstream/clickstream-enwiki-2018-01.tsv.gz,Aretha_Franklin,12470,95096,833,108399,23049
hdfs://spark-nn.eemcs.utwente.nl/user/s1934538/clickstream/clickstream-enwiki-2018-01.tsv.gz,DMX_(rapper),11065,88739,377,100181,26179
hdfs://spark-nn.eemcs.utwente.nl/user/s1934538/clickstream/clickstream-enwiki-2018-01.tsv.gz,"Prince_Philip,_Duke_of_Edinburgh",319579,1962162,6627,2288368,612840
hdfs://spark-nn.eemcs.utwente.nl/user/s1934538/clickstream/clickstream-enwiki-2018-01.tsv.gz,Avengers:_Infinity_War,201577,438953,7955,648485,401993
hdfs://spark-nn.eemcs.utwente.nl/user/s1934538/clickstream/clickstream-enwiki-2018-01.tsv.gz,Cardi_B,57543,2083529,9159,2150231,266886
hdfs://spark-nn.eemcs.utwente.nl/user/s1934538/clickstream/clickstream-enwiki-2018-01.tsv.gz,R._Kelly,17479,112943,751,131173,36346
hdfs://spark-nn.eemcs.utwente.nl/user/s1934538/clickstream/clickstream-enwiki-2018-01.tsv.gz,The_Nun_(2018_film),58351,132741,304,191396,65892
hdfs://spark-nn.eemcs.utwente.nl/user/s1934538/clickstream/clickstream-enwiki-2018-01.tsv.gz,Khabib_Nurmagomedov,34654,251483,2483,288620,102656
hdfs://spark-nn.eemcs.utwente.nl/user/s1934538/clickstream/clickstream-enwiki-2018-01.tsv.gz,Rishi_Sunak,3023,13719,56,16798,2414
hdfs://spark-nn.eemcs.utwente.nl/user/s1934538/clickstream/clickstream-enwiki-2018-01.tsv.gz,Charles_III,106,744,115,965,514
hdfs://spark-nn.eemcs.utwente.nl/user/s1934538/clickstream/clickstream-enwiki-2018-01.tsv.gz,Game_of_Thrones_(season_8),45448,163128,842,209418,66183
hdfs://spark-nn.eemcs.utwente.nl/user/s1934538/clickstream/clickstream-enwiki-2018-01.tsv.gz,Puneeth_Rajkumar,9698,28843,45,38586,15944
hdfs://spark-nn.eemcs.utwente.nl/user/s1934538/clickstream/clickstream-enwiki-2018-01.tsv.gz,Elizabeth_II,584683,2983912,6012,3574607,1358698
hdfs://spark-nn.eemcs.utwente.nl/user/s1934538/clickstream/clickstream-enwiki-2018-01.tsv.gz,Wikipedia,42021,519986,1341,563348,204401
hdfs://spark-nn.eemcs.utwente.nl/user/s1934538/clickstream/clickstream-enwiki-2018-01.tsv.gz,Brie_Larson,73251,263628,1897,338776,93653
hdfs://spark-nn.eemcs.utwente.nl/user/s1934538/clickstream/clickstream-enwiki-2018-01.tsv.gz,Central_Park_jogger_case,3634,43342,173,47149,4958
hdfs://spark-nn.eemcs.utwente.nl/user/s1934538/clickstream/clickstream-enwiki-2018-01.tsv.gz,Valentine's_Day,5097,185489,992,191578,3053
hdfs://spark-nn.eemcs.utwente.nl/user/s1934538/clickstream/clickstream-enwiki-2018-01.tsv.gz,Ukraine,33337,145195,2455,180987,68126
hdfs://spark-nn.eemcs.utwente.nl/user/s1934538/clickstream/clickstream-enwiki-2018-01.tsv.gz,David_Beckham,25851,256877,1677,284405,57877
hdfs://spark-nn.eemcs.utwente.nl/user/s1934538/clickstream/clickstream-enwiki-2018-01.tsv.gz,Betty_White,34900,466678,4382,505960,61659
hdfs://spark-nn.eemcs.utwente.nl/user/s1934538/clickstream/clickstream-enwiki-2018-01.tsv.gz,Media,64,22239,354,22657,3393
hdfs://spark-nn.eemcs.utwente.nl/user/s1934538/clickstream/clickstream-enwiki-2018-01.tsv.gz,2020_Summer_Olympics,56145,142283,757,199185,64146
hdfs://spark-nn.eemcs.utwente.nl/user/s1934538/clickstream/clickstream-enwiki-2018-01.tsv.gz,Kelly_Preston,37782,72654,686,111122,19520
hdfs://spark-nn.eemcs.utwente.nl/user/s1934538/clickstream/clickstream-enwiki-2018-01.tsv.gz,Jeffrey_Dahmer,19202,400104,2542,421848,93308
hdfs://spark-nn.eemcs.utwente.nl/user/s1934538/clickstream/clickstream-enwiki-2018-01.tsv.gz,Darth_Vader,37329,2613832,1220,2652381,73960
hdfs://spark-nn.eemcs.utwente.nl/user/s1934538/clickstream/clickstream-enwiki-2018-01.tsv.gz,Irrfan_Khan,26363,68544,141,95048,42868
hdfs://spark-nn.eemcs.utwente.nl/user/s1934538/clickstream/clickstream-enwiki-2018-01.tsv.gz,Saaho,41842,70818,105,112765,48293
hdfs://spark-nn.eemcs.utwente.nl/user/s1934538/clickstream/clickstream-enwiki-2018-01.tsv.gz,UEFA_Euro_2020,13707,52122,1223,67052,28764
hdfs://spark-nn.eemcs.utwente.nl/user/s1934538/clickstream/clickstream-enwiki-2018-01.tsv.gz,Main_Page,22179,540208007,3038930,543269116,31625045
hdfs://spark-nn.eemcs.utwente.nl/user/s1934538/clickstream/clickstream-enwiki-2018-01.tsv.gz,Mac_Miller,20386,59601,520,80507,14562
hdfs://spark-nn.eemcs.utwente.nl/user/s1934538/clickstream/clickstream-enwiki-2018-01.tsv.gz,Kamala_Harris,26157,271328,1377,298862,58113
hdfs://spark-nn.eemcs.utwente.nl/user/s1934538/clickstream/clickstream-enwiki-2018-01.tsv.gz,"Princess_Margaret,_Countess_of_Snowdon",233539,2869585,8905,3112029,684155
hdfs://spark-nn.eemcs.utwente.nl/user/s1934538/clickstream/clickstream-enwiki-2018-01.tsv.gz,Avicii,6669,44516,486,51671,15612
hdfs://spark-nn.eemcs.utwente.nl/user/s1934538/clickstream/clickstream-enwiki-2018-01.tsv.gz,Croatia,31497,158380,1579,191456,60548
hdfs://spark-nn.eemcs.utwente.nl/user/s1934538/clickstream/clickstream-enwiki-2018-01.tsv.gz,Salman_Rushdie,18053,88795,405,107253,34259
hdfs://spark-nn.eemcs.utwente.nl/user/s1934538/clickstream/clickstream-enwiki-2018-01.tsv.gz,List_of_highest-grossing_films,142760,563150,2564,708474,242062
hdfs://spark-nn.eemcs.utwente.nl/user/s1934538/clickstream/clickstream-enwiki-2018-01.tsv.gz,Bible,13097,110715,2365,126177,29810
hdfs://spark-nn.eemcs.utwente.nl/user/s1934538/clickstream/clickstream-enwiki-2018-01.tsv.gz,XXX_(franchise),46891,1785444,1045,1833380,308755
hdfs://spark-nn.eemcs.utwente.nl/user/s1934538/clickstream/clickstream-enwiki-2018-01.tsv.gz,Richard_Jewell,1966,8069,30,10065,1592
hdfs://spark-nn.eemcs.utwente.nl/user/s1934538/clickstream/clickstream-enwiki-2018-01.tsv.gz,Hyphen-minus,5707,51266451,8155828,59427986,945
hdfs://spark-nn.eemcs.utwente.nl/user/s1934538/clickstream/clickstream-enwiki-2018-01.tsv.gz,Ted_Bundy,40716,676150,4031,720897,98760
hdfs://spark-nn.eemcs.utwente.nl/user/s1934538/clickstream/clickstream-enwiki-2018-01.tsv.gz,Grimes_(musician),6673,31963,155,38791,13204
hdfs://spark-nn.eemcs.utwente.nl/user/s1934538/clickstream/clickstream-enwiki-2018-01.tsv.gz,Bird_Box_(film),2412,2040,33,4485,1550
hdfs://spark-nn.eemcs.utwente.nl/user/s1934538/clickstream/clickstream-enwiki-2018-01.tsv.gz,Asia_Cup,3891,17556,35,21482,6962
hdfs://spark-nn.eemcs.utwente.nl/user/s1934538/clickstream/clickstream-enwiki-2018-01.tsv.gz,WrestleMania_34,99759,85885,1440,187084,33233
hdfs://spark-nn.eemcs.utwente.nl/user/s1934538/clickstream/clickstream-enwiki-2018-01.tsv.gz,Tonya_Harding,226820,3045871,19424,3292115,481977
hdfs://spark-nn.eemcs.utwente.nl/user/s1934538/clickstream/clickstream-enwiki-2018-01.tsv.gz,Kate_Spade,29463,78808,89,108360,15148
hdfs://spark-nn.eemcs.utwente.nl/user/s1934538/clickstream/clickstream-enwiki-2018-01.tsv.gz,List_of_most_popular_websites,28161,192244,136,220541,84015
hdfs://spark-nn.eemcs.utwente.nl/user/s1934538/clickstream/clickstream-enwiki-2018-01.tsv.gz,Tunnel,3148,14350,105,17603,3786
hdfs://spark-nn.eemcs.utwente.nl/user/s1934538/clickstream/clickstream-enwiki-2018-01.tsv.gz,Jeffrey_Epstein,8584,39749,123,48456,10126
hdfs://spark-nn.eemcs.utwente.nl/user/s1934538/clickstream/clickstream-enwiki-2018-01.tsv.gz,J._Robert_Oppenheimer,15103,86359,219,101681,24567
hdfs://spark-nn.eemcs.utwente.nl/user/s1934538/clickstream/clickstream-enwiki-2018-01.tsv.gz,FIFA_World_Cup,28241,153276,2097,183614,95580
hdfs://spark-nn.eemcs.utwente.nl/user/s1934538/clickstream/clickstream-enwiki-2018-01.tsv.gz,Aaron_Carter,9888,62692,280,72860,13046
hdfs://spark-nn.eemcs.utwente.nl/user/s1934538/clickstream/clickstream-enwiki-2018-02.tsv.gz,Cook's_Country,124,4123,19,4266,38
hdfs://spark-nn.eemcs.utwente.nl/user/s1934538/clickstream/clickstream-enwiki-2018-02.tsv.gz,Kelly_Preston,31499,52832,153,84484,15567
hdfs://spark-nn.eemcs.utwente.nl/user/s1934538/clickstream/clickstream-enwiki-2018-02.tsv.gz,Joaquin_Phoenix,50742,173834,634,225210,89640
hdfs://spark-nn.eemcs.utwente.nl/user/s1934538/clickstream/clickstream-enwiki-2018-02.tsv.gz,Ruth_Bader_Ginsburg,16192,118539,514,135245,24538
hdfs://spark-nn.eemcs.utwente.nl/user/s1934538/clickstream/clickstream-enwiki-2018-02.tsv.gz,Avengers:_Infinity_War,343553,725027,8866,1077446,684693
hdfs://spark-nn.eemcs.utwente.nl/user/s1934538/clickstream/clickstream-enwiki-2018-02.tsv.gz,Fyre_Festival,887,16665,75,17627,4783
hdfs://spark-nn.eemcs.utwente.nl/user/s1934538/clickstream/clickstream-enwiki-2018-02.tsv.gz,XXX_(franchise),27727,1559909,946,1588582,260915
hdfs://spark-nn.eemcs.utwente.nl/user/s1934538/clickstream/clickstream-enwiki-2018-02.tsv.gz,The_Umbrella_Academy_(TV_series),5522,8666,26,14214,6797
hdfs://spark-nn.eemcs.utwente.nl/user/s1934538/clickstream/clickstream-enwiki-2018-02.tsv.gz,Juneteenth,2439,111514,60,114013,2689
hdfs://spark-nn.eemcs.utwente.nl/user/s1934538/clickstream/clickstream-enwiki-2018-02.tsv.gz,Fantastic_Beasts:_The_Crimes_of_Grindelwald,52778,82435,318,135531,67182
hdfs://spark-nn.eemcs.utwente.nl/user/s1934538/clickstream/clickstream-enwiki-2018-02.tsv.gz,YouTube,72822,688529,6914,768265,115850
hdfs://spark-nn.eemcs.utwente.nl/user/s1934538/clickstream/clickstream-enwiki-2018-02.tsv.gz,Glass_(2019_film),53139,64431,28,117598,43512
hdfs://spark-nn.eemcs.utwente.nl/user/s1934538/clickstream/clickstream-enwiki-2018-02.tsv.gz,Google_logo,949,20086,12,21047,2600
hdfs://spark-nn.eemcs.utwente.nl/user/s1934538/clickstream/clickstream-enwiki-2018-02.tsv.gz,Luke_Perry,13011,44973,177,58161,6147
hdfs://spark-nn.eemcs.utwente.nl/user/s1934538/clickstream/clickstream-enwiki-2018-02.tsv.gz,Jimmy_Buffett,5527,89609,688,95824,18683
hdfs://spark-nn.eemcs.utwente.nl/user/s1934538/clickstream/clickstream-enwiki-2018-02.tsv.gz,Cecil_Hotel_(Los_Angeles),3068,24388,40,27496,5626
hdfs://spark-nn.eemcs.utwente.nl/user/s1934538/clickstream/clickstream-enwiki-2018-02.tsv.gz,Cricket_World_Cup,7196,85710,369,93275,26923
hdfs://spark-nn.eemcs.utwente.nl/user/s1934538/clickstream/clickstream-enwiki-2018-02.tsv.gz,Tom_Brady,109731,1876452,10009,1996192,380816
hdfs://spark-nn.eemcs.utwente.nl/user/s1934538/clickstream/clickstream-enwiki-2018-02.tsv.gz,Stephen_Hawking,22074,769006,2635,793715,121096
hdfs://spark-nn.eemcs.utwente.nl/user/s1934538/clickstream/clickstream-enwiki-2018-02.tsv.gz,Elon_Musk,165665,3266621,40820,3473106,1392954
hdfs://spark-nn.eemcs.utwente.nl/user/s1934538/clickstream/clickstream-enwiki-2018-02.tsv.gz,Amber_Heard,111780,204553,531,316864,64349
hdfs://spark-nn.eemcs.utwente.nl/user/s1934538/clickstream/clickstream-enwiki-2018-02.tsv.gz,Chadwick_Boseman,393715,1628410,5726,2027851,405881
hdfs://spark-nn.eemcs.utwente.nl/user/s1934538/clickstream/clickstream-enwiki-2018-02.tsv.gz,Media,42,14439,326,14807,2797
hdfs://spark-nn.eemcs.utwente.nl/user/s1934538/clickstream/clickstream-enwiki-2018-02.tsv.gz,The_Lion_King_(2019_film),51660,123231,724,175615,126959
hdfs://spark-nn.eemcs.utwente.nl/user/s1934538/clickstream/clickstream-enwiki-2018-02.tsv.gz,Elizabeth_II,314421,1354513,4175,1673109,645038
hdfs://spark-nn.eemcs.utwente.nl/user/s1934538/clickstream/clickstream-enwiki-2018-02.tsv.gz,Shakira,10592,259823,1661,272076,71112
hdfs://spark-nn.eemcs.utwente.nl/user/s1934538/clickstream/clickstream-enwiki-2018-02.tsv.gz,Johnny_Depp,63642,334962,1875,400479,168743
hdfs://spark-nn.eemcs.utwente.nl/user/s1934538/clickstream/clickstream-enwiki-2018-02.tsv.gz,Jeffrey_Epstein,4090,21653,70,25813,5615
hdfs://spark-nn.eemcs.utwente.nl/user/s1934538/clickstream/clickstream-enwiki-2018-02.tsv.gz,Lisa_Marie_Presley,62036,171326,752,234114,71198
hdfs://spark-nn.eemcs.utwente.nl/user/s1934538/clickstream/clickstream-enwiki-2018-02.tsv.gz,Mac_Miller,17363,46674,198,64235,11200
hdfs://spark-nn.eemcs.utwente.nl/user/s1934538/clickstream/clickstream-enwiki-2018-02.tsv.gz,Grover,803,6228,34,7065,783
hdfs://spark-nn.eemcs.utwente.nl/user/s1934538/clickstream/clickstream-enwiki-2018-02.tsv.gz,Kobe_Bryant,28432,368162,2126,398720,58004
hdfs://spark-nn.eemcs.utwente.nl/user/s1934538/clickstream/clickstream-enwiki-2018-02.tsv.gz,William_Murdoch,510,1715,12,2237,254
hdfs://spark-nn.eemcs.utwente.nl/user/s1934538/clickstream/clickstream-enwiki-2018-02.tsv.gz,Lists_of_deaths_by_year,8251,221956,503,230710,157494
hdfs://spark-nn.eemcs.utwente.nl/user/s1934538/clickstream/clickstream-enwiki-2018-02.tsv.gz,"Diana,_Princess_of_Wales",83269,305300,471,389040,131350
hdfs://spark-nn.eemcs.utwente.nl/user/s1934538/clickstream/clickstream-enwiki-2018-02.tsv.gz,2.0_(film),40655,142626,3219,186500,51551
hdfs://spark-nn.eemcs.utwente.nl/user/s1934538/clickstream/clickstream-enwiki-2018-02.tsv.gz,Cardi_B,39214,1204018,6241,1249473,159715
hdfs://spark-nn.eemcs.utwente.nl/user/s1934538/clickstream/clickstream-enwiki-2018-02.tsv.gz,Irrfan_Khan,28396,67124,198,95718,49625
hdfs://spark-nn.eemcs.utwente.nl/user/s1934538/clickstream/clickstream-enwiki-2018-02.tsv.gz,Betty_White,26626,207271,1300,235197,29462
hdfs://spark-nn.eemcs.utwente.nl/user/s1934538/clickstream/clickstream-enwiki-2018-02.tsv.gz,George_VI,239643,564971,733,805347,271060
hdfs://spark-nn.eemcs.utwente.nl/user/s1934538/clickstream/clickstream-enwiki-2018-02.tsv.gz,Valentine's_Day,23546,1481406,14103,1519055,35413
hdfs://spark-nn.eemcs.utwente.nl/user/s1934538/clickstream/clickstream-enwiki-2018-02.tsv.gz,Louis_Tomlinson,19067,58645,255,77967,8043
hdfs://spark-nn.eemcs.utwente.nl/user/s1934538/clickstream/clickstream-enwiki-2018-02.tsv.gz,Royal_Rumble_(2018),69033,295191,3705,367929,216146
hdfs://spark-nn.eemcs.utwente.nl/user/s1934538/clickstream/clickstream-enwiki-2018-02.tsv.gz,Coronavirus,811,17298,26,18135,1237
hdfs://spark-nn.eemcs.utwente.nl/user/s1934538/clickstream/clickstream-enwiki-2018-02.tsv.gz,Ted_Bundy,37746,500310,3537,541593,79970
hdfs://spark-nn.eemcs.utwente.nl/user/s1934538/clickstream/clickstream-enwiki-2018-02.tsv.gz,Deadpool_2,94354,283885,5315,383554,269011
hdfs://spark-nn.eemcs.utwente.nl/user/s1934538/clickstream/clickstream-enwiki-2018-02.tsv.gz,List_of_James_Bond_films,10250,182141,188,192579,61149
hdfs://spark-nn.eemcs.utwente.nl/user/s1934538/clickstream/clickstream-enwiki-2018-02.tsv.gz,HTTP_cookie,4551,286243,105,290899,18374
hdfs://spark-nn.eemcs.utwente.nl/user/s1934538/clickstream/clickstream-enwiki-2018-02.tsv.gz,John_McCain,19508,116941,962,137411,33292
hdfs://spark-nn.eemcs.utwente.nl/user/s1934538/clickstream/clickstream-enwiki-2018-02.tsv.gz,Area_51,9430,188773,1114,199317,35489
hdfs://spark-nn.eemcs.utwente.nl/user/s1934538/clickstream/clickstream-enwiki-2018-02.tsv.gz,Meat_Loaf,12619,80412,529,93560,23338
hdfs://spark-nn.eemcs.utwente.nl/user/s1934538/clickstream/clickstream-enwiki-2018-02.tsv.gz,The_Irishman,47,578,32,657,471
hdfs://spark-nn.eemcs.utwente.nl/user/s1934538/clickstream/clickstream-enwiki-2018-02.tsv.gz,Stan_Lee,93863,417752,2802,514417,113978
hdfs://spark-nn.eemcs.utwente.nl/user/s1934538/clickstream/clickstream-enwiki-2018-02.tsv.gz,"Princess_Margaret,_Countess_of_Snowdon",100963,996122,2918,1100003,254034
hdfs://spark-nn.eemcs.utwente.nl/user/s1934538/clickstream/clickstream-enwiki-2018-02.tsv.gz,Kamala_Harris,14153,107785,526,122464,25385
hdfs://spark-nn.eemcs.utwente.nl/user/s1934538/clickstream/clickstream-enwiki-2018-02.tsv.gz,A_Star_Is_Born_(2018_film),16056,20729,76,36861,10963
hdfs://spark-nn.eemcs.utwente.nl/user/s1934538/clickstream/clickstream-enwiki-2018-02.tsv.gz,Jenna_Ortega,4120,20070,48,24238,2139
hdfs://spark-nn.eemcs.utwente.nl/user/s1934538/clickstream/clickstream-enwiki-2018-02.tsv.gz,2018_FIFA_World_Cup,71931,643256,7466,722653,257204
hdfs://spark-nn.eemcs.utwente.nl/user/s1934538/clickstream/clickstream-enwiki-2018-02.tsv.gz,2020_Summer_Olympics,179714,615081,3129,797924,223359
hdfs://spark-nn.eemcs.utwente.nl/user/s1934538/clickstream/clickstream-enwiki-2018-02.tsv.gz,Chernobyl_disaster,18160,247891,966,267017,53413
hdfs://spark-nn.eemcs.utwente.nl/user/s1934538/clickstream/clickstream-enwiki-2018-02.tsv.gz,Deion_Sanders,6654,98910,428,105992,15450
hdfs://spark-nn.eemcs.utwente.nl/user/s1934538/clickstream/clickstream-enwiki-2018-02.tsv.gz,Darth_Vader,14647,2786910,568,2802125,30046
hdfs://spark-nn.eemcs.utwente.nl/user/s1934538/clickstream/clickstream-enwiki-2018-02.tsv.gz,Cristiano_Ronaldo,68267,832923,3974,905164,120217
hdfs://spark-nn.eemcs.utwente.nl/user/s1934538/clickstream/clickstream-enwiki-2018-02.tsv.gz,Michael_Bloomberg,16502,54620,329,71451,19109
hdfs://spark-nn.eemcs.utwente.nl/user/s1934538/clickstream/clickstream-enwiki-2018-02.tsv.gz,Atal_Bihari_Vajpayee,16182,51369,85,67636,13661
hdfs://spark-nn.eemcs.utwente.nl/user/s1934538/clickstream/clickstream-enwiki-2018-02.tsv.gz,Notre-Dame_de_Paris,6550,67035,228,73813,9834
hdfs://spark-nn.eemcs.utwente.nl/user/s1934538/clickstream/clickstream-enwiki-2018-02.tsv.gz,"Prince_Philip,_Duke_of_Edinburgh",155767,725806,2465,884038,249830
hdfs://spark-nn.eemcs.utwente.nl/user/s1934538/clickstream/clickstream-enwiki-2018-02.tsv.gz,Charles_Sobhraj,2905,20909,58,23872,2772
hdfs://spark-nn.eemcs.utwente.nl/user/s1934538/clickstream/clickstream-enwiki-2018-02.tsv.gz,XXXTentacion,18578,180542,3141,202261,35951
hdfs://spark-nn.eemcs.utwente.nl/user/s1934538/clickstream/clickstream-enwiki-2018-02.tsv.gz,Lionel_Messi,50216,589552,4389,644157,89920
hdfs://spark-nn.eemcs.utwente.nl/user/s1934538/clickstream/clickstream-enwiki-2018-02.tsv.gz,1234,77,1781,12,1870,152
hdfs://spark-nn.eemcs.utwente.nl/user/s1934538/clickstream/clickstream-enwiki-2018-02.tsv.gz,List_of_FIFA_World_Cup_finals,1158,68867,50,70075,12416
hdfs://spark-nn.eemcs.utwente.nl/user/s1934538/clickstream/clickstream-enwiki-2018-02.tsv.gz,Israel,49279,307598,4011,360888,123973
hdfs://spark-nn.eemcs.utwente.nl/user/s1934538/clickstream/clickstream-enwiki-2018-02.tsv.gz,Bible,11248,97976,1296,110520,29577
hdfs://spark-nn.eemcs.utwente.nl/user/s1934538/clickstream/clickstream-enwiki-2018-02.tsv.gz,R._Kelly,14029,91560,508,106097,29200
hdfs://spark-nn.eemcs.utwente.nl/user/s1934538/clickstream/clickstream-enwiki-2018-02.tsv.gz,Kobe_Bryant_sexual_assault_case,2327,26647,20,28994,1881
hdfs://spark-nn.eemcs.utwente.nl/user/s1934538/clickstream/clickstream-enwiki-2018-02.tsv.gz,Alexander_Hamilton,46621,392731,1652,441004,100289
hdfs://spark-nn.eemcs.utwente.nl/user/s1934538/clickstream/clickstream-enwiki-2018-02.tsv.gz,Queen_(band),25148,142250,1759,169157,109289
hdfs://spark-nn.eemcs.utwente.nl/user/s1934538/clickstream/clickstream-enwiki-2018-02.tsv.gz,Lance_Reddick,11014,22320,64,33398,5197
hdfs://spark-nn.eemcs.utwente.nl/user/s1934538/clickstream/clickstream-enwiki-2018-03.tsv.gz,2018_Asian_Games,9721,47589,215,57525,12790
hdfs://spark-nn.eemcs.utwente.nl/user/s1934538/clickstream/clickstream-enwiki-2018-03.tsv.gz,Black_Panther_(film),352980,3965760,64258,4382998,1933127
hdfs://spark-nn.eemcs.utwente.nl/user/s1934538/clickstream/clickstream-enwiki-2018-03.tsv.gz,Hyphen-minus,5503,65496838,7787753,73290094,822
hdfs://spark-nn.eemcs.utwente.nl/user/s1934538/clickstream/clickstream-enwiki-2018-03.tsv.gz,Mac_Miller,23064,64833,210,88107,15823
hdfs://spark-nn.eemcs.utwente.nl/user/s1934538/clickstream/clickstream-enwiki-2018-03.tsv.gz,JSON_Web_Token,797,20367,26,21190,2012
hdfs://spark-nn.eemcs.utwente.nl/user/s1934538/clickstream/clickstream-enwiki-2018-03.tsv.gz,Cameron_Boyce,9402,43186,117,52705,6498
hdfs://spark-nn.eemcs.utwente.nl/user/s1934538/clickstream/clickstream-enwiki-2018-03.tsv.gz,"Princess_Margaret,_Countess_of_Snowdon",86410,729490,2381,818281,201017
hdfs://spark-nn.eemcs.utwente.nl/user/s1934538/clickstream/clickstream-enwiki-2018-03.tsv.gz,Donald_Trump,208660,1136501,12684,1357845,534902
hdfs://spark-nn.eemcs.utwente.nl/user/s1934538/clickstream/clickstream-enwiki-2018-03.tsv.gz,Aaron_Hernandez,7419,498605,1259,507283,56761
hdfs://spark-nn.eemcs.utwente.nl/user/s1934538/clickstream/clickstream-enwiki-2018-03.tsv.gz,Cecil_Hotel_(Los_Angeles),3238,35873,37,39148,8761
hdfs://spark-nn.eemcs.utwente.nl/user/s1934538/clickstream/clickstream-enwiki-2018-03.tsv.gz,Tom_Brady,20176,192826,1133,214135,39683
hdfs://spark-nn.eemcs.utwente.nl/user/s1934538/clickstream/clickstream-enwiki-2018-03.tsv.gz,Stephen_Hawking,176824,11717014,260407,12154245,2507377
hdfs://spark-nn.eemcs.utwente.nl/user/s1934538/clickstream/clickstream-enwiki-2018-03.tsv.gz,IPv4,13095,62895,234,76224,12967
hdfs://spark-nn.eemcs.utwente.nl/user/s1934538/clickstream/clickstream-enwiki-2018-03.tsv.gz,21_Savage,26340,169765,1341,197446,52130
hdfs://spark-nn.eemcs.utwente.nl/user/s1934538/clickstream/clickstream-enwiki-2018-03.tsv.gz,Elizabeth_II,306878,1198386,2623,1507887,618347
hdfs://spark-nn.eemcs.utwente.nl/user/s1934538/clickstream/clickstream-enwiki-2018-03.tsv.gz,List_of_James_Bond_films,11703,194542,210,206455,66232
hdfs://spark-nn.eemcs.utwente.nl/user/s1934538/clickstream/clickstream-enwiki-2018-03.tsv.gz,Michael_Jordan,49218,616401,4446,670065,127685
hdfs://spark-nn.eemcs.utwente.nl/user/s1934538/clickstream/clickstream-enwiki-2018-03.tsv.gz,Manti_Te'o,2288,16423,38,18749,122
hdfs://spark-nn.eemcs.utwente.nl/user/s1934538/clickstream/clickstream-enwiki-2018-03.tsv.gz,Cristiano_Ronaldo,79759,988860,5885,1074504,166713
hdfs://spark-nn.eemcs.utwente.nl/user/s1934538/clickstream/clickstream-enwiki-2018-03.tsv.gz,Tunnel,2892,15629,113,18634,3728
hdfs://spark-nn.eemcs.utwente.nl/user/s1934538/clickstream/clickstream-enwiki-2018-03.tsv.gz,Keanu_Reeves,54444,511424,2865,568733,222476
hdfs://spark-nn.eemcs.utwente.nl/user/s1934538/clickstream/clickstream-enwiki-2018-03.tsv.gz,Kelly_Preston,34541,61299,114,95954,17131
hdfs://spark-nn.eemcs.utwente.nl/user/s1934538/clickstream/clickstream-enwiki-2018-03.tsv.gz,Darth_Vader,19834,2711414,663,2731911,37142
hdfs://spark-nn.eemcs.utwente.nl/user/s1934538/clickstream/clickstream-enwiki-2018-03.tsv.gz,Deaths_in_2018,1124138,2240458,9426,3374022,1692558
hdfs://spark-nn.eemcs.utwente.nl/user/s1934538/clickstream/clickstream-enwiki-2018-03.tsv.gz,Elon_Musk,92950,1279726,8160,1380836,526361
hdfs://spark-nn.eemcs.utwente.nl/user/s1934538/clickstream/clickstream-enwiki-2018-03.tsv.gz,Sushant_Singh_Rajput,22247,75471,300,98018,43854
hdfs://spark-nn.eemcs.utwente.nl/user/s1934538/clickstream/clickstream-enwiki-2018-03.tsv.gz,Afghanistan,36083,158617,1733,196433,95829
hdfs://spark-nn.eemcs.utwente.nl/user/s1934538/clickstream/clickstream-enwiki-2018-03.tsv.gz,List_of_highest-grossing_Indian_films,106927,651506,906,759339,293151
hdfs://spark-nn.eemcs.utwente.nl/user/s1934538/clickstream/clickstream-enwiki-2018-03.tsv.gz,Aquaman_(film),85822,113466,962,200250,99956
hdfs://spark-nn.eemcs.utwente.nl/user/s1934538/clickstream/clickstream-enwiki-2018-03.tsv.gz,Naya_Rivera,14461,55593,71,70125,8015
hdfs://spark-nn.eemcs.utwente.nl/user/s1934538/clickstream/clickstream-enwiki-2018-03.tsv.gz,Meghan_Markle,48111,798367,4337,850815,135802
hdfs://spark-nn.eemcs.utwente.nl/user/s1934538/clickstream/clickstream-enwiki-2018-03.tsv.gz,Croatia,29145,149441,1531,180117,49350
hdfs://spark-nn.eemcs.utwente.nl/user/s1934538/clickstream/clickstream-enwiki-2018-03.tsv.gz,Betty_White,26777,215148,1219,243144,29651
hdfs://spark-nn.eemcs.utwente.nl/user/s1934538/clickstream/clickstream-enwiki-2018-03.tsv.gz,2.0_(film),40693,180488,780,221961,66394
hdfs://spark-nn.eemcs.utwente.nl/user/s1934538/clickstream/clickstream-enwiki-2018-03.tsv.gz,Kamala_Harris,12568,110000,567,123135,25396
hdfs://spark-nn.eemcs.utwente.nl/user/s1934538/clickstream/clickstream-enwiki-2018-03.tsv.gz,Cricket_World_Cup,9860,104615,779,115254,36867
hdfs://spark-nn.eemcs.utwente.nl/user/s1934538/clickstream/clickstream-enwiki-2018-03.tsv.gz,Ruth_Bader_Ginsburg,22585,193141,893,216619,53034
hdfs://spark-nn.eemcs.utwente.nl/user/s1934538/clickstream/clickstream-enwiki-2018-03.tsv.gz,George_VI,223811,515970,639,740420,253668
hdfs://spark-nn.eemcs.utwente.nl/user/s1934538/clickstream/clickstream-enwiki-2018-03.tsv.gz,Valentine's_Day,3937,66875,322,71134,867
hdfs://spark-nn.eemcs.utwente.nl/user/s1934538/clickstream/clickstream-enwiki-2018-03.tsv.gz,Jimmy_Buffett,6309,123743,826,130878,22780
hdfs://spark-nn.eemcs.utwente.nl/user/s1934538/clickstream/clickstream-enwiki-2018-03.tsv.gz,Olivia_Newton-John,14108,110715,835,125658,30478
hdfs://spark-nn.eemcs.utwente.nl/user/s1934538/clickstream/clickstream-enwiki-2018-03.tsv.gz,Captain_Marvel_(film),166154,180439,9050,355643,241868
hdfs://spark-nn.eemcs.utwente.nl/user/s1934538/clickstream/clickstream-enwiki-2018-03.tsv.gz,Bible,12992,112667,3114,128773,34966
hdfs://spark-nn.eemcs.utwente.nl/user/s1934538/clickstream/clickstream-enwiki-2018-03.tsv.gz,Bird_Box_(film),8797,8432,26,17255,5332
hdfs://spark-nn.eemcs.utwente.nl/user/s1934538/clickstream/clickstream-enwiki-2018-03.tsv.gz,R._Kelly,27083,141957,868,169908,46632
hdfs://spark-nn.eemcs.utwente.nl/user/s1934538/clickstream/clickstream-enwiki-2018-03.tsv.gz,Taliban,14236,112614,373,127223,33539
hdfs://spark-nn.eemcs.utwente.nl/user/s1934538/clickstream/clickstream-enwiki-2018-03.tsv.gz,Avengers:_Infinity_War,382211,1582569,28363,1993143,1185757
hdfs://spark-nn.eemcs.utwente.nl/user/s1934538/clickstream/clickstream-enwiki-2018-03.tsv.gz,Exo_(band),27642,2345082,909,2373633,181763
hdfs://spark-nn.eemcs.utwente.nl/user/s1934538/clickstream/clickstream-enwiki-2018-03.tsv.gz,Notre-Dame_de_Paris,7072,84974,395,92441,12831
hdfs://spark-nn.eemcs.utwente.nl/user/s1934538/clickstream/clickstream-enwiki-2018-03.tsv.gz,Israel,55135,330587,4082,389804,125062
hdfs://spark-nn.eemcs.utwente.nl/user/s1934538/clickstream/clickstream-enwiki-2018-03.tsv.gz,Key_frame,874,7120,12,8006,642
hdfs://spark-nn.eemcs.utwente.nl/user/s1934538/clickstream/clickstream-enwiki-2018-03.tsv.gz,Charles_III,60,433,55,548,330
hdfs://spark-nn.eemcs.utwente.nl/user/s1934538/clickstream/clickstream-enwiki-2018-03.tsv.gz,Media,72,20679,382,21133,3429
hdfs://spark-nn.eemcs.utwente.nl/user/s1934538/clickstream/clickstream-enwiki-2018-03.tsv.gz,Microsoft_Office,9408,93096,623,103127,22859
hdfs://spark-nn.eemcs.utwente.nl/user/s1934538/clickstream/clickstream-enwiki-2018-03.tsv.gz,The_Lion_King_(2019_film),56068,120538,1273,177879,135026
hdfs://spark-nn.eemcs.utwente.nl/user/s1934538/clickstream/clickstream-enwiki-2018-03.tsv.gz,Bob_Saget,12733,81258,528,94519,13666
hdfs://spark-nn.eemcs.utwente.nl/user/s1934538/clickstream/clickstream-enwiki-2018-03.tsv.gz,Kim_Jong-un,43639,402545,3465,449649,129002
hdfs://spark-nn.eemcs.utwente.nl/user/s1934538/clickstream/clickstream-enwiki-2018-03.tsv.gz,Glass_(2019_film),62365,72137,48,134550,50466
hdfs://spark-nn.eemcs.utwente.nl/user/s1934538/clickstream/clickstream-enwiki-2018-03.tsv.gz,Donald_Glover,68758,507221,2457,578436,121610
hdfs://spark-nn.eemcs.utwente.nl/user/s1934538/clickstream/clickstream-enwiki-2018-03.tsv.gz,Simone_Biles,7872,63629,187,71688,10294
hdfs://spark-nn.eemcs.utwente.nl/user/s1934538/clickstream/clickstream-enwiki-2018-03.tsv.gz,Prince_Harry,107437,325220,1179,433836,104715
hdfs://spark-nn.eemcs.utwente.nl/user/s1934538/clickstream/clickstream-enwiki-2018-03.tsv.gz,Hamilton_(musical),29583,445863,2045,477491,155404
hdfs://spark-nn.eemcs.utwente.nl/user/s1934538/clickstream/clickstream-enwiki-2018-03.tsv.gz,Stranger_Things,41214,544602,8897,594713,264406
hdfs://spark-nn.eemcs.utwente.nl/user/s1934538/clickstream/clickstream-enwiki-2018-03.tsv.gz,Naomi_Osaka,4789,263739,1266,269794,31283
hdfs://spark-nn.eemcs.utwente.nl/user/s1934538/clickstream/clickstream-enwiki-2018-03.tsv.gz,Jeffrey_Epstein,5426,31739,113,37278,9480
hdfs://spark-nn.eemcs.utwente.nl/user/s1934538/clickstream/clickstream-enwiki-2018-03.tsv.gz,Nipsey_Hussle,8442,99595,395,108432,30565
hdfs://spark-nn.eemcs.utwente.nl/user/s1934538/clickstream/clickstream-enwiki-2018-03.tsv.gz,WrestleMania_34,299654,1521703,25147,1846504,707126
hdfs://spark-nn.eemcs.utwente.nl/user/s1934538/clickstream/clickstream-enwiki-2018-03.tsv.gz,Avicii,6676,43045,413,50134,14092
hdfs://spark-nn.eemcs.utwente.nl/user/s1934538/clickstream/clickstream-enwiki-2018-03.tsv.gz,Joe_Biden,24391,261209,2531,288131,47523
hdfs://spark-nn.eemcs.utwente.nl/user/s1934538/clickstream/clickstream-enwiki-2018-03.tsv.gz,XXX_(franchise),66410,2938725,1167,3006302,487825
hdfs://spark-nn.eemcs.utwente.nl/user/s1934538/clickstream/clickstream-enwiki-2018-03.tsv.gz,Luke_Perry,14680,51778,217,66675,7336
hdfs://spark-nn.eemcs.utwente.nl/user/s1934538/clickstream/clickstream-enwiki-2018-03.tsv.gz,Richard_Jewell,2147,9390,40,11577,1837
hdfs://spark-nn.eemcs.utwente.nl/user/s1934538/clickstream/clickstream-enwiki-2018-03.tsv.gz,John_McCain,19431,115089,954,135474,33700
hdfs://spark-nn.eemcs.utwente.nl/user/s1934538/clickstream/clickstream-enwiki-2018-03.tsv.gz,List_of_FIFA_World_Cup_finals,1682,115230,98,117010,22042
hdfs://spark-nn.eemcs.utwente.nl/user/s1934538/clickstream/clickstream-enwiki-2018-03.tsv.gz,Death_of_Elisa_Lam,8188,103229,198,111615,17007
hdfs://spark-nn.eemcs.utwente.nl/user/s1934538/clickstream/clickstream-enwiki-2018-03.tsv.gz,Irrfan_Khan,33022,316725,5173,354920,109409
hdfs://spark-nn.eemcs.utwente.nl/user/s1934538/clickstream/clickstream-enwiki-2018-03.tsv.gz,Chadwick_Boseman,201756,820034,2852,1024642,206221
hdfs://spark-nn.eemcs.utwente.nl/user/s1934538/clickstream/clickstream-enwiki-2018-03.tsv.gz,Tonya_Harding,134305,1490448,4918,1629671,207546
hdfs://spark-nn.eemcs.utwente.nl/user/s1934538/clickstream/clickstream-enwiki-2018-03.tsv.gz,Venom_(2018_film),50747,173444,1650,225841,83275
hdfs://spark-nn.eemcs.utwente.nl/user/s1934538/clickstream/clickstream-enwiki-2018-03.tsv.gz,List_of_awards_and_nominations_received_by_Meryl_Streep,33200,99801,248,133249,25435
hdfs://spark-nn.eemcs.utwente.nl/user/s1934538/clickstream/clickstream-enwiki-2018-03.tsv.gz,A_Star_Is_Born_(2018_film),23890,33709,107,57706,19194
hdfs://spark-nn.eemcs.utwente.nl/user/s1934538/clickstream/clickstream-enwiki-2018-03.tsv.gz,Puneeth_Rajkumar,10252,41527,40,51819,17844
hdfs://spark-nn.eemcs.utwente.nl/user/s1934538/clickstream/clickstream-enwiki-2018-03.tsv.gz,The_Shape_of_Water,231524,2709845,121031,3062400,488688
hdfs://spark-nn.eemcs.utwente.nl/user/s1934538/clickstream/clickstream-enwiki-2018-03.tsv.gz,Kobe_Bryant_sexual_assault_case,8726,157069,156,165951,7440
hdfs://spark-nn.eemcs.utwente.nl/user/s1934538/clickstream/clickstream-enwiki-2018-03.tsv.gz,Burt_Reynolds,30146,378519,3083,411748,102741
hdfs://spark-nn.eemcs.utwente.nl/user/s1934538/clickstream/clickstream-enwiki-2018-03.tsv.gz,Jimmy_Hoffa,18642,75516,353,94511,19661
hdfs://spark-nn.eemcs.utwente.nl/user/s1934538/clickstream/clickstream-enwiki-2018-03.tsv.gz,"Prince_Philip,_Duke_of_Edinburgh",147511,581072,2671,731254,219710
hdfs://spark-nn.eemcs.utwente.nl/user/s1934538/clickstream/clickstream-enwiki-2018-03.tsv.gz,QAnon,29,2935,170,3134,336
hdfs://spark-nn.eemcs.utwente.nl/user/s1934538/clickstream/clickstream-enwiki-2019-02.tsv.gz,XNXX,3024,64843,6311,74178,20860
hdfs://spark-nn.eemcs.utwente.nl/user/s1934538/clickstream/clickstream-enwiki-2019-02.tsv.gz,Taliban,40143,144213,624,184980,83853
hdfs://spark-nn.eemcs.utwente.nl/user/s1934538/clickstream/clickstream-enwiki-2019-02.tsv.gz,Brie_Larson,149182,549735,5081,703998,286873
hdfs://spark-nn.eemcs.utwente.nl/user/s1934538/clickstream/clickstream-enwiki-2019-02.tsv.gz,Tina_Turner,18666,453159,10455,482280,101891
hdfs://spark-nn.eemcs.utwente.nl/user/s1934538/clickstream/clickstream-enwiki-2019-02.tsv.gz,Qasem_Soleimani,2596,8217,23,10836,4630
hdfs://spark-nn.eemcs.utwente.nl/user/s1934538/clickstream/clickstream-enwiki-2019-02.tsv.gz,Tunnel,3360,11656,101,15117,3786
hdfs://spark-nn.eemcs.utwente.nl/user/s1934538/clickstream/clickstream-enwiki-2019-02.tsv.gz,Israel,73666,327588,5019,406273,178279
hdfs://spark-nn.eemcs.utwente.nl/user/s1934538/clickstream/clickstream-enwiki-2019-02.tsv.gz,Crazy_Rich_Asians_(film),62054,283907,6644,352605,328102
hdfs://spark-nn.eemcs.utwente.nl/user/s1934538/clickstream/clickstream-enwiki-2019-02.tsv.gz,Grover,1213,4973694,38,4974945,1292
hdfs://spark-nn.eemcs.utwente.nl/user/s1934538/clickstream/clickstream-enwiki-2019-02.tsv.gz,Ukraine,37732,131254,3332,172318,75834
hdfs://spark-nn.eemcs.utwente.nl/user/s1934538/clickstream/clickstream-enwiki-2019-02.tsv.gz,Black_Panther_(film),127059,338957,8996,475012,289188
hdfs://spark-nn.eemcs.utwente.nl/user/s1934538/clickstream/clickstream-enwiki-2019-02.tsv.gz,Henry_V_of_England,41417,28712,197,70326,47858
hdfs://spark-nn.eemcs.utwente.nl/user/s1934538/clickstream/clickstream-enwiki-2019-02.tsv.gz,21_Savage,44804,3690709,25883,3761396,674102
hdfs://spark-nn.eemcs.utwente.nl/user/s1934538/clickstream/clickstream-enwiki-2019-02.tsv.gz,Deadpool_2,79257,195415,5376,280048,236756
hdfs://spark-nn.eemcs.utwente.nl/user/s1934538/clickstream/clickstream-enwiki-2019-02.tsv.gz,2022_FIFA_World_Cup,48458,80818,2428,131704,70490
hdfs://spark-nn.eemcs.utwente.nl/user/s1934538/clickstream/clickstream-enwiki-2019-02.tsv.gz,Avengers:_Endgame,336028,485294,12876,834198,499132
hdfs://spark-nn.eemcs.utwente.nl/user/s1934538/clickstream/clickstream-enwiki-2019-02.tsv.gz,Main_Page,25375,453425862,3743396,457194633,31214640
hdfs://spark-nn.eemcs.utwente.nl/user/s1934538/clickstream/clickstream-enwiki-2019-02.tsv.gz,Ghislaine_Maxwell,4863,5970,84,10917,2668
hdfs://spark-nn.eemcs.utwente.nl/user/s1934538/clickstream/clickstream-enwiki-2019-02.tsv.gz,Deaths_in_2019,1309278,1777769,6953,3094000,1891838
hdfs://spark-nn.eemcs.utwente.nl/user/s1934538/clickstream/clickstream-enwiki-2019-02.tsv.gz,The_Irishman,93,645,216,954,1293
hdfs://spark-nn.eemcs.utwente.nl/user/s1934538/clickstream/clickstream-enwiki-2019-02.tsv.gz,Cristiano_Ronaldo,224668,1025806,4937,1255411,191140
hdfs://spark-nn.eemcs.utwente.nl/user/s1934538/clickstream/clickstream-enwiki-2019-02.tsv.gz,HTTP_cookie,13207,284642,117,297966,49838
hdfs://spark-nn.eemcs.utwente.nl/user/s1934538/clickstream/clickstream-enwiki-2019-02.tsv.gz,XXXTentacion,102714,462256,9829,574799,157825
hdfs://spark-nn.eemcs.utwente.nl/user/s1934538/clickstream/clickstream-enwiki-2019-02.tsv.gz,Spanish_flu,21995,93645,908,116548,25971
hdfs://spark-nn.eemcs.utwente.nl/user/s1934538/clickstream/clickstream-enwiki-2019-02.tsv.gz,List_of_Marvel_Cinematic_Universe_films,86433,712843,1842,801118,243546
hdfs://spark-nn.eemcs.utwente.nl/user/s1934538/clickstream/clickstream-enwiki-2019-02.tsv.gz,William_Murdoch,555,1750,20,2325,272
hdfs://spark-nn.eemcs.utwente.nl/user/s1934538/clickstream/clickstream-enwiki-2019-02.tsv.gz,Richard_Ramirez,11709,226768,2938,241415,50903
hdfs://spark-nn.eemcs.utwente.nl/user/s1934538/clickstream/clickstream-enwiki-2019-02.tsv.gz,List_of_James_Bond_films,19752,300302,578,320632,133587
hdfs://spark-nn.eemcs.utwente.nl/user/s1934538/clickstream/clickstream-enwiki-2019-02.tsv.gz,Priyanka_Chopra,136769,526884,2436,666089,292060
hdfs://spark-nn.eemcs.utwente.nl/user/s1934538/clickstream/clickstream-enwiki-2019-02.tsv.gz,Amber_Heard,152204,206945,809,359958,190281
hdfs://spark-nn.eemcs.utwente.nl/user/s1934538/clickstream/clickstream-enwiki-2019-02.tsv.gz,Media,71,20188,277,20536,2361
hdfs://spark-nn.eemcs.utwente.nl/user/s1934538/clickstream/clickstream-enwiki-2019-02.tsv.gz,Lisa_Marie_Presley,172491,137274,443,310208,145407
hdfs://spark-nn.eemcs.utwente.nl/user/s1934538/clickstream/clickstream-enwiki-2019-02.tsv.gz,Atal_Bihari_Vajpayee,24945,84342,134,109421,23210
hdfs://spark-nn.eemcs.utwente.nl/user/s1934538/clickstream/clickstream-enwiki-2019-02.tsv.gz,Valentine's_Day,36133,1751849,16453,1804435,59483
hdfs://spark-nn.eemcs.utwente.nl/user/s1934538/clickstream/clickstream-enwiki-2019-02.tsv.gz,Vladimir_Putin,59424,220732,3417,283573,142203
hdfs://spark-nn.eemcs.utwente.nl/user/s1934538/clickstream/clickstream-enwiki-2019-02.tsv.gz,DMX_(rapper),15589,91557,711,107857,40744
hdfs://spark-nn.eemcs.utwente.nl/user/s1934538/clickstream/clickstream-enwiki-2019-02.tsv.gz,Croatia,31857,110223,1890,143970,52258
hdfs://spark-nn.eemcs.utwente.nl/user/s1934538/clickstream/clickstream-enwiki-2019-02.tsv.gz,Freddie_Mercury,786147,5614497,28897,6429541,2331809
hdfs://spark-nn.eemcs.utwente.nl/user/s1934538/clickstream/clickstream-enwiki-2019-02.tsv.gz,Donald_Glover,96462,572277,5458,674197,226303
hdfs://spark-nn.eemcs.utwente.nl/user/s1934538/clickstream/clickstream-enwiki-2019-02.tsv.gz,The_Shape_of_Water,51740,120741,1903,174384,80975
hdfs://spark-nn.eemcs.utwente.nl/user/s1934538/clickstream/clickstream-enwiki-2019-02.tsv.gz,Avicii,19792,328727,2850,351369,79962
hdfs://spark-nn.eemcs.utwente.nl/user/s1934538/clickstream/clickstream-enwiki-2019-02.tsv.gz,IPv4,13704,49669,139,63512,10604
hdfs://spark-nn.eemcs.utwente.nl/user/s1934538/clickstream/clickstream-enwiki-2019-02.tsv.gz,Jenna_Ortega,11235,21596,744,33575,6088
hdfs://spark-nn.eemcs.utwente.nl/user/s1934538/clickstream/clickstream-enwiki-2019-02.tsv.gz,Simple_Mail_Transfer_Protocol,4963,37401,220,42584,4963
hdfs://spark-nn.eemcs.utwente.nl/user/s1934538/clickstream/clickstream-enwiki-2019-02.tsv.gz,2020_Summer_Olympics,47239,114995,1823,164057,115498
hdfs://spark-nn.eemcs.utwente.nl/user/s1934538/clickstream/clickstream-enwiki-2019-02.tsv.gz,Line_shaft,496,1043,40,1579,98
hdfs://spark-nn.eemcs.utwente.nl/user/s1934538/clickstream/clickstream-enwiki-2019-02.tsv.gz,The_Umbrella_Academy_(TV_series),587995,2778603,38899,3405497,2151704
hdfs://spark-nn.eemcs.utwente.nl/user/s1934538/clickstream/clickstream-enwiki-2019-02.tsv.gz,QAnon,4703,113903,797,119403,26180
hdfs://spark-nn.eemcs.utwente.nl/user/s1934538/clickstream/clickstream-enwiki-2019-02.tsv.gz,Kobe_Bryant,45078,276966,2195,324239,86191
hdfs://spark-nn.eemcs.utwente.nl/user/s1934538/clickstream/clickstream-enwiki-2019-02.tsv.gz,Sushant_Singh_Rajput,31570,87847,319,119736,74635
hdfs://spark-nn.eemcs.utwente.nl/user/s1934538/clickstream/clickstream-enwiki-2019-02.tsv.gz,Naomi_Osaka,12845,110617,811,124273,23532
hdfs://spark-nn.eemcs.utwente.nl/user/s1934538/clickstream/clickstream-enwiki-2019-02.tsv.gz,Venom_(2018_film),49421,268416,5424,323261,170871
hdfs://spark-nn.eemcs.utwente.nl/user/s1934538/clickstream/clickstream-enwiki-2019-02.tsv.gz,Indian_Premier_League,17157,71387,206,88750,56318
hdfs://spark-nn.eemcs.utwente.nl/user/s1934538/clickstream/clickstream-enwiki-2019-02.tsv.gz,Saaho,32217,48226,1093,81536,59020
hdfs://spark-nn.eemcs.utwente.nl/user/s1934538/clickstream/clickstream-enwiki-2019-02.tsv.gz,The_Irishman_(2019_film),76343,185519,2520,264382,225340
hdfs://spark-nn.eemcs.utwente.nl/user/s1934538/clickstream/clickstream-enwiki-2019-02.tsv.gz,Dennis_Nilsen,8557,39610,256,48423,9462
hdfs://spark-nn.eemcs.utwente.nl/user/s1934538/clickstream/clickstream-enwiki-2019-02.tsv.gz,United_States_Electoral_College,22088,101523,180,123791,14624
hdfs://spark-nn.eemcs.utwente.nl/user/s1934538/clickstream/clickstream-enwiki-2019-02.tsv.gz,Johnny_Depp,96580,281722,2145,380447,236552
hdfs://spark-nn.eemcs.utwente.nl/user/s1934538/clickstream/clickstream-enwiki-2019-02.tsv.gz,Anne_Heche,30241,38256,205,68702,19934
hdfs://spark-nn.eemcs.utwente.nl/user/s1934538/clickstream/clickstream-enwiki-2019-02.tsv.gz,Tonya_Harding,33694,172324,779,206797,44483
hdfs://spark-nn.eemcs.utwente.nl/user/s1934538/clickstream/clickstream-enwiki-2019-02.tsv.gz,Matthew_Perry,70724,188099,877,259700,116764
hdfs://spark-nn.eemcs.utwente.nl/user/s1934538/clickstream/clickstream-enwiki-2019-02.tsv.gz,2018_FIFA_World_Cup,59708,734907,1725,796340,113194
hdfs://spark-nn.eemcs.utwente.nl/user/s1934538/clickstream/clickstream-enwiki-2019-02.tsv.gz,Aretha_Franklin,41016,174850,1706,217572,49590
hdfs://spark-nn.eemcs.utwente.nl/user/s1934538/clickstream/clickstream-enwiki-2019-02.tsv.gz,Fyre_Festival,101709,1824100,7589,1933398,884727
hdfs://spark-nn.eemcs.utwente.nl/user/s1934538/clickstream/clickstream-enwiki-2019-02.tsv.gz,Kobe_Bryant_sexual_assault_case,3364,22518,14,25896,2665
hdfs://spark-nn.eemcs.utwente.nl/user/s1934538/clickstream/clickstream-enwiki-2019-02.tsv.gz,Death_of_Elisa_Lam,6492,51052,229,57773,14646
hdfs://spark-nn.eemcs.utwente.nl/user/s1934538/clickstream/clickstream-enwiki-2019-02.tsv.gz,Michael_Jordan,89819,712562,6237,808618,252156
hdfs://spark-nn.eemcs.utwente.nl/user/s1934538/clickstream/clickstream-enwiki-2019-02.tsv.gz,Burt_Reynolds,40475,223799,2277,266551,84493
hdfs://spark-nn.eemcs.utwente.nl/user/s1934538/clickstream/clickstream-enwiki-2019-02.tsv.gz,Queen_(band),418009,1738830,15785,2172624,2303228
hdfs://spark-nn.eemcs.utwente.nl/user/s1934538/clickstream/clickstream-enwiki-2019-02.tsv.gz,The_Nun_(2018_film),24492,118125,982,143599,88608
hdfs://spark-nn.eemcs.utwente.nl/user/s1934538/clickstream/clickstream-enwiki-2019-02.tsv.gz,Murder_of_Dee_Dee_Blanchard,34047,594659,773,629479,114651
hdfs://spark-nn.eemcs.utwente.nl/user/s1934538/clickstream/clickstream-enwiki-2019-02.tsv.gz,Charles_III,72,269,58,399,338
hdfs://spark-nn.eemcs.utwente.nl/user/s1934538/clickstream/clickstream-enwiki-2019-02.tsv.gz,Michael_Bloomberg,32493,84800,713,118006,44285
hdfs://spark-nn.eemcs.utwente.nl/user/s1934538/clickstream/clickstream-enwiki-2019-02.tsv.gz,The_Weeknd,43682,130180,1345,175207,70797
hdfs://spark-nn.eemcs.utwente.nl/user/s1934538/clickstream/clickstream-enwiki-2019-02.tsv.gz,Shakira,15310,187457,2411,205178,85546
hdfs://spark-nn.eemcs.utwente.nl/user/s1934538/clickstream/clickstream-enwiki-2019-02.tsv.gz,Mac_Miller,65918,348279,2953,417150,123130
hdfs://spark-nn.eemcs.utwente.nl/user/s1934538/clickstream/clickstream-enwiki-2019-02.tsv.gz,Anthony_Bourdain,12879,203638,1809,218326,58713
hdfs://spark-nn.eemcs.utwente.nl/user/s1934538/clickstream/clickstream-enwiki-2019-02.tsv.gz,List_of_highest-grossing_Indian_films,93703,444963,1643,540309,267587
hdfs://spark-nn.eemcs.utwente.nl/user/s1934538/clickstream/clickstream-enwiki-2019-02.tsv.gz,Chadwick_Boseman,55011,121414,735,177160,49595
hdfs://spark-nn.eemcs.utwente.nl/user/s1934538/clickstream/clickstream-enwiki-2019-02.tsv.gz,Chernobyl_disaster,35462,275377,2089,312928,96105
hdfs://spark-nn.eemcs.utwente.nl/user/s1934538/clickstream/clickstream-enwiki-2019-02.tsv.gz,Dark_Phoenix_(film),111304,147556,3673,262533,181412
hdfs://spark-nn.eemcs.utwente.nl/user/s1934538/clickstream/clickstream-enwiki-2019-02.tsv.gz,Area_51,15306,165428,1199,181933,51544
hdfs://spark-nn.eemcs.utwente.nl/user/s1934538/clickstream/clickstream-enwiki-2019-02.tsv.gz,State_of_Palestine,39356,76009,278,115643,49947
hdfs://spark-nn.eemcs.utwente.nl/user/s1934538/clickstream/clickstream-enwiki-2019-02.tsv.gz,YouTube,105695,754050,9013,868758,131027
hdfs://spark-nn.eemcs.utwente.nl/user/s1934538/clickstream/clickstream-enwiki-2019-02.tsv.gz,Exo_(band),22913,120368,605,143886,153488
hdfs://spark-nn.eemcs.utwente.nl/user/s1934538/clickstream/clickstream-enwiki-2019-02.tsv.gz,Cook's_Country,269,4412,34,4715,66
hdfs://spark-nn.eemcs.utwente.nl/user/s1934538/clickstream/clickstream-enwiki-2019-02.tsv.gz,Donald_Trump,261373,1076048,14473,1351894,797285
hdfs://spark-nn.eemcs.utwente.nl/user/s1934538/clickstream/clickstream-enwiki-2019-02.tsv.gz,Deion_Sanders,14826,342404,2423,359653,103013
hdfs://spark-nn.eemcs.utwente.nl/user/s1934538/clickstream/clickstream-enwiki-2019-02.tsv.gz,Asia_Cup,775,16882,113,17770,6315
hdfs://spark-nn.eemcs.utwente.nl/user/s1934538/clickstream/clickstream-enwiki-2019-02.tsv.gz,Bird_Box_(film),94293,389673,5741,489707,171447
hdfs://spark-nn.eemcs.utwente.nl/user/s1934538/clickstream/clickstream-enwiki-2019-02.tsv.gz,Grimes_(musician),91865,58136,427,150428,36965
hdfs://spark-nn.eemcs.utwente.nl/user/s1934538/clickstream/clickstream-enwiki-2019-02.tsv.gz,Sridevi,23988,150598,471,175057,52711
hdfs://spark-nn.eemcs.utwente.nl/user/s1934538/clickstream/clickstream-enwiki-2019-02.tsv.gz,"Diana,_Princess_of_Wales",112899,224761,2286,339946,198784
hdfs://spark-nn.eemcs.utwente.nl/user/s1934538/clickstream/clickstream-enwiki-2019-02.tsv.gz,John_McCain,36903,107003,1117,145023,63472
hdfs://spark-nn.eemcs.utwente.nl/user/s1934538/clickstream/clickstream-enwiki-2019-02.tsv.gz,1234,92,1468,10,1570,113
hdfs://spark-nn.eemcs.utwente.nl/user/s1934538/clickstream/clickstream-enwiki-2019-02.tsv.gz,Google_logo,954,20867,11,21832,2039
hdfs://spark-nn.eemcs.utwente.nl/user/s1934538/clickstream/clickstream-enwiki-2019-02.tsv.gz,Roe_v._Wade,16318,155901,806,173025,44350
hdfs://spark-nn.eemcs.utwente.nl/user/s1934538/clickstream/clickstream-enwiki-2019-02.tsv.gz,Sushma_Swaraj,5558,46211,60,51829,12529
hdfs://spark-nn.eemcs.utwente.nl/user/s1934538/clickstream/clickstream-enwiki-2019-02.tsv.gz,Aaron_Carter,14925,36177,228,51330,15564
hdfs://spark-nn.eemcs.utwente.nl/user/s1934538/clickstream/clickstream-enwiki-2019-02.tsv.gz,Wonder_Woman_1984,69692,31280,277,101249,56101
hdfs://spark-nn.eemcs.utwente.nl/user/s1934538/clickstream/clickstream-enwiki-2019-02.tsv.gz,Fantastic_Beasts:_The_Crimes_of_Grindelwald,107481,364365,5860,477706,252538
hdfs://spark-nn.eemcs.utwente.nl/user/s1934538/clickstream/clickstream-enwiki-2019-02.tsv.gz,The_Lion_King_(2019_film),69672,147970,2071,219713,206258
hdfs://spark-nn.eemcs.utwente.nl/user/s1934538/clickstream/clickstream-enwiki-2020-07.tsv.gz,Sinéad_O'Connor,12929,84641,642,98212,26695
hdfs://spark-nn.eemcs.utwente.nl/user/s1934538/clickstream/clickstream-enwiki-2020-07.tsv.gz,The_Shape_of_Water,27235,76094,739,104068,42183
hdfs://spark-nn.eemcs.utwente.nl/user/s1934538/clickstream/clickstream-enwiki-2020-07.tsv.gz,1234,66,1639,13,1718,198
hdfs://spark-nn.eemcs.utwente.nl/user/s1934538/clickstream/clickstream-enwiki-2020-07.tsv.gz,Israel,95497,279553,4344,379394,188929
hdfs://spark-nn.eemcs.utwente.nl/user/s1934538/clickstream/clickstream-enwiki-2020-07.tsv.gz,Matthew_Perry,74070,189488,725,264283,152183
hdfs://spark-nn.eemcs.utwente.nl/user/s1934538/clickstream/clickstream-enwiki-2020-07.tsv.gz,Indian_Premier_League,11980,64981,78,77039,50167
hdfs://spark-nn.eemcs.utwente.nl/user/s1934538/clickstream/clickstream-enwiki-2020-07.tsv.gz,Shooting_of_Breonna_Taylor,18974,1161424,6449,1186847,90005
hdfs://spark-nn.eemcs.utwente.nl/user/s1934538/clickstream/clickstream-enwiki-2020-07.tsv.gz,Juneteenth,6921,194240,980,202141,18836
hdfs://spark-nn.eemcs.utwente.nl/user/s1934538/clickstream/clickstream-enwiki-2020-07.tsv.gz,Coronavirus_disease_2019,319107,672163,9980,1001250,325541
hdfs://spark-nn.eemcs.utwente.nl/user/s1934538/clickstream/clickstream-enwiki-2020-07.tsv.gz,Elizabeth_II,576866,732556,3482,1312904,1078073
hdfs://spark-nn.eemcs.utwente.nl/user/s1934538/clickstream/clickstream-enwiki-2020-07.tsv.gz,Freddie_Mercury,86067,552847,3835,642749,233586
hdfs://spark-nn.eemcs.utwente.nl/user/s1934538/clickstream/clickstream-enwiki-2020-07.tsv.gz,Wonder_Woman_1984,63527,107649,3789,174965,83839
hdfs://spark-nn.eemcs.utwente.nl/user/s1934538/clickstream/clickstream-enwiki-2020-07.tsv.gz,Lionel_Messi,116339,574021,6828,697188,164954
hdfs://spark-nn.eemcs.utwente.nl/user/s1934538/clickstream/clickstream-enwiki-2020-07.tsv.gz,"Diana,_Princess_of_Wales",154622,380804,3019,538445,346595
hdfs://spark-nn.eemcs.utwente.nl/user/s1934538/clickstream/clickstream-enwiki-2020-07.tsv.gz,Fyre_Festival,11755,78828,454,91037,50591
hdfs://spark-nn.eemcs.utwente.nl/user/s1934538/clickstream/clickstream-enwiki-2020-07.tsv.gz,HTTP_cookie,3801,379670,119,383590,24521
hdfs://spark-nn.eemcs.utwente.nl/user/s1934538/clickstream/clickstream-enwiki-2020-07.tsv.gz,Death_of_Elisa_Lam,6709,70059,876,77644,20449
hdfs://spark-nn.eemcs.utwente.nl/user/s1934538/clickstream/clickstream-enwiki-2020-07.tsv.gz,John_McCain,53210,119842,1265,174317,85098
hdfs://spark-nn.eemcs.utwente.nl/user/s1934538/clickstream/clickstream-enwiki-2020-07.tsv.gz,21_Savage,14979,65458,666,81103,27519
hdfs://spark-nn.eemcs.utwente.nl/user/s1934538/clickstream/clickstream-enwiki-2020-07.tsv.gz,Aretha_Franklin,25630,108586,1297,135513,57025
hdfs://spark-nn.eemcs.utwente.nl/user/s1934538/clickstream/clickstream-enwiki-2020-07.tsv.gz,Mötley_Crüe,32450,107523,1141,141114,175875
hdfs://spark-nn.eemcs.utwente.nl/user/s1934538/clickstream/clickstream-enwiki-2020-07.tsv.gz,Hyphen-minus,4432,6710157,7873168,14587757,710
hdfs://spark-nn.eemcs.utwente.nl/user/s1934538/clickstream/clickstream-enwiki-2020-07.tsv.gz,Ted_Bundy,44915,413467,4261,462643,109190
hdfs://spark-nn.eemcs.utwente.nl/user/s1934538/clickstream/clickstream-enwiki-2020-07.tsv.gz,Grimes_(musician),197541,307927,926,506394,119912
hdfs://spark-nn.eemcs.utwente.nl/user/s1934538/clickstream/clickstream-enwiki-2020-07.tsv.gz,UEFA_Euro_2020,38127,111296,1720,151143,67576
hdfs://spark-nn.eemcs.utwente.nl/user/s1934538/clickstream/clickstream-enwiki-2020-07.tsv.gz,Simone_Biles,27392,139415,879,167686,50532
hdfs://spark-nn.eemcs.utwente.nl/user/s1934538/clickstream/clickstream-enwiki-2020-07.tsv.gz,"Prince_Philip,_Duke_of_Edinburgh",273621,337443,6928,617992,402559
hdfs://spark-nn.eemcs.utwente.nl/user/s1934538/clickstream/clickstream-enwiki-2020-07.tsv.gz,Notre-Dame_de_Paris,13831,80801,983,95615,25903
hdfs://spark-nn.eemcs.utwente.nl/user/s1934538/clickstream/clickstream-enwiki-2020-07.tsv.gz,Dark_Phoenix_(film),77206,138071,1174,216451,116195
hdfs://spark-nn.eemcs.utwente.nl/user/s1934538/clickstream/clickstream-enwiki-2020-07.tsv.gz,The_Falcon_and_the_Winter_Soldier,55952,56174,645,112771,57391
hdfs://spark-nn.eemcs.utwente.nl/user/s1934538/clickstream/clickstream-enwiki-2020-07.tsv.gz,Deadpool_2,56132,115875,1687,173694,110628
hdfs://spark-nn.eemcs.utwente.nl/user/s1934538/clickstream/clickstream-enwiki-2020-07.tsv.gz,State_of_Palestine,51047,298327,177,349551,111812
hdfs://spark-nn.eemcs.utwente.nl/user/s1934538/clickstream/clickstream-enwiki-2020-07.tsv.gz,2020_United_States_presidential_election,222233,837927,15754,1075914,629097
hdfs://spark-nn.eemcs.utwente.nl/user/s1934538/clickstream/clickstream-enwiki-2020-07.tsv.gz,Taliban,26288,59904,380,86572,57252
hdfs://spark-nn.eemcs.utwente.nl/user/s1934538/clickstream/clickstream-enwiki-2020-07.tsv.gz,Antifa_(United_States),23982,632373,1926,658281,91239
hdfs://spark-nn.eemcs.utwente.nl/user/s1934538/clickstream/clickstream-enwiki-2020-07.tsv.gz,List_of_Marvel_Cinematic_Universe_films,85524,832681,2010,920215,339138
hdfs://spark-nn.eemcs.utwente.nl/user/s1934538/clickstream/clickstream-enwiki-2020-07.tsv.gz,Atal_Bihari_Vajpayee,33889,64630,64,98583,32563
hdfs://spark-nn.eemcs.utwente.nl/user/s1934538/clickstream/clickstream-enwiki-2020-07.tsv.gz,Cricket_World_Cup,7576,68825,262,76663,35429
hdfs://spark-nn.eemcs.utwente.nl/user/s1934538/clickstream/clickstream-enwiki-2020-07.tsv.gz,List_of_highest-grossing_films,122051,338338,911,461300,199641
hdfs://spark-nn.eemcs.utwente.nl/user/s1934538/clickstream/clickstream-enwiki-2020-07.tsv.gz,Wikipedia,250573,740187,1065,991825,277519
hdfs://spark-nn.eemcs.utwente.nl/user/s1934538/clickstream/clickstream-enwiki-2020-07.tsv.gz,Glass_(2019_film),49668,79372,541,129581,43011
hdfs://spark-nn.eemcs.utwente.nl/user/s1934538/clickstream/clickstream-enwiki-2020-07.tsv.gz,Ukraine,46897,117615,2589,167101,82261
hdfs://spark-nn.eemcs.utwente.nl/user/s1934538/clickstream/clickstream-enwiki-2020-07.tsv.gz,William_Murdoch,586,1246,14,1846,243
hdfs://spark-nn.eemcs.utwente.nl/user/s1934538/clickstream/clickstream-enwiki-2020-07.tsv.gz,Brett_Kavanaugh,47105,57852,308,105265,40616
hdfs://spark-nn.eemcs.utwente.nl/user/s1934538/clickstream/clickstream-enwiki-2020-07.tsv.gz,Sushant_Singh_Rajput,240980,2043856,28780,2313616,796631
hdfs://spark-nn.eemcs.utwente.nl/user/s1934538/clickstream/clickstream-enwiki-2020-07.tsv.gz,Main_Page,61590,162819417,4520225,167401232,33773111
hdfs://spark-nn.eemcs.utwente.nl/user/s1934538/clickstream/clickstream-enwiki-2020-07.tsv.gz,Chadwick_Boseman,37465,64850,380,102695,35290
hdfs://spark-nn.eemcs.utwente.nl/user/s1934538/clickstream/clickstream-enwiki-2020-07.tsv.gz,1917_(2019_film),38408,207611,3081,249100,126184
hdfs://spark-nn.eemcs.utwente.nl/user/s1934538/clickstream/clickstream-enwiki-2020-07.tsv.gz,Central_Park_jogger_case,32008,172249,527,204784,30729
hdfs://spark-nn.eemcs.utwente.nl/user/s1934538/clickstream/clickstream-enwiki-2020-07.tsv.gz,Ghislaine_Maxwell,556340,2906549,25502,3488391,1647807
hdfs://spark-nn.eemcs.utwente.nl/user/s1934538/clickstream/clickstream-enwiki-2020-07.tsv.gz,Richard_Ramirez,24130,229895,1523,255548,83549
hdfs://spark-nn.eemcs.utwente.nl/user/s1934538/clickstream/clickstream-enwiki-2020-07.tsv.gz,Joe_Biden,180021,837140,13108,1030269,379857
hdfs://spark-nn.eemcs.utwente.nl/user/s1934538/clickstream/clickstream-enwiki-2020-07.tsv.gz,Stephen_Hawking,41583,403194,2090,446867,181785
hdfs://spark-nn.eemcs.utwente.nl/user/s1934538/clickstream/clickstream-enwiki-2020-07.tsv.gz,Kobe_Bryant_sexual_assault_case,4707,28971,41,33719,2514
hdfs://spark-nn.eemcs.utwente.nl/user/s1934538/clickstream/clickstream-enwiki-2020-07.tsv.gz,QAnon,107981,2664749,10911,2783641,433591
hdfs://spark-nn.eemcs.utwente.nl/user/s1934538/clickstream/clickstream-enwiki-2020-07.tsv.gz,Cleopatra,49102,979005,2127,1030234,146346
hdfs://spark-nn.eemcs.utwente.nl/user/s1934538/clickstream/clickstream-enwiki-2020-07.tsv.gz,Charles_Sobhraj,3431,21956,45,25432,5559
hdfs://spark-nn.eemcs.utwente.nl/user/s1934538/clickstream/clickstream-enwiki-2020-07.tsv.gz,Loki_(TV_series),31001,17057,82,48140,18773
hdfs://spark-nn.eemcs.utwente.nl/user/s1934538/clickstream/clickstream-enwiki-2020-07.tsv.gz,Top_Gun:_Maverick,61290,106654,4123,172067,104146
hdfs://spark-nn.eemcs.utwente.nl/user/s1934538/clickstream/clickstream-enwiki-2020-07.tsv.gz,Pornhub,48237,563156,14666,626059,113203
hdfs://spark-nn.eemcs.utwente.nl/user/s1934538/clickstream/clickstream-enwiki-2020-07.tsv.gz,Christopher_Scarver,58508,27131,16,85655,27036
hdfs://spark-nn.eemcs.utwente.nl/user/s1934538/clickstream/clickstream-enwiki-2020-07.tsv.gz,J._Robert_Oppenheimer,26941,160630,655,188226,69117
hdfs://spark-nn.eemcs.utwente.nl/user/s1934538/clickstream/clickstream-enwiki-2020-07.tsv.gz,List_of_Queen_of_the_South_episodes,41385,30799,81,72265,1987
hdfs://spark-nn.eemcs.utwente.nl/user/s1934538/clickstream/clickstream-enwiki-2020-07.tsv.gz,The_Batman_(film),112420,102814,2697,217931,216318
hdfs://spark-nn.eemcs.utwente.nl/user/s1934538/clickstream/clickstream-enwiki-2020-07.tsv.gz,The_Weeknd,66922,223274,2871,293067,128096
hdfs://spark-nn.eemcs.utwente.nl/user/s1934538/clickstream/clickstream-enwiki-2020-07.tsv.gz,WandaVision,43251,31872,271,75394,38231
hdfs://spark-nn.eemcs.utwente.nl/user/s1934538/clickstream/clickstream-enwiki-2020-07.tsv.gz,Cook's_Country,493,4628,45,5166,1406
hdfs://spark-nn.eemcs.utwente.nl/user/s1934538/clickstream/clickstream-enwiki-2020-07.tsv.gz,IPv4,9881,42741,125,52747,8832
hdfs://spark-nn.eemcs.utwente.nl/user/s1934538/clickstream/clickstream-enwiki-2020-07.tsv.gz,Vladimir_Putin,110261,470521,5822,586604,341388
hdfs://spark-nn.eemcs.utwente.nl/user/s1934538/clickstream/clickstream-enwiki-2020-07.tsv.gz,Pelé,37934,133213,1031,172178,57055
hdfs://spark-nn.eemcs.utwente.nl/user/s1934538/clickstream/clickstream-enwiki-2020-07.tsv.gz,David_Beckham,79629,277057,2024,358710,145065
hdfs://spark-nn.eemcs.utwente.nl/user/s1934538/clickstream/clickstream-enwiki-2020-07.tsv.gz,Royal_Rumble_(2018),10755,8964,117,19836,13182
hdfs://spark-nn.eemcs.utwente.nl/user/s1934538/clickstream/clickstream-enwiki-2020-07.tsv.gz,Stranger_Things_(season_3),22243,63448,690,86381,48488
hdfs://spark-nn.eemcs.utwente.nl/user/s1934538/clickstream/clickstream-enwiki-2020-07.tsv.gz,Queen_(band),62567,220186,3350,286103,284500
hdfs://spark-nn.eemcs.utwente.nl/user/s1934538/clickstream/clickstream-enwiki-2020-07.tsv.gz,Star_Wars:_The_Rise_of_Skywalker,105061,169181,3807,278049,152342
hdfs://spark-nn.eemcs.utwente.nl/user/s1934538/clickstream/clickstream-enwiki-2020-07.tsv.gz,Kelly_Preston,438409,3528770,42922,4010101,1356760
hdfs://spark-nn.eemcs.utwente.nl/user/s1934538/clickstream/clickstream-enwiki-2020-07.tsv.gz,Simple_Mail_Transfer_Protocol,3594,28945,128,32667,3459
hdfs://spark-nn.eemcs.utwente.nl/user/s1934538/clickstream/clickstream-enwiki-2020-07.tsv.gz,Watts_family_murders,4447,147845,259,152551,46594
hdfs://spark-nn.eemcs.utwente.nl/user/s1934538/clickstream/clickstream-enwiki-2020-07.tsv.gz,Deaths_in_2020,1407460,2381412,17693,3806565,2354101
hdfs://spark-nn.eemcs.utwente.nl/user/s1934538/clickstream/clickstream-enwiki-2020-07.tsv.gz,Rami_Malek,71225,183432,699,255356,98541
hdfs://spark-nn.eemcs.utwente.nl/user/s1934538/clickstream/clickstream-enwiki-2020-07.tsv.gz,Louis_Tomlinson,62583,116604,463,179650,30014
hdfs://spark-nn.eemcs.utwente.nl/user/s1934538/clickstream/clickstream-enwiki-2020-07.tsv.gz,Greta_Thunberg,10327,173368,1380,185075,44884
hdfs://spark-nn.eemcs.utwente.nl/user/s1934538/clickstream/clickstream-enwiki-2020-07.tsv.gz,Stranger_Things_(season_4),35245,192639,824,228708,119010
hdfs://spark-nn.eemcs.utwente.nl/user/s1934538/clickstream/clickstream-enwiki-2020-07.tsv.gz,Parasite_(2019_film),54592,376467,3322,434381,177412
hdfs://spark-nn.eemcs.utwente.nl/user/s1934538/clickstream/clickstream-enwiki-2020-07.tsv.gz,List_of_most_popular_websites,15005,75532,81,90618,37506
hdfs://spark-nn.eemcs.utwente.nl/user/s1934538/clickstream/clickstream-enwiki-2020-07.tsv.gz,"Meghan,_Duchess_of_Sussex",115750,283704,1961,401415,210767
hdfs://spark-nn.eemcs.utwente.nl/user/s1934538/clickstream/clickstream-enwiki-2020-07.tsv.gz,Crazy_Rich_Asians_(film),39798,163311,1752,204861,212053
hdfs://spark-nn.eemcs.utwente.nl/user/s1934538/clickstream/clickstream-enwiki-2020-07.tsv.gz,2020_Summer_Olympics,55772,168002,2938,226712,122306
hdfs://spark-nn.eemcs.utwente.nl/user/s1934538/clickstream/clickstream-enwiki-2020-07.tsv.gz,Coronavirus,32068,584955,8941,625964,167780
hdfs://spark-nn.eemcs.utwente.nl/user/s1934538/clickstream/clickstream-enwiki-2020-07.tsv.gz,Charles_III,100,272,58,430,301
hdfs://spark-nn.eemcs.utwente.nl/user/s1934538/clickstream/clickstream-enwiki-2020-07.tsv.gz,Amy_Coney_Barrett,2320,13746,83,16149,4058
hdfs://spark-nn.eemcs.utwente.nl/user/s1934538/clickstream/clickstream-enwiki-2020-07.tsv.gz,Juice_Wrld,56593,932597,8029,997219,361729
hdfs://spark-nn.eemcs.utwente.nl/user/s1934538/clickstream/clickstream-enwiki-2020-07.tsv.gz,2018_Winter_Olympics,19510,15073,233,34816,25498
hdfs://spark-nn.eemcs.utwente.nl/user/s1934538/clickstream/clickstream-enwiki-2020-07.tsv.gz,YouTube,165130,971575,9675,1146380,141106
hdfs://spark-nn.eemcs.utwente.nl/user/s1934538/clickstream/clickstream-enwiki-2020-07.tsv.gz,Nipsey_Hussle,33065,147159,1116,181340,55761
hdfs://spark-nn.eemcs.utwente.nl/user/s1934538/clickstream/clickstream-enwiki-2020-07.tsv.gz,The_Lion_King_(2019_film),52694,175728,1082,229504,110185
hdfs://spark-nn.eemcs.utwente.nl/user/s1934538/clickstream/clickstream-enwiki-2020-07.tsv.gz,Kate_Spade,31565,66352,722,98639,33543
hdfs://spark-nn.eemcs.utwente.nl/user/s1934538/clickstream/clickstream-enwiki-2020-07.tsv.gz,WrestleMania_34,19507,11754,193,31454,20679
hdfs://spark-nn.eemcs.utwente.nl/user/s1934538/clickstream/clickstream-enwiki-2020-07.tsv.gz,The_Mandalorian,65559,317544,8463,391566,265951
hdfs://spark-nn.eemcs.utwente.nl/user/s1934538/clickstream/clickstream-enwiki-2020-07.tsv.gz,Lisa_Marie_Presley,279212,717203,7799,1004214,567866
hdfs://spark-nn.eemcs.utwente.nl/user/s1934538/clickstream/clickstream-enwiki-2020-07.tsv.gz,Tenet_(film),122948,427676,8759,559383,275275
hdfs://spark-nn.eemcs.utwente.nl/user/s1934538/clickstream/clickstream-enwiki-2020-07.tsv.gz,DMX_(rapper),21612,154858,944,177414,81690
hdfs://spark-nn.eemcs.utwente.nl/user/s1934538/clickstream/clickstream-enwiki-2020-07.tsv.gz,XXXTentacion,84505,463525,4775,552805,108619
hdfs://spark-nn.eemcs.utwente.nl/user/s1934538/clickstream/clickstream-enwiki-2020-07.tsv.gz,The_Nun_(2018_film),20782,84535,539,105856,67717
hdfs://spark-nn.eemcs.utwente.nl/user/s1934538/clickstream/clickstream-enwiki-2020-07.tsv.gz,The_Umbrella_Academy_(TV_series),89578,646460,13381,749419,464399
hdfs://spark-nn.eemcs.utwente.nl/user/s1934538/clickstream/clickstream-enwiki-2020-07.tsv.gz,2023_Cricket_World_Cup,10545,21722,114,32381,11016
hdfs://spark-nn.eemcs.utwente.nl/user/s1934538/clickstream/clickstream-enwiki-2020-07.tsv.gz,Stan_Lee,49241,134963,1109,185313,54783
hdfs://spark-nn.eemcs.utwente.nl/user/s1934538/clickstream/clickstream-enwiki-2020-08.tsv.gz,Ghislaine_Maxwell,193678,464068,2513,660259,249037
hdfs://spark-nn.eemcs.utwente.nl/user/s1934538/clickstream/clickstream-enwiki-2020-08.tsv.gz,Naomi_Osaka,13949,150477,7883,172309,51611
hdfs://spark-nn.eemcs.utwente.nl/user/s1934538/clickstream/clickstream-enwiki-2020-08.tsv.gz,Grimes_(musician),137826,156309,430,294565,69901
hdfs://spark-nn.eemcs.utwente.nl/user/s1934538/clickstream/clickstream-enwiki-2020-08.tsv.gz,Area_51,20112,157342,1398,178852,46131
hdfs://spark-nn.eemcs.utwente.nl/user/s1934538/clickstream/clickstream-enwiki-2020-08.tsv.gz,Charles_III,87,308,72,467,305
hdfs://spark-nn.eemcs.utwente.nl/user/s1934538/clickstream/clickstream-enwiki-2020-08.tsv.gz,Brie_Larson,81796,254735,15389,351920,133688
hdfs://spark-nn.eemcs.utwente.nl/user/s1934538/clickstream/clickstream-enwiki-2020-08.tsv.gz,Bible,16827,5091638,1808,5110273,35640
hdfs://spark-nn.eemcs.utwente.nl/user/s1934538/clickstream/clickstream-enwiki-2020-08.tsv.gz,K.G.F:_Chapter_2,29234,151579,196,181009,79296
hdfs://spark-nn.eemcs.utwente.nl/user/s1934538/clickstream/clickstream-enwiki-2020-08.tsv.gz,United_States_Senate,125436,98663,2077,226176,93512
hdfs://spark-nn.eemcs.utwente.nl/user/s1934538/clickstream/clickstream-enwiki-2020-08.tsv.gz,Murder_of_Dee_Dee_Blanchard,19451,163377,547,183375,33853
hdfs://spark-nn.eemcs.utwente.nl/user/s1934538/clickstream/clickstream-enwiki-2020-08.tsv.gz,Tina_Turner,27277,269352,1880,298509,88217
hdfs://spark-nn.eemcs.utwente.nl/user/s1934538/clickstream/clickstream-enwiki-2020-08.tsv.gz,Us_(2019_film),34217,146120,889,181226,52572
hdfs://spark-nn.eemcs.utwente.nl/user/s1934538/clickstream/clickstream-enwiki-2020-08.tsv.gz,2020_Summer_Olympics,46364,114170,2243,162777,98383
hdfs://spark-nn.eemcs.utwente.nl/user/s1934538/clickstream/clickstream-enwiki-2020-08.tsv.gz,Bipin_Rawat,9662,23813,19,33494,16470
hdfs://spark-nn.eemcs.utwente.nl/user/s1934538/clickstream/clickstream-enwiki-2020-08.tsv.gz,The_Suicide_Squad_(film),232716,368660,6819,608195,1159654
hdfs://spark-nn.eemcs.utwente.nl/user/s1934538/clickstream/clickstream-enwiki-2020-08.tsv.gz,2.0_(film),19961,50820,148,70929,18115
hdfs://spark-nn.eemcs.utwente.nl/user/s1934538/clickstream/clickstream-enwiki-2020-08.tsv.gz,List_of_highest-grossing_Indian_films,49821,175350,221,225392,126316
hdfs://spark-nn.eemcs.utwente.nl/user/s1934538/clickstream/clickstream-enwiki-2020-08.tsv.gz,Johnny_Depp,139560,445963,2911,588434,416171
hdfs://spark-nn.eemcs.utwente.nl/user/s1934538/clickstream/clickstream-enwiki-2020-08.tsv.gz,Chernobyl_disaster,70880,457305,3696,531881,208812
hdfs://spark-nn.eemcs.utwente.nl/user/s1934538/clickstream/clickstream-enwiki-2020-08.tsv.gz,Shinzo_Abe,157093,325540,517,483150,278159
hdfs://spark-nn.eemcs.utwente.nl/user/s1934538/clickstream/clickstream-enwiki-2020-08.tsv.gz,Kelly_Preston,133066,321308,2084,456458,143263
hdfs://spark-nn.eemcs.utwente.nl/user/s1934538/clickstream/clickstream-enwiki-2020-08.tsv.gz,A_Star_Is_Born_(2018_film),37061,163758,782,201601,91850
hdfs://spark-nn.eemcs.utwente.nl/user/s1934538/clickstream/clickstream-enwiki-2020-08.tsv.gz,Michael_Bloomberg,48367,80414,1023,129804,55242
hdfs://spark-nn.eemcs.utwente.nl/user/s1934538/clickstream/clickstream-enwiki-2020-08.tsv.gz,Rihanna,72191,295932,3846,371969,181629
hdfs://spark-nn.eemcs.utwente.nl/user/s1934538/clickstream/clickstream-enwiki-2020-08.tsv.gz,Godzilla_vs._Kong,61772,57768,8331,127871,79360
hdfs://spark-nn.eemcs.utwente.nl/user/s1934538/clickstream/clickstream-enwiki-2020-08.tsv.gz,NATO,49260,114043,2396,165699,64305
hdfs://spark-nn.eemcs.utwente.nl/user/s1934538/clickstream/clickstream-enwiki-2020-08.tsv.gz,Puneeth_Rajkumar,10887,20391,44,31322,17248
hdfs://spark-nn.eemcs.utwente.nl/user/s1934538/clickstream/clickstream-enwiki-2020-08.tsv.gz,Venom_(2018_film),31652,194187,2077,227916,124883
hdfs://spark-nn.eemcs.utwente.nl/user/s1934538/clickstream/clickstream-enwiki-2020-08.tsv.gz,Sylvester_Stallone,101992,316417,2204,420613,308318
hdfs://spark-nn.eemcs.utwente.nl/user/s1934538/clickstream/clickstream-enwiki-2020-08.tsv.gz,Mulan_(2020_film),73588,528162,9842,611592,291352
hdfs://spark-nn.eemcs.utwente.nl/user/s1934538/clickstream/clickstream-enwiki-2020-08.tsv.gz,Adele,22764,201677,2724,227165,75934
hdfs://spark-nn.eemcs.utwente.nl/user/s1934538/clickstream/clickstream-enwiki-2020-08.tsv.gz,Watts_family_murders,4222,175336,327,179885,58898
hdfs://spark-nn.eemcs.utwente.nl/user/s1934538/clickstream/clickstream-enwiki-2020-08.tsv.gz,The_Umbrella_Academy_(TV_series),392781,3606742,60155,4059678,2914398
hdfs://spark-nn.eemcs.utwente.nl/user/s1934538/clickstream/clickstream-enwiki-2020-08.tsv.gz,Ray_Liotta,43361,65907,388,109656,35620
hdfs://spark-nn.eemcs.utwente.nl/user/s1934538/clickstream/clickstream-enwiki-2020-08.tsv.gz,2016_United_States_presidential_election,318573,691807,7299,1017679,765462
hdfs://spark-nn.eemcs.utwente.nl/user/s1934538/clickstream/clickstream-enwiki-2020-08.tsv.gz,William_Murdoch,533,1465,11,2009,318
hdfs://spark-nn.eemcs.utwente.nl/user/s1934538/clickstream/clickstream-enwiki-2020-08.tsv.gz,Aaron_Hernandez,7876,96426,414,104716,31176
hdfs://spark-nn.eemcs.utwente.nl/user/s1934538/clickstream/clickstream-enwiki-2020-08.tsv.gz,Captain_Marvel_(film),46983,138875,1595,187453,96023
hdfs://spark-nn.eemcs.utwente.nl/user/s1934538/clickstream/clickstream-enwiki-2020-08.tsv.gz,Top_Gun:_Maverick,57725,94005,2135,153865,104782
hdfs://spark-nn.eemcs.utwente.nl/user/s1934538/clickstream/clickstream-enwiki-2020-08.tsv.gz,DMX_(rapper),24310,128209,814,153333,80459
hdfs://spark-nn.eemcs.utwente.nl/user/s1934538/clickstream/clickstream-enwiki-2020-08.tsv.gz,Jimmy_Hoffa,41034,174490,1352,216876,78994
hdfs://spark-nn.eemcs.utwente.nl/user/s1934538/clickstream/clickstream-enwiki-2020-08.tsv.gz,J._Robert_Oppenheimer,32996,183347,968,217311,78644
hdfs://spark-nn.eemcs.utwente.nl/user/s1934538/clickstream/clickstream-enwiki-2020-08.tsv.gz,Dark_Phoenix_(film),72253,118155,1110,191518,112585
hdfs://spark-nn.eemcs.utwente.nl/user/s1934538/clickstream/clickstream-enwiki-2020-08.tsv.gz,Rami_Malek,66808,165627,733,233168,94126
hdfs://spark-nn.eemcs.utwente.nl/user/s1934538/clickstream/clickstream-enwiki-2020-08.tsv.gz,Once_Upon_a_Time_in_Hollywood,110735,274166,3721,388622,402732
hdfs://spark-nn.eemcs.utwente.nl/user/s1934538/clickstream/clickstream-enwiki-2020-08.tsv.gz,Coronavirus,27919,403659,6126,437704,117431
hdfs://spark-nn.eemcs.utwente.nl/user/s1934538/clickstream/clickstream-enwiki-2020-08.tsv.gz,Anne_Heche,39254,138504,977,178735,55756
hdfs://spark-nn.eemcs.utwente.nl/user/s1934538/clickstream/clickstream-enwiki-2020-08.tsv.gz,XXX:_Return_of_Xander_Cage,33873,409656,923,444452,54271
hdfs://spark-nn.eemcs.utwente.nl/user/s1934538/clickstream/clickstream-enwiki-2020-08.tsv.gz,The_Witcher_(TV_series),37874,232304,3909,274087,173517
hdfs://spark-nn.eemcs.utwente.nl/user/s1934538/clickstream/clickstream-enwiki-2020-08.tsv.gz,List_of_Marvel_Cinematic_Universe_films,150814,803116,2043,955973,399179
hdfs://spark-nn.eemcs.utwente.nl/user/s1934538/clickstream/clickstream-enwiki-2020-08.tsv.gz,The_Nun_(2018_film),21923,63845,397,86165,52967
hdfs://spark-nn.eemcs.utwente.nl/user/s1934538/clickstream/clickstream-enwiki-2020-08.tsv.gz,Main_Page,60511,161742089,4518885,166321485,33402426
hdfs://spark-nn.eemcs.utwente.nl/user/s1934538/clickstream/clickstream-enwiki-2020-08.tsv.gz,Cecil_Hotel_(Los_Angeles),5908,28860,43,34811,12620
hdfs://spark-nn.eemcs.utwente.nl/user/s1934538/clickstream/clickstream-enwiki-2020-08.tsv.gz,Betty_White,69243,252066,2957,324266,98782
hdfs://spark-nn.eemcs.utwente.nl/user/s1934538/clickstream/clickstream-enwiki-2020-08.tsv.gz,Army_of_the_Dead,45198,22363,320,67881,49780
hdfs://spark-nn.eemcs.utwente.nl/user/s1934538/clickstream/clickstream-enwiki-2020-08.tsv.gz,Avicii,20478,292262,2305,315045,134923
hdfs://spark-nn.eemcs.utwente.nl/user/s1934538/clickstream/clickstream-enwiki-2020-08.tsv.gz,Cardi_B,101341,745338,11874,858553,291717
hdfs://spark-nn.eemcs.utwente.nl/user/s1934538/clickstream/clickstream-enwiki-2020-08.tsv.gz,Critical_race_theory,3578,60419,279,64276,17019
hdfs://spark-nn.eemcs.utwente.nl/user/s1934538/clickstream/clickstream-enwiki-2020-08.tsv.gz,COVID-19_pandemic_by_country_and_territory,695297,849703,128115,1673115,1498338
hdfs://spark-nn.eemcs.utwente.nl/user/s1934538/clickstream/clickstream-enwiki-2020-08.tsv.gz,September_11_attacks,96848,346849,2541,446238,217392
hdfs://spark-nn.eemcs.utwente.nl/user/s1934538/clickstream/clickstream-enwiki-2020-08.tsv.gz,Article_370_of_the_Constitution_of_India,5097,104338,55,109490,7422
hdfs://spark-nn.eemcs.utwente.nl/user/s1934538/clickstream/clickstream-enwiki-2020-08.tsv.gz,COVID-19_pandemic,753150,1029726,6574,1789450,1129407
hdfs://spark-nn.eemcs.utwente.nl/user/s1934538/clickstream/clickstream-enwiki-2020-08.tsv.gz,Antifa_(United_States),24167,698367,2508,725042,87793
hdfs://spark-nn.eemcs.utwente.nl/user/s1934538/clickstream/clickstream-enwiki-2020-08.tsv.gz,It_Chapter_Two,40734,126714,1122,168570,112865
hdfs://spark-nn.eemcs.utwente.nl/user/s1934538/clickstream/clickstream-enwiki-2020-08.tsv.gz,List_of_awards_and_nominations_received_by_Meryl_Streep,17684,11029,161,28874,11391
hdfs://spark-nn.eemcs.utwente.nl/user/s1934538/clickstream/clickstream-enwiki-2020-08.tsv.gz,Shakira,25479,258776,1988,286243,136828
hdfs://spark-nn.eemcs.utwente.nl/user/s1934538/clickstream/clickstream-enwiki-2020-08.tsv.gz,Lionel_Messi,140751,1225843,13976,1380570,333039
hdfs://spark-nn.eemcs.utwente.nl/user/s1934538/clickstream/clickstream-enwiki-2020-08.tsv.gz,Notre-Dame_de_Paris,10912,73618,847,85377,19482
hdfs://spark-nn.eemcs.utwente.nl/user/s1934538/clickstream/clickstream-enwiki-2020-08.tsv.gz,Rishi_Sunak,28527,109848,440,138815,52996
hdfs://spark-nn.eemcs.utwente.nl/user/s1934538/clickstream/clickstream-enwiki-2020-08.tsv.gz,Amber_Heard,110045,270276,2301,382622,173503
hdfs://spark-nn.eemcs.utwente.nl/user/s1934538/clickstream/clickstream-enwiki-2020-08.tsv.gz,War_(2019_film),21251,101170,193,122614,27357
hdfs://spark-nn.eemcs.utwente.nl/user/s1934538/clickstream/clickstream-enwiki-2020-08.tsv.gz,Spanish_flu,67065,705975,8091,781131,165643
hdfs://spark-nn.eemcs.utwente.nl/user/s1934538/clickstream/clickstream-enwiki-2020-08.tsv.gz,Croatia,45540,140537,1953,188030,67444
hdfs://spark-nn.eemcs.utwente.nl/user/s1934538/clickstream/clickstream-enwiki-2020-08.tsv.gz,FIFA_World_Cup,43200,158865,1939,204004,148520
hdfs://spark-nn.eemcs.utwente.nl/user/s1934538/clickstream/clickstream-enwiki-2020-08.tsv.gz,WrestleMania_34,18331,11554,277,30162,19631
hdfs://spark-nn.eemcs.utwente.nl/user/s1934538/clickstream/clickstream-enwiki-2020-08.tsv.gz,Greta_Thunberg,11347,166898,1017,179262,39942
hdfs://spark-nn.eemcs.utwente.nl/user/s1934538/clickstream/clickstream-enwiki-2020-08.tsv.gz,Deadpool_2,47936,69662,1161,118759,85829
hdfs://spark-nn.eemcs.utwente.nl/user/s1934538/clickstream/clickstream-enwiki-2020-08.tsv.gz,Taliban,27005,61101,357,88463,58462
hdfs://spark-nn.eemcs.utwente.nl/user/s1934538/clickstream/clickstream-enwiki-2020-08.tsv.gz,Exo_(band),25575,129296,391,155262,147843
hdfs://spark-nn.eemcs.utwente.nl/user/s1934538/clickstream/clickstream-enwiki-2020-08.tsv.gz,"Diana,_Princess_of_Wales",156424,417757,7955,582136,353326
hdfs://spark-nn.eemcs.utwente.nl/user/s1934538/clickstream/clickstream-enwiki-2020-08.tsv.gz,Stranger_Things,66471,298898,6036,371405,309662
hdfs://spark-nn.eemcs.utwente.nl/user/s1934538/clickstream/clickstream-enwiki-2020-08.tsv.gz,Media,66,3275,316,3657,1719
hdfs://spark-nn.eemcs.utwente.nl/user/s1934538/clickstream/clickstream-enwiki-2020-08.tsv.gz,Game_of_Thrones,74271,265980,6207,346458,228225
hdfs://spark-nn.eemcs.utwente.nl/user/s1934538/clickstream/clickstream-enwiki-2020-08.tsv.gz,YouTube,144531,1017891,11323,1173745,129290
hdfs://spark-nn.eemcs.utwente.nl/user/s1934538/clickstream/clickstream-enwiki-2020-08.tsv.gz,Louis_Tomlinson,44613,99117,494,144224,22920
hdfs://spark-nn.eemcs.utwente.nl/user/s1934538/clickstream/clickstream-enwiki-2020-08.tsv.gz,Russo-Ukrainian_War,24295,28149,145,52589,33289
hdfs://spark-nn.eemcs.utwente.nl/user/s1934538/clickstream/clickstream-enwiki-2020-08.tsv.gz,Ukraine,55242,135543,3362,194147,96625
hdfs://spark-nn.eemcs.utwente.nl/user/s1934538/clickstream/clickstream-enwiki-2020-08.tsv.gz,21_Savage,14765,58315,599,73679,26415
hdfs://spark-nn.eemcs.utwente.nl/user/s1934538/clickstream/clickstream-enwiki-2020-08.tsv.gz,Crazy_Rich_Asians_(film),31469,118587,1230,151286,144406
hdfs://spark-nn.eemcs.utwente.nl/user/s1934538/clickstream/clickstream-enwiki-2020-08.tsv.gz,Jeffrey_Epstein,101561,1182347,6711,1290619,519143
hdfs://spark-nn.eemcs.utwente.nl/user/s1934538/clickstream/clickstream-enwiki-2020-08.tsv.gz,Avengers:_Endgame,170687,287578,4003,462268,283463
hdfs://spark-nn.eemcs.utwente.nl/user/s1934538/clickstream/clickstream-enwiki-2020-08.tsv.gz,Elon_Musk,129293,1972732,11644,2113669,851876
hdfs://spark-nn.eemcs.utwente.nl/user/s1934538/clickstream/clickstream-enwiki-2020-08.tsv.gz,Key_frame,633,4900,10,5543,468
hdfs://spark-nn.eemcs.utwente.nl/user/s1934538/clickstream/clickstream-enwiki-2020-08.tsv.gz,Kamala_Harris,626563,14629854,107942,15364359,7505863
hdfs://spark-nn.eemcs.utwente.nl/user/s1934538/clickstream/clickstream-enwiki-2020-08.tsv.gz,Game_of_Thrones_(season_8),16236,56144,773,73153,26767
hdfs://spark-nn.eemcs.utwente.nl/user/s1934538/clickstream/clickstream-enwiki-2020-08.tsv.gz,XHamster,15341,85470,3359,104170,18453
hdfs://spark-nn.eemcs.utwente.nl/user/s1934538/clickstream/clickstream-enwiki-2020-08.tsv.gz,Salman_Rushdie,38512,77681,418,116611,43101
hdfs://spark-nn.eemcs.utwente.nl/user/s1934538/clickstream/clickstream-enwiki-2020-08.tsv.gz,Joaquin_Phoenix,171961,313940,1169,487070,320468
hdfs://spark-nn.eemcs.utwente.nl/user/s1934538/clickstream/clickstream-enwiki-2020-08.tsv.gz,Black_Panther_(film),413685,1103387,21263,1538335,893948
hdfs://spark-nn.eemcs.utwente.nl/user/s1934538/clickstream/clickstream-enwiki-2020-08.tsv.gz,Death_of_Elisa_Lam,8626,174878,525,184029,29769
hdfs://spark-nn.eemcs.utwente.nl/user/s1934538/clickstream/clickstream-enwiki-2020-08.tsv.gz,Aaron_Carter,15024,44755,258,60037,27257
hdfs://spark-nn.eemcs.utwente.nl/user/s1934538/clickstream/clickstream-enwiki-2020-08.tsv.gz,Jimmy_Buffett,10032,54721,601,65354,26854
hdfs://spark-nn.eemcs.utwente.nl/user/s1934538/clickstream/clickstream-enwiki-2020-08.tsv.gz,Sushma_Swaraj,7728,47648,63,55439,11981
hdfs://spark-nn.eemcs.utwente.nl/user/s1934538/clickstream/clickstream-enwiki-2020-08.tsv.gz,Juice_Wrld,44853,642637,5722,693212,210052
hdfs://spark-nn.eemcs.utwente.nl/user/s1934538/clickstream/clickstream-enwiki-2020-08.tsv.gz,Freddie_Mercury,74996,480262,3512,558770,201874
hdfs://spark-nn.eemcs.utwente.nl/user/s1934538/clickstream/clickstream-enwiki-2020-08.tsv.gz,Saaho,24254,74858,357,99469,31733
hdfs://spark-nn.eemcs.utwente.nl/user/s1934538/clickstream/clickstream-enwiki-2020-08.tsv.gz,List_of_Queen_of_the_South_episodes,26211,20506,106,46823,1237
hdfs://spark-nn.eemcs.utwente.nl/user/s1934538/clickstream/clickstream-enwiki-2020-08.tsv.gz,Indian_Premier_League,20333,136655,178,157166,101852
hdfs://spark-nn.eemcs.utwente.nl/user/s1934538/clickstream/clickstream-enwiki-2020-08.tsv.gz,No_Time_to_Die,143558,131246,2569,277373,183255
hdfs://spark-nn.eemcs.utwente.nl/user/s1934538/clickstream/clickstream-enwiki-2020-08.tsv.gz,Roe_v._Wade,18720,72687,348,91755,28658
hdfs://spark-nn.eemcs.utwente.nl/user/s1934538/clickstream/clickstream-enwiki-2020-08.tsv.gz,Mac_Miller,36731,212606,1680,251017,83699
hdfs://spark-nn.eemcs.utwente.nl/user/s1934538/clickstream/clickstream-enwiki-2020-08.tsv.gz,Richard_Jewell,69769,586752,2445,658966,208952
hdfs://spark-nn.eemcs.utwente.nl/user/s1934538/clickstream/clickstream-enwiki-2020-08.tsv.gz,Joe_Biden,516495,3108621,37453,3662569,1680634
hdfs://spark-nn.eemcs.utwente.nl/user/s1934538/clickstream/clickstream-enwiki-2020-08.tsv.gz,The_Irishman,62540,164234,2394,229168,195618
hdfs://spark-nn.eemcs.utwente.nl/user/s1934538/clickstream/clickstream-enwiki-2020-08.tsv.gz,John_McCain,70256,194580,2229,267065,124162
hdfs://spark-nn.eemcs.utwente.nl/user/s1934538/clickstream/clickstream-enwiki-2020-08.tsv.gz,Meat_Loaf,25572,93707,889,120168,42237
hdfs://spark-nn.eemcs.utwente.nl/user/s1934538/clickstream/clickstream-enwiki-2020-08.tsv.gz,Anthony_Bourdain,19132,309106,2333,330571,94072
hdfs://spark-nn.eemcs.utwente.nl/user/s1934538/clickstream/clickstream-enwiki-2020-08.tsv.gz,Parasite_(2019_film),48853,379920,2887,431660,161358
hdfs://spark-nn.eemcs.utwente.nl/user/s1934538/clickstream/clickstream-enwiki-2020-08.tsv.gz,2020_United_States_presidential_election,331974,878990,21691,1232655,876760
hdfs://spark-nn.eemcs.utwente.nl/user/s1934538/clickstream/clickstream-enwiki-2020-08.tsv.gz,Simple_Mail_Transfer_Protocol,3419,27667,118,31204,3383
hdfs://spark-nn.eemcs.utwente.nl/user/s1934538/clickstream/clickstream-enwiki-2020-08.tsv.gz,Atal_Bihari_Vajpayee,38078,121794,185,160057,41013
hdfs://spark-nn.eemcs.utwente.nl/user/s1934538/clickstream/clickstream-enwiki-2020-08.tsv.gz,Hamilton_(musical),137467,713674,6211,857352,728653
hdfs://spark-nn.eemcs.utwente.nl/user/s1934538/clickstream/clickstream-enwiki-2020-08.tsv.gz,Naya_Rivera,103581,389770,2338,495689,162111
hdfs://spark-nn.eemcs.utwente.nl/user/s1934538/clickstream/clickstream-enwiki-2020-08.tsv.gz,UEFA_Euro_2020,41795,106959,1443,150197,66664
hdfs://spark-nn.eemcs.utwente.nl/user/s1934538/clickstream/clickstream-enwiki-2020-08.tsv.gz,Irrfan_Khan,43926,117004,351,161281,54407
hdfs://spark-nn.eemcs.utwente.nl/user/s1934538/clickstream/clickstream-enwiki-2020-08.tsv.gz,Bonnie_and_Clyde,26677,265020,1743,293440,69488
hdfs://spark-nn.eemcs.utwente.nl/user/s1934538/clickstream/clickstream-enwiki-2020-08.tsv.gz,A_Quiet_Place_(film),26724,94213,752,121689,41304
hdfs://spark-nn.eemcs.utwente.nl/user/s1934538/clickstream/clickstream-enwiki-2020-08.tsv.gz,Mötley_Crüe,31827,101085,1315,134227,168063
hdfs://spark-nn.eemcs.utwente.nl/user/s1934538/clickstream/clickstream-enwiki-2020-08.tsv.gz,Anna_Sorokin,9999,30344,99,40442,8793
hdfs://spark-nn.eemcs.utwente.nl/user/s1934538/clickstream/clickstream-enwiki-2020-08.tsv.gz,Cleopatra,47290,849112,2055,898457,137149
hdfs://spark-nn.eemcs.utwente.nl/user/s1934538/clickstream/clickstream-enwiki-2020-09.tsv.gz,Crazy_Rich_Asians_(film),27301,97076,1121,125498,118539
hdfs://spark-nn.eemcs.utwente.nl/user/s1934538/clickstream/clickstream-enwiki-2020-09.tsv.gz,Game_of_Thrones,76631,267761,6447,350839,223609
hdfs://spark-nn.eemcs.utwente.nl/user/s1934538/clickstream/clickstream-enwiki-2020-09.tsv.gz,Ukraine,42540,117793,2543,162876,76341
hdfs://spark-nn.eemcs.utwente.nl/user/s1934538/clickstream/clickstream-enwiki-2020-09.tsv.gz,Cameron_Boyce,31232,180109,774,212115,61034
hdfs://spark-nn.eemcs.utwente.nl/user/s1934538/clickstream/clickstream-enwiki-2020-09.tsv.gz,Afghanistan,50627,131904,1771,184302,97059
hdfs://spark-nn.eemcs.utwente.nl/user/s1934538/clickstream/clickstream-enwiki-2020-09.tsv.gz,Dennis_Nilsen,153613,3375996,18447,3548056,676621
hdfs://spark-nn.eemcs.utwente.nl/user/s1934538/clickstream/clickstream-enwiki-2020-09.tsv.gz,Sinéad_O'Connor,12305,79205,615,92125,26832
hdfs://spark-nn.eemcs.utwente.nl/user/s1934538/clickstream/clickstream-enwiki-2020-09.tsv.gz,Grover,1211,5457,40,6708,1388
hdfs://spark-nn.eemcs.utwente.nl/user/s1934538/clickstream/clickstream-enwiki-2020-09.tsv.gz,List_of_James_Bond_films,89571,545898,532,636001,409175
hdfs://spark-nn.eemcs.utwente.nl/user/s1934538/clickstream/clickstream-enwiki-2020-09.tsv.gz,2020_Summer_Olympics,44651,90792,1677,137120,85184
hdfs://spark-nn.eemcs.utwente.nl/user/s1934538/clickstream/clickstream-enwiki-2020-09.tsv.gz,Asia_Cup,849,10223,67,11139,5160
hdfs://spark-nn.eemcs.utwente.nl/user/s1934538/clickstream/clickstream-enwiki-2020-09.tsv.gz,Salman_Rushdie,39106,61100,315,100521,39771
hdfs://spark-nn.eemcs.utwente.nl/user/s1934538/clickstream/clickstream-enwiki-2020-09.tsv.gz,XXX:_Return_of_Xander_Cage,38310,451510,1320,491140,66704
hdfs://spark-nn.eemcs.utwente.nl/user/s1934538/clickstream/clickstream-enwiki-2020-09.tsv.gz,Israel,83021,252179,4668,339868,166289
hdfs://spark-nn.eemcs.utwente.nl/user/s1934538/clickstream/clickstream-enwiki-2020-09.tsv.gz,Vladimir_Putin,89435,285878,3038,378351,215620
hdfs://spark-nn.eemcs.utwente.nl/user/s1934538/clickstream/clickstream-enwiki-2020-09.tsv.gz,Burt_Reynolds,48363,161646,1129,211138,91257
hdfs://spark-nn.eemcs.utwente.nl/user/s1934538/clickstream/clickstream-enwiki-2020-09.tsv.gz,Ted_Bundy,41634,400637,4380,446651,105401
hdfs://spark-nn.eemcs.utwente.nl/user/s1934538/clickstream/clickstream-enwiki-2020-09.tsv.gz,Taliban,30288,75656,821,106765,67157
hdfs://spark-nn.eemcs.utwente.nl/user/s1934538/clickstream/clickstream-enwiki-2020-09.tsv.gz,Jeffrey_Epstein,39389,367871,2457,409717,161132
hdfs://spark-nn.eemcs.utwente.nl/user/s1934538/clickstream/clickstream-enwiki-2020-09.tsv.gz,Google_logo,1263,14705,15,15983,1417
hdfs://spark-nn.eemcs.utwente.nl/user/s1934538/clickstream/clickstream-enwiki-2020-09.tsv.gz,Mac_Miller,35010,298043,1789,334842,98937
hdfs://spark-nn.eemcs.utwente.nl/user/s1934538/clickstream/clickstream-enwiki-2020-09.tsv.gz,Lance_Reddick,27515,35910,215,63640,13560
hdfs://spark-nn.eemcs.utwente.nl/user/s1934538/clickstream/clickstream-enwiki-2020-09.tsv.gz,Bipin_Rawat,9721,23750,30,33501,16100
hdfs://spark-nn.eemcs.utwente.nl/user/s1934538/clickstream/clickstream-enwiki-2020-09.tsv.gz,State_of_Palestine,42430,114456,77,156963,68062
hdfs://spark-nn.eemcs.utwente.nl/user/s1934538/clickstream/clickstream-enwiki-2020-09.tsv.gz,When_They_See_Us,18684,59336,285,78305,38128
hdfs://spark-nn.eemcs.utwente.nl/user/s1934538/clickstream/clickstream-enwiki-2020-09.tsv.gz,Michael_Bloomberg,40269,102594,705,143568,59831
hdfs://spark-nn.eemcs.utwente.nl/user/s1934538/clickstream/clickstream-enwiki-2020-09.tsv.gz,Game_of_Thrones_(season_8),16106,53003,736,69845,25130
hdfs://spark-nn.eemcs.utwente.nl/user/s1934538/clickstream/clickstream-enwiki-2020-09.tsv.gz,Exo_(band),24533,122501,352,147386,136431
hdfs://spark-nn.eemcs.utwente.nl/user/s1934538/clickstream/clickstream-enwiki-2020-09.tsv.gz,Bible,16506,3160788,1633,3178927,33077
hdfs://spark-nn.eemcs.utwente.nl/user/s1934538/clickstream/clickstream-enwiki-2020-09.tsv.gz,Main_Page,11969,155968809,4430049,160410827,32516480
hdfs://spark-nn.eemcs.utwente.nl/user/s1934538/clickstream/clickstream-enwiki-2020-09.tsv.gz,Venom_(2018_film),32399,178809,4147,215355,122929
hdfs://spark-nn.eemcs.utwente.nl/user/s1934538/clickstream/clickstream-enwiki-2020-09.tsv.gz,"Diana,_Princess_of_Wales",132541,345069,3127,480737,289450
hdfs://spark-nn.eemcs.utwente.nl/user/s1934538/clickstream/clickstream-enwiki-2020-09.tsv.gz,Luke_Perry,37494,136066,603,174163,53756
hdfs://spark-nn.eemcs.utwente.nl/user/s1934538/clickstream/clickstream-enwiki-2020-09.tsv.gz,Central_Park_jogger_case,23906,129374,489,153769,22387
hdfs://spark-nn.eemcs.utwente.nl/user/s1934538/clickstream/clickstream-enwiki-2020-09.tsv.gz,List_of_awards_and_nominations_received_by_Meryl_Streep,16128,10747,204,27079,10687
hdfs://spark-nn.eemcs.utwente.nl/user/s1934538/clickstream/clickstream-enwiki-2020-09.tsv.gz,Godzilla_vs._Kong,73433,56670,1007,131110,82471
hdfs://spark-nn.eemcs.utwente.nl/user/s1934538/clickstream/clickstream-enwiki-2020-09.tsv.gz,Donald_Glover,54528,209318,1273,265119,100372
hdfs://spark-nn.eemcs.utwente.nl/user/s1934538/clickstream/clickstream-enwiki-2020-09.tsv.gz,Cleopatra,49958,853535,4906,908399,134786
hdfs://spark-nn.eemcs.utwente.nl/user/s1934538/clickstream/clickstream-enwiki-2020-09.tsv.gz,FIFA_World_Cup,35884,133629,1823,171336,118415
hdfs://spark-nn.eemcs.utwente.nl/user/s1934538/clickstream/clickstream-enwiki-2020-09.tsv.gz,Stranger_Things_(season_3),19908,57334,433,77675,39720
hdfs://spark-nn.eemcs.utwente.nl/user/s1934538/clickstream/clickstream-enwiki-2020-09.tsv.gz,A_Quiet_Place_(film),25380,97189,774,123343,40477
hdfs://spark-nn.eemcs.utwente.nl/user/s1934538/clickstream/clickstream-enwiki-2020-09.tsv.gz,George_H._W._Bush,215643,172068,1179,388890,229040
hdfs://spark-nn.eemcs.utwente.nl/user/s1934538/clickstream/clickstream-enwiki-2020-09.tsv.gz,Elon_Musk,100418,1090762,9006,1200186,654833
hdfs://spark-nn.eemcs.utwente.nl/user/s1934538/clickstream/clickstream-enwiki-2020-09.tsv.gz,The_Nun_(2018_film),19289,66192,762,86243,51253
hdfs://spark-nn.eemcs.utwente.nl/user/s1934538/clickstream/clickstream-enwiki-2020-09.tsv.gz,Glass_(2019_film),51846,62453,432,114731,38609
hdfs://spark-nn.eemcs.utwente.nl/user/s1934538/clickstream/clickstream-enwiki-2020-09.tsv.gz,Fantastic_Beasts:_The_Crimes_of_Grindelwald,59876,99422,1159,160457,84529
hdfs://spark-nn.eemcs.utwente.nl/user/s1934538/clickstream/clickstream-enwiki-2020-09.tsv.gz,Antifa_(United_States),54134,1043433,3835,1101402,144648
hdfs://spark-nn.eemcs.utwente.nl/user/s1934538/clickstream/clickstream-enwiki-2020-09.tsv.gz,War_(2019_film),17086,91675,146,108907,23057
hdfs://spark-nn.eemcs.utwente.nl/user/s1934538/clickstream/clickstream-enwiki-2020-09.tsv.gz,Naya_Rivera,108049,274730,1169,383948,133933
hdfs://spark-nn.eemcs.utwente.nl/user/s1934538/clickstream/clickstream-enwiki-2020-09.tsv.gz,XHamster,12381,114514,2678,129573,19503
hdfs://spark-nn.eemcs.utwente.nl/user/s1934538/clickstream/clickstream-enwiki-2020-09.tsv.gz,Charles_III,66,200,54,320,241
hdfs://spark-nn.eemcs.utwente.nl/user/s1934538/clickstream/clickstream-enwiki-2020-09.tsv.gz,Brett_Kavanaugh,268955,273947,1867,544769,205443
hdfs://spark-nn.eemcs.utwente.nl/user/s1934538/clickstream/clickstream-enwiki-2020-09.tsv.gz,2.0_(film),15031,39071,153,54255,15213
hdfs://spark-nn.eemcs.utwente.nl/user/s1934538/clickstream/clickstream-enwiki-2020-09.tsv.gz,The_Mandalorian,89614,504820,11644,606078,389056
hdfs://spark-nn.eemcs.utwente.nl/user/s1934538/clickstream/clickstream-enwiki-2020-09.tsv.gz,Kate_Spade,28292,53638,262,82192,28147
hdfs://spark-nn.eemcs.utwente.nl/user/s1934538/clickstream/clickstream-enwiki-2020-09.tsv.gz,Lionel_Messi,93725,663455,7188,764368,167416
hdfs://spark-nn.eemcs.utwente.nl/user/s1934538/clickstream/clickstream-enwiki-2020-09.tsv.gz,WandaVision,72003,343150,6735,421888,282252
hdfs://spark-nn.eemcs.utwente.nl/user/s1934538/clickstream/clickstream-enwiki-2020-09.tsv.gz,Betty_White,76142,276649,2679,355470,104140
hdfs://spark-nn.eemcs.utwente.nl/user/s1934538/clickstream/clickstream-enwiki-2020-09.tsv.gz,September_11_attacks,214673,1795398,30858,2040929,857756
hdfs://spark-nn.eemcs.utwente.nl/user/s1934538/clickstream/clickstream-enwiki-2020-09.tsv.gz,Simone_Biles,10386,56838,282,67506,22014
hdfs://spark-nn.eemcs.utwente.nl/user/s1934538/clickstream/clickstream-enwiki-2020-09.tsv.gz,The_Queen's_Gambit_(miniseries),10407,29197,345,39949,20890
hdfs://spark-nn.eemcs.utwente.nl/user/s1934538/clickstream/clickstream-enwiki-2020-09.tsv.gz,Gaza_Strip,17776,36340,207,54323,20998
hdfs://spark-nn.eemcs.utwente.nl/user/s1934538/clickstream/clickstream-enwiki-2020-09.tsv.gz,List_of_FIFA_World_Cup_finals,2173,51015,42,53230,15040
hdfs://spark-nn.eemcs.utwente.nl/user/s1934538/clickstream/clickstream-enwiki-2020-09.tsv.gz,Tina_Turner,20625,213470,1886,235981,62959
hdfs://spark-nn.eemcs.utwente.nl/user/s1934538/clickstream/clickstream-enwiki-2020-09.tsv.gz,Jimmy_Hoffa,32143,131600,1143,164886,59758
hdfs://spark-nn.eemcs.utwente.nl/user/s1934538/clickstream/clickstream-enwiki-2020-09.tsv.gz,Media,50,3249,294,3593,1666
hdfs://spark-nn.eemcs.utwente.nl/user/s1934538/clickstream/clickstream-enwiki-2020-09.tsv.gz,Ghislaine_Maxwell,62043,134557,504,197104,64877
hdfs://spark-nn.eemcs.utwente.nl/user/s1934538/clickstream/clickstream-enwiki-2020-09.tsv.gz,RRR_(film),28313,34888,32,63233,34444
hdfs://spark-nn.eemcs.utwente.nl/user/s1934538/clickstream/clickstream-enwiki-2020-09.tsv.gz,Kobe_Bryant_sexual_assault_case,6595,33914,31,40540,3278
hdfs://spark-nn.eemcs.utwente.nl/user/s1934538/clickstream/clickstream-enwiki-2020-09.tsv.gz,Charles_Sobhraj,3355,16264,46,19665,3967
hdfs://spark-nn.eemcs.utwente.nl/user/s1934538/clickstream/clickstream-enwiki-2020-09.tsv.gz,Hamilton_(musical),65125,367076,2814,435015,337644
hdfs://spark-nn.eemcs.utwente.nl/user/s1934538/clickstream/clickstream-enwiki-2020-09.tsv.gz,Irrfan_Khan,35105,89717,167,124989,40913
hdfs://spark-nn.eemcs.utwente.nl/user/s1934538/clickstream/clickstream-enwiki-2020-09.tsv.gz,2020_United_States_presidential_election,251436,884248,21646,1157330,755138
hdfs://spark-nn.eemcs.utwente.nl/user/s1934538/clickstream/clickstream-enwiki-2020-09.tsv.gz,2023_Cricket_World_Cup,8331,14543,24,22898,6775
hdfs://spark-nn.eemcs.utwente.nl/user/s1934538/clickstream/clickstream-enwiki-2020-09.tsv.gz,Murder_of_Dee_Dee_Blanchard,14610,146377,401,161388,28381
hdfs://spark-nn.eemcs.utwente.nl/user/s1934538/clickstream/clickstream-enwiki-2020-09.tsv.gz,Darth_Vader,25846,71642,630,98118,57198
hdfs://spark-nn.eemcs.utwente.nl/user/s1934538/clickstream/clickstream-enwiki-2020-09.tsv.gz,It_Chapter_Two,37933,100067,858,138858,88055
hdfs://spark-nn.eemcs.utwente.nl/user/s1934538/clickstream/clickstream-enwiki-2020-09.tsv.gz,Mulan_(2020_film),168135,2990505,46996,3205636,1768167
hdfs://spark-nn.eemcs.utwente.nl/user/s1934538/clickstream/clickstream-enwiki-2020-09.tsv.gz,Eddie_Van_Halen,31728,40365,365,72458,30453
hdfs://spark-nn.eemcs.utwente.nl/user/s1934538/clickstream/clickstream-enwiki-2020-09.tsv.gz,List_of_Marvel_Cinematic_Universe_films,122916,722569,3058,848543,354952
hdfs://spark-nn.eemcs.utwente.nl/user/s1934538/clickstream/clickstream-enwiki-2020-09.tsv.gz,Rihanna,67578,260017,6164,333759,159759
hdfs://spark-nn.eemcs.utwente.nl/user/s1934538/clickstream/clickstream-enwiki-2020-09.tsv.gz,Joe_Exotic,67909,298481,1066,367456,84655
hdfs://spark-nn.eemcs.utwente.nl/user/s1934538/clickstream/clickstream-enwiki-2020-09.tsv.gz,List_of_most_popular_websites,11956,56019,75,68050,26549
hdfs://spark-nn.eemcs.utwente.nl/user/s1934538/clickstream/clickstream-enwiki-2020-09.tsv.gz,Laal_Singh_Chaddha,21306,22144,42,43492,21792
hdfs://spark-nn.eemcs.utwente.nl/user/s1934538/clickstream/clickstream-enwiki-2020-09.tsv.gz,Aaron_Carter,18135,85887,599,104621,39847
hdfs://spark-nn.eemcs.utwente.nl/user/s1934538/clickstream/clickstream-enwiki-2020-09.tsv.gz,The_Irishman,52010,129169,1812,182991,151130
hdfs://spark-nn.eemcs.utwente.nl/user/s1934538/clickstream/clickstream-enwiki-2020-09.tsv.gz,Amber_Heard,80242,156103,3613,239958,110636
hdfs://spark-nn.eemcs.utwente.nl/user/s1934538/clickstream/clickstream-enwiki-2020-09.tsv.gz,Wonder_Woman_1984,68054,167499,5405,240958,102508
hdfs://spark-nn.eemcs.utwente.nl/user/s1934538/clickstream/clickstream-enwiki-2020-09.tsv.gz,Black_Widow_(2021_film),109064,214364,12653,336081,36440
hdfs://spark-nn.eemcs.utwente.nl/user/s1934538/clickstream/clickstream-enwiki-2020-09.tsv.gz,Bird_Box_(film),28925,78925,718,108568,31021
hdfs://spark-nn.eemcs.utwente.nl/user/s1934538/clickstream/clickstream-enwiki-2020-09.tsv.gz,Deion_Sanders,15549,266795,1409,283753,94183
hdfs://spark-nn.eemcs.utwente.nl/user/s1934538/clickstream/clickstream-enwiki-2020-09.tsv.gz,Dark_Phoenix_(film),54089,84985,781,139855,80798
hdfs://spark-nn.eemcs.utwente.nl/user/s1934538/clickstream/clickstream-enwiki-2020-09.tsv.gz,Rishi_Sunak,24510,141006,1267,166783,72855
hdfs://spark-nn.eemcs.utwente.nl/user/s1934538/clickstream/clickstream-enwiki-2020-09.tsv.gz,Jason_Momoa,92373,289977,1808,384158,168183
hdfs://spark-nn.eemcs.utwente.nl/user/s1934538/clickstream/clickstream-enwiki-2020-09.tsv.gz,Sushma_Swaraj,5544,21011,51,26606,5962
hdfs://spark-nn.eemcs.utwente.nl/user/s1934538/clickstream/clickstream-enwiki-2020-09.tsv.gz,Wikipedia,233536,737373,1138,972047,288304
hdfs://spark-nn.eemcs.utwente.nl/user/s1934538/clickstream/clickstream-enwiki-2020-09.tsv.gz,Qasem_Soleimani,14292,42715,178,57185,28054
hdfs://spark-nn.eemcs.utwente.nl/user/s1934538/clickstream/clickstream-enwiki-2020-09.tsv.gz,IPv4,10897,44761,113,55771,9321
hdfs://spark-nn.eemcs.utwente.nl/user/s1934538/clickstream/clickstream-enwiki-2020-09.tsv.gz,Matthew_Perry,63199,159159,988,223346,126207
hdfs://spark-nn.eemcs.utwente.nl/user/s1934538/clickstream/clickstream-enwiki-2020-09.tsv.gz,"Princess_Margaret,_Countess_of_Snowdon",136301,406515,2501,545317,334185
hdfs://spark-nn.eemcs.utwente.nl/user/s1934538/clickstream/clickstream-enwiki-2020-09.tsv.gz,Saaho,16596,51700,121,68417,20953
hdfs://spark-nn.eemcs.utwente.nl/user/s1934538/clickstream/clickstream-enwiki-2020-09.tsv.gz,Amy_Coney_Barrett,60636,5811991,35413,5908040,1485398
hdfs://spark-nn.eemcs.utwente.nl/user/s1934538/clickstream/clickstream-enwiki-2020-09.tsv.gz,Shooting_of_Breonna_Taylor,23270,3927763,14281,3965314,254156
hdfs://spark-nn.eemcs.utwente.nl/user/s1934538/clickstream/clickstream-enwiki-2020-09.tsv.gz,Area_51,16162,131763,1101,149026,37400
hdfs://spark-nn.eemcs.utwente.nl/user/s1934538/clickstream/clickstream-enwiki-2020-09.tsv.gz,Priyanka_Chopra,97465,213010,704,311179,103813
hdfs://spark-nn.eemcs.utwente.nl/user/s1934538/clickstream/clickstream-enwiki-2020-09.tsv.gz,Jimmy_Buffett,8496,43432,459,52387,22158
hdfs://spark-nn.eemcs.utwente.nl/user/s1934538/clickstream/clickstream-enwiki-2020-09.tsv.gz,United_States_Senate,116048,270183,3381,389612,143809
hdfs://spark-nn.eemcs.utwente.nl/user/s1934538/clickstream/clickstream-enwiki-2020-09.tsv.gz,Joker_(2019_film),67167,343931,6694,417792,175999
hdfs://spark-nn.eemcs.utwente.nl/user/s1934538/clickstream/clickstream-enwiki-2020-09.tsv.gz,Shakira,19998,229709,1854,251561,118864
hdfs://spark-nn.eemcs.utwente.nl/user/s1934538/clickstream/clickstream-enwiki-2020-09.tsv.gz,UEFA_Euro_2020,48244,105605,1418,155267,69135
hdfs://spark-nn.eemcs.utwente.nl/user/s1934538/clickstream/clickstream-enwiki-2020-09.tsv.gz,Chernobyl_disaster,54299,343413,2773,400485,163317
hdfs://spark-nn.eemcs.utwente.nl/user/s1934538/clickstream/clickstream-enwiki-2020-09.tsv.gz,The_Weeknd,71057,255043,2713,328813,135124
hdfs://spark-nn.eemcs.utwente.nl/user/s1934538/clickstream/clickstream-enwiki-2020-10.tsv.gz,State_of_Palestine,36809,92292,210,129311,54086
hdfs://spark-nn.eemcs.utwente.nl/user/s1934538/clickstream/clickstream-enwiki-2020-10.tsv.gz,Kamala_Harris,309346,3295005,20770,3625121,1814333
hdfs://spark-nn.eemcs.utwente.nl/user/s1934538/clickstream/clickstream-enwiki-2020-10.tsv.gz,The_Nun_(2018_film),35459,139545,999,176003,109816
hdfs://spark-nn.eemcs.utwente.nl/user/s1934538/clickstream/clickstream-enwiki-2020-10.tsv.gz,The_Sandman_(TV_series),450,760,25,1235,422
hdfs://spark-nn.eemcs.utwente.nl/user/s1934538/clickstream/clickstream-enwiki-2020-10.tsv.gz,Eternals_(film),87967,62124,335,150426,170255
hdfs://spark-nn.eemcs.utwente.nl/user/s1934538/clickstream/clickstream-enwiki-2020-10.tsv.gz,Area_51,13346,122396,967,136709,33278
hdfs://spark-nn.eemcs.utwente.nl/user/s1934538/clickstream/clickstream-enwiki-2020-10.tsv.gz,Fantastic_Beasts:_The_Crimes_of_Grindelwald,58610,123067,1166,182843,102254
hdfs://spark-nn.eemcs.utwente.nl/user/s1934538/clickstream/clickstream-enwiki-2020-10.tsv.gz,List_of_most_popular_websites,12374,67856,134,80364,32890
hdfs://spark-nn.eemcs.utwente.nl/user/s1934538/clickstream/clickstream-enwiki-2020-10.tsv.gz,Stranger_Things_(season_4),39973,193671,891,234535,120315
hdfs://spark-nn.eemcs.utwente.nl/user/s1934538/clickstream/clickstream-enwiki-2020-10.tsv.gz,List_of_FIFA_World_Cup_finals,2444,50846,45,53335,15497
hdfs://spark-nn.eemcs.utwente.nl/user/s1934538/clickstream/clickstream-enwiki-2020-10.tsv.gz,Grimes_(musician),94965,113920,429,209314,55091
hdfs://spark-nn.eemcs.utwente.nl/user/s1934538/clickstream/clickstream-enwiki-2020-10.tsv.gz,Saaho,15867,49631,75,65573,20378
hdfs://spark-nn.eemcs.utwente.nl/user/s1934538/clickstream/clickstream-enwiki-2020-10.tsv.gz,Main_Page,10892,169788224,4732750,174531866,40327169
hdfs://spark-nn.eemcs.utwente.nl/user/s1934538/clickstream/clickstream-enwiki-2020-10.tsv.gz,Notre-Dame_de_Paris,13839,96182,1042,111063,25208
hdfs://spark-nn.eemcs.utwente.nl/user/s1934538/clickstream/clickstream-enwiki-2020-10.tsv.gz,Dune_(2021_film),78291,185392,4853,268536,145083
hdfs://spark-nn.eemcs.utwente.nl/user/s1934538/clickstream/clickstream-enwiki-2020-10.tsv.gz,FIFA_World_Cup,35062,145957,2806,183825,126867
hdfs://spark-nn.eemcs.utwente.nl/user/s1934538/clickstream/clickstream-enwiki-2020-10.tsv.gz,Simple_Mail_Transfer_Protocol,4057,37815,200,42072,4107
hdfs://spark-nn.eemcs.utwente.nl/user/s1934538/clickstream/clickstream-enwiki-2020-10.tsv.gz,Juneteenth,3362,52827,236,56425,4445
hdfs://spark-nn.eemcs.utwente.nl/user/s1934538/clickstream/clickstream-enwiki-2020-10.tsv.gz,United_States_Senate,178036,267468,3383,448887,194498
hdfs://spark-nn.eemcs.utwente.nl/user/s1934538/clickstream/clickstream-enwiki-2020-10.tsv.gz,2022_FIFA_World_Cup,51993,97588,1873,151454,84410
hdfs://spark-nn.eemcs.utwente.nl/user/s1934538/clickstream/clickstream-enwiki-2020-10.tsv.gz,Juice_Wrld,34765,435751,5259,475775,146142
hdfs://spark-nn.eemcs.utwente.nl/user/s1934538/clickstream/clickstream-enwiki-2020-10.tsv.gz,Michael_Jordan,137515,812292,6140,955947,310052
hdfs://spark-nn.eemcs.utwente.nl/user/s1934538/clickstream/clickstream-enwiki-2020-10.tsv.gz,Priyanka_Chopra,100229,233232,720,334181,116206
hdfs://spark-nn.eemcs.utwente.nl/user/s1934538/clickstream/clickstream-enwiki-2020-10.tsv.gz,Tasuku_Honjo,1646,787937,84,789667,24160
hdfs://spark-nn.eemcs.utwente.nl/user/s1934538/clickstream/clickstream-enwiki-2020-10.tsv.gz,Darth_Vader,26382,75489,621,102492,58342
hdfs://spark-nn.eemcs.utwente.nl/user/s1934538/clickstream/clickstream-enwiki-2020-10.tsv.gz,Killing_of_George_Floyd,49959,113664,763,164386,50945
hdfs://spark-nn.eemcs.utwente.nl/user/s1934538/clickstream/clickstream-enwiki-2020-10.tsv.gz,Zack_Snyder's_Justice_League,80501,92752,635,173888,82696
hdfs://spark-nn.eemcs.utwente.nl/user/s1934538/clickstream/clickstream-enwiki-2020-10.tsv.gz,Amy_Coney_Barrett,161789,3954323,27973,4144085,952883
hdfs://spark-nn.eemcs.utwente.nl/user/s1934538/clickstream/clickstream-enwiki-2020-10.tsv.gz,Anna_Sorokin,8678,45739,103,54520,13529
hdfs://spark-nn.eemcs.utwente.nl/user/s1934538/clickstream/clickstream-enwiki-2020-10.tsv.gz,Sylvester_Stallone,91500,306041,2106,399647,276150
hdfs://spark-nn.eemcs.utwente.nl/user/s1934538/clickstream/clickstream-enwiki-2020-10.tsv.gz,Charles_Sobhraj,3396,24986,78,28460,5383
hdfs://spark-nn.eemcs.utwente.nl/user/s1934538/clickstream/clickstream-enwiki-2020-10.tsv.gz,The_Falcon_and_the_Winter_Soldier,41185,45773,511,87469,45380
hdfs://spark-nn.eemcs.utwente.nl/user/s1934538/clickstream/clickstream-enwiki-2020-10.tsv.gz,Joaquin_Phoenix,145977,267126,1189,414292,247665
hdfs://spark-nn.eemcs.utwente.nl/user/s1934538/clickstream/clickstream-enwiki-2020-10.tsv.gz,The_Witcher_(TV_series),41635,241609,4486,287730,165317
hdfs://spark-nn.eemcs.utwente.nl/user/s1934538/clickstream/clickstream-enwiki-2020-10.tsv.gz,Stephen_Hawking,50827,530708,2951,584486,252537
hdfs://spark-nn.eemcs.utwente.nl/user/s1934538/clickstream/clickstream-enwiki-2020-10.tsv.gz,Joe_Exotic,29450,244372,820,274642,59242
hdfs://spark-nn.eemcs.utwente.nl/user/s1934538/clickstream/clickstream-enwiki-2020-10.tsv.gz,Johnny_Depp,141150,381177,2452,524779,352439
hdfs://spark-nn.eemcs.utwente.nl/user/s1934538/clickstream/clickstream-enwiki-2020-10.tsv.gz,Line_shaft,510,1050,15,1575,103
hdfs://spark-nn.eemcs.utwente.nl/user/s1934538/clickstream/clickstream-enwiki-2020-10.tsv.gz,List_of_highest-grossing_Indian_films,34681,114798,201,149680,86992
hdfs://spark-nn.eemcs.utwente.nl/user/s1934538/clickstream/clickstream-enwiki-2020-10.tsv.gz,Israel,80197,222626,4172,306995,146451
hdfs://spark-nn.eemcs.utwente.nl/user/s1934538/clickstream/clickstream-enwiki-2020-10.tsv.gz,Sridevi,24229,70144,457,94830,38398
hdfs://spark-nn.eemcs.utwente.nl/user/s1934538/clickstream/clickstream-enwiki-2020-10.tsv.gz,Sidharth_Shukla,37384,127217,495,165096,46826
hdfs://spark-nn.eemcs.utwente.nl/user/s1934538/clickstream/clickstream-enwiki-2020-10.tsv.gz,Nipsey_Hussle,25007,109273,835,135115,41397
hdfs://spark-nn.eemcs.utwente.nl/user/s1934538/clickstream/clickstream-enwiki-2020-10.tsv.gz,COVID-19_pandemic_by_country_and_territory,511205,758129,2967,1272301,1176753
hdfs://spark-nn.eemcs.utwente.nl/user/s1934538/clickstream/clickstream-enwiki-2020-10.tsv.gz,Joe_Biden,560349,3532133,40093,4132575,2022315
hdfs://spark-nn.eemcs.utwente.nl/user/s1934538/clickstream/clickstream-enwiki-2020-10.tsv.gz,2023_Cricket_World_Cup,12330,22254,42,34626,10196
hdfs://spark-nn.eemcs.utwente.nl/user/s1934538/clickstream/clickstream-enwiki-2020-10.tsv.gz,Afghanistan,54367,135094,1895,191356,100682
hdfs://spark-nn.eemcs.utwente.nl/user/s1934538/clickstream/clickstream-enwiki-2020-10.tsv.gz,Central_Park_jogger_case,22929,150524,567,174020,19620
hdfs://spark-nn.eemcs.utwente.nl/user/s1934538/clickstream/clickstream-enwiki-2020-10.tsv.gz,List_of_awards_and_nominations_received_by_Meryl_Streep,14133,11671,203,26007,9154
hdfs://spark-nn.eemcs.utwente.nl/user/s1934538/clickstream/clickstream-enwiki-2020-10.tsv.gz,Salman_Rushdie,29560,63767,382,93709,36798
hdfs://spark-nn.eemcs.utwente.nl/user/s1934538/clickstream/clickstream-enwiki-2020-10.tsv.gz,Stranger_Things_(season_3),22942,62717,526,86185,46175
hdfs://spark-nn.eemcs.utwente.nl/user/s1934538/clickstream/clickstream-enwiki-2020-10.tsv.gz,2018_Winter_Olympics,14975,14038,180,29193,20387
hdfs://spark-nn.eemcs.utwente.nl/user/s1934538/clickstream/clickstream-enwiki-2020-10.tsv.gz,Glass_(2019_film),63004,82500,446,145950,46017
hdfs://spark-nn.eemcs.utwente.nl/user/s1934538/clickstream/clickstream-enwiki-2020-10.tsv.gz,Cardi_B,61008,455113,8833,524954,155001
hdfs://spark-nn.eemcs.utwente.nl/user/s1934538/clickstream/clickstream-enwiki-2020-10.tsv.gz,Elizabeth_II,496179,793818,3608,1293605,1007036
hdfs://spark-nn.eemcs.utwente.nl/user/s1934538/clickstream/clickstream-enwiki-2020-10.tsv.gz,Donald_Glover,49364,253204,1532,304100,98703
hdfs://spark-nn.eemcs.utwente.nl/user/s1934538/clickstream/clickstream-enwiki-2020-10.tsv.gz,List_of_Queen_of_the_South_episodes,14085,12937,132,27154,664
hdfs://spark-nn.eemcs.utwente.nl/user/s1934538/clickstream/clickstream-enwiki-2020-10.tsv.gz,Carlos_Alcaraz,922,6252,18,7192,1300
hdfs://spark-nn.eemcs.utwente.nl/user/s1934538/clickstream/clickstream-enwiki-2020-10.tsv.gz,Michael_Bloomberg,62090,70763,440,133293,63334
hdfs://spark-nn.eemcs.utwente.nl/user/s1934538/clickstream/clickstream-enwiki-2020-10.tsv.gz,QAnon,86056,2771048,16524,2873628,494341
hdfs://spark-nn.eemcs.utwente.nl/user/s1934538/clickstream/clickstream-enwiki-2020-10.tsv.gz,Chernobyl_(miniseries),19902,91614,1349,112865,94690
hdfs://spark-nn.eemcs.utwente.nl/user/s1934538/clickstream/clickstream-enwiki-2020-10.tsv.gz,K.G.F:_Chapter_2,19930,367995,395,388320,68091
hdfs://spark-nn.eemcs.utwente.nl/user/s1934538/clickstream/clickstream-enwiki-2020-10.tsv.gz,Asia_Cup,962,13282,133,14377,6297
hdfs://spark-nn.eemcs.utwente.nl/user/s1934538/clickstream/clickstream-enwiki-2020-10.tsv.gz,Laal_Singh_Chaddha,26867,32790,36,59693,28209
hdfs://spark-nn.eemcs.utwente.nl/user/s1934538/clickstream/clickstream-enwiki-2020-10.tsv.gz,Puneeth_Rajkumar,8270,14854,65,23189,11592
hdfs://spark-nn.eemcs.utwente.nl/user/s1934538/clickstream/clickstream-enwiki-2020-10.tsv.gz,Khabib_Nurmagomedov,286722,2093001,16846,2396569,1343098
hdfs://spark-nn.eemcs.utwente.nl/user/s1934538/clickstream/clickstream-enwiki-2020-10.tsv.gz,R._Kelly,27717,167048,1540,196305,83375
hdfs://spark-nn.eemcs.utwente.nl/user/s1934538/clickstream/clickstream-enwiki-2020-10.tsv.gz,1917_(2019_film),32611,256442,3039,292092,140337
hdfs://spark-nn.eemcs.utwente.nl/user/s1934538/clickstream/clickstream-enwiki-2020-10.tsv.gz,Indian_Premier_League,70173,872376,946,943495,441304
hdfs://spark-nn.eemcs.utwente.nl/user/s1934538/clickstream/clickstream-enwiki-2020-10.tsv.gz,Watts_family_murders,374866,3994160,5711,4374737,946148
hdfs://spark-nn.eemcs.utwente.nl/user/s1934538/clickstream/clickstream-enwiki-2020-10.tsv.gz,Shakira,19707,176664,1492,197863,83502
hdfs://spark-nn.eemcs.utwente.nl/user/s1934538/clickstream/clickstream-enwiki-2020-10.tsv.gz,Kobe_Bryant_sexual_assault_case,6410,34388,85,40883,3041
hdfs://spark-nn.eemcs.utwente.nl/user/s1934538/clickstream/clickstream-enwiki-2020-10.tsv.gz,Coronavirus,31696,413265,6137,451098,113920
hdfs://spark-nn.eemcs.utwente.nl/user/s1934538/clickstream/clickstream-enwiki-2020-10.tsv.gz,The_Umbrella_Academy_(TV_series),47940,373432,5821,427193,257158
hdfs://spark-nn.eemcs.utwente.nl/user/s1934538/clickstream/clickstream-enwiki-2020-10.tsv.gz,Chadwick_Boseman,83798,418970,3838,506606,156731
hdfs://spark-nn.eemcs.utwente.nl/user/s1934538/clickstream/clickstream-enwiki-2020-10.tsv.gz,Us_(2019_film),41040,237003,950,278993,83276
hdfs://spark-nn.eemcs.utwente.nl/user/s1934538/clickstream/clickstream-enwiki-2020-10.tsv.gz,It_Chapter_Two,59487,157334,1287,218108,147862
hdfs://spark-nn.eemcs.utwente.nl/user/s1934538/clickstream/clickstream-enwiki-2020-10.tsv.gz,Sushma_Swaraj,4383,15721,14,20118,4615
hdfs://spark-nn.eemcs.utwente.nl/user/s1934538/clickstream/clickstream-enwiki-2020-10.tsv.gz,2020_United_States_presidential_election,485436,1796267,38879,2320582,1420418
hdfs://spark-nn.eemcs.utwente.nl/user/s1934538/clickstream/clickstream-enwiki-2020-10.tsv.gz,Olivia_Newton-John,27714,133293,1190,162197,71079
hdfs://spark-nn.eemcs.utwente.nl/user/s1934538/clickstream/clickstream-enwiki-2020-10.tsv.gz,Bonnie_and_Clyde,22938,233998,1261,258197,54722
hdfs://spark-nn.eemcs.utwente.nl/user/s1934538/clickstream/clickstream-enwiki-2020-10.tsv.gz,Luke_Perry,39095,245428,745,285268,77449
hdfs://spark-nn.eemcs.utwente.nl/user/s1934538/clickstream/clickstream-enwiki-2020-10.tsv.gz,Shooting_of_Breonna_Taylor,7627,438808,1410,447845,29550
hdfs://spark-nn.eemcs.utwente.nl/user/s1934538/clickstream/clickstream-enwiki-2020-10.tsv.gz,Betty_White,65420,307051,3265,375736,120572
hdfs://spark-nn.eemcs.utwente.nl/user/s1934538/clickstream/clickstream-enwiki-2020-10.tsv.gz,A_Quiet_Place_(film),29159,179556,1336,210051,59102
hdfs://spark-nn.eemcs.utwente.nl/user/s1934538/clickstream/clickstream-enwiki-2020-10.tsv.gz,Kobe_Bryant,108134,611813,5597,725544,194583
hdfs://spark-nn.eemcs.utwente.nl/user/s1934538/clickstream/clickstream-enwiki-2020-10.tsv.gz,Avicii,17364,196035,1442,214841,98197
hdfs://spark-nn.eemcs.utwente.nl/user/s1934538/clickstream/clickstream-enwiki-2020-10.tsv.gz,Jenna_Ortega,58186,62744,1503,122433,24784
hdfs://spark-nn.eemcs.utwente.nl/user/s1934538/clickstream/clickstream-enwiki-2020-10.tsv.gz,Lionel_Messi,74611,409665,4629,488905,100716
hdfs://spark-nn.eemcs.utwente.nl/user/s1934538/clickstream/clickstream-enwiki-2020-10.tsv.gz,War_(2019_film),14536,93573,104,108213,19596
hdfs://spark-nn.eemcs.utwente.nl/user/s1934538/clickstream/clickstream-enwiki-2020-10.tsv.gz,Pornhub,42680,438295,14039,495014,102576
hdfs://spark-nn.eemcs.utwente.nl/user/s1934538/clickstream/clickstream-enwiki-2020-10.tsv.gz,Atal_Bihari_Vajpayee,28265,45249,127,73641,20791
hdfs://spark-nn.eemcs.utwente.nl/user/s1934538/clickstream/clickstream-enwiki-2020-10.tsv.gz,Deaths_in_2020,1259249,2339370,12051,3610670,2077405
hdfs://spark-nn.eemcs.utwente.nl/user/s1934538/clickstream/clickstream-enwiki-2020-10.tsv.gz,Adele,31045,451771,7269,490085,145855
hdfs://spark-nn.eemcs.utwente.nl/user/s1934538/clickstream/clickstream-enwiki-2020-10.tsv.gz,Amber_Heard,84486,168605,1137,254228,109349
hdfs://spark-nn.eemcs.utwente.nl/user/s1934538/clickstream/clickstream-enwiki-2020-10.tsv.gz,Mortal_Kombat_(2021_film),32231,46764,256,79251,102267
hdfs://spark-nn.eemcs.utwente.nl/user/s1934538/clickstream/clickstream-enwiki-2020-10.tsv.gz,YouTube,131729,1290429,10637,1432795,136394
hdfs://spark-nn.eemcs.utwente.nl/user/s1934538/clickstream/clickstream-enwiki-2020-10.tsv.gz,A_Star_Is_Born_(2018_film),31956,165336,798,198090,78156
hdfs://spark-nn.eemcs.utwente.nl/user/s1934538/clickstream/clickstream-enwiki-2020-10.tsv.gz,George_VI,364926,184521,679,550126,396969
hdfs://spark-nn.eemcs.utwente.nl/user/s1934538/clickstream/clickstream-enwiki-2020-10.tsv.gz,Wonder_Woman_1984,60060,132377,4963,197400,73809
hdfs://spark-nn.eemcs.utwente.nl/user/s1934538/clickstream/clickstream-enwiki-2020-10.tsv.gz,Meat_Loaf,31301,101869,997,134167,48983
hdfs://spark-nn.eemcs.utwente.nl/user/s1934538/clickstream/clickstream-enwiki-2020-10.tsv.gz,Greta_Thunberg,13618,209517,1651,224786,50188
hdfs://spark-nn.eemcs.utwente.nl/user/s1934538/clickstream/clickstream-enwiki-2020-10.tsv.gz,Anthony_Bourdain,16322,200493,1310,218125,62990
hdfs://spark-nn.eemcs.utwente.nl/user/s1934538/clickstream/clickstream-enwiki-2020-10.tsv.gz,Key_frame,629,6487,26,7142,529
hdfs://spark-nn.eemcs.utwente.nl/user/s1934538/clickstream/clickstream-enwiki-2020-10.tsv.gz,Croatia,37316,106215,1363,144894,52160
hdfs://spark-nn.eemcs.utwente.nl/user/s1934538/clickstream/clickstream-enwiki-2020-10.tsv.gz,2.0_(film),13648,31011,71,44730,12187
hdfs://spark-nn.eemcs.utwente.nl/user/s1934538/clickstream/clickstream-enwiki-2020-10.tsv.gz,Army_of_the_Dead,28716,17771,301,46788,29474
hdfs://spark-nn.eemcs.utwente.nl/user/s1934538/clickstream/clickstream-enwiki-2020-10.tsv.gz,Kenosha_unrest_shooting,8008,3458,699,12165,1104
hdfs://spark-nn.eemcs.utwente.nl/user/s1934538/clickstream/clickstream-enwiki-2020-10.tsv.gz,Murder_of_Dee_Dee_Blanchard,14352,126164,324,140840,24415
hdfs://spark-nn.eemcs.utwente.nl/user/s1934538/clickstream/clickstream-enwiki-2020-10.tsv.gz,21_Savage,23986,197667,2249,223902,110386
hdfs://spark-nn.eemcs.utwente.nl/user/s1934538/clickstream/clickstream-enwiki-2020-10.tsv.gz,Dark_Phoenix_(film),51839,94558,625,147022,65744
hdfs://spark-nn.eemcs.utwente.nl/user/s1934538/clickstream/clickstream-enwiki-2020-10.tsv.gz,Mötley_Crüe,37572,123658,1379,162609,198740
hdfs://spark-nn.eemcs.utwente.nl/user/s1934538/clickstream/clickstream-enwiki-2020-10.tsv.gz,Ray_Liotta,74848,93169,478,168495,42937
hdfs://spark-nn.eemcs.utwente.nl/user/s1934538/clickstream/clickstream-enwiki-2020-10.tsv.gz,September_11_attacks,74831,272988,2636,350455,149839
hdfs://spark-nn.eemcs.utwente.nl/user/s1934538/clickstream/clickstream-enwiki-2020-10.tsv.gz,Jeffrey_Epstein,49794,357871,4248,411913,169755
hdfs://spark-nn.eemcs.utwente.nl/user/s1934538/clickstream/clickstream-enwiki-2020-10.tsv.gz,HTTP_cookie,3626,488127,167,491920,26872
hdfs://spark-nn.eemcs.utwente.nl/user/s1934538/clickstream/clickstream-enwiki-2020-10.tsv.gz,Irrfan_Khan,32364,78767,168,111299,36237
hdfs://spark-nn.eemcs.utwente.nl/user/s1934538/clickstream/clickstream-enwiki-2020-11.tsv.gz,Deaths_in_2020,1237430,2333197,12001,3582628,2039130
hdfs://spark-nn.eemcs.utwente.nl/user/s1934538/clickstream/clickstream-enwiki-2020-11.tsv.gz,Wikipedia,224974,835618,1039,1061631,296540
hdfs://spark-nn.eemcs.utwente.nl/user/s1934538/clickstream/clickstream-enwiki-2020-11.tsv.gz,UEFA_Euro_2020,82691,375873,7745,466309,200028
hdfs://spark-nn.eemcs.utwente.nl/user/s1934538/clickstream/clickstream-enwiki-2020-11.tsv.gz,Dune_(2021_film),62571,118423,2615,183609,132022
hdfs://spark-nn.eemcs.utwente.nl/user/s1934538/clickstream/clickstream-enwiki-2020-11.tsv.gz,Eternals_(film),85872,79435,341,165648,184750
hdfs://spark-nn.eemcs.utwente.nl/user/s1934538/clickstream/clickstream-enwiki-2020-11.tsv.gz,Pelé,74583,522549,4139,601271,168156
hdfs://spark-nn.eemcs.utwente.nl/user/s1934538/clickstream/clickstream-enwiki-2020-11.tsv.gz,Puneeth_Rajkumar,9450,17849,118,27417,14150
hdfs://spark-nn.eemcs.utwente.nl/user/s1934538/clickstream/clickstream-enwiki-2020-11.tsv.gz,"Princess_Margaret,_Countess_of_Snowdon",957967,4300335,24466,5282768,2781448
hdfs://spark-nn.eemcs.utwente.nl/user/s1934538/clickstream/clickstream-enwiki-2020-11.tsv.gz,George_VI,1546552,963445,4091,2514088,1874561
hdfs://spark-nn.eemcs.utwente.nl/user/s1934538/clickstream/clickstream-enwiki-2020-11.tsv.gz,Hyphen-minus,4691,6741893,7421496,14168080,751
hdfs://spark-nn.eemcs.utwente.nl/user/s1934538/clickstream/clickstream-enwiki-2020-11.tsv.gz,Godzilla_vs._Kong,56237,67054,1061,124352,71784
hdfs://spark-nn.eemcs.utwente.nl/user/s1934538/clickstream/clickstream-enwiki-2020-11.tsv.gz,Spider-Man:_Far_From_Home,59503,103835,1515,164853,93669
hdfs://spark-nn.eemcs.utwente.nl/user/s1934538/clickstream/clickstream-enwiki-2020-11.tsv.gz,Saaho,14459,43984,99,58542,18819
hdfs://spark-nn.eemcs.utwente.nl/user/s1934538/clickstream/clickstream-enwiki-2020-11.tsv.gz,Sridevi,27351,69355,134,96840,41122
hdfs://spark-nn.eemcs.utwente.nl/user/s1934538/clickstream/clickstream-enwiki-2020-11.tsv.gz,R._Kelly,29735,158975,1422,190132,82108
hdfs://spark-nn.eemcs.utwente.nl/user/s1934538/clickstream/clickstream-enwiki-2020-11.tsv.gz,XHamster,16828,156194,2949,175971,24069
hdfs://spark-nn.eemcs.utwente.nl/user/s1934538/clickstream/clickstream-enwiki-2020-11.tsv.gz,Rishi_Sunak,32648,339145,1826,373619,183889
hdfs://spark-nn.eemcs.utwente.nl/user/s1934538/clickstream/clickstream-enwiki-2020-11.tsv.gz,List_of_Queen_of_the_South_episodes,12107,10809,131,23047,540
hdfs://spark-nn.eemcs.utwente.nl/user/s1934538/clickstream/clickstream-enwiki-2020-11.tsv.gz,Stranger_Things_(season_3),20287,57960,502,78749,41277
hdfs://spark-nn.eemcs.utwente.nl/user/s1934538/clickstream/clickstream-enwiki-2020-11.tsv.gz,Cameron_Boyce,48272,264426,970,313668,79417
hdfs://spark-nn.eemcs.utwente.nl/user/s1934538/clickstream/clickstream-enwiki-2020-11.tsv.gz,Dark_Phoenix_(film),54391,105262,790,160443,79000
hdfs://spark-nn.eemcs.utwente.nl/user/s1934538/clickstream/clickstream-enwiki-2020-11.tsv.gz,IPv4,11554,48745,119,60418,9756
hdfs://spark-nn.eemcs.utwente.nl/user/s1934538/clickstream/clickstream-enwiki-2020-11.tsv.gz,RRR_(film),31896,68348,727,100971,59830
hdfs://spark-nn.eemcs.utwente.nl/user/s1934538/clickstream/clickstream-enwiki-2020-11.tsv.gz,Rihanna,66494,233536,2838,302868,147778
hdfs://spark-nn.eemcs.utwente.nl/user/s1934538/clickstream/clickstream-enwiki-2020-11.tsv.gz,WrestleMania_34,19356,11942,187,31485,20431
hdfs://spark-nn.eemcs.utwente.nl/user/s1934538/clickstream/clickstream-enwiki-2020-11.tsv.gz,David_Beckham,39659,194812,1260,235731,82244
hdfs://spark-nn.eemcs.utwente.nl/user/s1934538/clickstream/clickstream-enwiki-2020-11.tsv.gz,Afghanistan,57134,140767,2328,200229,111955
hdfs://spark-nn.eemcs.utwente.nl/user/s1934538/clickstream/clickstream-enwiki-2020-11.tsv.gz,Mac_Miller,40686,215330,1539,257555,82589
hdfs://spark-nn.eemcs.utwente.nl/user/s1934538/clickstream/clickstream-enwiki-2020-11.tsv.gz,Top_Gun:_Maverick,41346,78447,1369,121162,71256
hdfs://spark-nn.eemcs.utwente.nl/user/s1934538/clickstream/clickstream-enwiki-2020-11.tsv.gz,Us_(2019_film),30618,180252,539,211409,61475
hdfs://spark-nn.eemcs.utwente.nl/user/s1934538/clickstream/clickstream-enwiki-2020-11.tsv.gz,2020_Summer_Olympics,40208,89120,1958,131286,86540
hdfs://spark-nn.eemcs.utwente.nl/user/s1934538/clickstream/clickstream-enwiki-2020-11.tsv.gz,Freddie_Mercury,70705,504281,4309,579295,201670
hdfs://spark-nn.eemcs.utwente.nl/user/s1934538/clickstream/clickstream-enwiki-2020-11.tsv.gz,Bob_Saget,44046,71898,462,116406,17472
hdfs://spark-nn.eemcs.utwente.nl/user/s1934538/clickstream/clickstream-enwiki-2020-11.tsv.gz,Simple_Mail_Transfer_Protocol,4055,35553,140,39748,3938
hdfs://spark-nn.eemcs.utwente.nl/user/s1934538/clickstream/clickstream-enwiki-2020-11.tsv.gz,Rami_Malek,66483,161004,605,228092,88933
hdfs://spark-nn.eemcs.utwente.nl/user/s1934538/clickstream/clickstream-enwiki-2020-11.tsv.gz,Kenosha_unrest_shooting,45073,333328,1770,380171,45824
hdfs://spark-nn.eemcs.utwente.nl/user/s1934538/clickstream/clickstream-enwiki-2020-11.tsv.gz,The_Suicide_Squad_(film),95970,87916,698,184584,158975
hdfs://spark-nn.eemcs.utwente.nl/user/s1934538/clickstream/clickstream-enwiki-2020-11.tsv.gz,Priyanka_Chopra,120730,217299,4781,342810,110269
hdfs://spark-nn.eemcs.utwente.nl/user/s1934538/clickstream/clickstream-enwiki-2020-11.tsv.gz,Tenet_(film),123148,633000,7349,763497,317368
hdfs://spark-nn.eemcs.utwente.nl/user/s1934538/clickstream/clickstream-enwiki-2020-11.tsv.gz,Central_Park_jogger_case,23995,123660,387,148042,17902
hdfs://spark-nn.eemcs.utwente.nl/user/s1934538/clickstream/clickstream-enwiki-2020-11.tsv.gz,Avengers:_Infinity_War,48117,92762,1058,141937,82780
hdfs://spark-nn.eemcs.utwente.nl/user/s1934538/clickstream/clickstream-enwiki-2020-11.tsv.gz,Once_Upon_a_Time_in_Hollywood,107225,228994,2556,338775,316365
hdfs://spark-nn.eemcs.utwente.nl/user/s1934538/clickstream/clickstream-enwiki-2020-11.tsv.gz,John_McCain,298627,934374,7597,1240598,607653
hdfs://spark-nn.eemcs.utwente.nl/user/s1934538/clickstream/clickstream-enwiki-2020-11.tsv.gz,Tasuku_Honjo,1021,413225,60,414306,13436
hdfs://spark-nn.eemcs.utwente.nl/user/s1934538/clickstream/clickstream-enwiki-2020-11.tsv.gz,XXX:_Return_of_Xander_Cage,29990,477791,717,508498,68224
hdfs://spark-nn.eemcs.utwente.nl/user/s1934538/clickstream/clickstream-enwiki-2020-11.tsv.gz,Cricket_World_Cup,8632,79143,202,87977,43565
hdfs://spark-nn.eemcs.utwente.nl/user/s1934538/clickstream/clickstream-enwiki-2020-11.tsv.gz,Roe_v._Wade,45863,182031,854,228748,72610
hdfs://spark-nn.eemcs.utwente.nl/user/s1934538/clickstream/clickstream-enwiki-2020-11.tsv.gz,A_Star_Is_Born_(2018_film),34550,151461,696,186707,80029
hdfs://spark-nn.eemcs.utwente.nl/user/s1934538/clickstream/clickstream-enwiki-2020-11.tsv.gz,Kobe_Bryant,53467,371978,3890,429335,114802
hdfs://spark-nn.eemcs.utwente.nl/user/s1934538/clickstream/clickstream-enwiki-2020-11.tsv.gz,Greta_Thunberg,18915,319684,2513,341112,84235
hdfs://spark-nn.eemcs.utwente.nl/user/s1934538/clickstream/clickstream-enwiki-2020-11.tsv.gz,HTTP_cookie,3574,386105,136,389815,28342
hdfs://spark-nn.eemcs.utwente.nl/user/s1934538/clickstream/clickstream-enwiki-2020-11.tsv.gz,State_of_Palestine,42338,104157,3021,149516,66592
hdfs://spark-nn.eemcs.utwente.nl/user/s1934538/clickstream/clickstream-enwiki-2020-11.tsv.gz,"Diana,_Princess_of_Wales",1281314,4629969,54326,5965609,3922933
hdfs://spark-nn.eemcs.utwente.nl/user/s1934538/clickstream/clickstream-enwiki-2020-11.tsv.gz,Kobe_Bryant_sexual_assault_case,4934,25634,84,30652,2233
hdfs://spark-nn.eemcs.utwente.nl/user/s1934538/clickstream/clickstream-enwiki-2020-11.tsv.gz,Elizabeth_II,2303093,3952146,17967,6273206,6040888
hdfs://spark-nn.eemcs.utwente.nl/user/s1934538/clickstream/clickstream-enwiki-2020-11.tsv.gz,Richard_Ramirez,29034,221321,1124,251479,71382
hdfs://spark-nn.eemcs.utwente.nl/user/s1934538/clickstream/clickstream-enwiki-2020-11.tsv.gz,Area_51,13903,131581,1147,146631,36129
hdfs://spark-nn.eemcs.utwente.nl/user/s1934538/clickstream/clickstream-enwiki-2020-11.tsv.gz,Valentine's_Day,4158,35543,380,40081,3775
hdfs://spark-nn.eemcs.utwente.nl/user/s1934538/clickstream/clickstream-enwiki-2020-11.tsv.gz,Tom_Brady,82961,480246,4013,567220,184344
hdfs://spark-nn.eemcs.utwente.nl/user/s1934538/clickstream/clickstream-enwiki-2020-11.tsv.gz,Kylian_Mbappé,25714,129427,1432,156573,28018
hdfs://spark-nn.eemcs.utwente.nl/user/s1934538/clickstream/clickstream-enwiki-2020-11.tsv.gz,Cardi_B,45185,281604,4758,331547,106660
hdfs://spark-nn.eemcs.utwente.nl/user/s1934538/clickstream/clickstream-enwiki-2020-11.tsv.gz,United_States_Electoral_College,569858,8822774,8115,9400747,783537
hdfs://spark-nn.eemcs.utwente.nl/user/s1934538/clickstream/clickstream-enwiki-2020-11.tsv.gz,Queen_(band),50386,159821,2315,212522,198576
hdfs://spark-nn.eemcs.utwente.nl/user/s1934538/clickstream/clickstream-enwiki-2020-11.tsv.gz,Laal_Singh_Chaddha,25217,27397,264,52878,27695
hdfs://spark-nn.eemcs.utwente.nl/user/s1934538/clickstream/clickstream-enwiki-2020-11.tsv.gz,Taliban,31812,78035,893,110740,73097
hdfs://spark-nn.eemcs.utwente.nl/user/s1934538/clickstream/clickstream-enwiki-2020-11.tsv.gz,Darth_Vader,64824,154613,1668,221105,145200
hdfs://spark-nn.eemcs.utwente.nl/user/s1934538/clickstream/clickstream-enwiki-2020-11.tsv.gz,Naomi_Osaka,11555,42477,245,54277,14562
hdfs://spark-nn.eemcs.utwente.nl/user/s1934538/clickstream/clickstream-enwiki-2020-11.tsv.gz,Notre-Dame_de_Paris,14361,95682,1028,111071,27490
hdfs://spark-nn.eemcs.utwente.nl/user/s1934538/clickstream/clickstream-enwiki-2020-11.tsv.gz,The_Queen's_Gambit_(miniseries),475521,6416529,46374,6938424,3803763
hdfs://spark-nn.eemcs.utwente.nl/user/s1934538/clickstream/clickstream-enwiki-2020-11.tsv.gz,Fantastic_Beasts:_The_Crimes_of_Grindelwald,82283,114623,1640,198546,114290
hdfs://spark-nn.eemcs.utwente.nl/user/s1934538/clickstream/clickstream-enwiki-2020-11.tsv.gz,Joker_(2019_film),55222,309714,2519,367455,124481
hdfs://spark-nn.eemcs.utwente.nl/user/s1934538/clickstream/clickstream-enwiki-2020-11.tsv.gz,2018_FIFA_World_Cup,81931,111237,1325,194493,110464
hdfs://spark-nn.eemcs.utwente.nl/user/s1934538/clickstream/clickstream-enwiki-2020-11.tsv.gz,A_Quiet_Place_(film),31748,152691,1259,185698,59095
hdfs://spark-nn.eemcs.utwente.nl/user/s1934538/clickstream/clickstream-enwiki-2020-11.tsv.gz,Nipsey_Hussle,33488,129148,1198,163834,48019
hdfs://spark-nn.eemcs.utwente.nl/user/s1934538/clickstream/clickstream-enwiki-2020-11.tsv.gz,The_Falcon_and_the_Winter_Soldier,42348,46442,216,89006,42187
hdfs://spark-nn.eemcs.utwente.nl/user/s1934538/clickstream/clickstream-enwiki-2020-11.tsv.gz,Qasem_Soleimani,21434,58725,312,80471,37776
hdfs://spark-nn.eemcs.utwente.nl/user/s1934538/clickstream/clickstream-enwiki-2020-11.tsv.gz,Manti_Te'o,6617,57363,310,64290,7261
hdfs://spark-nn.eemcs.utwente.nl/user/s1934538/clickstream/clickstream-enwiki-2020-11.tsv.gz,Gaza_Strip,17519,32252,256,50027,19998
hdfs://spark-nn.eemcs.utwente.nl/user/s1934538/clickstream/clickstream-enwiki-2020-11.tsv.gz,NATO,58578,123626,1810,184014,64964
hdfs://spark-nn.eemcs.utwente.nl/user/s1934538/clickstream/clickstream-enwiki-2020-11.tsv.gz,Adele,23128,186861,2211,212200,64748
hdfs://spark-nn.eemcs.utwente.nl/user/s1934538/clickstream/clickstream-enwiki-2020-11.tsv.gz,Betty_White,54758,299691,3691,358140,106938
hdfs://spark-nn.eemcs.utwente.nl/user/s1934538/clickstream/clickstream-enwiki-2020-11.tsv.gz,Russo-Ukrainian_War,18070,25670,177,43917,25133
hdfs://spark-nn.eemcs.utwente.nl/user/s1934538/clickstream/clickstream-enwiki-2020-11.tsv.gz,2016_United_States_presidential_election,2483757,8979300,51720,11514777,5774257
hdfs://spark-nn.eemcs.utwente.nl/user/s1934538/clickstream/clickstream-enwiki-2020-11.tsv.gz,Croatia,37359,101967,1316,140642,51810
hdfs://spark-nn.eemcs.utwente.nl/user/s1934538/clickstream/clickstream-enwiki-2020-11.tsv.gz,Asia_Cup,1365,21901,141,23407,10168
hdfs://spark-nn.eemcs.utwente.nl/user/s1934538/clickstream/clickstream-enwiki-2020-11.tsv.gz,Anne_Heche,28801,68495,363,97659,29025
hdfs://spark-nn.eemcs.utwente.nl/user/s1934538/clickstream/clickstream-enwiki-2020-11.tsv.gz,Burt_Reynolds,53752,172583,1804,228139,92064
hdfs://spark-nn.eemcs.utwente.nl/user/s1934538/clickstream/clickstream-enwiki-2020-11.tsv.gz,Juice_Wrld,40880,404499,5037,450416,141471
hdfs://spark-nn.eemcs.utwente.nl/user/s1934538/clickstream/clickstream-enwiki-2020-11.tsv.gz,Aaron_Hernandez,10228,136860,549,147637,45173
hdfs://spark-nn.eemcs.utwente.nl/user/s1934538/clickstream/clickstream-enwiki-2020-11.tsv.gz,Article_370_of_the_Constitution_of_India,2977,55549,114,58640,4010
hdfs://spark-nn.eemcs.utwente.nl/user/s1934538/clickstream/clickstream-enwiki-2020-11.tsv.gz,Death_of_Elisa_Lam,10195,129403,659,140257,31561
hdfs://spark-nn.eemcs.utwente.nl/user/s1934538/clickstream/clickstream-enwiki-2020-11.tsv.gz,Fyre_Festival,7230,50167,316,57713,32056
hdfs://spark-nn.eemcs.utwente.nl/user/s1934538/clickstream/clickstream-enwiki-2020-11.tsv.gz,Tina_Turner,21431,195854,2743,220028,66096
hdfs://spark-nn.eemcs.utwente.nl/user/s1934538/clickstream/clickstream-enwiki-2020-11.tsv.gz,List_of_James_Bond_films,123468,838173,908,962549,606859
hdfs://spark-nn.eemcs.utwente.nl/user/s1934538/clickstream/clickstream-enwiki-2020-11.tsv.gz,George_H._W._Bush,977757,609326,4106,1591189,915944
hdfs://spark-nn.eemcs.utwente.nl/user/s1934538/clickstream/clickstream-enwiki-2020-11.tsv.gz,Doctor_Strange_in_the_Multiverse_of_Madness,45250,10628,688,56566,20187
hdfs://spark-nn.eemcs.utwente.nl/user/s1934538/clickstream/clickstream-enwiki-2020-11.tsv.gz,Media,62,4331,305,4698,1786
hdfs://spark-nn.eemcs.utwente.nl/user/s1934538/clickstream/clickstream-enwiki-2020-11.tsv.gz,Indian_Premier_League,43442,490915,608,534965,270171
hdfs://spark-nn.eemcs.utwente.nl/user/s1934538/clickstream/clickstream-enwiki-2020-11.tsv.gz,1234,89,1538,17,1644,239
hdfs://spark-nn.eemcs.utwente.nl/user/s1934538/clickstream/clickstream-enwiki-2020-11.tsv.gz,2022_FIFA_World_Cup,72169,120580,2689,195438,115188
hdfs://spark-nn.eemcs.utwente.nl/user/s1934538/clickstream/clickstream-enwiki-2020-11.tsv.gz,List_of_Marvel_Cinematic_Universe_films,87702,559904,1330,648936,264788
hdfs://spark-nn.eemcs.utwente.nl/user/s1934538/clickstream/clickstream-enwiki-2020-11.tsv.gz,Antifa_(United_States),30900,481629,1879,514408,88106
hdfs://spark-nn.eemcs.utwente.nl/user/s1934538/clickstream/clickstream-enwiki-2020-11.tsv.gz,2.0_(film),14421,46193,73,60687,16292
hdfs://spark-nn.eemcs.utwente.nl/user/s1934538/clickstream/clickstream-enwiki-2020-11.tsv.gz,Dennis_Nilsen,24201,171637,1019,196857,46120
hdfs://spark-nn.eemcs.utwente.nl/user/s1934538/clickstream/clickstream-enwiki-2020-11.tsv.gz,Charles_Sobhraj,4226,19215,51,23492,4565
hdfs://spark-nn.eemcs.utwente.nl/user/s1934538/clickstream/clickstream-enwiki-2020-11.tsv.gz,WandaVision,56900,167229,2529,226658,103828
hdfs://spark-nn.eemcs.utwente.nl/user/s1934538/clickstream/clickstream-enwiki-2020-11.tsv.gz,"Prince_Philip,_Duke_of_Edinburgh",1451563,1759990,29290,3240843,2176191
hdfs://spark-nn.eemcs.utwente.nl/user/s1934538/clickstream/clickstream-enwiki-2020-11.tsv.gz,Sushma_Swaraj,5377,18846,94,24317,5839
hdfs://spark-nn.eemcs.utwente.nl/user/s1934538/clickstream/clickstream-enwiki-2020-11.tsv.gz,List_of_FIFA_World_Cup_finals,3876,81689,80,85645,31177
hdfs://spark-nn.eemcs.utwente.nl/user/s1934538/clickstream/clickstream-enwiki-2020-11.tsv.gz,Chadwick_Boseman,85629,411186,7135,503950,156650
hdfs://spark-nn.eemcs.utwente.nl/user/s1934538/clickstream/clickstream-enwiki-2020-11.tsv.gz,Jeffrey_Epstein,82346,364448,2468,449262,176390
hdfs://spark-nn.eemcs.utwente.nl/user/s1934538/clickstream/clickstream-enwiki-2020-11.tsv.gz,Elon_Musk,210567,1344500,10155,1565222,898444
hdfs://spark-nn.eemcs.utwente.nl/user/s1934538/clickstream/clickstream-enwiki-2020-11.tsv.gz,Coronavirus_disease_2019,210654,542638,6909,760201,237993
hdfs://spark-nn.eemcs.utwente.nl/user/s1934538/clickstream/clickstream-enwiki-2020-11.tsv.gz,Joe_Biden,2176798,13764961,221693,16163452,9274686
hdfs://spark-nn.eemcs.utwente.nl/user/s1934538/clickstream/clickstream-enwiki-2020-11.tsv.gz,Cleopatra,46763,1676334,2002,1725099,175154
hdfs://spark-nn.eemcs.utwente.nl/user/s1934538/clickstream/clickstream-enwiki-2020-11.tsv.gz,Ray_Liotta,40563,69315,768,110646,33084
hdfs://spark-nn.eemcs.utwente.nl/user/s1934538/clickstream/clickstream-enwiki-2020-11.tsv.gz,Lists_of_deaths_by_year,5615,139666,392,145673,137102
hdfs://spark-nn.eemcs.utwente.nl/user/s1934538/clickstream/clickstream-enwiki-2020-11.tsv.gz,List_of_highest-grossing_Indian_films,35850,123707,318,159875,91436
hdfs://spark-nn.eemcs.utwente.nl/user/s1934538/clickstream/clickstream-enwiki-2020-11.tsv.gz,Salman_Rushdie,33818,59376,347,93541,36895
hdfs://spark-nn.eemcs.utwente.nl/user/s1934538/clickstream/clickstream-enwiki-2020-11.tsv.gz,DMX_(rapper),14185,63221,424,77830,31319
hdfs://spark-nn.eemcs.utwente.nl/user/s1934538/clickstream/clickstream-enwiki-2020-11.tsv.gz,Kate_Spade,24367,68943,329,93639,32771
hdfs://spark-nn.eemcs.utwente.nl/user/s1934538/clickstream/clickstream-enwiki-2020-11.tsv.gz,Luke_Perry,33708,133952,463,168123,48919
hdfs://spark-nn.eemcs.utwente.nl/user/s1934538/clickstream/clickstream-enwiki-2020-11.tsv.gz,Atal_Bihari_Vajpayee,34229,46361,117,80707,26455
hdfs://spark-nn.eemcs.utwente.nl/user/s1934538/clickstream/clickstream-enwiki-2020-11.tsv.gz,Crazy_Rich_Asians_(film),33499,160702,1392,195593,192693
hdfs://spark-nn.eemcs.utwente.nl/user/s1934538/clickstream/clickstream-enwiki-2020-11.tsv.gz,Sidharth_Shukla,20703,58533,116,79352,20797
hdfs://spark-nn.eemcs.utwente.nl/user/s1934538/clickstream/clickstream-enwiki-2021-07.tsv.gz,Puneeth_Rajkumar,12044,27073,733,39850,28279
hdfs://spark-nn.eemcs.utwente.nl/user/s1934538/clickstream/clickstream-enwiki-2021-07.tsv.gz,When_They_See_Us,19020,30780,194,49994,23664
hdfs://spark-nn.eemcs.utwente.nl/user/s1934538/clickstream/clickstream-enwiki-2021-07.tsv.gz,Thor:_Love_and_Thunder,253955,141260,1337,396552,315427
hdfs://spark-nn.eemcs.utwente.nl/user/s1934538/clickstream/clickstream-enwiki-2021-07.tsv.gz,Central_Park_jogger_case,13671,42787,196,56654,8791
hdfs://spark-nn.eemcs.utwente.nl/user/s1934538/clickstream/clickstream-enwiki-2021-07.tsv.gz,COVID-19_pandemic_by_country_and_territory,150505,368000,7267,525772,343661
hdfs://spark-nn.eemcs.utwente.nl/user/s1934538/clickstream/clickstream-enwiki-2021-07.tsv.gz,Deion_Sanders,9302,67326,596,77224,23221
hdfs://spark-nn.eemcs.utwente.nl/user/s1934538/clickstream/clickstream-enwiki-2021-07.tsv.gz,K.G.F:_Chapter_2,27116,283213,464,310793,78923
hdfs://spark-nn.eemcs.utwente.nl/user/s1934538/clickstream/clickstream-enwiki-2021-07.tsv.gz,Christopher_Scarver,62255,17545,64,79864,29058
hdfs://spark-nn.eemcs.utwente.nl/user/s1934538/clickstream/clickstream-enwiki-2021-07.tsv.gz,Avengers:_Infinity_War,83198,122129,1950,207277,116026
hdfs://spark-nn.eemcs.utwente.nl/user/s1934538/clickstream/clickstream-enwiki-2021-07.tsv.gz,The_Falcon_and_the_Winter_Soldier,98611,282285,4848,385744,241196
hdfs://spark-nn.eemcs.utwente.nl/user/s1934538/clickstream/clickstream-enwiki-2021-07.tsv.gz,Spider-Man:_No_Way_Home,317632,454213,5966,777811,412206
hdfs://spark-nn.eemcs.utwente.nl/user/s1934538/clickstream/clickstream-enwiki-2021-07.tsv.gz,Tom_Brady,62805,302491,2999,368295,151591
hdfs://spark-nn.eemcs.utwente.nl/user/s1934538/clickstream/clickstream-enwiki-2021-07.tsv.gz,Vivek_Ramaswamy,1451,13756,73,15280,3323
hdfs://spark-nn.eemcs.utwente.nl/user/s1934538/clickstream/clickstream-enwiki-2021-07.tsv.gz,Juice_Wrld,42678,247181,4132,293991,109443
hdfs://spark-nn.eemcs.utwente.nl/user/s1934538/clickstream/clickstream-enwiki-2021-07.tsv.gz,Naya_Rivera,67686,260060,1117,328863,126026
hdfs://spark-nn.eemcs.utwente.nl/user/s1934538/clickstream/clickstream-enwiki-2021-07.tsv.gz,Avengers:_Endgame,178389,266889,4887,450165,278972
hdfs://spark-nn.eemcs.utwente.nl/user/s1934538/clickstream/clickstream-enwiki-2021-07.tsv.gz,Amy_Coney_Barrett,21937,29877,264,52078,18937
hdfs://spark-nn.eemcs.utwente.nl/user/s1934538/clickstream/clickstream-enwiki-2021-07.tsv.gz,Dark_Phoenix_(film),44033,39495,415,83943,47104
hdfs://spark-nn.eemcs.utwente.nl/user/s1934538/clickstream/clickstream-enwiki-2021-07.tsv.gz,Meat_Loaf,26052,77887,878,104817,38472
hdfs://spark-nn.eemcs.utwente.nl/user/s1934538/clickstream/clickstream-enwiki-2021-07.tsv.gz,Adele,22623,193345,2803,218771,66475
hdfs://spark-nn.eemcs.utwente.nl/user/s1934538/clickstream/clickstream-enwiki-2021-07.tsv.gz,Chernobyl_(miniseries),28377,150192,2436,181005,153302
hdfs://spark-nn.eemcs.utwente.nl/user/s1934538/clickstream/clickstream-enwiki-2021-07.tsv.gz,Kim_Jong-un,97399,182926,2123,282448,174138
hdfs://spark-nn.eemcs.utwente.nl/user/s1934538/clickstream/clickstream-enwiki-2021-07.tsv.gz,The_Irishman,55459,104339,1961,161759,140307
hdfs://spark-nn.eemcs.utwente.nl/user/s1934538/clickstream/clickstream-enwiki-2021-07.tsv.gz,Henry_V_of_England,81014,79946,385,161345,119192
hdfs://spark-nn.eemcs.utwente.nl/user/s1934538/clickstream/clickstream-enwiki-2021-07.tsv.gz,Charles_Sobhraj,98972,394495,853,494320,97096
hdfs://spark-nn.eemcs.utwente.nl/user/s1934538/clickstream/clickstream-enwiki-2021-07.tsv.gz,Spanish_flu,36790,310057,3601,350448,71482
hdfs://spark-nn.eemcs.utwente.nl/user/s1934538/clickstream/clickstream-enwiki-2021-07.tsv.gz,The_Last_of_Us_(TV_series),36157,50546,515,87218,79903
hdfs://spark-nn.eemcs.utwente.nl/user/s1934538/clickstream/clickstream-enwiki-2021-07.tsv.gz,Juneteenth,10542,123865,1676,136083,13698
hdfs://spark-nn.eemcs.utwente.nl/user/s1934538/clickstream/clickstream-enwiki-2021-07.tsv.gz,Jeffrey_Dahmer,34014,284687,29208,347909,171214
hdfs://spark-nn.eemcs.utwente.nl/user/s1934538/clickstream/clickstream-enwiki-2021-07.tsv.gz,Tenet_(film),79239,315108,4026,398373,217631
hdfs://spark-nn.eemcs.utwente.nl/user/s1934538/clickstream/clickstream-enwiki-2021-07.tsv.gz,Bonnie_and_Clyde,24297,218558,1472,244327,59769
hdfs://spark-nn.eemcs.utwente.nl/user/s1934538/clickstream/clickstream-enwiki-2021-07.tsv.gz,Coronavirus,19399,169844,3959,193202,58989
hdfs://spark-nn.eemcs.utwente.nl/user/s1934538/clickstream/clickstream-enwiki-2021-07.tsv.gz,Kobe_Bryant,82811,406659,3570,493040,144591
hdfs://spark-nn.eemcs.utwente.nl/user/s1934538/clickstream/clickstream-enwiki-2021-07.tsv.gz,Aaron_Carter,25749,136052,525,162326,38069
hdfs://spark-nn.eemcs.utwente.nl/user/s1934538/clickstream/clickstream-enwiki-2021-07.tsv.gz,Asia_Cup,2547,32789,176,35512,18651
hdfs://spark-nn.eemcs.utwente.nl/user/s1934538/clickstream/clickstream-enwiki-2021-07.tsv.gz,Sushma_Swaraj,9952,20903,191,31046,9624
hdfs://spark-nn.eemcs.utwente.nl/user/s1934538/clickstream/clickstream-enwiki-2021-07.tsv.gz,Khabib_Nurmagomedov,222557,580813,5529,808899,458612
hdfs://spark-nn.eemcs.utwente.nl/user/s1934538/clickstream/clickstream-enwiki-2021-07.tsv.gz,Simple_Mail_Transfer_Protocol,2960,36580,175,39715,3192
hdfs://spark-nn.eemcs.utwente.nl/user/s1934538/clickstream/clickstream-enwiki-2021-07.tsv.gz,Hamas,21759,36760,384,58903,22379
hdfs://spark-nn.eemcs.utwente.nl/user/s1934538/clickstream/clickstream-enwiki-2021-07.tsv.gz,Bipin_Rawat,11082,28256,25,39363,18303
hdfs://spark-nn.eemcs.utwente.nl/user/s1934538/clickstream/clickstream-enwiki-2021-07.tsv.gz,Black_Widow_(2021_film),527178,4287406,113927,4928511,3528268
hdfs://spark-nn.eemcs.utwente.nl/user/s1934538/clickstream/clickstream-enwiki-2021-07.tsv.gz,Aaron_Hernandez,9038,124749,600,134387,43883
hdfs://spark-nn.eemcs.utwente.nl/user/s1934538/clickstream/clickstream-enwiki-2021-07.tsv.gz,Loki_(TV_series),319600,3189191,83355,3592146,1939235
hdfs://spark-nn.eemcs.utwente.nl/user/s1934538/clickstream/clickstream-enwiki-2021-07.tsv.gz,Betty_White,70069,229681,3305,303055,98823
hdfs://spark-nn.eemcs.utwente.nl/user/s1934538/clickstream/clickstream-enwiki-2021-07.tsv.gz,QAnon,44172,255996,1890,302058,80379
hdfs://spark-nn.eemcs.utwente.nl/user/s1934538/clickstream/clickstream-enwiki-2021-07.tsv.gz,Main_Page,72592,171481967,4723386,176277945,39582601
hdfs://spark-nn.eemcs.utwente.nl/user/s1934538/clickstream/clickstream-enwiki-2021-07.tsv.gz,Priyanka_Chopra,112557,300201,1096,413854,149111
hdfs://spark-nn.eemcs.utwente.nl/user/s1934538/clickstream/clickstream-enwiki-2021-07.tsv.gz,Anna_Sorokin,5993,40632,158,46783,14366
hdfs://spark-nn.eemcs.utwente.nl/user/s1934538/clickstream/clickstream-enwiki-2021-07.tsv.gz,Dennis_Nilsen,9931,72571,412,82914,23426
hdfs://spark-nn.eemcs.utwente.nl/user/s1934538/clickstream/clickstream-enwiki-2021-07.tsv.gz,2.0_(film),23818,33290,101,57209,18148
hdfs://spark-nn.eemcs.utwente.nl/user/s1934538/clickstream/clickstream-enwiki-2021-07.tsv.gz,War_(2019_film),19247,62100,191,81538,22773
hdfs://spark-nn.eemcs.utwente.nl/user/s1934538/clickstream/clickstream-enwiki-2021-07.tsv.gz,Glass_(2019_film),97049,85242,719,183010,65285
hdfs://spark-nn.eemcs.utwente.nl/user/s1934538/clickstream/clickstream-enwiki-2021-07.tsv.gz,Alexander_Hamilton,79274,251024,2191,332489,179617
hdfs://spark-nn.eemcs.utwente.nl/user/s1934538/clickstream/clickstream-enwiki-2021-07.tsv.gz,A_Star_Is_Born_(2018_film),33634,98110,596,132340,62312
hdfs://spark-nn.eemcs.utwente.nl/user/s1934538/clickstream/clickstream-enwiki-2021-07.tsv.gz,Anthony_Bourdain,43383,657417,6268,707068,230033
hdfs://spark-nn.eemcs.utwente.nl/user/s1934538/clickstream/clickstream-enwiki-2021-07.tsv.gz,Shang-Chi_and_the_Legend_of_the_Ten_Rings,205343,222569,3156,431068,264127
hdfs://spark-nn.eemcs.utwente.nl/user/s1934538/clickstream/clickstream-enwiki-2021-07.tsv.gz,Army_of_the_Dead,58900,184893,3660,247453,186300
hdfs://spark-nn.eemcs.utwente.nl/user/s1934538/clickstream/clickstream-enwiki-2021-07.tsv.gz,Aretha_Franklin,34816,198288,1868,234972,108332
hdfs://spark-nn.eemcs.utwente.nl/user/s1934538/clickstream/clickstream-enwiki-2021-07.tsv.gz,Eternals_(film),198139,173275,2152,373566,301696
hdfs://spark-nn.eemcs.utwente.nl/user/s1934538/clickstream/clickstream-enwiki-2021-07.tsv.gz,Emma_Raducanu,26819,1644253,8704,1679776,237876
hdfs://spark-nn.eemcs.utwente.nl/user/s1934538/clickstream/clickstream-enwiki-2021-07.tsv.gz,Critical_race_theory,24409,1552233,10758,1587400,189317
hdfs://spark-nn.eemcs.utwente.nl/user/s1934538/clickstream/clickstream-enwiki-2021-07.tsv.gz,List_of_FIFA_World_Cup_finals,25281,459025,694,485000,122421
hdfs://spark-nn.eemcs.utwente.nl/user/s1934538/clickstream/clickstream-enwiki-2021-07.tsv.gz,Bob_Saget,18593,38661,294,57548,12071
hdfs://spark-nn.eemcs.utwente.nl/user/s1934538/clickstream/clickstream-enwiki-2021-07.tsv.gz,The_Shape_of_Water,22756,54525,682,77963,36252
hdfs://spark-nn.eemcs.utwente.nl/user/s1934538/clickstream/clickstream-enwiki-2021-07.tsv.gz,Johnny_Depp,149985,362985,2452,515422,374317
hdfs://spark-nn.eemcs.utwente.nl/user/s1934538/clickstream/clickstream-enwiki-2021-07.tsv.gz,Kamala_Harris,90842,204148,1931,296921,134112
hdfs://spark-nn.eemcs.utwente.nl/user/s1934538/clickstream/clickstream-enwiki-2021-07.tsv.gz,No_Time_to_Die,180868,209102,3251,393221,194900
hdfs://spark-nn.eemcs.utwente.nl/user/s1934538/clickstream/clickstream-enwiki-2021-07.tsv.gz,Rishi_Sunak,17196,50774,250,68220,29362
hdfs://spark-nn.eemcs.utwente.nl/user/s1934538/clickstream/clickstream-enwiki-2021-07.tsv.gz,Sylvester_Stallone,106512,364537,3063,474112,342718
hdfs://spark-nn.eemcs.utwente.nl/user/s1934538/clickstream/clickstream-enwiki-2021-07.tsv.gz,Sidharth_Shukla,14256,33047,121,47424,12214
hdfs://spark-nn.eemcs.utwente.nl/user/s1934538/clickstream/clickstream-enwiki-2021-07.tsv.gz,Stranger_Things,103876,290932,6502,401310,336253
hdfs://spark-nn.eemcs.utwente.nl/user/s1934538/clickstream/clickstream-enwiki-2021-07.tsv.gz,Keanu_Reeves,107835,453300,3189,564324,331102
hdfs://spark-nn.eemcs.utwente.nl/user/s1934538/clickstream/clickstream-enwiki-2021-07.tsv.gz,Bird_Box_(film),18073,68290,886,87249,27874
hdfs://spark-nn.eemcs.utwente.nl/user/s1934538/clickstream/clickstream-enwiki-2021-07.tsv.gz,Naomi_Osaka,118003,1752243,9469,1879715,464589
hdfs://spark-nn.eemcs.utwente.nl/user/s1934538/clickstream/clickstream-enwiki-2021-07.tsv.gz,Salman_Rushdie,27834,56304,373,84511,35086
hdfs://spark-nn.eemcs.utwente.nl/user/s1934538/clickstream/clickstream-enwiki-2021-07.tsv.gz,"Prince_Philip,_Duke_of_Edinburgh",194275,203376,4122,401773,243960
hdfs://spark-nn.eemcs.utwente.nl/user/s1934538/clickstream/clickstream-enwiki-2021-07.tsv.gz,Article_370_of_the_Constitution_of_India,2588,41300,40,43928,2617
hdfs://spark-nn.eemcs.utwente.nl/user/s1934538/clickstream/clickstream-enwiki-2021-07.tsv.gz,Tonya_Harding,31729,166143,869,198741,52633
hdfs://spark-nn.eemcs.utwente.nl/user/s1934538/clickstream/clickstream-enwiki-2021-07.tsv.gz,WrestleMania_34,15495,8420,121,24036,15719
hdfs://spark-nn.eemcs.utwente.nl/user/s1934538/clickstream/clickstream-enwiki-2021-07.tsv.gz,"Citizenship_(Amendment)_Act,_2019",4535,28044,79,32658,3714
hdfs://spark-nn.eemcs.utwente.nl/user/s1934538/clickstream/clickstream-enwiki-2021-07.tsv.gz,List_of_Queen_of_the_South_episodes,26236,18325,150,44711,1233
hdfs://spark-nn.eemcs.utwente.nl/user/s1934538/clickstream/clickstream-enwiki-2021-07.tsv.gz,Elon_Musk,144524,1141224,9637,1295385,701846
hdfs://spark-nn.eemcs.utwente.nl/user/s1934538/clickstream/clickstream-enwiki-2021-07.tsv.gz,Mötley_Crüe,35690,111681,1453,148824,162545
hdfs://spark-nn.eemcs.utwente.nl/user/s1934538/clickstream/clickstream-enwiki-2021-07.tsv.gz,Burt_Reynolds,67996,176965,1844,246805,118706
hdfs://spark-nn.eemcs.utwente.nl/user/s1934538/clickstream/clickstream-enwiki-2021-07.tsv.gz,Spider-Man:_Far_From_Home,105053,124072,2107,231232,131534
hdfs://spark-nn.eemcs.utwente.nl/user/s1934538/clickstream/clickstream-enwiki-2021-07.tsv.gz,Jimmy_Buffett,11104,87633,1047,99784,33689
hdfs://spark-nn.eemcs.utwente.nl/user/s1934538/clickstream/clickstream-enwiki-2021-07.tsv.gz,Michael_Jordan,185200,740225,6686,932111,330494
hdfs://spark-nn.eemcs.utwente.nl/user/s1934538/clickstream/clickstream-enwiki-2021-07.tsv.gz,Kelly_Preston,108938,214844,1541,325323,97197
hdfs://spark-nn.eemcs.utwente.nl/user/s1934538/clickstream/clickstream-enwiki-2021-07.tsv.gz,Matthew_Perry,66540,200071,8585,275196,142006
hdfs://spark-nn.eemcs.utwente.nl/user/s1934538/clickstream/clickstream-enwiki-2021-07.tsv.gz,Brie_Larson,69179,158369,1442,228990,94030
hdfs://spark-nn.eemcs.utwente.nl/user/s1934538/clickstream/clickstream-enwiki-2021-07.tsv.gz,Elizabeth_II,452704,661287,3713,1117704,823014
hdfs://spark-nn.eemcs.utwente.nl/user/s1934538/clickstream/clickstream-enwiki-2021-07.tsv.gz,The_Lion_King_(2019_film),40216,51238,503,91957,44570
hdfs://spark-nn.eemcs.utwente.nl/user/s1934538/clickstream/clickstream-enwiki-2021-07.tsv.gz,Hyphen-minus,744,5837613,19784,5858141,720
hdfs://spark-nn.eemcs.utwente.nl/user/s1934538/clickstream/clickstream-enwiki-2021-07.tsv.gz,Rami_Malek,72891,177240,568,250699,100994
hdfs://spark-nn.eemcs.utwente.nl/user/s1934538/clickstream/clickstream-enwiki-2021-07.tsv.gz,Ray_Liotta,53031,67339,521,120891,45651
hdfs://spark-nn.eemcs.utwente.nl/user/s1934538/clickstream/clickstream-enwiki-2021-07.tsv.gz,HTTP_cookie,2600,285187,207,287994,26576
hdfs://spark-nn.eemcs.utwente.nl/user/s1934538/clickstream/clickstream-enwiki-2021-07.tsv.gz,Indian_Premier_League,14086,56867,139,71092,39223
hdfs://spark-nn.eemcs.utwente.nl/user/s1934538/clickstream/clickstream-enwiki-2021-07.tsv.gz,2018_FIFA_World_Cup,332197,435928,6811,774936,407420
hdfs://spark-nn.eemcs.utwente.nl/user/s1934538/clickstream/clickstream-enwiki-2021-07.tsv.gz,Queen_(band),69033,236857,4171,310061,312350
hdfs://spark-nn.eemcs.utwente.nl/user/s1934538/clickstream/clickstream-enwiki-2021-07.tsv.gz,2020_Summer_Olympics,1854888,4794592,76771,6726251,8320556
hdfs://spark-nn.eemcs.utwente.nl/user/s1934538/clickstream/clickstream-enwiki-2021-07.tsv.gz,2023_Cricket_World_Cup,23895,40443,141,64479,25451
hdfs://spark-nn.eemcs.utwente.nl/user/s1934538/clickstream/clickstream-enwiki-2021-07.tsv.gz,Donald_Glover,42523,136840,1132,180495,78543
hdfs://spark-nn.eemcs.utwente.nl/user/s1934538/clickstream/clickstream-enwiki-2021-07.tsv.gz,2020_United_States_presidential_election,180791,314617,7973,503381,492803
hdfs://spark-nn.eemcs.utwente.nl/user/s1934538/clickstream/clickstream-enwiki-2021-07.tsv.gz,Notre-Dame_de_Paris,10920,68738,700,80358,18822
hdfs://spark-nn.eemcs.utwente.nl/user/s1934538/clickstream/clickstream-enwiki-2021-07.tsv.gz,George_VI,346598,138198,617,485413,355976
hdfs://spark-nn.eemcs.utwente.nl/user/s1934538/clickstream/clickstream-enwiki-2021-07.tsv.gz,Darth_Vader,27409,64296,673,92378,55088
hdfs://spark-nn.eemcs.utwente.nl/user/s1934538/clickstream/clickstream-enwiki-2021-07.tsv.gz,Jimmy_Hoffa,34051,138039,1198,173288,68540
hdfs://spark-nn.eemcs.utwente.nl/user/s1934538/clickstream/clickstream-enwiki-2021-07.tsv.gz,2016_United_States_presidential_election,117350,76062,1170,194582,187060
hdfs://spark-nn.eemcs.utwente.nl/user/s1934538/clickstream/clickstream-enwiki-2021-07.tsv.gz,Game_of_Thrones,75531,304831,6880,387242,261292
hdfs://spark-nn.eemcs.utwente.nl/user/s1934538/clickstream/clickstream-enwiki-2021-07.tsv.gz,Aquaman_(film),33203,114332,1784,149319,90371
hdfs://spark-nn.eemcs.utwente.nl/user/s1934538/clickstream/clickstream-enwiki-2021-07.tsv.gz,Google_logo,1141,51861,25,53027,1149
hdfs://spark-nn.eemcs.utwente.nl/user/s1934538/clickstream/clickstream-enwiki-2021-07.tsv.gz,Tina_Turner,26942,213610,2730,243282,88105
hdfs://spark-nn.eemcs.utwente.nl/user/s1934538/clickstream/clickstream-enwiki-2021-07.tsv.gz,Dune_(2021_film),160708,510565,12019,683292,562185
hdfs://spark-nn.eemcs.utwente.nl/user/s1934538/clickstream/clickstream-enwiki-2021-07.tsv.gz,Atal_Bihari_Vajpayee,33455,62057,88,95600,32647
hdfs://spark-nn.eemcs.utwente.nl/user/s1934538/clickstream/clickstream-enwiki-2021-07.tsv.gz,R._Kelly,36162,214718,2674,253554,121500
hdfs://spark-nn.eemcs.utwente.nl/user/s1934538/clickstream/clickstream-enwiki-2021-08.tsv.gz,Atal_Bihari_Vajpayee,32972,89088,105,122165,34873
hdfs://spark-nn.eemcs.utwente.nl/user/s1934538/clickstream/clickstream-enwiki-2021-08.tsv.gz,House_of_the_Dragon,27701,41011,341,69053,56172
hdfs://spark-nn.eemcs.utwente.nl/user/s1934538/clickstream/clickstream-enwiki-2021-08.tsv.gz,Article_370_of_the_Constitution_of_India,2948,71410,48,74406,3775
hdfs://spark-nn.eemcs.utwente.nl/user/s1934538/clickstream/clickstream-enwiki-2021-08.tsv.gz,Saaho,16312,40780,100,57192,20474
hdfs://spark-nn.eemcs.utwente.nl/user/s1934538/clickstream/clickstream-enwiki-2021-08.tsv.gz,Black_Adam_(film),99307,40322,420,140049,107511
hdfs://spark-nn.eemcs.utwente.nl/user/s1934538/clickstream/clickstream-enwiki-2021-08.tsv.gz,Amy_Coney_Barrett,21448,37924,264,59636,20521
hdfs://spark-nn.eemcs.utwente.nl/user/s1934538/clickstream/clickstream-enwiki-2021-08.tsv.gz,COVID-19_pandemic_by_country_and_territory,125103,331176,6835,463114,286488
hdfs://spark-nn.eemcs.utwente.nl/user/s1934538/clickstream/clickstream-enwiki-2021-08.tsv.gz,Stan_Lee,58736,209589,1236,269561,61709
hdfs://spark-nn.eemcs.utwente.nl/user/s1934538/clickstream/clickstream-enwiki-2021-08.tsv.gz,"Princess_Margaret,_Countess_of_Snowdon",101417,243745,1951,347113,200067
hdfs://spark-nn.eemcs.utwente.nl/user/s1934538/clickstream/clickstream-enwiki-2021-08.tsv.gz,WandaVision,55978,211397,5057,272432,151914
hdfs://spark-nn.eemcs.utwente.nl/user/s1934538/clickstream/clickstream-enwiki-2021-08.tsv.gz,Adele,21670,148297,1887,171854,56229
hdfs://spark-nn.eemcs.utwente.nl/user/s1934538/clickstream/clickstream-enwiki-2021-08.tsv.gz,United_States_Electoral_College,9822,24585,78,34485,5962
hdfs://spark-nn.eemcs.utwente.nl/user/s1934538/clickstream/clickstream-enwiki-2021-08.tsv.gz,Spider-Man:_Far_From_Home,153256,204198,5397,362851,218490
hdfs://spark-nn.eemcs.utwente.nl/user/s1934538/clickstream/clickstream-enwiki-2021-08.tsv.gz,Sridevi,36380,101976,278,138634,63808
hdfs://spark-nn.eemcs.utwente.nl/user/s1934538/clickstream/clickstream-enwiki-2021-08.tsv.gz,The_Shape_of_Water,24264,63265,755,88284,42195
hdfs://spark-nn.eemcs.utwente.nl/user/s1934538/clickstream/clickstream-enwiki-2021-08.tsv.gz,Keanu_Reeves,104774,537695,3736,646205,380558
hdfs://spark-nn.eemcs.utwente.nl/user/s1934538/clickstream/clickstream-enwiki-2021-08.tsv.gz,2020_Summer_Olympics,1367263,3100333,230864,4698460,6055771
hdfs://spark-nn.eemcs.utwente.nl/user/s1934538/clickstream/clickstream-enwiki-2021-08.tsv.gz,Loki_(TV_series),75943,498031,9216,583190,326587
hdfs://spark-nn.eemcs.utwente.nl/user/s1934538/clickstream/clickstream-enwiki-2021-08.tsv.gz,Cameron_Boyce,32861,169797,730,203388,54890
hdfs://spark-nn.eemcs.utwente.nl/user/s1934538/clickstream/clickstream-enwiki-2021-08.tsv.gz,Valentine's_Day,3530,28692,252,32474,3296
hdfs://spark-nn.eemcs.utwente.nl/user/s1934538/clickstream/clickstream-enwiki-2021-08.tsv.gz,No_Time_to_Die,167710,250650,4954,423314,230150
hdfs://spark-nn.eemcs.utwente.nl/user/s1934538/clickstream/clickstream-enwiki-2021-08.tsv.gz,Ted_Bundy,45565,465865,6153,517583,133083
hdfs://spark-nn.eemcs.utwente.nl/user/s1934538/clickstream/clickstream-enwiki-2021-08.tsv.gz,Christopher_Scarver,59048,17665,57,76770,27149
hdfs://spark-nn.eemcs.utwente.nl/user/s1934538/clickstream/clickstream-enwiki-2021-08.tsv.gz,The_Queen's_Gambit_(miniseries),35731,175624,1900,213255,110642
hdfs://spark-nn.eemcs.utwente.nl/user/s1934538/clickstream/clickstream-enwiki-2021-08.tsv.gz,Anthony_Bourdain,32661,360879,3051,396591,126734
hdfs://spark-nn.eemcs.utwente.nl/user/s1934538/clickstream/clickstream-enwiki-2021-08.tsv.gz,Shinzo_Abe,32343,29646,299,62288,37618
hdfs://spark-nn.eemcs.utwente.nl/user/s1934538/clickstream/clickstream-enwiki-2021-08.tsv.gz,Deaths_in_2021,1428473,2410113,19459,3858045,2320921
hdfs://spark-nn.eemcs.utwente.nl/user/s1934538/clickstream/clickstream-enwiki-2021-08.tsv.gz,Black_Panther:_Wakanda_Forever,144509,87631,1681,233821,188768
hdfs://spark-nn.eemcs.utwente.nl/user/s1934538/clickstream/clickstream-enwiki-2021-08.tsv.gz,Joker_(2019_film),64048,257697,3355,325100,155792
hdfs://spark-nn.eemcs.utwente.nl/user/s1934538/clickstream/clickstream-enwiki-2021-08.tsv.gz,2023_Cricket_World_Cup,15751,32305,101,48157,15525
hdfs://spark-nn.eemcs.utwente.nl/user/s1934538/clickstream/clickstream-enwiki-2021-08.tsv.gz,The_Last_of_Us_(TV_series),45138,38090,202,83430,70410
hdfs://spark-nn.eemcs.utwente.nl/user/s1934538/clickstream/clickstream-enwiki-2021-08.tsv.gz,The_Umbrella_Academy_(TV_series),30143,143390,2746,176279,97436
hdfs://spark-nn.eemcs.utwente.nl/user/s1934538/clickstream/clickstream-enwiki-2021-08.tsv.gz,Key_frame,517,5339,13,5869,351
hdfs://spark-nn.eemcs.utwente.nl/user/s1934538/clickstream/clickstream-enwiki-2021-08.tsv.gz,Cardi_B,57416,269537,5312,332265,118070
hdfs://spark-nn.eemcs.utwente.nl/user/s1934538/clickstream/clickstream-enwiki-2021-08.tsv.gz,Brett_Kavanaugh,15591,26784,168,42543,13119
hdfs://spark-nn.eemcs.utwente.nl/user/s1934538/clickstream/clickstream-enwiki-2021-08.tsv.gz,XXX:_Return_of_Xander_Cage,73219,710195,1159,784573,92520
hdfs://spark-nn.eemcs.utwente.nl/user/s1934538/clickstream/clickstream-enwiki-2021-08.tsv.gz,Notre-Dame_de_Paris,11118,72072,697,83887,19109
hdfs://spark-nn.eemcs.utwente.nl/user/s1934538/clickstream/clickstream-enwiki-2021-08.tsv.gz,When_They_See_Us,14624,28094,176,42894,20161
hdfs://spark-nn.eemcs.utwente.nl/user/s1934538/clickstream/clickstream-enwiki-2021-08.tsv.gz,Dune_(2021_film),160880,384046,9279,554205,396198
hdfs://spark-nn.eemcs.utwente.nl/user/s1934538/clickstream/clickstream-enwiki-2021-08.tsv.gz,Kobe_Bryant,72135,468743,4634,545512,146705
hdfs://spark-nn.eemcs.utwente.nl/user/s1934538/clickstream/clickstream-enwiki-2021-08.tsv.gz,Spanish_flu,41915,424839,4463,471217,96556
hdfs://spark-nn.eemcs.utwente.nl/user/s1934538/clickstream/clickstream-enwiki-2021-08.tsv.gz,YouTube,133482,2367386,10067,2510935,120718
hdfs://spark-nn.eemcs.utwente.nl/user/s1934538/clickstream/clickstream-enwiki-2021-08.tsv.gz,Critical_race_theory,14470,616569,3673,634712,71726
hdfs://spark-nn.eemcs.utwente.nl/user/s1934538/clickstream/clickstream-enwiki-2021-08.tsv.gz,Spider-Man:_No_Way_Home,433436,1414396,26228,1874060,1276955
hdfs://spark-nn.eemcs.utwente.nl/user/s1934538/clickstream/clickstream-enwiki-2021-08.tsv.gz,Jeffrey_Dahmer,32582,310704,4822,348108,161119
hdfs://spark-nn.eemcs.utwente.nl/user/s1934538/clickstream/clickstream-enwiki-2021-08.tsv.gz,Stranger_Things,93575,289278,6612,389465,306613
hdfs://spark-nn.eemcs.utwente.nl/user/s1934538/clickstream/clickstream-enwiki-2021-08.tsv.gz,David_Beckham,51006,248664,1488,301158,110106
hdfs://spark-nn.eemcs.utwente.nl/user/s1934538/clickstream/clickstream-enwiki-2021-08.tsv.gz,Microsoft_Office,7525,1758606,699,1766830,18760
hdfs://spark-nn.eemcs.utwente.nl/user/s1934538/clickstream/clickstream-enwiki-2021-08.tsv.gz,Avengers:_Endgame,134371,207159,3343,344873,205083
hdfs://spark-nn.eemcs.utwente.nl/user/s1934538/clickstream/clickstream-enwiki-2021-08.tsv.gz,Joaquin_Phoenix,151296,216402,1116,368814,225569
hdfs://spark-nn.eemcs.utwente.nl/user/s1934538/clickstream/clickstream-enwiki-2021-08.tsv.gz,The_Mandalorian,68736,200958,4196,273890,186011
hdfs://spark-nn.eemcs.utwente.nl/user/s1934538/clickstream/clickstream-enwiki-2021-08.tsv.gz,Kate_Spade,38074,80932,517,119523,43906
hdfs://spark-nn.eemcs.utwente.nl/user/s1934538/clickstream/clickstream-enwiki-2021-08.tsv.gz,Game_of_Thrones_(season_8),17320,48996,656,66972,22344
hdfs://spark-nn.eemcs.utwente.nl/user/s1934538/clickstream/clickstream-enwiki-2021-08.tsv.gz,Godzilla_vs._Kong,87779,274155,4788,366722,197005
hdfs://spark-nn.eemcs.utwente.nl/user/s1934538/clickstream/clickstream-enwiki-2021-08.tsv.gz,Kobe_Bryant_sexual_assault_case,7557,31078,32,38667,3299
hdfs://spark-nn.eemcs.utwente.nl/user/s1934538/clickstream/clickstream-enwiki-2021-08.tsv.gz,List_of_Queen_of_the_South_episodes,18366,13752,105,32223,845
hdfs://spark-nn.eemcs.utwente.nl/user/s1934538/clickstream/clickstream-enwiki-2021-08.tsv.gz,Elon_Musk,138627,1081787,8972,1229386,696208
hdfs://spark-nn.eemcs.utwente.nl/user/s1934538/clickstream/clickstream-enwiki-2021-08.tsv.gz,Lance_Reddick,39890,43968,237,84095,17538
hdfs://spark-nn.eemcs.utwente.nl/user/s1934538/clickstream/clickstream-enwiki-2021-08.tsv.gz,Vladimir_Putin,101869,244870,2922,349661,216314
hdfs://spark-nn.eemcs.utwente.nl/user/s1934538/clickstream/clickstream-enwiki-2021-08.tsv.gz,Aretha_Franklin,87926,807221,6510,901657,459004
hdfs://spark-nn.eemcs.utwente.nl/user/s1934538/clickstream/clickstream-enwiki-2021-08.tsv.gz,Crazy_Rich_Asians_(film),43119,115935,1439,160493,147696
hdfs://spark-nn.eemcs.utwente.nl/user/s1934538/clickstream/clickstream-enwiki-2021-08.tsv.gz,Matthew_Perry,57469,170293,850,228612,124988
hdfs://spark-nn.eemcs.utwente.nl/user/s1934538/clickstream/clickstream-enwiki-2021-08.tsv.gz,HTTP_cookie,2573,370158,135,372866,21207
hdfs://spark-nn.eemcs.utwente.nl/user/s1934538/clickstream/clickstream-enwiki-2021-08.tsv.gz,Watts_family_murders,15472,223438,504,239414,53729
hdfs://spark-nn.eemcs.utwente.nl/user/s1934538/clickstream/clickstream-enwiki-2021-08.tsv.gz,Jimmy_Hoffa,33279,128002,1168,162449,64788
hdfs://spark-nn.eemcs.utwente.nl/user/s1934538/clickstream/clickstream-enwiki-2021-08.tsv.gz,Gaza_Strip,16045,35547,260,51852,17935
hdfs://spark-nn.eemcs.utwente.nl/user/s1934538/clickstream/clickstream-enwiki-2021-08.tsv.gz,Area_51,14834,129275,1368,145477,39119
hdfs://spark-nn.eemcs.utwente.nl/user/s1934538/clickstream/clickstream-enwiki-2021-08.tsv.gz,Emma_Raducanu,4803,53290,378,58471,10885
hdfs://spark-nn.eemcs.utwente.nl/user/s1934538/clickstream/clickstream-enwiki-2021-08.tsv.gz,Squid_Game,3645,22643,69,26357,9696
hdfs://spark-nn.eemcs.utwente.nl/user/s1934538/clickstream/clickstream-enwiki-2021-08.tsv.gz,Glass_(2019_film),58733,56381,472,115586,39647
hdfs://spark-nn.eemcs.utwente.nl/user/s1934538/clickstream/clickstream-enwiki-2021-08.tsv.gz,The_Irishman,54386,96154,1864,152404,130939
hdfs://spark-nn.eemcs.utwente.nl/user/s1934538/clickstream/clickstream-enwiki-2021-08.tsv.gz,Naya_Rivera,76660,126948,641,204249,74181
hdfs://spark-nn.eemcs.utwente.nl/user/s1934538/clickstream/clickstream-enwiki-2021-08.tsv.gz,Alexander_Hamilton,63617,190586,1692,255895,136434
hdfs://spark-nn.eemcs.utwente.nl/user/s1934538/clickstream/clickstream-enwiki-2021-08.tsv.gz,Top_Gun:_Maverick,103225,130469,2930,236624,141453
hdfs://spark-nn.eemcs.utwente.nl/user/s1934538/clickstream/clickstream-enwiki-2021-08.tsv.gz,Juice_Wrld,43442,227617,3492,274551,101663
hdfs://spark-nn.eemcs.utwente.nl/user/s1934538/clickstream/clickstream-enwiki-2021-08.tsv.gz,Mac_Miller,30070,191469,1320,222859,68659
hdfs://spark-nn.eemcs.utwente.nl/user/s1934538/clickstream/clickstream-enwiki-2021-08.tsv.gz,COVID-19_pandemic,365039,411882,2048,778969,415326
hdfs://spark-nn.eemcs.utwente.nl/user/s1934538/clickstream/clickstream-enwiki-2021-08.tsv.gz,Indian_Premier_League,15446,64198,101,79745,46802
hdfs://spark-nn.eemcs.utwente.nl/user/s1934538/clickstream/clickstream-enwiki-2021-08.tsv.gz,Chadwick_Boseman,90965,417879,2669,511513,148375
hdfs://spark-nn.eemcs.utwente.nl/user/s1934538/clickstream/clickstream-enwiki-2021-08.tsv.gz,2018_FIFA_World_Cup,98043,92904,1270,192217,120019
hdfs://spark-nn.eemcs.utwente.nl/user/s1934538/clickstream/clickstream-enwiki-2021-08.tsv.gz,Bird_Box_(film),20401,62641,812,83854,26631
hdfs://spark-nn.eemcs.utwente.nl/user/s1934538/clickstream/clickstream-enwiki-2021-08.tsv.gz,Game_of_Thrones,80698,325157,7056,412911,317045
hdfs://spark-nn.eemcs.utwente.nl/user/s1934538/clickstream/clickstream-enwiki-2021-08.tsv.gz,Jenna_Ortega,32661,73077,1354,107092,31218
hdfs://spark-nn.eemcs.utwente.nl/user/s1934538/clickstream/clickstream-enwiki-2021-08.tsv.gz,Olivia_Newton-John,26864,87560,1105,115529,50605
hdfs://spark-nn.eemcs.utwente.nl/user/s1934538/clickstream/clickstream-enwiki-2021-08.tsv.gz,Tonya_Harding,43297,216936,1028,261261,74463
hdfs://spark-nn.eemcs.utwente.nl/user/s1934538/clickstream/clickstream-enwiki-2021-08.tsv.gz,Mortal_Kombat_(2021_film),48928,152040,3398,204366,173738
hdfs://spark-nn.eemcs.utwente.nl/user/s1934538/clickstream/clickstream-enwiki-2021-08.tsv.gz,XHamster,6492,203607,5708,215807,21388
hdfs://spark-nn.eemcs.utwente.nl/user/s1934538/clickstream/clickstream-enwiki-2021-08.tsv.gz,Mötley_Crüe,33456,106311,1175,140942,158599
hdfs://spark-nn.eemcs.utwente.nl/user/s1934538/clickstream/clickstream-enwiki-2021-08.tsv.gz,Juneteenth,5447,39608,206,45261,4305
hdfs://spark-nn.eemcs.utwente.nl/user/s1934538/clickstream/clickstream-enwiki-2021-08.tsv.gz,William_Murdoch,578,1301,38,1917,326
hdfs://spark-nn.eemcs.utwente.nl/user/s1934538/clickstream/clickstream-enwiki-2021-08.tsv.gz,Dark_Phoenix_(film),42891,37803,423,81117,44755
hdfs://spark-nn.eemcs.utwente.nl/user/s1934538/clickstream/clickstream-enwiki-2021-08.tsv.gz,Israel,86607,258689,6156,351452,167226
hdfs://spark-nn.eemcs.utwente.nl/user/s1934538/clickstream/clickstream-enwiki-2021-08.tsv.gz,Jeffrey_Epstein,49645,282494,2364,334503,153110
hdfs://spark-nn.eemcs.utwente.nl/user/s1934538/clickstream/clickstream-enwiki-2021-08.tsv.gz,"Citizenship_(Amendment)_Act,_2019",4396,39555,33,43984,4724
hdfs://spark-nn.eemcs.utwente.nl/user/s1934538/clickstream/clickstream-enwiki-2021-08.tsv.gz,Central_Park_jogger_case,12800,40389,182,53371,8715
hdfs://spark-nn.eemcs.utwente.nl/user/s1934538/clickstream/clickstream-enwiki-2021-08.tsv.gz,Afghanistan,842919,5149062,96998,6088979,4061572
hdfs://spark-nn.eemcs.utwente.nl/user/s1934538/clickstream/clickstream-enwiki-2021-08.tsv.gz,Death_of_Elisa_Lam,14522,96544,319,111385,26432
hdfs://spark-nn.eemcs.utwente.nl/user/s1934538/clickstream/clickstream-enwiki-2021-08.tsv.gz,Qasem_Soleimani,19310,40582,146,60038,31385
hdfs://spark-nn.eemcs.utwente.nl/user/s1934538/clickstream/clickstream-enwiki-2021-08.tsv.gz,Luke_Perry,52338,136668,616,189622,70991
hdfs://spark-nn.eemcs.utwente.nl/user/s1934538/clickstream/clickstream-enwiki-2021-08.tsv.gz,Black_Panther_(film),52032,127540,2535,182107,117899
hdfs://spark-nn.eemcs.utwente.nl/user/s1934538/clickstream/clickstream-enwiki-2021-09.tsv.gz,Kobe_Bryant_sexual_assault_case,5304,28616,57,33977,2872
hdfs://spark-nn.eemcs.utwente.nl/user/s1934538/clickstream/clickstream-enwiki-2021-09.tsv.gz,Google_logo,1639,21637,13,23289,1445
hdfs://spark-nn.eemcs.utwente.nl/user/s1934538/clickstream/clickstream-enwiki-2021-09.tsv.gz,"Princess_Margaret,_Countess_of_Snowdon",90650,208180,2221,301051,170383
hdfs://spark-nn.eemcs.utwente.nl/user/s1934538/clickstream/clickstream-enwiki-2021-09.tsv.gz,Charles_III,75,157,67,299,318
hdfs://spark-nn.eemcs.utwente.nl/user/s1934538/clickstream/clickstream-enwiki-2021-09.tsv.gz,Bob_Saget,25313,67728,927,93968,25961
hdfs://spark-nn.eemcs.utwente.nl/user/s1934538/clickstream/clickstream-enwiki-2021-09.tsv.gz,Loki_(TV_series),54739,250582,4601,309922,178295
hdfs://spark-nn.eemcs.utwente.nl/user/s1934538/clickstream/clickstream-enwiki-2021-09.tsv.gz,Luke_Perry,50397,139431,687,190515,71790
hdfs://spark-nn.eemcs.utwente.nl/user/s1934538/clickstream/clickstream-enwiki-2021-09.tsv.gz,Bible,16451,4067921,1980,4086352,34778
hdfs://spark-nn.eemcs.utwente.nl/user/s1934538/clickstream/clickstream-enwiki-2021-09.tsv.gz,Louis_Tomlinson,27213,48504,266,75983,27462
hdfs://spark-nn.eemcs.utwente.nl/user/s1934538/clickstream/clickstream-enwiki-2021-09.tsv.gz,Coronavirus,18682,161816,4789,185287,53327
hdfs://spark-nn.eemcs.utwente.nl/user/s1934538/clickstream/clickstream-enwiki-2021-09.tsv.gz,Anne_Heche,23179,42555,197,65931,21476
hdfs://spark-nn.eemcs.utwente.nl/user/s1934538/clickstream/clickstream-enwiki-2021-09.tsv.gz,Puneeth_Rajkumar,8404,17948,533,26885,18146
hdfs://spark-nn.eemcs.utwente.nl/user/s1934538/clickstream/clickstream-enwiki-2021-09.tsv.gz,JSON_Web_Token,767,28209,35,29011,1973
hdfs://spark-nn.eemcs.utwente.nl/user/s1934538/clickstream/clickstream-enwiki-2021-09.tsv.gz,House_of_the_Dragon,28041,51028,443,79512,65978
hdfs://spark-nn.eemcs.utwente.nl/user/s1934538/clickstream/clickstream-enwiki-2021-09.tsv.gz,List_of_highest-grossing_Indian_films,43757,104807,328,148892,88236
hdfs://spark-nn.eemcs.utwente.nl/user/s1934538/clickstream/clickstream-enwiki-2021-09.tsv.gz,Amber_Heard,116766,198543,1040,316349,132532
hdfs://spark-nn.eemcs.utwente.nl/user/s1934538/clickstream/clickstream-enwiki-2021-09.tsv.gz,Jenna_Ortega,35257,38752,1248,75257,21160
hdfs://spark-nn.eemcs.utwente.nl/user/s1934538/clickstream/clickstream-enwiki-2021-09.tsv.gz,Sridevi,29339,73597,145,103081,45396
hdfs://spark-nn.eemcs.utwente.nl/user/s1934538/clickstream/clickstream-enwiki-2021-09.tsv.gz,Us_(2019_film),30322,92208,342,122872,39945
hdfs://spark-nn.eemcs.utwente.nl/user/s1934538/clickstream/clickstream-enwiki-2021-09.tsv.gz,Godzilla_vs._Kong,65608,153653,3075,222336,113033
hdfs://spark-nn.eemcs.utwente.nl/user/s1934538/clickstream/clickstream-enwiki-2021-09.tsv.gz,Joe_Exotic,28116,102079,767,130962,54773
hdfs://spark-nn.eemcs.utwente.nl/user/s1934538/clickstream/clickstream-enwiki-2021-09.tsv.gz,Deaths_in_2021,1407914,2359087,15215,3782216,2303644
hdfs://spark-nn.eemcs.utwente.nl/user/s1934538/clickstream/clickstream-enwiki-2021-09.tsv.gz,Jimmy_Hoffa,28743,105877,1152,135772,52987
hdfs://spark-nn.eemcs.utwente.nl/user/s1934538/clickstream/clickstream-enwiki-2021-09.tsv.gz,Murder_of_Dee_Dee_Blanchard,14582,90397,390,105369,22986
hdfs://spark-nn.eemcs.utwente.nl/user/s1934538/clickstream/clickstream-enwiki-2021-09.tsv.gz,Ted_Bundy,43389,486192,6062,535643,136953
hdfs://spark-nn.eemcs.utwente.nl/user/s1934538/clickstream/clickstream-enwiki-2021-09.tsv.gz,Sidharth_Shukla,192489,3430899,4192,3627580,663357
hdfs://spark-nn.eemcs.utwente.nl/user/s1934538/clickstream/clickstream-enwiki-2021-09.tsv.gz,Black_Panther:_Wakanda_Forever,129068,68627,1073,198768,164055
hdfs://spark-nn.eemcs.utwente.nl/user/s1934538/clickstream/clickstream-enwiki-2021-09.tsv.gz,The_Haunting_of_Bly_Manor,61693,89981,719,152393,83140
hdfs://spark-nn.eemcs.utwente.nl/user/s1934538/clickstream/clickstream-enwiki-2021-09.tsv.gz,Richard_Ramirez,22861,256493,1900,281254,72714
hdfs://spark-nn.eemcs.utwente.nl/user/s1934538/clickstream/clickstream-enwiki-2021-09.tsv.gz,Cricket_World_Cup,10472,70689,253,81414,39282
hdfs://spark-nn.eemcs.utwente.nl/user/s1934538/clickstream/clickstream-enwiki-2021-09.tsv.gz,Laal_Singh_Chaddha,58513,76043,3661,138217,66321
hdfs://spark-nn.eemcs.utwente.nl/user/s1934538/clickstream/clickstream-enwiki-2021-09.tsv.gz,Henry_V_of_England,74073,79294,379,153746,111938
hdfs://spark-nn.eemcs.utwente.nl/user/s1934538/clickstream/clickstream-enwiki-2021-09.tsv.gz,Game_of_Thrones,71137,289646,6513,367296,280231
hdfs://spark-nn.eemcs.utwente.nl/user/s1934538/clickstream/clickstream-enwiki-2021-09.tsv.gz,Wonder_Woman_1984,41837,125995,2675,170507,88375
hdfs://spark-nn.eemcs.utwente.nl/user/s1934538/clickstream/clickstream-enwiki-2021-09.tsv.gz,Deion_Sanders,16849,235421,1865,254135,94959
hdfs://spark-nn.eemcs.utwente.nl/user/s1934538/clickstream/clickstream-enwiki-2021-09.tsv.gz,Lionel_Messi,150499,1000260,10330,1161089,238860
hdfs://spark-nn.eemcs.utwente.nl/user/s1934538/clickstream/clickstream-enwiki-2021-09.tsv.gz,State_of_Palestine,37916,93005,583,131504,52694
hdfs://spark-nn.eemcs.utwente.nl/user/s1934538/clickstream/clickstream-enwiki-2021-09.tsv.gz,Glass_(2019_film),51427,62495,455,114377,38208
hdfs://spark-nn.eemcs.utwente.nl/user/s1934538/clickstream/clickstream-enwiki-2021-09.tsv.gz,Lists_of_deaths_by_year,4863,152396,565,157824,170048
hdfs://spark-nn.eemcs.utwente.nl/user/s1934538/clickstream/clickstream-enwiki-2021-09.tsv.gz,Elliot_Page,72296,416258,2009,490563,195066
hdfs://spark-nn.eemcs.utwente.nl/user/s1934538/clickstream/clickstream-enwiki-2021-09.tsv.gz,Sinéad_O'Connor,14878,68761,639,84278,27520
hdfs://spark-nn.eemcs.utwente.nl/user/s1934538/clickstream/clickstream-enwiki-2021-09.tsv.gz,Royal_Rumble_(2018),6480,3934,76,10490,7618
hdfs://spark-nn.eemcs.utwente.nl/user/s1934538/clickstream/clickstream-enwiki-2021-09.tsv.gz,Dark_Phoenix_(film),50245,93024,1465,144734,92572
hdfs://spark-nn.eemcs.utwente.nl/user/s1934538/clickstream/clickstream-enwiki-2021-09.tsv.gz,Doctor_Strange_in_the_Multiverse_of_Madness,165908,103334,1081,270323,154737
hdfs://spark-nn.eemcs.utwente.nl/user/s1934538/clickstream/clickstream-enwiki-2021-09.tsv.gz,Tasuku_Honjo,931,143233,37,144201,4692
hdfs://spark-nn.eemcs.utwente.nl/user/s1934538/clickstream/clickstream-enwiki-2021-09.tsv.gz,Microsoft_Office,8397,1410659,751,1419807,19712
hdfs://spark-nn.eemcs.utwente.nl/user/s1934538/clickstream/clickstream-enwiki-2021-09.tsv.gz,Jimmy_Buffett,8214,54844,651,63709,22570
hdfs://spark-nn.eemcs.utwente.nl/user/s1934538/clickstream/clickstream-enwiki-2021-09.tsv.gz,Pelé,39884,224346,2213,266443,83602
hdfs://spark-nn.eemcs.utwente.nl/user/s1934538/clickstream/clickstream-enwiki-2021-09.tsv.gz,Hamilton_(musical),32173,194968,1841,228982,136163
hdfs://spark-nn.eemcs.utwente.nl/user/s1934538/clickstream/clickstream-enwiki-2021-09.tsv.gz,The_Mandalorian,64301,187705,4055,256061,166139
hdfs://spark-nn.eemcs.utwente.nl/user/s1934538/clickstream/clickstream-enwiki-2021-09.tsv.gz,Antifa_(United_States),11915,68749,541,81205,17158
hdfs://spark-nn.eemcs.utwente.nl/user/s1934538/clickstream/clickstream-enwiki-2021-09.tsv.gz,Simple_Mail_Transfer_Protocol,3158,34320,96,37574,3209
hdfs://spark-nn.eemcs.utwente.nl/user/s1934538/clickstream/clickstream-enwiki-2021-09.tsv.gz,WandaVision,59197,202426,17189,278812,156425
hdfs://spark-nn.eemcs.utwente.nl/user/s1934538/clickstream/clickstream-enwiki-2021-09.tsv.gz,2020_United_States_presidential_election,168122,277544,7062,452728,421537
hdfs://spark-nn.eemcs.utwente.nl/user/s1934538/clickstream/clickstream-enwiki-2021-09.tsv.gz,Donald_Glover,40905,149122,1422,191449,72445
hdfs://spark-nn.eemcs.utwente.nl/user/s1934538/clickstream/clickstream-enwiki-2021-09.tsv.gz,Area_51,13224,123024,1321,137569,34206
hdfs://spark-nn.eemcs.utwente.nl/user/s1934538/clickstream/clickstream-enwiki-2021-09.tsv.gz,Aaron_Hernandez,13431,113561,752,127744,45302
hdfs://spark-nn.eemcs.utwente.nl/user/s1934538/clickstream/clickstream-enwiki-2021-09.tsv.gz,Kylian_Mbappé,31123,225383,1950,258456,47219
hdfs://spark-nn.eemcs.utwente.nl/user/s1934538/clickstream/clickstream-enwiki-2021-09.tsv.gz,FIFA_World_Cup,51813,213916,5005,270734,171457
hdfs://spark-nn.eemcs.utwente.nl/user/s1934538/clickstream/clickstream-enwiki-2021-09.tsv.gz,Mortal_Kombat_(2021_film),46122,204163,3858,254143,246258
hdfs://spark-nn.eemcs.utwente.nl/user/s1934538/clickstream/clickstream-enwiki-2021-09.tsv.gz,2.0_(film),17430,30196,64,47690,14448
hdfs://spark-nn.eemcs.utwente.nl/user/s1934538/clickstream/clickstream-enwiki-2021-09.tsv.gz,Saaho,12518,33008,54,45580,15396
hdfs://spark-nn.eemcs.utwente.nl/user/s1934538/clickstream/clickstream-enwiki-2021-09.tsv.gz,List_of_James_Bond_films,157847,889352,1269,1048468,695174
hdfs://spark-nn.eemcs.utwente.nl/user/s1934538/clickstream/clickstream-enwiki-2021-09.tsv.gz,The_Weeknd,89471,240309,3090,332870,137742
hdfs://spark-nn.eemcs.utwente.nl/user/s1934538/clickstream/clickstream-enwiki-2021-09.tsv.gz,Adipurush,35501,22192,23,57716,44410
hdfs://spark-nn.eemcs.utwente.nl/user/s1934538/clickstream/clickstream-enwiki-2021-09.tsv.gz,The_Shape_of_Water,24208,53442,655,78305,36515
hdfs://spark-nn.eemcs.utwente.nl/user/s1934538/clickstream/clickstream-enwiki-2021-09.tsv.gz,Ruth_Bader_Ginsburg,25679,147598,1368,174645,58048
hdfs://spark-nn.eemcs.utwente.nl/user/s1934538/clickstream/clickstream-enwiki-2021-09.tsv.gz,George_H._W._Bush,192602,143241,1140,336983,199847
hdfs://spark-nn.eemcs.utwente.nl/user/s1934538/clickstream/clickstream-enwiki-2021-09.tsv.gz,The_Matrix_Resurrections,390186,1012299,24057,1426542,1247544
hdfs://spark-nn.eemcs.utwente.nl/user/s1934538/clickstream/clickstream-enwiki-2021-09.tsv.gz,Salman_Rushdie,27034,65134,436,92604,39829
hdfs://spark-nn.eemcs.utwente.nl/user/s1934538/clickstream/clickstream-enwiki-2021-09.tsv.gz,21_Savage,17490,74360,659,92509,36447
hdfs://spark-nn.eemcs.utwente.nl/user/s1934538/clickstream/clickstream-enwiki-2021-09.tsv.gz,COVID-19_pandemic_by_country_and_territory,98929,258721,6469,364119,208945
hdfs://spark-nn.eemcs.utwente.nl/user/s1934538/clickstream/clickstream-enwiki-2021-09.tsv.gz,Stranger_Things_(season_4),26824,211182,1226,239232,126029
hdfs://spark-nn.eemcs.utwente.nl/user/s1934538/clickstream/clickstream-enwiki-2021-09.tsv.gz,Kobe_Bryant,42691,266915,2772,312378,84182
hdfs://spark-nn.eemcs.utwente.nl/user/s1934538/clickstream/clickstream-enwiki-2021-09.tsv.gz,Emma_Raducanu,207044,5202694,184233,5593971,1079561
hdfs://spark-nn.eemcs.utwente.nl/user/s1934538/clickstream/clickstream-enwiki-2021-09.tsv.gz,Israel,73860,212604,6738,293202,142550
hdfs://spark-nn.eemcs.utwente.nl/user/s1934538/clickstream/clickstream-enwiki-2021-09.tsv.gz,Army_of_the_Dead,38819,80336,1289,120444,78613
hdfs://spark-nn.eemcs.utwente.nl/user/s1934538/clickstream/clickstream-enwiki-2021-09.tsv.gz,List_of_Marvel_Cinematic_Universe_films,301758,775508,2651,1079917,638886
hdfs://spark-nn.eemcs.utwente.nl/user/s1934538/clickstream/clickstream-enwiki-2021-09.tsv.gz,David_Beckham,56324,257187,1655,315166,120987
hdfs://spark-nn.eemcs.utwente.nl/user/s1934538/clickstream/clickstream-enwiki-2021-09.tsv.gz,The_Batman_(film),125866,164547,3637,294050,236510
hdfs://spark-nn.eemcs.utwente.nl/user/s1934538/clickstream/clickstream-enwiki-2021-09.tsv.gz,Lance_Reddick,41501,42152,298,83951,18113
hdfs://spark-nn.eemcs.utwente.nl/user/s1934538/clickstream/clickstream-enwiki-2021-09.tsv.gz,Bird_Box_(film),22217,57609,758,80584,23906
hdfs://spark-nn.eemcs.utwente.nl/user/s1934538/clickstream/clickstream-enwiki-2021-09.tsv.gz,A_Star_Is_Born_(2018_film),25673,101076,600,127349,59344
hdfs://spark-nn.eemcs.utwente.nl/user/s1934538/clickstream/clickstream-enwiki-2021-09.tsv.gz,Donald_Trump,225005,447587,9975,682567,395441
hdfs://spark-nn.eemcs.utwente.nl/user/s1934538/clickstream/clickstream-enwiki-2021-09.tsv.gz,Michael_Jordan,65584,371957,3870,441411,147373
hdfs://spark-nn.eemcs.utwente.nl/user/s1934538/clickstream/clickstream-enwiki-2021-09.tsv.gz,WrestleMania_34,15621,8168,124,23913,15711
hdfs://spark-nn.eemcs.utwente.nl/user/s1934538/clickstream/clickstream-enwiki-2021-09.tsv.gz,Stranger_Things,66771,233220,5136,305127,220788
hdfs://spark-nn.eemcs.utwente.nl/user/s1934538/clickstream/clickstream-enwiki-2021-09.tsv.gz,Avengers:_Infinity_War,59371,86369,1318,147058,81668
hdfs://spark-nn.eemcs.utwente.nl/user/s1934538/clickstream/clickstream-enwiki-2021-09.tsv.gz,Freddie_Mercury,118885,753572,14975,887432,344190
hdfs://spark-nn.eemcs.utwente.nl/user/s1934538/clickstream/clickstream-enwiki-2021-09.tsv.gz,Olivia_Newton-John,29457,115296,1571,146324,60862
hdfs://spark-nn.eemcs.utwente.nl/user/s1934538/clickstream/clickstream-enwiki-2021-09.tsv.gz,Gaza_Strip,14604,32410,3365,50379,17311
hdfs://spark-nn.eemcs.utwente.nl/user/s1934538/clickstream/clickstream-enwiki-2021-09.tsv.gz,ICC_Men's_T20_World_Cup,24051,212858,747,237656,103718
hdfs://spark-nn.eemcs.utwente.nl/user/s1934538/clickstream/clickstream-enwiki-2021-09.tsv.gz,Rishi_Sunak,20038,48320,272,68630,30407
hdfs://spark-nn.eemcs.utwente.nl/user/s1934538/clickstream/clickstream-enwiki-2021-09.tsv.gz,Jason_Momoa,130020,448842,2565,581427,258460
hdfs://spark-nn.eemcs.utwente.nl/user/s1934538/clickstream/clickstream-enwiki-2021-09.tsv.gz,Khabib_Nurmagomedov,44259,189652,1916,235827,125744
hdfs://spark-nn.eemcs.utwente.nl/user/s1934538/clickstream/clickstream-enwiki-2021-09.tsv.gz,Chadwick_Boseman,69949,306652,1650,378251,110985
hdfs://spark-nn.eemcs.utwente.nl/user/s1934538/clickstream/clickstream-enwiki-2021-09.tsv.gz,Cardi_B,42458,264855,5182,312495,105625
hdfs://spark-nn.eemcs.utwente.nl/user/s1934538/clickstream/clickstream-enwiki-2021-09.tsv.gz,Anna_Sorokin,5771,49283,167,55221,17144
hdfs://spark-nn.eemcs.utwente.nl/user/s1934538/clickstream/clickstream-enwiki-2021-09.tsv.gz,The_Witcher_(TV_series),40227,200884,4505,245616,149487
hdfs://spark-nn.eemcs.utwente.nl/user/s1934538/clickstream/clickstream-enwiki-2021-09.tsv.gz,XXXTentacion,78777,460121,6610,545508,103587
hdfs://spark-nn.eemcs.utwente.nl/user/s1934538/clickstream/clickstream-enwiki-2021-09.tsv.gz,Christopher_Scarver,54480,14938,15,69433,24403
hdfs://spark-nn.eemcs.utwente.nl/user/s1934538/clickstream/clickstream-enwiki-2021-09.tsv.gz,Kim_Jong-un,72269,228119,1998,302386,165644
hdfs://spark-nn.eemcs.utwente.nl/user/s1934538/clickstream/clickstream-enwiki-2021-09.tsv.gz,Johnny_Depp,136741,355279,3041,495061,352996
hdfs://spark-nn.eemcs.utwente.nl/user/s1934538/clickstream/clickstream-enwiki-2021-09.tsv.gz,Zack_Snyder's_Justice_League,81887,158179,3003,243069,127275
hdfs://spark-nn.eemcs.utwente.nl/user/s1934538/clickstream/clickstream-enwiki-2021-09.tsv.gz,Croatia,44469,158244,2709,205422,67475
hdfs://spark-nn.eemcs.utwente.nl/user/s1934538/clickstream/clickstream-enwiki-2021-09.tsv.gz,Valentine's_Day,3226,29020,183,32429,3186
hdfs://spark-nn.eemcs.utwente.nl/user/s1934538/clickstream/clickstream-enwiki-2021-09.tsv.gz,R._Kelly,79602,758788,11090,849480,464321
hdfs://spark-nn.eemcs.utwente.nl/user/s1934538/clickstream/clickstream-enwiki-2021-09.tsv.gz,Cook's_Country,405,2255,29,2689,777
hdfs://spark-nn.eemcs.utwente.nl/user/s1934538/clickstream/clickstream-enwiki-2021-09.tsv.gz,The_Nun_(2018_film),23566,48612,316,72494,38179
hdfs://spark-nn.eemcs.utwente.nl/user/s1934538/clickstream/clickstream-enwiki-2021-09.tsv.gz,Bonnie_and_Clyde,19380,156426,1183,176989,45283
hdfs://spark-nn.eemcs.utwente.nl/user/s1934538/clickstream/clickstream-enwiki-2021-09.tsv.gz,2018_Asian_Games,13989,14064,226,28279,30998
hdfs://spark-nn.eemcs.utwente.nl/user/s1934538/clickstream/clickstream-enwiki-2021-09.tsv.gz,Ant-Man_and_the_Wasp:_Quantumania,84387,28802,137,113326,75975
hdfs://spark-nn.eemcs.utwente.nl/user/s1934538/clickstream/clickstream-enwiki-2021-09.tsv.gz,NATO,61159,157656,2510,221325,78986
hdfs://spark-nn.eemcs.utwente.nl/user/s1934538/clickstream/clickstream-enwiki-2021-09.tsv.gz,The_Sandman_(TV_series),43378,108097,1505,152980,141074
hdfs://spark-nn.eemcs.utwente.nl/user/s1934538/clickstream/clickstream-enwiki-2021-09.tsv.gz,Fyre_Festival,9649,67893,543,78085,44796
hdfs://spark-nn.eemcs.utwente.nl/user/s1934538/clickstream/clickstream-enwiki-2021-09.tsv.gz,United_States_Senate,49995,60220,1301,111516,51399
hdfs://spark-nn.eemcs.utwente.nl/user/s1934538/clickstream/clickstream-enwiki-2021-09.tsv.gz,Wikipedia,248472,907209,1326,1157007,321884
hdfs://spark-nn.eemcs.utwente.nl/user/s1934538/clickstream/clickstream-enwiki-2021-09.tsv.gz,Ghislaine_Maxwell,47329,89334,369,137032,51546
hdfs://spark-nn.eemcs.utwente.nl/user/s1934538/clickstream/clickstream-enwiki-2021-09.tsv.gz,YouTube,130916,2196276,12682,2339874,130923
hdfs://spark-nn.eemcs.utwente.nl/user/s1934538/clickstream/clickstream-enwiki-2021-09.tsv.gz,Spider-Man:_Far_From_Home,106800,143657,2521,252978,143517
hdfs://spark-nn.eemcs.utwente.nl/user/s1934538/clickstream/clickstream-enwiki-2021-09.tsv.gz,Darth_Vader,23142,63748,565,87455,47191
hdfs://spark-nn.eemcs.utwente.nl/user/s1934538/clickstream/clickstream-enwiki-2021-09.tsv.gz,Black_Panther_(film),49591,127035,2424,179050,110474
hdfs://spark-nn.eemcs.utwente.nl/user/s1934538/clickstream/clickstream-enwiki-2021-09.tsv.gz,Tina_Turner,22973,184596,1836,209405,67864
hdfs://spark-nn.eemcs.utwente.nl/user/s1934538/clickstream/clickstream-enwiki-2021-09.tsv.gz,Greta_Thunberg,9547,212389,2165,224101,61871
hdfs://spark-nn.eemcs.utwente.nl/user/s1934538/clickstream/clickstream-enwiki-2021-09.tsv.gz,COVID-19_pandemic,322045,368713,2545,693303,339480
hdfs://spark-nn.eemcs.utwente.nl/user/s1934538/clickstream/clickstream-enwiki-2021-09.tsv.gz,"Prince_Philip,_Duke_of_Edinburgh",178942,215553,2416,396911,237514
hdfs://spark-nn.eemcs.utwente.nl/user/s1934538/clickstream/clickstream-enwiki-2021-09.tsv.gz,List_of_highest-grossing_films,122378,199236,1224,322838,180643
hdfs://spark-nn.eemcs.utwente.nl/user/s1934538/clickstream/clickstream-enwiki-2021-09.tsv.gz,2018_FIFA_World_Cup,75443,82701,1110,159254,95344
hdfs://spark-nn.eemcs.utwente.nl/user/s1934538/clickstream/clickstream-enwiki-2021-09.tsv.gz,The_Irishman,47205,85965,1695,134865,112881
hdfs://spark-nn.eemcs.utwente.nl/user/s1934538/clickstream/clickstream-enwiki-2021-10.tsv.gz,Burt_Reynolds,45333,114789,1234,161356,75037
hdfs://spark-nn.eemcs.utwente.nl/user/s1934538/clickstream/clickstream-enwiki-2021-10.tsv.gz,Stephen_Hawking,27482,466842,2611,496935,160551
hdfs://spark-nn.eemcs.utwente.nl/user/s1934538/clickstream/clickstream-enwiki-2021-10.tsv.gz,Mortal_Kombat_(2021_film),31130,112174,2336,145640,134110
hdfs://spark-nn.eemcs.utwente.nl/user/s1934538/clickstream/clickstream-enwiki-2021-10.tsv.gz,Cook's_Country,421,3258,38,3717,1149
hdfs://spark-nn.eemcs.utwente.nl/user/s1934538/clickstream/clickstream-enwiki-2021-10.tsv.gz,Spider-Man:_No_Way_Home,232949,432873,11985,677807,324839
hdfs://spark-nn.eemcs.utwente.nl/user/s1934538/clickstream/clickstream-enwiki-2021-10.tsv.gz,Murder_of_Dee_Dee_Blanchard,28240,128705,455,157400,29148
hdfs://spark-nn.eemcs.utwente.nl/user/s1934538/clickstream/clickstream-enwiki-2021-10.tsv.gz,Saaho,15246,56938,693,72877,25967
hdfs://spark-nn.eemcs.utwente.nl/user/s1934538/clickstream/clickstream-enwiki-2021-10.tsv.gz,Chadwick_Boseman,58901,246839,1223,306963,87600
hdfs://spark-nn.eemcs.utwente.nl/user/s1934538/clickstream/clickstream-enwiki-2021-10.tsv.gz,United_States_Senate,50940,74474,934,126348,53249
hdfs://spark-nn.eemcs.utwente.nl/user/s1934538/clickstream/clickstream-enwiki-2021-10.tsv.gz,Bob_Saget,21711,33628,326,55665,12867
hdfs://spark-nn.eemcs.utwente.nl/user/s1934538/clickstream/clickstream-enwiki-2021-10.tsv.gz,Avengers:_Infinity_War,49113,69836,1091,120040,64575
hdfs://spark-nn.eemcs.utwente.nl/user/s1934538/clickstream/clickstream-enwiki-2021-10.tsv.gz,Adipurush,48742,28333,44,77119,57559
hdfs://spark-nn.eemcs.utwente.nl/user/s1934538/clickstream/clickstream-enwiki-2021-10.tsv.gz,Grover,1161,5018,37,6216,1306
hdfs://spark-nn.eemcs.utwente.nl/user/s1934538/clickstream/clickstream-enwiki-2021-10.tsv.gz,Sridevi,28398,70504,338,99240,43877
hdfs://spark-nn.eemcs.utwente.nl/user/s1934538/clickstream/clickstream-enwiki-2021-10.tsv.gz,21_Savage,12936,75378,640,88954,31712
hdfs://spark-nn.eemcs.utwente.nl/user/s1934538/clickstream/clickstream-enwiki-2021-10.tsv.gz,Salman_Rushdie,25184,69803,446,95433,39112
hdfs://spark-nn.eemcs.utwente.nl/user/s1934538/clickstream/clickstream-enwiki-2021-10.tsv.gz,QAnon,39879,230459,2094,272432,66743
hdfs://spark-nn.eemcs.utwente.nl/user/s1934538/clickstream/clickstream-enwiki-2021-10.tsv.gz,Game_of_Thrones_(season_8),17191,42471,655,60317,21485
hdfs://spark-nn.eemcs.utwente.nl/user/s1934538/clickstream/clickstream-enwiki-2021-10.tsv.gz,Game_of_Thrones,82596,315824,7773,406193,289609
hdfs://spark-nn.eemcs.utwente.nl/user/s1934538/clickstream/clickstream-enwiki-2021-10.tsv.gz,WrestleMania_34,12733,6995,160,19888,12777
hdfs://spark-nn.eemcs.utwente.nl/user/s1934538/clickstream/clickstream-enwiki-2021-10.tsv.gz,The_Shape_of_Water,24984,59696,1046,85726,35233
hdfs://spark-nn.eemcs.utwente.nl/user/s1934538/clickstream/clickstream-enwiki-2021-10.tsv.gz,Dark_Phoenix_(film),39809,47485,625,87919,50752
hdfs://spark-nn.eemcs.utwente.nl/user/s1934538/clickstream/clickstream-enwiki-2021-10.tsv.gz,The_Queen's_Gambit_(miniseries),32495,155899,1466,189860,96310
hdfs://spark-nn.eemcs.utwente.nl/user/s1934538/clickstream/clickstream-enwiki-2021-10.tsv.gz,Don't_Look_Up_(2021_film),118737,61065,856,180658,63497
hdfs://spark-nn.eemcs.utwente.nl/user/s1934538/clickstream/clickstream-enwiki-2021-10.tsv.gz,Qasem_Soleimani,10379,16677,81,27137,15079
hdfs://spark-nn.eemcs.utwente.nl/user/s1934538/clickstream/clickstream-enwiki-2021-10.tsv.gz,The_Witcher_(TV_series),33417,183565,4457,221439,131239
hdfs://spark-nn.eemcs.utwente.nl/user/s1934538/clickstream/clickstream-enwiki-2021-10.tsv.gz,Pornhub,45508,274493,13706,333707,80262
hdfs://spark-nn.eemcs.utwente.nl/user/s1934538/clickstream/clickstream-enwiki-2021-10.tsv.gz,List_of_Queen_of_the_South_episodes,9027,6330,146,15503,491
hdfs://spark-nn.eemcs.utwente.nl/user/s1934538/clickstream/clickstream-enwiki-2021-10.tsv.gz,Watts_family_murders,14354,182420,470,197244,49577
hdfs://spark-nn.eemcs.utwente.nl/user/s1934538/clickstream/clickstream-enwiki-2021-10.tsv.gz,FIFA_World_Cup,52160,231049,5656,288865,181193
hdfs://spark-nn.eemcs.utwente.nl/user/s1934538/clickstream/clickstream-enwiki-2021-10.tsv.gz,Mötley_Crüe,33066,96852,1456,131374,143679
hdfs://spark-nn.eemcs.utwente.nl/user/s1934538/clickstream/clickstream-enwiki-2021-10.tsv.gz,Simple_Mail_Transfer_Protocol,3595,35405,127,39127,3454
hdfs://spark-nn.eemcs.utwente.nl/user/s1934538/clickstream/clickstream-enwiki-2021-10.tsv.gz,Cameron_Boyce,39414,220022,736,260172,62266
hdfs://spark-nn.eemcs.utwente.nl/user/s1934538/clickstream/clickstream-enwiki-2021-10.tsv.gz,Charles_III,94,176,86,356,377
hdfs://spark-nn.eemcs.utwente.nl/user/s1934538/clickstream/clickstream-enwiki-2021-10.tsv.gz,Simone_Biles,9720,64025,739,74484,21299
hdfs://spark-nn.eemcs.utwente.nl/user/s1934538/clickstream/clickstream-enwiki-2021-10.tsv.gz,Guardians_of_the_Galaxy_Vol._3,78602,14573,437,93612,46040
hdfs://spark-nn.eemcs.utwente.nl/user/s1934538/clickstream/clickstream-enwiki-2021-10.tsv.gz,Joker_(2019_film),58167,246568,3609,308344,146567
hdfs://spark-nn.eemcs.utwente.nl/user/s1934538/clickstream/clickstream-enwiki-2021-10.tsv.gz,Spider-Man:_Far_From_Home,88385,97194,1731,187310,104628
hdfs://spark-nn.eemcs.utwente.nl/user/s1934538/clickstream/clickstream-enwiki-2021-10.tsv.gz,Tenet_(film),72515,171824,2391,246730,126323
hdfs://spark-nn.eemcs.utwente.nl/user/s1934538/clickstream/clickstream-enwiki-2021-10.tsv.gz,Michael_Jordan,70234,354742,3754,428730,144842
hdfs://spark-nn.eemcs.utwente.nl/user/s1934538/clickstream/clickstream-enwiki-2021-10.tsv.gz,Sinéad_O'Connor,17192,74683,658,92533,29105
hdfs://spark-nn.eemcs.utwente.nl/user/s1934538/clickstream/clickstream-enwiki-2021-10.tsv.gz,Louis_Tomlinson,33036,63363,616,97015,25949
hdfs://spark-nn.eemcs.utwente.nl/user/s1934538/clickstream/clickstream-enwiki-2021-10.tsv.gz,Aquaman_(film),29910,79208,1405,110523,63383
hdfs://spark-nn.eemcs.utwente.nl/user/s1934538/clickstream/clickstream-enwiki-2021-10.tsv.gz,2.0_(film),17467,25072,47,42586,13672
hdfs://spark-nn.eemcs.utwente.nl/user/s1934538/clickstream/clickstream-enwiki-2021-10.tsv.gz,Area_51,14201,131369,1454,147024,39108
hdfs://spark-nn.eemcs.utwente.nl/user/s1934538/clickstream/clickstream-enwiki-2021-10.tsv.gz,Kate_Spade,21015,46690,268,67973,25528
hdfs://spark-nn.eemcs.utwente.nl/user/s1934538/clickstream/clickstream-enwiki-2021-10.tsv.gz,2018_FIFA_World_Cup,77252,77734,975,155961,94257
hdfs://spark-nn.eemcs.utwente.nl/user/s1934538/clickstream/clickstream-enwiki-2021-10.tsv.gz,Black_Adam_(film),107565,141279,2534,251378,226278
hdfs://spark-nn.eemcs.utwente.nl/user/s1934538/clickstream/clickstream-enwiki-2021-10.tsv.gz,Jenna_Ortega,112957,96381,2691,212029,50712
hdfs://spark-nn.eemcs.utwente.nl/user/s1934538/clickstream/clickstream-enwiki-2021-10.tsv.gz,House_of_the_Dragon,56085,337523,5755,399363,385481
hdfs://spark-nn.eemcs.utwente.nl/user/s1934538/clickstream/clickstream-enwiki-2021-10.tsv.gz,Star_Wars:_The_Rise_of_Skywalker,74894,56746,1470,133110,69739
hdfs://spark-nn.eemcs.utwente.nl/user/s1934538/clickstream/clickstream-enwiki-2021-10.tsv.gz,Adele,133623,1840845,25054,1999522,1018717
hdfs://spark-nn.eemcs.utwente.nl/user/s1934538/clickstream/clickstream-enwiki-2021-10.tsv.gz,Betty_White,53727,403459,4933,462119,144826
hdfs://spark-nn.eemcs.utwente.nl/user/s1934538/clickstream/clickstream-enwiki-2021-10.tsv.gz,Kobe_Bryant,49815,302696,3252,355763,98555
hdfs://spark-nn.eemcs.utwente.nl/user/s1934538/clickstream/clickstream-enwiki-2021-10.tsv.gz,Matthew_Perry,46751,130733,1183,178667,94594
hdfs://spark-nn.eemcs.utwente.nl/user/s1934538/clickstream/clickstream-enwiki-2021-10.tsv.gz,YouTube,121679,2135089,10880,2267648,123766
hdfs://spark-nn.eemcs.utwente.nl/user/s1934538/clickstream/clickstream-enwiki-2021-10.tsv.gz,Cecil_Hotel_(Los_Angeles),7337,74460,184,81981,22463
hdfs://spark-nn.eemcs.utwente.nl/user/s1934538/clickstream/clickstream-enwiki-2021-10.tsv.gz,Kylian_Mbappé,33035,231968,2414,267417,56587
hdfs://spark-nn.eemcs.utwente.nl/user/s1934538/clickstream/clickstream-enwiki-2021-10.tsv.gz,Emma_Raducanu,21137,186181,2461,209779,42544
hdfs://spark-nn.eemcs.utwente.nl/user/s1934538/clickstream/clickstream-enwiki-2021-10.tsv.gz,Wikipedia,257353,1044225,1614,1303192,425011
hdfs://spark-nn.eemcs.utwente.nl/user/s1934538/clickstream/clickstream-enwiki-2021-10.tsv.gz,Doctor_Strange_in_the_Multiverse_of_Madness,124414,78768,1004,204186,103874
hdfs://spark-nn.eemcs.utwente.nl/user/s1934538/clickstream/clickstream-enwiki-2021-10.tsv.gz,The_Suicide_Squad_(film),110202,228515,5319,344036,217039
hdfs://spark-nn.eemcs.utwente.nl/user/s1934538/clickstream/clickstream-enwiki-2021-10.tsv.gz,Nipsey_Hussle,19970,76347,601,96918,30193
hdfs://spark-nn.eemcs.utwente.nl/user/s1934538/clickstream/clickstream-enwiki-2021-10.tsv.gz,IPv4,11141,40436,151,51728,9328
hdfs://spark-nn.eemcs.utwente.nl/user/s1934538/clickstream/clickstream-enwiki-2021-10.tsv.gz,Squid_Game,412782,13445861,208044,14066687,6474454
hdfs://spark-nn.eemcs.utwente.nl/user/s1934538/clickstream/clickstream-enwiki-2021-10.tsv.gz,Kamala_Harris,83116,197990,7772,288878,117435
hdfs://spark-nn.eemcs.utwente.nl/user/s1934538/clickstream/clickstream-enwiki-2021-10.tsv.gz,Sylvester_Stallone,89225,278055,2632,369912,272093
hdfs://spark-nn.eemcs.utwente.nl/user/s1934538/clickstream/clickstream-enwiki-2021-10.tsv.gz,Cristiano_Ronaldo,148019,1419051,9261,1576331,359395
hdfs://spark-nn.eemcs.utwente.nl/user/s1934538/clickstream/clickstream-enwiki-2021-10.tsv.gz,Joe_Biden,193418,463774,8890,666082,310288
hdfs://spark-nn.eemcs.utwente.nl/user/s1934538/clickstream/clickstream-enwiki-2021-10.tsv.gz,HTTP_cookie,2901,377252,174,380327,25468
hdfs://spark-nn.eemcs.utwente.nl/user/s1934538/clickstream/clickstream-enwiki-2021-10.tsv.gz,Olivia_Newton-John,28426,135211,1626,165263,68828
hdfs://spark-nn.eemcs.utwente.nl/user/s1934538/clickstream/clickstream-enwiki-2021-10.tsv.gz,Afghanistan,261640,407411,11873,680924,451842
hdfs://spark-nn.eemcs.utwente.nl/user/s1934538/clickstream/clickstream-enwiki-2021-10.tsv.gz,Manti_Te'o,5515,27184,107,32806,3971
hdfs://spark-nn.eemcs.utwente.nl/user/s1934538/clickstream/clickstream-enwiki-2021-10.tsv.gz,Ponniyin_Selvan:_I,47349,60414,129,107892,34127
hdfs://spark-nn.eemcs.utwente.nl/user/s1934538/clickstream/clickstream-enwiki-2021-10.tsv.gz,Amber_Heard,104413,162590,978,267981,109660
hdfs://spark-nn.eemcs.utwente.nl/user/s1934538/clickstream/clickstream-enwiki-2021-10.tsv.gz,Sushant_Singh_Rajput,25510,93304,287,119101,50108
hdfs://spark-nn.eemcs.utwente.nl/user/s1934538/clickstream/clickstream-enwiki-2021-10.tsv.gz,JSON_Web_Token,782,29220,41,30043,2228
hdfs://spark-nn.eemcs.utwente.nl/user/s1934538/clickstream/clickstream-enwiki-2021-10.tsv.gz,Puneeth_Rajkumar,175633,3615581,1539,3792753,1873976
hdfs://spark-nn.eemcs.utwente.nl/user/s1934538/clickstream/clickstream-enwiki-2021-10.tsv.gz,Shang-Chi_and_the_Legend_of_the_Ten_Rings,232115,831899,15695,1079709,538515
hdfs://spark-nn.eemcs.utwente.nl/user/s1934538/clickstream/clickstream-enwiki-2021-10.tsv.gz,RRR_(film),35556,82626,334,118516,53859
hdfs://spark-nn.eemcs.utwente.nl/user/s1934538/clickstream/clickstream-enwiki-2021-10.tsv.gz,Stan_Lee,46852,176369,1336,224557,55807
hdfs://spark-nn.eemcs.utwente.nl/user/s1934538/clickstream/clickstream-enwiki-2021-10.tsv.gz,"Princess_Margaret,_Countess_of_Snowdon",96396,241981,2038,340415,190591
hdfs://spark-nn.eemcs.utwente.nl/user/s1934538/clickstream/clickstream-enwiki-2021-10.tsv.gz,United_States_Electoral_College,11315,31476,76,42867,7048
hdfs://spark-nn.eemcs.utwente.nl/user/s1934538/clickstream/clickstream-enwiki-2021-10.tsv.gz,Loki_(TV_series),40722,159271,3189,203182,112090
hdfs://spark-nn.eemcs.utwente.nl/user/s1934538/clickstream/clickstream-enwiki-2021-10.tsv.gz,Deion_Sanders,14702,162774,1122,178598,55482
hdfs://spark-nn.eemcs.utwente.nl/user/s1934538/clickstream/clickstream-enwiki-2021-10.tsv.gz,The_Umbrella_Academy_(TV_series),29237,111564,2107,142908,74373
hdfs://spark-nn.eemcs.utwente.nl/user/s1934538/clickstream/clickstream-enwiki-2021-10.tsv.gz,Cricket_World_Cup,28834,199254,717,228805,96069
hdfs://spark-nn.eemcs.utwente.nl/user/s1934538/clickstream/clickstream-enwiki-2021-10.tsv.gz,Darth_Vader,24109,60943,749,85801,48232
hdfs://spark-nn.eemcs.utwente.nl/user/s1934538/clickstream/clickstream-enwiki-2021-10.tsv.gz,Rami_Malek,230015,984823,6898,1221736,546969
hdfs://spark-nn.eemcs.utwente.nl/user/s1934538/clickstream/clickstream-enwiki-2021-10.tsv.gz,Sushma_Swaraj,5058,21159,57,26274,5776
hdfs://spark-nn.eemcs.utwente.nl/user/s1934538/clickstream/clickstream-enwiki-2021-10.tsv.gz,Aaron_Carter,16444,32032,301,48777,19273
hdfs://spark-nn.eemcs.utwente.nl/user/s1934538/clickstream/clickstream-enwiki-2021-10.tsv.gz,The_Matrix_Resurrections,127099,147745,3901,278745,204417
hdfs://spark-nn.eemcs.utwente.nl/user/s1934538/clickstream/clickstream-enwiki-2021-10.tsv.gz,Rihanna,71857,227740,3758,303355,149701
hdfs://spark-nn.eemcs.utwente.nl/user/s1934538/clickstream/clickstream-enwiki-2021-10.tsv.gz,J._Robert_Oppenheimer,34913,175668,574,211155,74309
hdfs://spark-nn.eemcs.utwente.nl/user/s1934538/clickstream/clickstream-enwiki-2021-10.tsv.gz,The_Mandalorian,63127,164557,3665,231349,158590
hdfs://spark-nn.eemcs.utwente.nl/user/s1934538/clickstream/clickstream-enwiki-2021-10.tsv.gz,Ray_Liotta,61573,128610,888,191071,65832
hdfs://spark-nn.eemcs.utwente.nl/user/s1934538/clickstream/clickstream-enwiki-2021-10.tsv.gz,The_Sandman_(TV_series),28522,66873,729,96124,73147
hdfs://spark-nn.eemcs.utwente.nl/user/s1934538/clickstream/clickstream-enwiki-2021-10.tsv.gz,"Citizenship_(Amendment)_Act,_2019",3561,24910,45,28516,3281
hdfs://spark-nn.eemcs.utwente.nl/user/s1934538/clickstream/clickstream-enwiki-2021-10.tsv.gz,List_of_highest-grossing_Indian_films,46614,101354,123,148091,90892
hdfs://spark-nn.eemcs.utwente.nl/user/s1934538/clickstream/clickstream-enwiki-2021-10.tsv.gz,Cardi_B,35384,246147,4739,286270,94559
hdfs://spark-nn.eemcs.utwente.nl/user/s1934538/clickstream/clickstream-enwiki-2021-10.tsv.gz,Queen_(band),70730,216328,3301,290359,273532
hdfs://spark-nn.eemcs.utwente.nl/user/s1934538/clickstream/clickstream-enwiki-2021-10.tsv.gz,Elizabeth_II,449572,867796,6361,1323729,888693
hdfs://spark-nn.eemcs.utwente.nl/user/s1934538/clickstream/clickstream-enwiki-2021-10.tsv.gz,Tonya_Harding,18336,79027,413,97776,24194
hdfs://spark-nn.eemcs.utwente.nl/user/s1934538/clickstream/clickstream-enwiki-2021-10.tsv.gz,Lionel_Messi,115067,751612,7713,874392,169368
hdfs://spark-nn.eemcs.utwente.nl/user/s1934538/clickstream/clickstream-enwiki-2021-10.tsv.gz,Alexander_Hamilton,69703,233310,4186,307199,152903
hdfs://spark-nn.eemcs.utwente.nl/user/s1934538/clickstream/clickstream-enwiki-2021-10.tsv.gz,Cleopatra,47234,4651465,2730,4701429,373410
hdfs://spark-nn.eemcs.utwente.nl/user/s1934538/clickstream/clickstream-enwiki-2021-10.tsv.gz,Bonnie_and_Clyde,19241,181888,1232,202361,45913
hdfs://spark-nn.eemcs.utwente.nl/user/s1934538/clickstream/clickstream-enwiki-2021-10.tsv.gz,Michael_Bloomberg,29321,33873,254,63448,26910
hdfs://spark-nn.eemcs.utwente.nl/user/s1934538/clickstream/clickstream-enwiki-2021-10.tsv.gz,No_Time_to_Die,776769,3774460,92706,4643935,3228157
hdfs://spark-nn.eemcs.utwente.nl/user/s1934538/clickstream/clickstream-enwiki-2021-10.tsv.gz,The_Haunting_of_Bly_Manor,123525,173679,1849,299053,159249
hdfs://spark-nn.eemcs.utwente.nl/user/s1934538/clickstream/clickstream-enwiki-2021-10.tsv.gz,Croatia,42785,132168,2009,176962,62114
hdfs://spark-nn.eemcs.utwente.nl/user/s1934538/clickstream/clickstream-enwiki-2021-10.tsv.gz,The_Irishman,47495,80306,1674,129475,106547
hdfs://spark-nn.eemcs.utwente.nl/user/s1934538/clickstream/clickstream-enwiki-2021-10.tsv.gz,September_11_attacks,78456,255575,3844,337875,171267
hdfs://spark-nn.eemcs.utwente.nl/user/s1934538/clickstream/clickstream-enwiki-2021-10.tsv.gz,Antifa_(United_States),9746,51348,226,61320,12797
hdfs://spark-nn.eemcs.utwente.nl/user/s1934538/clickstream/clickstream-enwiki-2021-10.tsv.gz,Lance_Reddick,30455,30519,193,61167,12886
hdfs://spark-nn.eemcs.utwente.nl/user/s1934538/clickstream/clickstream-enwiki-2021-10.tsv.gz,Elon_Musk,186747,1434444,12732,1633923,935562
hdfs://spark-nn.eemcs.utwente.nl/user/s1934538/clickstream/clickstream-enwiki-2021-10.tsv.gz,Gaza_Strip,12652,24249,251,37152,13442
hdfs://spark-nn.eemcs.utwente.nl/user/s1934538/clickstream/clickstream-enwiki-2021-10.tsv.gz,Aretha_Franklin,33207,228910,1609,263726,119831
hdfs://spark-nn.eemcs.utwente.nl/user/s1934538/clickstream/clickstream-enwiki-2022-02.tsv.gz,Jimmy_Buffett,7680,40451,485,48616,18067
hdfs://spark-nn.eemcs.utwente.nl/user/s1934538/clickstream/clickstream-enwiki-2022-02.tsv.gz,Aretha_Franklin,30025,228063,1594,259682,100240
hdfs://spark-nn.eemcs.utwente.nl/user/s1934538/clickstream/clickstream-enwiki-2022-02.tsv.gz,Cameron_Boyce,24924,110748,510,136182,37683
hdfs://spark-nn.eemcs.utwente.nl/user/s1934538/clickstream/clickstream-enwiki-2022-02.tsv.gz,Johnny_Depp,113039,285299,2738,401076,242856
hdfs://spark-nn.eemcs.utwente.nl/user/s1934538/clickstream/clickstream-enwiki-2022-02.tsv.gz,Deion_Sanders,15069,135144,1152,151365,48382
hdfs://spark-nn.eemcs.utwente.nl/user/s1934538/clickstream/clickstream-enwiki-2022-02.tsv.gz,Pelé,25943,113661,1154,140758,47212
hdfs://spark-nn.eemcs.utwente.nl/user/s1934538/clickstream/clickstream-enwiki-2022-02.tsv.gz,Meat_Loaf,39991,254847,4184,299022,105602
hdfs://spark-nn.eemcs.utwente.nl/user/s1934538/clickstream/clickstream-enwiki-2022-02.tsv.gz,Stephen_Hawking,24389,290514,2273,317176,114507
hdfs://spark-nn.eemcs.utwente.nl/user/s1934538/clickstream/clickstream-enwiki-2022-02.tsv.gz,Mortal_Kombat_(2021_film),22804,76832,1577,101213,100645
hdfs://spark-nn.eemcs.utwente.nl/user/s1934538/clickstream/clickstream-enwiki-2022-02.tsv.gz,Queen_(band),52921,184439,3955,241315,219060
hdfs://spark-nn.eemcs.utwente.nl/user/s1934538/clickstream/clickstream-enwiki-2022-02.tsv.gz,Area_51,18636,123900,1243,143779,43901
hdfs://spark-nn.eemcs.utwente.nl/user/s1934538/clickstream/clickstream-enwiki-2022-02.tsv.gz,Parasite_(2019_film),32845,148261,1992,183098,78933
hdfs://spark-nn.eemcs.utwente.nl/user/s1934538/clickstream/clickstream-enwiki-2022-02.tsv.gz,Cleopatra,50851,4083642,2147,4136640,307591
hdfs://spark-nn.eemcs.utwente.nl/user/s1934538/clickstream/clickstream-enwiki-2022-02.tsv.gz,John_McCain,29598,61562,731,91891,43812
hdfs://spark-nn.eemcs.utwente.nl/user/s1934538/clickstream/clickstream-enwiki-2022-02.tsv.gz,Donald_Glover,39267,116413,895,156575,68112
hdfs://spark-nn.eemcs.utwente.nl/user/s1934538/clickstream/clickstream-enwiki-2022-02.tsv.gz,"Princess_Margaret,_Countess_of_Snowdon",122715,244598,14987,382300,223467
hdfs://spark-nn.eemcs.utwente.nl/user/s1934538/clickstream/clickstream-enwiki-2022-02.tsv.gz,Simone_Biles,26248,169629,1743,197620,53899
hdfs://spark-nn.eemcs.utwente.nl/user/s1934538/clickstream/clickstream-enwiki-2022-02.tsv.gz,Ray_Liotta,29390,43470,367,73227,27059
hdfs://spark-nn.eemcs.utwente.nl/user/s1934538/clickstream/clickstream-enwiki-2022-02.tsv.gz,Chernobyl_(miniseries),25301,114452,2367,142120,126893
hdfs://spark-nn.eemcs.utwente.nl/user/s1934538/clickstream/clickstream-enwiki-2022-02.tsv.gz,WandaVision,47737,126281,2201,176219,91328
hdfs://spark-nn.eemcs.utwente.nl/user/s1934538/clickstream/clickstream-enwiki-2022-02.tsv.gz,Valentine's_Day,30657,1417349,17356,1465362,128010
hdfs://spark-nn.eemcs.utwente.nl/user/s1934538/clickstream/clickstream-enwiki-2022-02.tsv.gz,When_They_See_Us,17200,24533,141,41874,18026
hdfs://spark-nn.eemcs.utwente.nl/user/s1934538/clickstream/clickstream-enwiki-2022-02.tsv.gz,Tunnel,4048,7367,117,11532,3184
hdfs://spark-nn.eemcs.utwente.nl/user/s1934538/clickstream/clickstream-enwiki-2022-02.tsv.gz,Donald_Trump,211276,492210,8221,711707,385865
hdfs://spark-nn.eemcs.utwente.nl/user/s1934538/clickstream/clickstream-enwiki-2022-02.tsv.gz,Elizabeth_II,591946,1505681,29583,2127210,1379499
hdfs://spark-nn.eemcs.utwente.nl/user/s1934538/clickstream/clickstream-enwiki-2022-02.tsv.gz,Wonder_Woman_1984,37761,55636,1432,94829,47175
hdfs://spark-nn.eemcs.utwente.nl/user/s1934538/clickstream/clickstream-enwiki-2022-02.tsv.gz,Game_of_Thrones_(season_8),14770,37201,729,52700,21077
hdfs://spark-nn.eemcs.utwente.nl/user/s1934538/clickstream/clickstream-enwiki-2022-02.tsv.gz,Nipsey_Hussle,23548,94684,827,119059,39225
hdfs://spark-nn.eemcs.utwente.nl/user/s1934538/clickstream/clickstream-enwiki-2022-02.tsv.gz,Laal_Singh_Chaddha,44342,49986,159,94487,48175
hdfs://spark-nn.eemcs.utwente.nl/user/s1934538/clickstream/clickstream-enwiki-2022-02.tsv.gz,Puneeth_Rajkumar,19505,78888,867,99260,47473
hdfs://spark-nn.eemcs.utwente.nl/user/s1934538/clickstream/clickstream-enwiki-2022-02.tsv.gz,2018_FIFA_World_Cup,98290,90586,1103,189979,117552
hdfs://spark-nn.eemcs.utwente.nl/user/s1934538/clickstream/clickstream-enwiki-2022-02.tsv.gz,Death_of_Elisa_Lam,15569,85493,361,101423,25226
hdfs://spark-nn.eemcs.utwente.nl/user/s1934538/clickstream/clickstream-enwiki-2022-02.tsv.gz,Kate_Spade,40676,56999,406,98081,35107
hdfs://spark-nn.eemcs.utwente.nl/user/s1934538/clickstream/clickstream-enwiki-2022-02.tsv.gz,Greta_Thunberg,8842,119179,1088,129109,26863
hdfs://spark-nn.eemcs.utwente.nl/user/s1934538/clickstream/clickstream-enwiki-2022-02.tsv.gz,Vladimir_Putin,1029652,6960989,79072,8069713,5599466
hdfs://spark-nn.eemcs.utwente.nl/user/s1934538/clickstream/clickstream-enwiki-2022-02.tsv.gz,Christopher_Scarver,42032,11434,24,53490,17562
hdfs://spark-nn.eemcs.utwente.nl/user/s1934538/clickstream/clickstream-enwiki-2022-02.tsv.gz,Rihanna,178372,739167,9526,927065,532226
hdfs://spark-nn.eemcs.utwente.nl/user/s1934538/clickstream/clickstream-enwiki-2022-02.tsv.gz,"Meghan,_Duchess_of_Sussex",79935,166073,1099,247107,137286
hdfs://spark-nn.eemcs.utwente.nl/user/s1934538/clickstream/clickstream-enwiki-2022-02.tsv.gz,2020_United_States_presidential_election,115564,164727,3727,284018,263199
hdfs://spark-nn.eemcs.utwente.nl/user/s1934538/clickstream/clickstream-enwiki-2022-02.tsv.gz,Cristiano_Ronaldo,109945,1386303,8456,1504704,326459
hdfs://spark-nn.eemcs.utwente.nl/user/s1934538/clickstream/clickstream-enwiki-2022-02.tsv.gz,Zack_Snyder's_Justice_League,74209,94205,1071,169485,89276
hdfs://spark-nn.eemcs.utwente.nl/user/s1934538/clickstream/clickstream-enwiki-2022-02.tsv.gz,Everything_Everywhere_All_at_Once,21189,27697,355,49241,19622
hdfs://spark-nn.eemcs.utwente.nl/user/s1934538/clickstream/clickstream-enwiki-2022-02.tsv.gz,Lance_Reddick,27312,37875,207,65394,14703
hdfs://spark-nn.eemcs.utwente.nl/user/s1934538/clickstream/clickstream-enwiki-2022-02.tsv.gz,Tom_Brady,166536,1219252,16994,1402782,642634
hdfs://spark-nn.eemcs.utwente.nl/user/s1934538/clickstream/clickstream-enwiki-2022-02.tsv.gz,Grimes_(musician),125776,102145,823,228744,72306
hdfs://spark-nn.eemcs.utwente.nl/user/s1934538/clickstream/clickstream-enwiki-2022-02.tsv.gz,Cricket_World_Cup,9747,55067,308,65122,32503
hdfs://spark-nn.eemcs.utwente.nl/user/s1934538/clickstream/clickstream-enwiki-2022-02.tsv.gz,The_Suicide_Squad_(film),143106,174569,3531,321206,242265
hdfs://spark-nn.eemcs.utwente.nl/user/s1934538/clickstream/clickstream-enwiki-2022-02.tsv.gz,IPv4,9532,37568,148,47248,8460
hdfs://spark-nn.eemcs.utwente.nl/user/s1934538/clickstream/clickstream-enwiki-2022-02.tsv.gz,It_Chapter_Two,21288,31760,388,53436,32831
hdfs://spark-nn.eemcs.utwente.nl/user/s1934538/clickstream/clickstream-enwiki-2022-02.tsv.gz,List_of_Marvel_Cinematic_Universe_films,217880,612298,2490,832668,455676
hdfs://spark-nn.eemcs.utwente.nl/user/s1934538/clickstream/clickstream-enwiki-2022-02.tsv.gz,Priyanka_Chopra,80221,262558,1467,344246,124929
hdfs://spark-nn.eemcs.utwente.nl/user/s1934538/clickstream/clickstream-enwiki-2022-02.tsv.gz,Eddie_Van_Halen,39354,84269,1139,124762,48635
hdfs://spark-nn.eemcs.utwente.nl/user/s1934538/clickstream/clickstream-enwiki-2022-02.tsv.gz,Bob_Saget,34041,633018,11897,678956,134263
hdfs://spark-nn.eemcs.utwente.nl/user/s1934538/clickstream/clickstream-enwiki-2022-02.tsv.gz,Luke_Perry,28651,104002,659,133312,54688
hdfs://spark-nn.eemcs.utwente.nl/user/s1934538/clickstream/clickstream-enwiki-2022-02.tsv.gz,Volodymyr_Zelenskyy,1340059,4491145,25935,5857139,2815400
hdfs://spark-nn.eemcs.utwente.nl/user/s1934538/clickstream/clickstream-enwiki-2022-02.tsv.gz,Brett_Kavanaugh,24764,35681,417,60862,19089
hdfs://spark-nn.eemcs.utwente.nl/user/s1934538/clickstream/clickstream-enwiki-2022-02.tsv.gz,Bipin_Rawat,9929,50205,87,60221,17142
hdfs://spark-nn.eemcs.utwente.nl/user/s1934538/clickstream/clickstream-enwiki-2022-02.tsv.gz,Cardi_B,29252,178469,3123,210844,65277
hdfs://spark-nn.eemcs.utwente.nl/user/s1934538/clickstream/clickstream-enwiki-2022-02.tsv.gz,XXX:_Return_of_Xander_Cage,69306,486448,976,556730,79313
hdfs://spark-nn.eemcs.utwente.nl/user/s1934538/clickstream/clickstream-enwiki-2022-02.tsv.gz,Fyre_Festival,33039,317073,2343,352455,177450
hdfs://spark-nn.eemcs.utwente.nl/user/s1934538/clickstream/clickstream-enwiki-2022-02.tsv.gz,List_of_highest-grossing_Indian_films,74507,188962,519,263988,163072
hdfs://spark-nn.eemcs.utwente.nl/user/s1934538/clickstream/clickstream-enwiki-2022-02.tsv.gz,COVID-19_pandemic_by_country_and_territory,48188,115342,2827,166357,100178
hdfs://spark-nn.eemcs.utwente.nl/user/s1934538/clickstream/clickstream-enwiki-2022-02.tsv.gz,Tasuku_Honjo,764,369751,102,370617,11481
hdfs://spark-nn.eemcs.utwente.nl/user/s1934538/clickstream/clickstream-enwiki-2022-02.tsv.gz,Sushma_Swaraj,8619,31449,59,40127,9856
hdfs://spark-nn.eemcs.utwente.nl/user/s1934538/clickstream/clickstream-enwiki-2022-02.tsv.gz,1917_(2019_film),22684,68386,1518,92588,51890
hdfs://spark-nn.eemcs.utwente.nl/user/s1934538/clickstream/clickstream-enwiki-2022-02.tsv.gz,Kylian_Mbappé,30981,265703,2908,299592,57925
hdfs://spark-nn.eemcs.utwente.nl/user/s1934538/clickstream/clickstream-enwiki-2022-02.tsv.gz,The_Nun_(2018_film),13704,39556,264,53524,31738
hdfs://spark-nn.eemcs.utwente.nl/user/s1934538/clickstream/clickstream-enwiki-2022-02.tsv.gz,The_Last_of_Us_(TV_series),43034,52248,513,95795,77661
hdfs://spark-nn.eemcs.utwente.nl/user/s1934538/clickstream/clickstream-enwiki-2022-02.tsv.gz,Murder_of_Dee_Dee_Blanchard,14186,113376,441,128003,27888
hdfs://spark-nn.eemcs.utwente.nl/user/s1934538/clickstream/clickstream-enwiki-2022-02.tsv.gz,Anne_Heche,26049,54580,328,80957,26382
hdfs://spark-nn.eemcs.utwente.nl/user/s1934538/clickstream/clickstream-enwiki-2022-02.tsv.gz,List_of_James_Bond_films,59844,412399,981,473224,272278
hdfs://spark-nn.eemcs.utwente.nl/user/s1934538/clickstream/clickstream-enwiki-2022-02.tsv.gz,Black_Panther:_Wakanda_Forever,100888,71011,954,172853,131321
hdfs://spark-nn.eemcs.utwente.nl/user/s1934538/clickstream/clickstream-enwiki-2022-02.tsv.gz,Brie_Larson,51515,138804,1339,191658,81949
hdfs://spark-nn.eemcs.utwente.nl/user/s1934538/clickstream/clickstream-enwiki-2022-02.tsv.gz,Anna_Sorokin,787989,7640074,30181,8458244,2727250
hdfs://spark-nn.eemcs.utwente.nl/user/s1934538/clickstream/clickstream-enwiki-2022-02.tsv.gz,"Citizenship_(Amendment)_Act,_2019",3241,19824,37,23102,2788
hdfs://spark-nn.eemcs.utwente.nl/user/s1934538/clickstream/clickstream-enwiki-2022-02.tsv.gz,Jeffrey_Epstein,59257,263986,3002,326245,146229
hdfs://spark-nn.eemcs.utwente.nl/user/s1934538/clickstream/clickstream-enwiki-2022-02.tsv.gz,Spider-Man:_No_Way_Home,352470,1360507,33160,1746137,864450
hdfs://spark-nn.eemcs.utwente.nl/user/s1934538/clickstream/clickstream-enwiki-2022-02.tsv.gz,Lisa_Marie_Presley,161013,88264,386,249663,151429
hdfs://spark-nn.eemcs.utwente.nl/user/s1934538/clickstream/clickstream-enwiki-2022-02.tsv.gz,"Diana,_Princess_of_Wales",195921,480307,3972,680200,441238
hdfs://spark-nn.eemcs.utwente.nl/user/s1934538/clickstream/clickstream-enwiki-2022-02.tsv.gz,Jenna_Ortega,97100,130483,1043,228626,80294
hdfs://spark-nn.eemcs.utwente.nl/user/s1934538/clickstream/clickstream-enwiki-2022-02.tsv.gz,The_Kashmir_Files,15724,58466,190,74380,44735
hdfs://spark-nn.eemcs.utwente.nl/user/s1934538/clickstream/clickstream-enwiki-2022-02.tsv.gz,J._Robert_Oppenheimer,55348,195672,575,251595,87345
hdfs://spark-nn.eemcs.utwente.nl/user/s1934538/clickstream/clickstream-enwiki-2022-02.tsv.gz,Dark_Phoenix_(film),45140,48155,627,93922,57691
hdfs://spark-nn.eemcs.utwente.nl/user/s1934538/clickstream/clickstream-enwiki-2022-02.tsv.gz,Godzilla_vs._Kong,39865,62446,1288,103599,55926
hdfs://spark-nn.eemcs.utwente.nl/user/s1934538/clickstream/clickstream-enwiki-2022-02.tsv.gz,Richard_Jewell,11914,47840,278,60032,21461
hdfs://spark-nn.eemcs.utwente.nl/user/s1934538/clickstream/clickstream-enwiki-2022-02.tsv.gz,The_Shape_of_Water,33134,49021,723,82878,37454
hdfs://spark-nn.eemcs.utwente.nl/user/s1934538/clickstream/clickstream-enwiki-2022-02.tsv.gz,State_of_Palestine,39594,95192,188,134974,59353
hdfs://spark-nn.eemcs.utwente.nl/user/s1934538/clickstream/clickstream-enwiki-2022-02.tsv.gz,Tenet_(film),61808,123605,1709,187122,94529
hdfs://spark-nn.eemcs.utwente.nl/user/s1934538/clickstream/clickstream-enwiki-2022-02.tsv.gz,Shinzo_Abe,25673,28248,266,54187,29924
hdfs://spark-nn.eemcs.utwente.nl/user/s1934538/clickstream/clickstream-enwiki-2022-02.tsv.gz,Crazy_Rich_Asians_(film),27160,73566,1035,101761,90069
hdfs://spark-nn.eemcs.utwente.nl/user/s1934538/clickstream/clickstream-enwiki-2022-02.tsv.gz,Avicii,19752,167156,1452,188360,55605
hdfs://spark-nn.eemcs.utwente.nl/user/s1934538/clickstream/clickstream-enwiki-2022-02.tsv.gz,Game_of_Thrones,67520,247187,6379,321086,218148
hdfs://spark-nn.eemcs.utwente.nl/user/s1934538/clickstream/clickstream-enwiki-2022-02.tsv.gz,Dennis_Nilsen,7798,99352,745,107895,24384
hdfs://spark-nn.eemcs.utwente.nl/user/s1934538/clickstream/clickstream-enwiki-2022-02.tsv.gz,House_of_the_Dragon,28451,84211,1297,113959,75480
hdfs://spark-nn.eemcs.utwente.nl/user/s1934538/clickstream/clickstream-enwiki-2022-02.tsv.gz,2018_Asian_Games,11343,7003,114,18460,19075
hdfs://spark-nn.eemcs.utwente.nl/user/s1934538/clickstream/clickstream-enwiki-2022-02.tsv.gz,List_of_awards_and_nominations_received_by_Meryl_Streep,13028,10501,206,23735,9907
hdfs://spark-nn.eemcs.utwente.nl/user/s1934538/clickstream/clickstream-enwiki-2022-02.tsv.gz,Top_Gun:_Maverick,68880,79029,2193,150102,90131
hdfs://spark-nn.eemcs.utwente.nl/user/s1934538/clickstream/clickstream-enwiki-2022-02.tsv.gz,Spanish_flu,28078,188940,2378,219396,47065
hdfs://spark-nn.eemcs.utwente.nl/user/s1934538/clickstream/clickstream-enwiki-2022-02.tsv.gz,Kamala_Harris,81528,206650,5074,293252,113253
hdfs://spark-nn.eemcs.utwente.nl/user/s1934538/clickstream/clickstream-enwiki-2022-02.tsv.gz,2016_United_States_presidential_election,84314,69262,827,154403,125280
hdfs://spark-nn.eemcs.utwente.nl/user/s1934538/clickstream/clickstream-enwiki-2022-02.tsv.gz,Keanu_Reeves,79736,572910,3518,656164,397307
hdfs://spark-nn.eemcs.utwente.nl/user/s1934538/clickstream/clickstream-enwiki-2022-02.tsv.gz,Vivek_Ramaswamy,959,33682,331,34972,5589
hdfs://spark-nn.eemcs.utwente.nl/user/s1934538/clickstream/clickstream-enwiki-2022-02.tsv.gz,Kelly_Preston,73976,83489,479,157944,47794
hdfs://spark-nn.eemcs.utwente.nl/user/s1934538/clickstream/clickstream-enwiki-2022-02.tsv.gz,The_Sandman_(TV_series),18599,26806,358,45763,34746
hdfs://spark-nn.eemcs.utwente.nl/user/s1934538/clickstream/clickstream-enwiki-2022-02.tsv.gz,Pornhub,48041,466693,13837,528571,92327
hdfs://spark-nn.eemcs.utwente.nl/user/s1934538/clickstream/clickstream-enwiki-2022-02.tsv.gz,Alexander_Hamilton,69919,244832,5508,320259,164873
hdfs://spark-nn.eemcs.utwente.nl/user/s1934538/clickstream/clickstream-enwiki-2022-02.tsv.gz,United_States_Electoral_College,10334,33951,64,44349,6828
hdfs://spark-nn.eemcs.utwente.nl/user/s1934538/clickstream/clickstream-enwiki-2022-02.tsv.gz,Captain_Marvel_(film),31900,90070,1206,123176,64671
hdfs://spark-nn.eemcs.utwente.nl/user/s1934538/clickstream/clickstream-enwiki-2022-02.tsv.gz,Michael_Bloomberg,29103,38682,267,68052,29258
hdfs://spark-nn.eemcs.utwente.nl/user/s1934538/clickstream/clickstream-enwiki-2022-02.tsv.gz,Tonya_Harding,54884,238079,1695,294658,84869
hdfs://spark-nn.eemcs.utwente.nl/user/s1934538/clickstream/clickstream-enwiki-2022-02.tsv.gz,Elliot_Page,58790,197320,1369,257479,110143
hdfs://spark-nn.eemcs.utwente.nl/user/s1934538/clickstream/clickstream-enwiki-2022-02.tsv.gz,2022_Russian_invasion_of_Ukraine,4565536,3983347,28028,8576911,5374083
hdfs://spark-nn.eemcs.utwente.nl/user/s1934538/clickstream/clickstream-enwiki-2022-02.tsv.gz,George_VI,459749,259670,8450,727869,524960
hdfs://spark-nn.eemcs.utwente.nl/user/s1934538/clickstream/clickstream-enwiki-2022-08.tsv.gz,Kim_Jong-un,69919,151922,1084,222925,135994
hdfs://spark-nn.eemcs.utwente.nl/user/s1934538/clickstream/clickstream-enwiki-2022-08.tsv.gz,Manti_Te'o,97118,4529936,13086,4640140,518335
hdfs://spark-nn.eemcs.utwente.nl/user/s1934538/clickstream/clickstream-enwiki-2022-08.tsv.gz,Deadpool_2,59254,58241,1284,118779,84251
hdfs://spark-nn.eemcs.utwente.nl/user/s1934538/clickstream/clickstream-enwiki-2022-08.tsv.gz,Amy_Coney_Barrett,18979,33366,290,52635,16691
hdfs://spark-nn.eemcs.utwente.nl/user/s1934538/clickstream/clickstream-enwiki-2022-08.tsv.gz,Donald_Glover,39816,127271,861,167948,67464
hdfs://spark-nn.eemcs.utwente.nl/user/s1934538/clickstream/clickstream-enwiki-2022-08.tsv.gz,List_of_FIFA_World_Cup_finals,3289,77236,61,80586,22008
hdfs://spark-nn.eemcs.utwente.nl/user/s1934538/clickstream/clickstream-enwiki-2022-08.tsv.gz,Game_of_Thrones,193996,666352,16451,876799,638652
hdfs://spark-nn.eemcs.utwente.nl/user/s1934538/clickstream/clickstream-enwiki-2022-08.tsv.gz,YouTube,122952,3163941,9305,3296198,112103
hdfs://spark-nn.eemcs.utwente.nl/user/s1934538/clickstream/clickstream-enwiki-2022-08.tsv.gz,Stranger_Things_(season_3),61931,136442,1758,200131,110604
hdfs://spark-nn.eemcs.utwente.nl/user/s1934538/clickstream/clickstream-enwiki-2022-08.tsv.gz,Alexander_Hamilton,62614,174709,1462,238785,134733
hdfs://spark-nn.eemcs.utwente.nl/user/s1934538/clickstream/clickstream-enwiki-2022-08.tsv.gz,Kelly_Preston,232293,257063,671,490027,140798
hdfs://spark-nn.eemcs.utwente.nl/user/s1934538/clickstream/clickstream-enwiki-2022-08.tsv.gz,List_of_Queen_of_the_South_episodes,8226,6447,82,14755,284
hdfs://spark-nn.eemcs.utwente.nl/user/s1934538/clickstream/clickstream-enwiki-2022-08.tsv.gz,Captain_Marvel_(film),32364,85987,1152,119503,59941
hdfs://spark-nn.eemcs.utwente.nl/user/s1934538/clickstream/clickstream-enwiki-2022-08.tsv.gz,Mötley_Crüe,42178,152395,1751,196324,223537
hdfs://spark-nn.eemcs.utwente.nl/user/s1934538/clickstream/clickstream-enwiki-2022-08.tsv.gz,Cameron_Boyce,28548,147154,470,176172,46516
hdfs://spark-nn.eemcs.utwente.nl/user/s1934538/clickstream/clickstream-enwiki-2022-08.tsv.gz,Jurassic_World_Dominion,162173,453746,12164,628083,372210
hdfs://spark-nn.eemcs.utwente.nl/user/s1934538/clickstream/clickstream-enwiki-2022-08.tsv.gz,Tonya_Harding,24540,130143,546,155229,39918
hdfs://spark-nn.eemcs.utwente.nl/user/s1934538/clickstream/clickstream-enwiki-2022-08.tsv.gz,Luke_Perry,43440,145452,810,189702,69943
hdfs://spark-nn.eemcs.utwente.nl/user/s1934538/clickstream/clickstream-enwiki-2022-08.tsv.gz,Dennis_Nilsen,8467,51560,265,60292,16066
hdfs://spark-nn.eemcs.utwente.nl/user/s1934538/clickstream/clickstream-enwiki-2022-08.tsv.gz,Avengers:_Infinity_War,51164,80698,1304,133166,70114
hdfs://spark-nn.eemcs.utwente.nl/user/s1934538/clickstream/clickstream-enwiki-2022-08.tsv.gz,Adipurush,58348,74371,267,132986,103785
hdfs://spark-nn.eemcs.utwente.nl/user/s1934538/clickstream/clickstream-enwiki-2022-08.tsv.gz,Joker_(2019_film),73778,198340,4336,276454,127022
hdfs://spark-nn.eemcs.utwente.nl/user/s1934538/clickstream/clickstream-enwiki-2022-08.tsv.gz,War_(2019_film),34026,46297,71,80394,20250
hdfs://spark-nn.eemcs.utwente.nl/user/s1934538/clickstream/clickstream-enwiki-2022-08.tsv.gz,"Diana,_Princess_of_Wales",148735,596912,16725,762372,470869
hdfs://spark-nn.eemcs.utwente.nl/user/s1934538/clickstream/clickstream-enwiki-2022-08.tsv.gz,A_Star_Is_Born_(2018_film),29852,103738,783,134373,64544
hdfs://spark-nn.eemcs.utwente.nl/user/s1934538/clickstream/clickstream-enwiki-2022-08.tsv.gz,Lisa_Marie_Presley,494147,546886,855,1041888,634292
hdfs://spark-nn.eemcs.utwente.nl/user/s1934538/clickstream/clickstream-enwiki-2022-08.tsv.gz,List_of_highest-grossing_films,150642,527513,10809,688964,324501
hdfs://spark-nn.eemcs.utwente.nl/user/s1934538/clickstream/clickstream-enwiki-2022-08.tsv.gz,2016_United_States_presidential_election,107948,78517,1188,187653,162834
hdfs://spark-nn.eemcs.utwente.nl/user/s1934538/clickstream/clickstream-enwiki-2022-08.tsv.gz,Kobe_Bryant_sexual_assault_case,14260,48242,74,62576,5976
hdfs://spark-nn.eemcs.utwente.nl/user/s1934538/clickstream/clickstream-enwiki-2022-08.tsv.gz,Rami_Malek,56088,137265,618,193971,84167
hdfs://spark-nn.eemcs.utwente.nl/user/s1934538/clickstream/clickstream-enwiki-2022-08.tsv.gz,Jenna_Ortega,147835,306220,2272,456327,153641
hdfs://spark-nn.eemcs.utwente.nl/user/s1934538/clickstream/clickstream-enwiki-2022-08.tsv.gz,Dune_(2021_film),65082,218718,4520,288320,200339
hdfs://spark-nn.eemcs.utwente.nl/user/s1934538/clickstream/clickstream-enwiki-2022-08.tsv.gz,HTTP_cookie,2612,321231,106,323949,22774
hdfs://spark-nn.eemcs.utwente.nl/user/s1934538/clickstream/clickstream-enwiki-2022-08.tsv.gz,Thor:_Love_and_Thunder,218517,985569,23508,1227594,513845
hdfs://spark-nn.eemcs.utwente.nl/user/s1934538/clickstream/clickstream-enwiki-2022-08.tsv.gz,Keanu_Reeves,85252,527386,3785,616423,364712
hdfs://spark-nn.eemcs.utwente.nl/user/s1934538/clickstream/clickstream-enwiki-2022-08.tsv.gz,Grover,1337,4686,40,6063,1305
hdfs://spark-nn.eemcs.utwente.nl/user/s1934538/clickstream/clickstream-enwiki-2022-08.tsv.gz,The_Sandman_(TV_series),394393,3664193,75556,4134142,3700341
hdfs://spark-nn.eemcs.utwente.nl/user/s1934538/clickstream/clickstream-enwiki-2022-08.tsv.gz,Aquaman_(film),25287,64967,991,91245,45503
hdfs://spark-nn.eemcs.utwente.nl/user/s1934538/clickstream/clickstream-enwiki-2022-08.tsv.gz,Shakira,30281,364953,3233,398467,161889
hdfs://spark-nn.eemcs.utwente.nl/user/s1934538/clickstream/clickstream-enwiki-2022-08.tsv.gz,List_of_James_Bond_films,80624,362907,2602,446133,280663
hdfs://spark-nn.eemcs.utwente.nl/user/s1934538/clickstream/clickstream-enwiki-2022-08.tsv.gz,Juice_Wrld,32990,198890,2138,234018,92925
hdfs://spark-nn.eemcs.utwente.nl/user/s1934538/clickstream/clickstream-enwiki-2022-08.tsv.gz,Notre-Dame_de_Paris,12174,95387,817,108378,19797
hdfs://spark-nn.eemcs.utwente.nl/user/s1934538/clickstream/clickstream-enwiki-2022-08.tsv.gz,Aaron_Carter,19941,64011,364,84316,34307
hdfs://spark-nn.eemcs.utwente.nl/user/s1934538/clickstream/clickstream-enwiki-2022-08.tsv.gz,Glass_(2019_film),38659,49289,347,88295,28347
hdfs://spark-nn.eemcs.utwente.nl/user/s1934538/clickstream/clickstream-enwiki-2022-08.tsv.gz,Lionel_Messi,108139,677432,4748,790319,169815
hdfs://spark-nn.eemcs.utwente.nl/user/s1934538/clickstream/clickstream-enwiki-2022-08.tsv.gz,Anne_Heche,256650,9808873,133183,10198706,3103822
hdfs://spark-nn.eemcs.utwente.nl/user/s1934538/clickstream/clickstream-enwiki-2022-08.tsv.gz,Main_Page,88425,132791784,4884581,137764790,34168732
hdfs://spark-nn.eemcs.utwente.nl/user/s1934538/clickstream/clickstream-enwiki-2022-08.tsv.gz,Mortal_Kombat_(2021_film),20894,55904,914,77712,64030
hdfs://spark-nn.eemcs.utwente.nl/user/s1934538/clickstream/clickstream-enwiki-2022-08.tsv.gz,Army_of_the_Dead,50316,46487,594,97397,52326
hdfs://spark-nn.eemcs.utwente.nl/user/s1934538/clickstream/clickstream-enwiki-2022-08.tsv.gz,Critical_race_theory,13253,141109,913,155275,19282
hdfs://spark-nn.eemcs.utwente.nl/user/s1934538/clickstream/clickstream-enwiki-2022-08.tsv.gz,Bipin_Rawat,9729,28801,13,38543,14320
hdfs://spark-nn.eemcs.utwente.nl/user/s1934538/clickstream/clickstream-enwiki-2022-08.tsv.gz,UEFA_Euro_2020,40142,52878,859,93879,53189
hdfs://spark-nn.eemcs.utwente.nl/user/s1934538/clickstream/clickstream-enwiki-2022-08.tsv.gz,Michael_Jordan,75759,469405,3937,549101,170992
hdfs://spark-nn.eemcs.utwente.nl/user/s1934538/clickstream/clickstream-enwiki-2022-08.tsv.gz,Eddie_Van_Halen,40410,79476,729,120615,45941
hdfs://spark-nn.eemcs.utwente.nl/user/s1934538/clickstream/clickstream-enwiki-2022-08.tsv.gz,Chernobyl_(miniseries),17800,57863,1328,76991,80262
hdfs://spark-nn.eemcs.utwente.nl/user/s1934538/clickstream/clickstream-enwiki-2022-08.tsv.gz,"Citizenship_(Amendment)_Act,_2019",3605,21629,10,25244,3072
hdfs://spark-nn.eemcs.utwente.nl/user/s1934538/clickstream/clickstream-enwiki-2022-08.tsv.gz,Bridgerton,31968,171768,3247,206983,162791
hdfs://spark-nn.eemcs.utwente.nl/user/s1934538/clickstream/clickstream-enwiki-2022-08.tsv.gz,Lance_Reddick,43135,50174,265,93574,22183
hdfs://spark-nn.eemcs.utwente.nl/user/s1934538/clickstream/clickstream-enwiki-2022-08.tsv.gz,The_Suicide_Squad_(film),79249,82688,1212,163149,96107
hdfs://spark-nn.eemcs.utwente.nl/user/s1934538/clickstream/clickstream-enwiki-2022-08.tsv.gz,XNXX,20835,1064290,8092,1093217,87342
hdfs://spark-nn.eemcs.utwente.nl/user/s1934538/clickstream/clickstream-enwiki-2022-08.tsv.gz,Star_Wars:_The_Rise_of_Skywalker,64038,58690,1163,123891,66116
hdfs://spark-nn.eemcs.utwente.nl/user/s1934538/clickstream/clickstream-enwiki-2022-08.tsv.gz,R._Kelly,28457,241763,2807,273027,159981
hdfs://spark-nn.eemcs.utwente.nl/user/s1934538/clickstream/clickstream-enwiki-2022-08.tsv.gz,Roe_v._Wade,18734,190601,2182,211517,63079
hdfs://spark-nn.eemcs.utwente.nl/user/s1934538/clickstream/clickstream-enwiki-2022-08.tsv.gz,Kobe_Bryant,73421,553142,19703,646266,201548
hdfs://spark-nn.eemcs.utwente.nl/user/s1934538/clickstream/clickstream-enwiki-2022-08.tsv.gz,David_Beckham,54051,167805,1165,223021,90600
hdfs://spark-nn.eemcs.utwente.nl/user/s1934538/clickstream/clickstream-enwiki-2022-08.tsv.gz,Elon_Musk,105777,944820,11887,1062484,573319
hdfs://spark-nn.eemcs.utwente.nl/user/s1934538/clickstream/clickstream-enwiki-2022-08.tsv.gz,Shinzo_Abe,56115,149812,2965,208892,121148
hdfs://spark-nn.eemcs.utwente.nl/user/s1934538/clickstream/clickstream-enwiki-2022-08.tsv.gz,Black_Adam_(film),106841,133352,2872,243065,150458
hdfs://spark-nn.eemcs.utwente.nl/user/s1934538/clickstream/clickstream-enwiki-2022-08.tsv.gz,Top_Gun:_Maverick,397744,1750707,39530,2187981,1592574
hdfs://spark-nn.eemcs.utwente.nl/user/s1934538/clickstream/clickstream-enwiki-2022-08.tsv.gz,Stephen_Hawking,25826,318729,1803,346358,124607
hdfs://spark-nn.eemcs.utwente.nl/user/s1934538/clickstream/clickstream-enwiki-2022-08.tsv.gz,Spanish_flu,17189,57419,526,75134,20899
hdfs://spark-nn.eemcs.utwente.nl/user/s1934538/clickstream/clickstream-enwiki-2022-08.tsv.gz,1917_(2019_film),20070,89397,1843,111310,62199
hdfs://spark-nn.eemcs.utwente.nl/user/s1934538/clickstream/clickstream-enwiki-2022-08.tsv.gz,Brett_Kavanaugh,15497,30379,183,46059,15190
hdfs://spark-nn.eemcs.utwente.nl/user/s1934538/clickstream/clickstream-enwiki-2022-08.tsv.gz,Betty_White,44007,128051,1644,173702,45138
hdfs://spark-nn.eemcs.utwente.nl/user/s1934538/clickstream/clickstream-enwiki-2022-08.tsv.gz,Atal_Bihari_Vajpayee,41071,101708,80,142859,44978
hdfs://spark-nn.eemcs.utwente.nl/user/s1934538/clickstream/clickstream-enwiki-2022-08.tsv.gz,Article_370_of_the_Constitution_of_India,3475,64075,32,67582,3871
hdfs://spark-nn.eemcs.utwente.nl/user/s1934538/clickstream/clickstream-enwiki-2022-08.tsv.gz,WrestleMania_34,13949,7188,96,21233,14026
hdfs://spark-nn.eemcs.utwente.nl/user/s1934538/clickstream/clickstream-enwiki-2022-08.tsv.gz,WandaVision,56941,96504,1412,154857,65838
hdfs://spark-nn.eemcs.utwente.nl/user/s1934538/clickstream/clickstream-enwiki-2022-08.tsv.gz,Google_logo,683,19562,10,20255,858
hdfs://spark-nn.eemcs.utwente.nl/user/s1934538/clickstream/clickstream-enwiki-2022-08.tsv.gz,The_Falcon_and_the_Winter_Soldier,26435,44574,760,71769,44371
hdfs://spark-nn.eemcs.utwente.nl/user/s1934538/clickstream/clickstream-enwiki-2022-08.tsv.gz,Rishi_Sunak,50229,376251,2523,429003,199294
hdfs://spark-nn.eemcs.utwente.nl/user/s1934538/clickstream/clickstream-enwiki-2022-08.tsv.gz,Sidharth_Shukla,9045,65923,91,75059,16651
hdfs://spark-nn.eemcs.utwente.nl/user/s1934538/clickstream/clickstream-enwiki-2022-08.tsv.gz,Israel,88968,250735,4781,344484,181914
hdfs://spark-nn.eemcs.utwente.nl/user/s1934538/clickstream/clickstream-enwiki-2022-08.tsv.gz,Charles_III,72,143,45,260,233
hdfs://spark-nn.eemcs.utwente.nl/user/s1934538/clickstream/clickstream-enwiki-2022-08.tsv.gz,Tenet_(film),58224,194387,2509,255120,127759
hdfs://spark-nn.eemcs.utwente.nl/user/s1934538/clickstream/clickstream-enwiki-2022-08.tsv.gz,Anna_Sorokin,41818,316592,1183,359593,143585
hdfs://spark-nn.eemcs.utwente.nl/user/s1934538/clickstream/clickstream-enwiki-2022-08.tsv.gz,Queen_(band),53407,198620,2949,254976,249362
hdfs://spark-nn.eemcs.utwente.nl/user/s1934538/clickstream/clickstream-enwiki-2022-08.tsv.gz,Ant-Man_and_the_Wasp:_Quantumania,81795,47532,1245,130572,87114
hdfs://spark-nn.eemcs.utwente.nl/user/s1934538/clickstream/clickstream-enwiki-2022-08.tsv.gz,United_States_Senate,66535,59222,1162,126919,62659
hdfs://spark-nn.eemcs.utwente.nl/user/s1934538/clickstream/clickstream-enwiki-2022-08.tsv.gz,Simple_Mail_Transfer_Protocol,2542,27778,113,30433,2793
hdfs://spark-nn.eemcs.utwente.nl/user/s1934538/clickstream/clickstream-enwiki-2022-08.tsv.gz,2022_FIFA_World_Cup,158901,617254,9982,786137,411741
hdfs://spark-nn.eemcs.utwente.nl/user/s1934538/clickstream/clickstream-enwiki-2022-08.tsv.gz,Mulan_(2020_film),17117,37830,462,55409,30095
hdfs://spark-nn.eemcs.utwente.nl/user/s1934538/clickstream/clickstream-enwiki-2022-08.tsv.gz,Khabib_Nurmagomedov,61994,251377,2188,315559,171011
hdfs://spark-nn.eemcs.utwente.nl/user/s1934538/clickstream/clickstream-enwiki-2022-08.tsv.gz,Rihanna,62120,248086,2857,313063,172042
hdfs://spark-nn.eemcs.utwente.nl/user/s1934538/clickstream/clickstream-enwiki-2022-08.tsv.gz,Black_Widow_(2021_film),48971,92209,1372,142552,72984
hdfs://spark-nn.eemcs.utwente.nl/user/s1934538/clickstream/clickstream-enwiki-2022-08.tsv.gz,Spider-Man:_Far_From_Home,51538,70983,576,123097,51728
hdfs://spark-nn.eemcs.utwente.nl/user/s1934538/clickstream/clickstream-enwiki-2022-08.tsv.gz,Richard_Ramirez,19132,210356,1731,231219,72227
hdfs://spark-nn.eemcs.utwente.nl/user/s1934538/clickstream/clickstream-enwiki-2022-08.tsv.gz,Darth_Vader,25860,84869,719,111448,59183
hdfs://spark-nn.eemcs.utwente.nl/user/s1934538/clickstream/clickstream-enwiki-2022-08.tsv.gz,Us_(2019_film),82538,140962,798,224298,71657
hdfs://spark-nn.eemcs.utwente.nl/user/s1934538/clickstream/clickstream-enwiki-2022-08.tsv.gz,List_of_highest-grossing_Indian_films,112718,361819,3525,478062,297598
hdfs://spark-nn.eemcs.utwente.nl/user/s1934538/clickstream/clickstream-enwiki-2022-08.tsv.gz,The_Last_of_Us_(TV_series),46548,88827,1123,136498,118574
hdfs://spark-nn.eemcs.utwente.nl/user/s1934538/clickstream/clickstream-enwiki-2022-08.tsv.gz,Pelé,31586,130571,837,162994,54976
hdfs://spark-nn.eemcs.utwente.nl/user/s1934538/clickstream/clickstream-enwiki-2022-08.tsv.gz,Adele,31229,169272,2431,202932,81094
hdfs://spark-nn.eemcs.utwente.nl/user/s1934538/clickstream/clickstream-enwiki-2022-08.tsv.gz,Zack_Snyder's_Justice_League,61364,77771,863,139998,68081
hdfs://spark-nn.eemcs.utwente.nl/user/s1934538/clickstream/clickstream-enwiki-2022-08.tsv.gz,Afghanistan,144109,270854,5691,420654,323644
hdfs://spark-nn.eemcs.utwente.nl/user/s1934538/clickstream/clickstream-enwiki-2022-08.tsv.gz,21_Savage,11995,52221,380,64596,22853
hdfs://spark-nn.eemcs.utwente.nl/user/s1934538/clickstream/clickstream-enwiki-2022-08.tsv.gz,Deion_Sanders,12741,135131,945,148817,45052
hdfs://spark-nn.eemcs.utwente.nl/user/s1934538/clickstream/clickstream-enwiki-2022-08.tsv.gz,Saltburn_(film),14773,6273,14,21060,10595
hdfs://spark-nn.eemcs.utwente.nl/user/s1934538/clickstream/clickstream-enwiki-2022-08.tsv.gz,Crazy_Rich_Asians_(film),30737,61909,975,93621,71809
hdfs://spark-nn.eemcs.utwente.nl/user/s1934538/clickstream/clickstream-enwiki-2022-08.tsv.gz,Bob_Saget,27000,93707,966,121673,27409
hdfs://spark-nn.eemcs.utwente.nl/user/s1934538/clickstream/clickstream-enwiki-2022-08.tsv.gz,Asia_Cup,39831,983247,1032,1024110,431272
hdfs://spark-nn.eemcs.utwente.nl/user/s1934538/clickstream/clickstream-enwiki-2022-08.tsv.gz,K.G.F:_Chapter_2,90751,387552,2464,480767,143249
hdfs://spark-nn.eemcs.utwente.nl/user/s1934538/clickstream/clickstream-enwiki-2022-08.tsv.gz,Dark_Phoenix_(film),41534,43064,484,85082,46156
hdfs://spark-nn.eemcs.utwente.nl/user/s1934538/clickstream/clickstream-enwiki-2022-08.tsv.gz,September_11_attacks,134390,325156,4161,463707,300123
hdfs://spark-nn.eemcs.utwente.nl/user/s1934538/clickstream/clickstream-enwiki-2022-08.tsv.gz,2018_FIFA_World_Cup,94001,84635,924,179560,111070
hdfs://spark-nn.eemcs.utwente.nl/user/s1934538/clickstream/clickstream-enwiki-2022-08.tsv.gz,John_McCain,37087,72518,947,110552,58280
hdfs://spark-nn.eemcs.utwente.nl/user/s1934538/clickstream/clickstream-enwiki-2022-08.tsv.gz,Cook's_Country,417,2098,26,2541,645
hdfs://spark-nn.eemcs.utwente.nl/user/s1934538/clickstream/clickstream-enwiki-2022-08.tsv.gz,Antifa_(United_States),9316,71925,283,81524,14311
hdfs://spark-nn.eemcs.utwente.nl/user/s1934538/clickstream/clickstream-enwiki-2022-08.tsv.gz,Elizabeth_II,380879,643823,3516,1028218,716916
hdfs://spark-nn.eemcs.utwente.nl/user/s1934538/clickstream/clickstream-enwiki-2022-08.tsv.gz,Sinéad_O'Connor,17861,75007,610,93478,26936
hdfs://spark-nn.eemcs.utwente.nl/user/s1934538/clickstream/clickstream-enwiki-2022-08.tsv.gz,Sushant_Singh_Rajput,23200,91968,177,115345,61004
hdfs://spark-nn.eemcs.utwente.nl/user/s1934538/clickstream/clickstream-enwiki-2022-08.tsv.gz,Aretha_Franklin,31163,248739,1736,281638,130521
hdfs://spark-nn.eemcs.utwente.nl/user/s1934538/clickstream/clickstream-enwiki-2022-08.tsv.gz,Loki_(TV_series),33829,82861,1709,118399,82876
hdfs://spark-nn.eemcs.utwente.nl/user/s1934538/clickstream/clickstream-enwiki-2022-08.tsv.gz,George_VI,289933,102934,463,393330,289840
hdfs://spark-nn.eemcs.utwente.nl/user/s1934538/clickstream/clickstream-enwiki-2022-08.tsv.gz,Ponniyin_Selvan:_I,69473,327146,1008,397627,332400
hdfs://spark-nn.eemcs.utwente.nl/user/s1934538/clickstream/clickstream-enwiki-2022-08.tsv.gz,Juneteenth,3853,34134,162,38149,4112
hdfs://spark-nn.eemcs.utwente.nl/user/s1934538/clickstream/clickstream-enwiki-2022-08.tsv.gz,Wonder_Woman_1984,35009,65476,1200,101685,51213
hdfs://spark-nn.eemcs.utwente.nl/user/s1934538/clickstream/clickstream-enwiki-2022-08.tsv.gz,Mac_Miller,28051,204531,1446,234028,67132
hdfs://spark-nn.eemcs.utwente.nl/user/s1934538/clickstream/clickstream-enwiki-2022-08.tsv.gz,Parasite_(2019_film),26274,152744,3040,182058,73412
hdfs://spark-nn.eemcs.utwente.nl/user/s1934538/clickstream/clickstream-enwiki-2022-08.tsv.gz,2020_United_States_presidential_election,143013,205532,5667,354212,346322
hdfs://spark-nn.eemcs.utwente.nl/user/s1934538/clickstream/clickstream-enwiki-2022-08.tsv.gz,Michael_Bloomberg,27864,28152,184,56200,26260
hdfs://spark-nn.eemcs.utwente.nl/user/s1934538/clickstream/clickstream-enwiki-2022-08.tsv.gz,2020_Summer_Olympics,91936,88658,2264,182858,176663
hdfs://spark-nn.eemcs.utwente.nl/user/s1934538/clickstream/clickstream-enwiki-2022-08.tsv.gz,Cecil_Hotel_(Los_Angeles),8642,88069,153,96864,23408
hdfs://spark-nn.eemcs.utwente.nl/user/s1934538/clickstream/clickstream-enwiki-2022-08.tsv.gz,Venom_(2018_film),17508,72149,713,90370,38346
hdfs://spark-nn.eemcs.utwente.nl/user/s1934538/clickstream/clickstream-enwiki-2022-08.tsv.gz,XHamster,6160,237527,5569,249256,32765
hdfs://spark-nn.eemcs.utwente.nl/user/s1934538/clickstream/clickstream-enwiki-2022-08.tsv.gz,Simone_Biles,14673,70935,405,86013,29534
hdfs://spark-nn.eemcs.utwente.nl/user/s1934538/clickstream/clickstream-enwiki-2022-08.tsv.gz,Donald_Trump,242147,699171,9871,951189,538517
hdfs://spark-nn.eemcs.utwente.nl/user/s1934538/clickstream/clickstream-enwiki-2022-08.tsv.gz,Stranger_Things_(season_4),128944,546595,8736,684275,405452
hdfs://spark-nn.eemcs.utwente.nl/user/s1934538/clickstream/clickstream-enwiki-2022-08.tsv.gz,Irrfan_Khan,32558,63093,240,95891,41012
hdfs://spark-nn.eemcs.utwente.nl/user/s1934538/clickstream/clickstream-enwiki-2022-08.tsv.gz,The_Mandalorian,46583,113226,2244,162053,108360
hdfs://spark-nn.eemcs.utwente.nl/user/s1934538/clickstream/clickstream-enwiki-2022-08.tsv.gz,The_Idol_(TV_series),96494,124254,3000,223748,138515
hdfs://spark-nn.eemcs.utwente.nl/user/s1934538/clickstream/clickstream-enwiki-2022-11.tsv.gz,R._Kelly,34147,160944,1822,196913,104256
hdfs://spark-nn.eemcs.utwente.nl/user/s1934538/clickstream/clickstream-enwiki-2022-11.tsv.gz,The_Weeknd,55667,183979,1991,241637,110921
hdfs://spark-nn.eemcs.utwente.nl/user/s1934538/clickstream/clickstream-enwiki-2022-11.tsv.gz,Black_Panther_(film),182980,1596596,9622,1789198,858304
hdfs://spark-nn.eemcs.utwente.nl/user/s1934538/clickstream/clickstream-enwiki-2022-11.tsv.gz,Aquaman_(film),26536,103626,1736,131898,64102
hdfs://spark-nn.eemcs.utwente.nl/user/s1934538/clickstream/clickstream-enwiki-2022-11.tsv.gz,Sridevi,53839,133685,179,187703,86752
hdfs://spark-nn.eemcs.utwente.nl/user/s1934538/clickstream/clickstream-enwiki-2022-11.tsv.gz,K.G.F:_Chapter_2,65284,223295,1448,290027,78132
hdfs://spark-nn.eemcs.utwente.nl/user/s1934538/clickstream/clickstream-enwiki-2022-11.tsv.gz,Lionel_Messi,295839,2352837,15130,2663806,583661
hdfs://spark-nn.eemcs.utwente.nl/user/s1934538/clickstream/clickstream-enwiki-2022-11.tsv.gz,Squid_Game,20305,160970,2708,183983,77500
hdfs://spark-nn.eemcs.utwente.nl/user/s1934538/clickstream/clickstream-enwiki-2022-11.tsv.gz,Carlos_Alcaraz,23429,64624,180,88233,20631
hdfs://spark-nn.eemcs.utwente.nl/user/s1934538/clickstream/clickstream-enwiki-2022-11.tsv.gz,Crazy_Rich_Asians_(film),21433,49257,814,71504,50832
hdfs://spark-nn.eemcs.utwente.nl/user/s1934538/clickstream/clickstream-enwiki-2022-11.tsv.gz,Brett_Kavanaugh,22257,27537,136,49930,16646
hdfs://spark-nn.eemcs.utwente.nl/user/s1934538/clickstream/clickstream-enwiki-2022-11.tsv.gz,Gaza_Strip,20147,33865,207,54219,22296
hdfs://spark-nn.eemcs.utwente.nl/user/s1934538/clickstream/clickstream-enwiki-2022-11.tsv.gz,Cecil_Hotel_(Los_Angeles),5702,40031,93,45826,11021
hdfs://spark-nn.eemcs.utwente.nl/user/s1934538/clickstream/clickstream-enwiki-2022-11.tsv.gz,Israel,100989,309340,7141,417470,225827
hdfs://spark-nn.eemcs.utwente.nl/user/s1934538/clickstream/clickstream-enwiki-2022-11.tsv.gz,UEFA_Euro_2020,181317,414021,5085,600423,220789
hdfs://spark-nn.eemcs.utwente.nl/user/s1934538/clickstream/clickstream-enwiki-2022-11.tsv.gz,Keanu_Reeves,84151,521110,3227,608488,366744
hdfs://spark-nn.eemcs.utwente.nl/user/s1934538/clickstream/clickstream-enwiki-2022-11.tsv.gz,Anna_Sorokin,16836,221243,951,239030,85487
hdfs://spark-nn.eemcs.utwente.nl/user/s1934538/clickstream/clickstream-enwiki-2022-11.tsv.gz,Kobe_Bryant_sexual_assault_case,7455,30302,16,37773,3469
hdfs://spark-nn.eemcs.utwente.nl/user/s1934538/clickstream/clickstream-enwiki-2022-11.tsv.gz,Vladimir_Putin,131916,351920,4748,488584,248683
hdfs://spark-nn.eemcs.utwente.nl/user/s1934538/clickstream/clickstream-enwiki-2022-11.tsv.gz,Dennis_Nilsen,10552,68591,440,79583,18334
hdfs://spark-nn.eemcs.utwente.nl/user/s1934538/clickstream/clickstream-enwiki-2022-11.tsv.gz,Lisa_Marie_Presley,173281,170041,484,343806,191711
hdfs://spark-nn.eemcs.utwente.nl/user/s1934538/clickstream/clickstream-enwiki-2022-11.tsv.gz,Jimmy_Buffett,7526,34187,403,42116,16401
hdfs://spark-nn.eemcs.utwente.nl/user/s1934538/clickstream/clickstream-enwiki-2022-11.tsv.gz,Russo-Ukrainian_War,133356,641699,8010,783065,423177
hdfs://spark-nn.eemcs.utwente.nl/user/s1934538/clickstream/clickstream-enwiki-2022-11.tsv.gz,Hamas,26995,27932,290,55217,25188
hdfs://spark-nn.eemcs.utwente.nl/user/s1934538/clickstream/clickstream-enwiki-2022-11.tsv.gz,George_VI,667223,286313,1395,954931,706484
hdfs://spark-nn.eemcs.utwente.nl/user/s1934538/clickstream/clickstream-enwiki-2022-11.tsv.gz,Joe_Exotic,12492,52647,245,65384,29809
hdfs://spark-nn.eemcs.utwente.nl/user/s1934538/clickstream/clickstream-enwiki-2022-11.tsv.gz,COVID-19_pandemic_by_country_and_territory,10768,34386,1142,46296,19683
hdfs://spark-nn.eemcs.utwente.nl/user/s1934538/clickstream/clickstream-enwiki-2022-11.tsv.gz,The_Batman_(film),84221,223124,4363,311708,153359
hdfs://spark-nn.eemcs.utwente.nl/user/s1934538/clickstream/clickstream-enwiki-2022-11.tsv.gz,The_Falcon_and_the_Winter_Soldier,23539,37283,577,61399,35543
hdfs://spark-nn.eemcs.utwente.nl/user/s1934538/clickstream/clickstream-enwiki-2022-11.tsv.gz,Cook's_Country,400,1408,51,1859,518
hdfs://spark-nn.eemcs.utwente.nl/user/s1934538/clickstream/clickstream-enwiki-2022-11.tsv.gz,Aretha_Franklin,24522,122567,999,148088,64124
hdfs://spark-nn.eemcs.utwente.nl/user/s1934538/clickstream/clickstream-enwiki-2022-11.tsv.gz,House_of_the_Dragon,119520,1010305,20246,1150071,627964
hdfs://spark-nn.eemcs.utwente.nl/user/s1934538/clickstream/clickstream-enwiki-2022-11.tsv.gz,Coronavirus,6068,31390,841,38299,12117
hdfs://spark-nn.eemcs.utwente.nl/user/s1934538/clickstream/clickstream-enwiki-2022-11.tsv.gz,Kamala_Harris,110801,171978,1230,284009,134148
hdfs://spark-nn.eemcs.utwente.nl/user/s1934538/clickstream/clickstream-enwiki-2022-11.tsv.gz,The_Haunting_of_Bly_Manor,24849,54646,368,79863,39576
hdfs://spark-nn.eemcs.utwente.nl/user/s1934538/clickstream/clickstream-enwiki-2022-11.tsv.gz,Adipurush,45898,98430,550,144878,74884
hdfs://spark-nn.eemcs.utwente.nl/user/s1934538/clickstream/clickstream-enwiki-2022-11.tsv.gz,Us_(2019_film),48692,87895,297,136884,45873
hdfs://spark-nn.eemcs.utwente.nl/user/s1934538/clickstream/clickstream-enwiki-2022-11.tsv.gz,Ghislaine_Maxwell,72069,328573,1722,402364,182536
hdfs://spark-nn.eemcs.utwente.nl/user/s1934538/clickstream/clickstream-enwiki-2022-11.tsv.gz,Spider-Man:_No_Way_Home,112578,239109,3453,355140,146355
hdfs://spark-nn.eemcs.utwente.nl/user/s1934538/clickstream/clickstream-enwiki-2022-11.tsv.gz,Jeffrey_Epstein,71135,292967,1969,366071,166669
hdfs://spark-nn.eemcs.utwente.nl/user/s1934538/clickstream/clickstream-enwiki-2022-11.tsv.gz,1917_(2019_film),19099,80411,1568,101078,45660
hdfs://spark-nn.eemcs.utwente.nl/user/s1934538/clickstream/clickstream-enwiki-2022-11.tsv.gz,The_Umbrella_Academy_(TV_series),20000,92207,1881,114088,67138
hdfs://spark-nn.eemcs.utwente.nl/user/s1934538/clickstream/clickstream-enwiki-2022-11.tsv.gz,Cardi_B,120771,232784,2272,355827,101231
hdfs://spark-nn.eemcs.utwente.nl/user/s1934538/clickstream/clickstream-enwiki-2022-11.tsv.gz,NATO,76834,264898,6608,348340,151322
hdfs://spark-nn.eemcs.utwente.nl/user/s1934538/clickstream/clickstream-enwiki-2022-11.tsv.gz,Taliban,35273,58640,824,94737,66825
hdfs://spark-nn.eemcs.utwente.nl/user/s1934538/clickstream/clickstream-enwiki-2022-11.tsv.gz,2020_United_States_presidential_election,263750,529003,7456,800209,587626
hdfs://spark-nn.eemcs.utwente.nl/user/s1934538/clickstream/clickstream-enwiki-2022-11.tsv.gz,Naomi_Osaka,9249,34372,241,43862,9713
hdfs://spark-nn.eemcs.utwente.nl/user/s1934538/clickstream/clickstream-enwiki-2022-11.tsv.gz,Mulan_(2020_film),15143,49405,556,65104,33464
hdfs://spark-nn.eemcs.utwente.nl/user/s1934538/clickstream/clickstream-enwiki-2022-11.tsv.gz,JSON_Web_Token,805,25528,46,26379,1927
hdfs://spark-nn.eemcs.utwente.nl/user/s1934538/clickstream/clickstream-enwiki-2022-11.tsv.gz,Rami_Malek,45174,116321,883,162378,65109
hdfs://spark-nn.eemcs.utwente.nl/user/s1934538/clickstream/clickstream-enwiki-2022-11.tsv.gz,Mortal_Kombat_(2021_film),17436,50924,650,69010,52710
hdfs://spark-nn.eemcs.utwente.nl/user/s1934538/clickstream/clickstream-enwiki-2022-11.tsv.gz,Kelly_Preston,85933,100057,363,186353,53975
hdfs://spark-nn.eemcs.utwente.nl/user/s1934538/clickstream/clickstream-enwiki-2022-11.tsv.gz,Tenet_(film),54027,114637,1248,169912,81186
hdfs://spark-nn.eemcs.utwente.nl/user/s1934538/clickstream/clickstream-enwiki-2022-11.tsv.gz,Queen_(band),47671,177311,2821,227803,204059
hdfs://spark-nn.eemcs.utwente.nl/user/s1934538/clickstream/clickstream-enwiki-2022-11.tsv.gz,Dark_Phoenix_(film),34196,33350,309,67855,35055
hdfs://spark-nn.eemcs.utwente.nl/user/s1934538/clickstream/clickstream-enwiki-2022-11.tsv.gz,Venom_(2018_film),13057,62251,668,75976,29793
hdfs://spark-nn.eemcs.utwente.nl/user/s1934538/clickstream/clickstream-enwiki-2022-11.tsv.gz,ICC_Men's_T20_World_Cup,94970,6040418,7099,6142487,836161
hdfs://spark-nn.eemcs.utwente.nl/user/s1934538/clickstream/clickstream-enwiki-2022-11.tsv.gz,Glass_(2019_film),36647,42688,279,79614,26171
hdfs://spark-nn.eemcs.utwente.nl/user/s1934538/clickstream/clickstream-enwiki-2022-11.tsv.gz,Loki_(TV_series),31430,58542,1351,91323,54740
hdfs://spark-nn.eemcs.utwente.nl/user/s1934538/clickstream/clickstream-enwiki-2022-11.tsv.gz,The_Suicide_Squad_(film),65864,68651,818,135333,74237
hdfs://spark-nn.eemcs.utwente.nl/user/s1934538/clickstream/clickstream-enwiki-2022-11.tsv.gz,Cleopatra,65253,4934939,2850,5003042,477773
hdfs://spark-nn.eemcs.utwente.nl/user/s1934538/clickstream/clickstream-enwiki-2022-11.tsv.gz,COVID-19_pandemic,89907,229619,6303,325829,103468
hdfs://spark-nn.eemcs.utwente.nl/user/s1934538/clickstream/clickstream-enwiki-2022-11.tsv.gz,When_They_See_Us,8853,19727,133,28713,12718
hdfs://spark-nn.eemcs.utwente.nl/user/s1934538/clickstream/clickstream-enwiki-2022-11.tsv.gz,Alexander_Hamilton,60970,165477,1375,227822,118112
hdfs://spark-nn.eemcs.utwente.nl/user/s1934538/clickstream/clickstream-enwiki-2022-11.tsv.gz,Elizabeth_II,781172,1229640,9695,2020507,1545432
hdfs://spark-nn.eemcs.utwente.nl/user/s1934538/clickstream/clickstream-enwiki-2022-11.tsv.gz,Joaquin_Phoenix,99766,138888,671,239325,139193
hdfs://spark-nn.eemcs.utwente.nl/user/s1934538/clickstream/clickstream-enwiki-2022-11.tsv.gz,William_Murdoch,567,1271,20,1858,339
hdfs://spark-nn.eemcs.utwente.nl/user/s1934538/clickstream/clickstream-enwiki-2022-11.tsv.gz,"Meghan,_Duchess_of_Sussex",89012,221741,2620,313373,150127
hdfs://spark-nn.eemcs.utwente.nl/user/s1934538/clickstream/clickstream-enwiki-2022-11.tsv.gz,List_of_highest-grossing_films,133758,360410,4702,498870,246970
hdfs://spark-nn.eemcs.utwente.nl/user/s1934538/clickstream/clickstream-enwiki-2022-11.tsv.gz,Stranger_Things_(season_4),34812,128387,1898,165097,92450
hdfs://spark-nn.eemcs.utwente.nl/user/s1934538/clickstream/clickstream-enwiki-2022-11.tsv.gz,Zack_Snyder's_Justice_League,54281,84250,760,139291,57439
hdfs://spark-nn.eemcs.utwente.nl/user/s1934538/clickstream/clickstream-enwiki-2022-11.tsv.gz,Donald_Glover,45118,132247,914,178279,78045
hdfs://spark-nn.eemcs.utwente.nl/user/s1934538/clickstream/clickstream-enwiki-2022-11.tsv.gz,Ruth_Bader_Ginsburg,18553,62637,492,81682,26020
hdfs://spark-nn.eemcs.utwente.nl/user/s1934538/clickstream/clickstream-enwiki-2022-11.tsv.gz,Spider-Man:_Far_From_Home,38881,50842,327,90050,31249
hdfs://spark-nn.eemcs.utwente.nl/user/s1934538/clickstream/clickstream-enwiki-2022-11.tsv.gz,Fyre_Festival,14684,87964,631,103279,58074
hdfs://spark-nn.eemcs.utwente.nl/user/s1934538/clickstream/clickstream-enwiki-2022-11.tsv.gz,Pathaan_(film),89507,275759,2938,368204,183762
hdfs://spark-nn.eemcs.utwente.nl/user/s1934538/clickstream/clickstream-enwiki-2022-11.tsv.gz,Freddie_Mercury,69982,436354,4056,510392,188274
hdfs://spark-nn.eemcs.utwente.nl/user/s1934538/clickstream/clickstream-enwiki-2022-11.tsv.gz,Donald_Trump,304520,924373,11950,1240843,662038
hdfs://spark-nn.eemcs.utwente.nl/user/s1934538/clickstream/clickstream-enwiki-2022-11.tsv.gz,Michael_Jordan,68163,405705,3862,477730,136788
hdfs://spark-nn.eemcs.utwente.nl/user/s1934538/clickstream/clickstream-enwiki-2022-11.tsv.gz,Bonnie_and_Clyde,17598,179379,1050,198027,47977
hdfs://spark-nn.eemcs.utwente.nl/user/s1934538/clickstream/clickstream-enwiki-2022-11.tsv.gz,Area_51,16946,113209,1018,131173,43978
hdfs://spark-nn.eemcs.utwente.nl/user/s1934538/clickstream/clickstream-enwiki-2022-11.tsv.gz,Joker_(2019_film),59550,139244,1509,200303,83411
hdfs://spark-nn.eemcs.utwente.nl/user/s1934538/clickstream/clickstream-enwiki-2022-11.tsv.gz,QAnon,47931,163606,1170,212707,67092
hdfs://spark-nn.eemcs.utwente.nl/user/s1934538/clickstream/clickstream-enwiki-2022-11.tsv.gz,Avengers:_Infinity_War,51146,76470,860,128476,59298
hdfs://spark-nn.eemcs.utwente.nl/user/s1934538/clickstream/clickstream-enwiki-2022-11.tsv.gz,Mac_Miller,21671,147688,1331,170690,48224
hdfs://spark-nn.eemcs.utwente.nl/user/s1934538/clickstream/clickstream-enwiki-2022-11.tsv.gz,Star_Wars:_The_Rise_of_Skywalker,57969,41834,1091,100894,50812
hdfs://spark-nn.eemcs.utwente.nl/user/s1934538/clickstream/clickstream-enwiki-2022-11.tsv.gz,Antifa_(United_States),9103,61898,201,71202,12570
hdfs://spark-nn.eemcs.utwente.nl/user/s1934538/clickstream/clickstream-enwiki-2022-11.tsv.gz,Brie_Larson,49948,90648,649,141245,53404
hdfs://spark-nn.eemcs.utwente.nl/user/s1934538/clickstream/clickstream-enwiki-2022-11.tsv.gz,Elliot_Page,50427,254017,1924,306368,116712
hdfs://spark-nn.eemcs.utwente.nl/user/s1934538/clickstream/clickstream-enwiki-2022-11.tsv.gz,Game_of_Thrones_(season_8),20680,48413,627,69720,27702
hdfs://spark-nn.eemcs.utwente.nl/user/s1934538/clickstream/clickstream-enwiki-2022-11.tsv.gz,The_Sandman_(TV_series),45416,179037,3251,227704,148655
hdfs://spark-nn.eemcs.utwente.nl/user/s1934538/clickstream/clickstream-enwiki-2022-11.tsv.gz,Spanish_flu,35989,61047,560,97596,30379
hdfs://spark-nn.eemcs.utwente.nl/user/s1934538/clickstream/clickstream-enwiki-2022-11.tsv.gz,"Princess_Margaret,_Countess_of_Snowdon",332813,1240148,10774,1583735,807806
hdfs://spark-nn.eemcs.utwente.nl/user/s1934538/clickstream/clickstream-enwiki-2022-11.tsv.gz,Kobe_Bryant,61825,333850,2361,398036,111100
hdfs://spark-nn.eemcs.utwente.nl/user/s1934538/clickstream/clickstream-enwiki-2022-11.tsv.gz,Stephen_Hawking,30214,368627,2043,400884,135766
hdfs://spark-nn.eemcs.utwente.nl/user/s1934538/clickstream/clickstream-enwiki-2022-11.tsv.gz,2018_FIFA_World_Cup,1340835,1658538,10259,3009632,1223269
hdfs://spark-nn.eemcs.utwente.nl/user/s1934538/clickstream/clickstream-enwiki-2022-11.tsv.gz,Bird_Box_(film),12164,67086,557,79807,27744
hdfs://spark-nn.eemcs.utwente.nl/user/s1934538/clickstream/clickstream-enwiki-2022-11.tsv.gz,Afghanistan,113235,204488,4383,322106,220358
hdfs://spark-nn.eemcs.utwente.nl/user/s1934538/clickstream/clickstream-enwiki-2022-11.tsv.gz,Jawan_(film),86516,61796,2095,150407,89415
hdfs://spark-nn.eemcs.utwente.nl/user/s1934538/clickstream/clickstream-enwiki-2022-11.tsv.gz,September_11_attacks,93048,240812,4430,338290,186055
hdfs://spark-nn.eemcs.utwente.nl/user/s1934538/clickstream/clickstream-enwiki-2022-11.tsv.gz,RRR_(film),55405,353619,2492,411516,177854
hdfs://spark-nn.eemcs.utwente.nl/user/s1934538/clickstream/clickstream-enwiki-2022-11.tsv.gz,Charles_Sobhraj,9141,42682,83,51906,9093
hdfs://spark-nn.eemcs.utwente.nl/user/s1934538/clickstream/clickstream-enwiki-2022-11.tsv.gz,WandaVision,66875,64168,1262,132305,51730
hdfs://spark-nn.eemcs.utwente.nl/user/s1934538/clickstream/clickstream-enwiki-2022-11.tsv.gz,2023_Cricket_World_Cup,107270,1349574,689,1457533,298619
hdfs://spark-nn.eemcs.utwente.nl/user/s1934538/clickstream/clickstream-enwiki-2022-11.tsv.gz,Media,47,2190,234,2471,1232
hdfs://spark-nn.eemcs.utwente.nl/user/s1934538/clickstream/clickstream-enwiki-2022-11.tsv.gz,Sidharth_Shukla,9584,50705,258,60547,11510
hdfs://spark-nn.eemcs.utwente.nl/user/s1934538/clickstream/clickstream-enwiki-2022-11.tsv.gz,Lance_Reddick,30928,27240,115,58283,10812
hdfs://spark-nn.eemcs.utwente.nl/user/s1934538/clickstream/clickstream-enwiki-2022-11.tsv.gz,Johnny_Depp,98375,299685,2423,400483,199448
hdfs://spark-nn.eemcs.utwente.nl/user/s1934538/clickstream/clickstream-enwiki-2022-11.tsv.gz,Deion_Sanders,19992,283434,1808,305234,96787
hdfs://spark-nn.eemcs.utwente.nl/user/s1934538/clickstream/clickstream-enwiki-2022-11.tsv.gz,Shakira,63396,438865,4650,506911,212041
hdfs://spark-nn.eemcs.utwente.nl/user/s1934538/clickstream/clickstream-enwiki-2022-11.tsv.gz,Kim_Jong-un,80590,234078,2112,316780,183658
hdfs://spark-nn.eemcs.utwente.nl/user/s1934538/clickstream/clickstream-enwiki-2022-11.tsv.gz,Rishi_Sunak,293902,971590,6182,1271674,577962
hdfs://spark-nn.eemcs.utwente.nl/user/s1934538/clickstream/clickstream-enwiki-2022-11.tsv.gz,John_Wick:_Chapter_4,86402,186808,3655,276865,208757
hdfs://spark-nn.eemcs.utwente.nl/user/s1934538/clickstream/clickstream-enwiki-2022-11.tsv.gz,Once_Upon_a_Time_in_Hollywood,91250,144428,2362,238040,232780
hdfs://spark-nn.eemcs.utwente.nl/user/s1934538/clickstream/clickstream-enwiki-2022-11.tsv.gz,Brahmāstra:_Part_One_–_Shiva,92727,1066124,3325,1162176,356153
hdfs://spark-nn.eemcs.utwente.nl/user/s1934538/clickstream/clickstream-enwiki-2022-11.tsv.gz,Bipin_Rawat,8552,25088,15,33655,11993
hdfs://spark-nn.eemcs.utwente.nl/user/s1934538/clickstream/clickstream-enwiki-2022-11.tsv.gz,Jenna_Ortega,475919,2575154,9422,3060495,851193
hdfs://spark-nn.eemcs.utwente.nl/user/s1934538/clickstream/clickstream-enwiki-2022-11.tsv.gz,FIFA_World_Cup,554869,6626347,52284,7233500,5923672
hdfs://spark-nn.eemcs.utwente.nl/user/s1934538/clickstream/clickstream-enwiki-2022-11.tsv.gz,"Prince_Philip,_Duke_of_Edinburgh",312445,425138,5773,743356,462512
hdfs://spark-nn.eemcs.utwente.nl/user/s1934538/clickstream/clickstream-enwiki-2022-11.tsv.gz,Kenosha_unrest_shooting,15995,51611,97,67703,13971
hdfs://spark-nn.eemcs.utwente.nl/user/s1934538/clickstream/clickstream-enwiki-2022-11.tsv.gz,The_Lion_King_(2019_film),50010,48179,551,98740,39649
hdfs://spark-nn.eemcs.utwente.nl/user/s1934538/clickstream/clickstream-enwiki-2022-11.tsv.gz,Asia_Cup,10023,115228,306,125557,48431
hdfs://spark-nn.eemcs.utwente.nl/user/s1934538/clickstream/clickstream-enwiki-2022-12.tsv.gz,Stan_Lee,36487,194402,1698,232587,63074
hdfs://spark-nn.eemcs.utwente.nl/user/s1934538/clickstream/clickstream-enwiki-2022-12.tsv.gz,"Princess_Margaret,_Countess_of_Snowdon",150316,554699,3595,708610,378911
hdfs://spark-nn.eemcs.utwente.nl/user/s1934538/clickstream/clickstream-enwiki-2022-12.tsv.gz,Betty_White,40876,185447,2166,228489,56211
hdfs://spark-nn.eemcs.utwente.nl/user/s1934538/clickstream/clickstream-enwiki-2022-12.tsv.gz,Bipin_Rawat,8826,32772,95,41693,14559
hdfs://spark-nn.eemcs.utwente.nl/user/s1934538/clickstream/clickstream-enwiki-2022-12.tsv.gz,Joe_Exotic,14167,58367,541,73075,33896
hdfs://spark-nn.eemcs.utwente.nl/user/s1934538/clickstream/clickstream-enwiki-2022-12.tsv.gz,Tunnel,4246,7906,102,12254,3258
hdfs://spark-nn.eemcs.utwente.nl/user/s1934538/clickstream/clickstream-enwiki-2022-12.tsv.gz,Vladimir_Putin,124310,322807,5745,452862,268622
hdfs://spark-nn.eemcs.utwente.nl/user/s1934538/clickstream/clickstream-enwiki-2022-12.tsv.gz,Luke_Perry,30475,81261,400,112136,43430
hdfs://spark-nn.eemcs.utwente.nl/user/s1934538/clickstream/clickstream-enwiki-2022-12.tsv.gz,Charles_Sobhraj,38773,971262,3169,1013204,192081
hdfs://spark-nn.eemcs.utwente.nl/user/s1934538/clickstream/clickstream-enwiki-2022-12.tsv.gz,Jurassic_World_Dominion,112119,140241,2932,255292,157546
hdfs://spark-nn.eemcs.utwente.nl/user/s1934538/clickstream/clickstream-enwiki-2022-12.tsv.gz,Fyre_Festival,10852,52223,356,63431,37018
hdfs://spark-nn.eemcs.utwente.nl/user/s1934538/clickstream/clickstream-enwiki-2022-12.tsv.gz,When_They_See_Us,9293,27306,894,37493,13651
hdfs://spark-nn.eemcs.utwente.nl/user/s1934538/clickstream/clickstream-enwiki-2022-12.tsv.gz,The_Matrix_Resurrections,67987,70348,1287,139622,67271
hdfs://spark-nn.eemcs.utwente.nl/user/s1934538/clickstream/clickstream-enwiki-2022-12.tsv.gz,Ghislaine_Maxwell,80108,257446,1075,338629,148242
hdfs://spark-nn.eemcs.utwente.nl/user/s1934538/clickstream/clickstream-enwiki-2022-12.tsv.gz,Captain_Marvel_(film),28726,57450,812,86988,41119
hdfs://spark-nn.eemcs.utwente.nl/user/s1934538/clickstream/clickstream-enwiki-2022-12.tsv.gz,Brett_Kavanaugh,15016,21964,214,37194,13340
hdfs://spark-nn.eemcs.utwente.nl/user/s1934538/clickstream/clickstream-enwiki-2022-12.tsv.gz,Donald_Trump,181796,382316,5528,569640,332916
hdfs://spark-nn.eemcs.utwente.nl/user/s1934538/clickstream/clickstream-enwiki-2022-12.tsv.gz,Salman_Rushdie,22742,70296,551,93589,42385
hdfs://spark-nn.eemcs.utwente.nl/user/s1934538/clickstream/clickstream-enwiki-2022-12.tsv.gz,Russo-Ukrainian_War,122328,514476,5213,642017,379502
hdfs://spark-nn.eemcs.utwente.nl/user/s1934538/clickstream/clickstream-enwiki-2022-12.tsv.gz,Elizabeth_II,532698,880496,7481,1420675,1014688
hdfs://spark-nn.eemcs.utwente.nl/user/s1934538/clickstream/clickstream-enwiki-2022-12.tsv.gz,Watts_family_murders,7674,202851,303,210828,50712
hdfs://spark-nn.eemcs.utwente.nl/user/s1934538/clickstream/clickstream-enwiki-2022-12.tsv.gz,Cardi_B,41654,177057,2205,220916,71252
hdfs://spark-nn.eemcs.utwente.nl/user/s1934538/clickstream/clickstream-enwiki-2022-12.tsv.gz,2020_Summer_Olympics,68901,51703,1279,121883,102843
hdfs://spark-nn.eemcs.utwente.nl/user/s1934538/clickstream/clickstream-enwiki-2022-12.tsv.gz,Alexander_Hamilton,63377,181704,2524,247605,131119
hdfs://spark-nn.eemcs.utwente.nl/user/s1934538/clickstream/clickstream-enwiki-2022-12.tsv.gz,The_Queen's_Gambit_(miniseries),27697,93425,847,121969,63181
hdfs://spark-nn.eemcs.utwente.nl/user/s1934538/clickstream/clickstream-enwiki-2022-12.tsv.gz,Stranger_Things_(season_4),32094,104087,1718,137899,82932
hdfs://spark-nn.eemcs.utwente.nl/user/s1934538/clickstream/clickstream-enwiki-2022-12.tsv.gz,Richard_Ramirez,15731,181971,1325,199027,55265
hdfs://spark-nn.eemcs.utwente.nl/user/s1934538/clickstream/clickstream-enwiki-2022-12.tsv.gz,Barbie_(film),118219,175843,5122,299184,271013
hdfs://spark-nn.eemcs.utwente.nl/user/s1934538/clickstream/clickstream-enwiki-2022-12.tsv.gz,Critical_race_theory,10368,87855,496,98719,11527
hdfs://spark-nn.eemcs.utwente.nl/user/s1934538/clickstream/clickstream-enwiki-2022-12.tsv.gz,Amber_Heard,74124,206858,1772,282754,120513
hdfs://spark-nn.eemcs.utwente.nl/user/s1934538/clickstream/clickstream-enwiki-2022-12.tsv.gz,Godzilla_vs._Kong,37846,58086,943,96875,55796
hdfs://spark-nn.eemcs.utwente.nl/user/s1934538/clickstream/clickstream-enwiki-2022-12.tsv.gz,WandaVision,63422,52407,1131,116960,44720
hdfs://spark-nn.eemcs.utwente.nl/user/s1934538/clickstream/clickstream-enwiki-2022-12.tsv.gz,The_Kashmir_Files,24065,58269,431,82765,35483
hdfs://spark-nn.eemcs.utwente.nl/user/s1934538/clickstream/clickstream-enwiki-2022-12.tsv.gz,Cook's_Country,413,1603,33,2049,609
hdfs://spark-nn.eemcs.utwente.nl/user/s1934538/clickstream/clickstream-enwiki-2022-12.tsv.gz,Ray_Liotta,104587,383596,4530,492713,113232
hdfs://spark-nn.eemcs.utwente.nl/user/s1934538/clickstream/clickstream-enwiki-2022-12.tsv.gz,Nipsey_Hussle,22055,78261,606,100922,32835
hdfs://spark-nn.eemcs.utwente.nl/user/s1934538/clickstream/clickstream-enwiki-2022-12.tsv.gz,Doctor_Strange_in_the_Multiverse_of_Madness,106581,139482,2846,248909,131260
hdfs://spark-nn.eemcs.utwente.nl/user/s1934538/clickstream/clickstream-enwiki-2022-12.tsv.gz,Game_of_Thrones_(season_8),15481,34551,475,50507,20670
hdfs://spark-nn.eemcs.utwente.nl/user/s1934538/clickstream/clickstream-enwiki-2022-12.tsv.gz,Oppenheimer_(film),191610,651844,12008,855462,912092
hdfs://spark-nn.eemcs.utwente.nl/user/s1934538/clickstream/clickstream-enwiki-2022-12.tsv.gz,RRR_(film),75467,421045,5092,501604,275718
hdfs://spark-nn.eemcs.utwente.nl/user/s1934538/clickstream/clickstream-enwiki-2022-12.tsv.gz,Microsoft_Office,5953,209482,532,215967,16569
hdfs://spark-nn.eemcs.utwente.nl/user/s1934538/clickstream/clickstream-enwiki-2022-12.tsv.gz,Stephen_Hawking,25147,306315,2662,334124,134571
hdfs://spark-nn.eemcs.utwente.nl/user/s1934538/clickstream/clickstream-enwiki-2022-12.tsv.gz,Deaths_in_2023,2580,11960,153,14693,987
hdfs://spark-nn.eemcs.utwente.nl/user/s1934538/clickstream/clickstream-enwiki-2022-12.tsv.gz,Black_Panther_(film),66672,268580,2098,337350,172348
hdfs://spark-nn.eemcs.utwente.nl/user/s1934538/clickstream/clickstream-enwiki-2022-12.tsv.gz,Rishi_Sunak,149369,313442,2387,465198,213922
hdfs://spark-nn.eemcs.utwente.nl/user/s1934538/clickstream/clickstream-enwiki-2022-12.tsv.gz,Saaho,16567,25374,33,41974,13878
hdfs://spark-nn.eemcs.utwente.nl/user/s1934538/clickstream/clickstream-enwiki-2022-12.tsv.gz,Lists_of_deaths_by_year,32261,2956611,1315846,4304718,112247
hdfs://spark-nn.eemcs.utwente.nl/user/s1934538/clickstream/clickstream-enwiki-2022-12.tsv.gz,Elliot_Page,55177,214510,1200,270887,117951
hdfs://spark-nn.eemcs.utwente.nl/user/s1934538/clickstream/clickstream-enwiki-2022-12.tsv.gz,2020_United_States_presidential_election,129825,151678,3943,285446,308107
hdfs://spark-nn.eemcs.utwente.nl/user/s1934538/clickstream/clickstream-enwiki-2022-12.tsv.gz,QAnon,41758,235498,1446,278702,78872
hdfs://spark-nn.eemcs.utwente.nl/user/s1934538/clickstream/clickstream-enwiki-2022-12.tsv.gz,List_of_James_Bond_films,74347,416096,1555,491998,297625
hdfs://spark-nn.eemcs.utwente.nl/user/s1934538/clickstream/clickstream-enwiki-2022-12.tsv.gz,COVID-19_pandemic,95763,223539,7162,326464,106749
hdfs://spark-nn.eemcs.utwente.nl/user/s1934538/clickstream/clickstream-enwiki-2022-12.tsv.gz,Johnny_Depp,109268,316708,2359,428335,230146
hdfs://spark-nn.eemcs.utwente.nl/user/s1934538/clickstream/clickstream-enwiki-2022-12.tsv.gz,Atal_Bihari_Vajpayee,29692,97704,128,127524,35922
hdfs://spark-nn.eemcs.utwente.nl/user/s1934538/clickstream/clickstream-enwiki-2022-12.tsv.gz,2018_Winter_Olympics,15844,9799,66,25709,18341
hdfs://spark-nn.eemcs.utwente.nl/user/s1934538/clickstream/clickstream-enwiki-2022-12.tsv.gz,Valentine's_Day,4129,56966,248,61343,5461
hdfs://spark-nn.eemcs.utwente.nl/user/s1934538/clickstream/clickstream-enwiki-2022-12.tsv.gz,Freddie_Mercury,72812,443432,3280,519524,199394
hdfs://spark-nn.eemcs.utwente.nl/user/s1934538/clickstream/clickstream-enwiki-2022-12.tsv.gz,Michael_Bloomberg,29810,29743,203,59756,28320
hdfs://spark-nn.eemcs.utwente.nl/user/s1934538/clickstream/clickstream-enwiki-2022-12.tsv.gz,Hamilton_(musical),26209,162569,1593,190371,112675
hdfs://spark-nn.eemcs.utwente.nl/user/s1934538/clickstream/clickstream-enwiki-2022-12.tsv.gz,2023_Indian_Premier_League,29394,101586,139,131119,76767
hdfs://spark-nn.eemcs.utwente.nl/user/s1934538/clickstream/clickstream-enwiki-2022-12.tsv.gz,Shakira,37369,360092,2958,400419,193489
hdfs://spark-nn.eemcs.utwente.nl/user/s1934538/clickstream/clickstream-enwiki-2022-12.tsv.gz,21_Savage,19010,108009,927,127946,47849
hdfs://spark-nn.eemcs.utwente.nl/user/s1934538/clickstream/clickstream-enwiki-2022-12.tsv.gz,Kantara_(film),58107,1001199,4435,1063741,422692
hdfs://spark-nn.eemcs.utwente.nl/user/s1934538/clickstream/clickstream-enwiki-2022-12.tsv.gz,Eternals_(film),62135,102926,1922,166983,134300
hdfs://spark-nn.eemcs.utwente.nl/user/s1934538/clickstream/clickstream-enwiki-2022-12.tsv.gz,Chernobyl_(miniseries),20597,53373,1126,75096,77963
hdfs://spark-nn.eemcs.utwente.nl/user/s1934538/clickstream/clickstream-enwiki-2022-12.tsv.gz,Spider-Man:_Across_the_Spider-Verse,104387,177761,4614,286762,226646
hdfs://spark-nn.eemcs.utwente.nl/user/s1934538/clickstream/clickstream-enwiki-2022-12.tsv.gz,Burt_Reynolds,59664,149465,1188,210317,101176
hdfs://spark-nn.eemcs.utwente.nl/user/s1934538/clickstream/clickstream-enwiki-2022-12.tsv.gz,Ukraine,104151,341639,10824,456614,241074
hdfs://spark-nn.eemcs.utwente.nl/user/s1934538/clickstream/clickstream-enwiki-2022-12.tsv.gz,Queen_(band),52063,165357,2470,219890,215034
hdfs://spark-nn.eemcs.utwente.nl/user/s1934538/clickstream/clickstream-enwiki-2022-12.tsv.gz,The_Haunting_of_Bly_Manor,17839,37171,235,55245,28001
hdfs://spark-nn.eemcs.utwente.nl/user/s1934538/clickstream/clickstream-enwiki-2022-12.tsv.gz,Joker_(2019_film),51979,127506,5672,185157,104146
hdfs://spark-nn.eemcs.utwente.nl/user/s1934538/clickstream/clickstream-enwiki-2022-12.tsv.gz,Amy_Coney_Barrett,18229,24087,158,42474,13895
hdfs://spark-nn.eemcs.utwente.nl/user/s1934538/clickstream/clickstream-enwiki-2022-12.tsv.gz,The_Mandalorian,52033,119784,2655,174472,122539
hdfs://spark-nn.eemcs.utwente.nl/user/s1934538/clickstream/clickstream-enwiki-2022-12.tsv.gz,Aretha_Franklin,27636,132377,974,160987,73562
hdfs://spark-nn.eemcs.utwente.nl/user/s1934538/clickstream/clickstream-enwiki-2022-12.tsv.gz,JSON_Web_Token,700,21411,34,22145,1684
hdfs://spark-nn.eemcs.utwente.nl/user/s1934538/clickstream/clickstream-enwiki-2022-12.tsv.gz,Fantastic_Beasts:_The_Crimes_of_Grindelwald,47409,49432,658,97499,54404
hdfs://spark-nn.eemcs.utwente.nl/user/s1934538/clickstream/clickstream-enwiki-2022-12.tsv.gz,Dennis_Nilsen,8388,48862,260,57510,13874
hdfs://spark-nn.eemcs.utwente.nl/user/s1934538/clickstream/clickstream-enwiki-2022-12.tsv.gz,Avengers:_Endgame,233418,166743,2265,402426,160439
hdfs://spark-nn.eemcs.utwente.nl/user/s1934538/clickstream/clickstream-enwiki-2022-12.tsv.gz,2016_United_States_presidential_election,97305,60663,1098,159066,151713
hdfs://spark-nn.eemcs.utwente.nl/user/s1934538/clickstream/clickstream-enwiki-2022-12.tsv.gz,Lionel_Messi,1138629,10324796,93346,11556771,3648488
hdfs://spark-nn.eemcs.utwente.nl/user/s1934538/clickstream/clickstream-enwiki-2022-12.tsv.gz,Brahmāstra:_Part_One_–_Shiva,63948,230262,1147,295357,87365
hdfs://spark-nn.eemcs.utwente.nl/user/s1934538/clickstream/clickstream-enwiki-2022-12.tsv.gz,Eddie_Van_Halen,38379,68868,573,107820,44427
hdfs://spark-nn.eemcs.utwente.nl/user/s1934538/clickstream/clickstream-enwiki-2022-12.tsv.gz,Vikram_(2022_film),42999,132850,1142,176991,82962
hdfs://spark-nn.eemcs.utwente.nl/user/s1934538/clickstream/clickstream-enwiki-2022-12.tsv.gz,Manti_Te'o,5620,75350,210,81180,9989
hdfs://spark-nn.eemcs.utwente.nl/user/s1934538/clickstream/clickstream-enwiki-2022-12.tsv.gz,Central_Park_jogger_case,9462,49751,286,59499,8192
hdfs://spark-nn.eemcs.utwente.nl/user/s1934538/clickstream/clickstream-enwiki-2022-12.tsv.gz,Cricket_World_Cup,20958,128927,754,150639,103291
hdfs://spark-nn.eemcs.utwente.nl/user/s1934538/clickstream/clickstream-enwiki-2022-12.tsv.gz,Cristiano_Ronaldo,668985,5565452,27195,6261632,1615095
hdfs://spark-nn.eemcs.utwente.nl/user/s1934538/clickstream/clickstream-enwiki-2022-12.tsv.gz,The_Nun_(2018_film),16050,39158,253,55461,31517
hdfs://spark-nn.eemcs.utwente.nl/user/s1934538/clickstream/clickstream-enwiki-2022-12.tsv.gz,Aquaman_(film),29552,68654,1488,99694,55299
hdfs://spark-nn.eemcs.utwente.nl/user/s1934538/clickstream/clickstream-enwiki-2022-12.tsv.gz,Ted_Bundy,31379,296792,7926,336097,80556
hdfs://spark-nn.eemcs.utwente.nl/user/s1934538/clickstream/clickstream-enwiki-2022-12.tsv.gz,1234,66,1643,29,1738,229
hdfs://spark-nn.eemcs.utwente.nl/user/s1934538/clickstream/clickstream-enwiki-2022-12.tsv.gz,Spanish_flu,21250,58363,523,80136,23068
hdfs://spark-nn.eemcs.utwente.nl/user/s1934538/clickstream/clickstream-enwiki-2022-12.tsv.gz,The_Suicide_Squad_(film),94628,85795,1065,181488,102321
hdfs://spark-nn.eemcs.utwente.nl/user/s1934538/clickstream/clickstream-enwiki-2022-12.tsv.gz,Lance_Reddick,28571,32017,217,60805,13569
hdfs://spark-nn.eemcs.utwente.nl/user/s1934538/clickstream/clickstream-enwiki-2022-12.tsv.gz,Cleopatra,56471,4719278,1937,4777686,391479
hdfs://spark-nn.eemcs.utwente.nl/user/s1934538/clickstream/clickstream-enwiki-2022-12.tsv.gz,Squid_Game,22765,139694,2606,165065,79698
hdfs://spark-nn.eemcs.utwente.nl/user/s1934538/clickstream/clickstream-enwiki-2022-12.tsv.gz,Charles_III,695912,488882,5781,1190575,835277
hdfs://spark-nn.eemcs.utwente.nl/user/s1934538/clickstream/clickstream-enwiki-2022-12.tsv.gz,The_Lion_King_(2019_film),67406,54116,522,122044,48208
hdfs://spark-nn.eemcs.utwente.nl/user/s1934538/clickstream/clickstream-enwiki-2022-12.tsv.gz,Juneteenth,8024,41076,10956,60056,9999
hdfs://spark-nn.eemcs.utwente.nl/user/s1934538/clickstream/clickstream-enwiki-2022-12.tsv.gz,Bird_Box_(film),13213,61037,556,74806,28453
hdfs://spark-nn.eemcs.utwente.nl/user/s1934538/clickstream/clickstream-enwiki-2022-12.tsv.gz,Bob_Saget,28665,133960,1525,164150,31948
hdfs://spark-nn.eemcs.utwente.nl/user/s1934538/clickstream/clickstream-enwiki-2022-12.tsv.gz,Vivek_Ramaswamy,431,24289,80,24800,4153
hdfs://spark-nn.eemcs.utwente.nl/user/s1934538/clickstream/clickstream-enwiki-2022-12.tsv.gz,2022_Russian_invasion_of_Ukraine,626682,686438,3592,1316712,689149
hdfs://spark-nn.eemcs.utwente.nl/user/s1934538/clickstream/clickstream-enwiki-2022-12.tsv.gz,Once_Upon_a_Time_in_Hollywood,108662,144350,2761,255773,282016
hdfs://spark-nn.eemcs.utwente.nl/user/s1934538/clickstream/clickstream-enwiki-2022-12.tsv.gz,Donald_Glover,42484,139307,964,182755,76091
hdfs://spark-nn.eemcs.utwente.nl/user/s1934538/clickstream/clickstream-enwiki-2022-12.tsv.gz,A_Star_Is_Born_(2018_film),25651,108793,735,135179,69693
hdfs://spark-nn.eemcs.utwente.nl/user/s1934538/clickstream/clickstream-enwiki-2022-12.tsv.gz,Royal_Rumble_(2018),8795,4685,53,13533,10882
hdfs://spark-nn.eemcs.utwente.nl/user/s1934538/clickstream/clickstream-enwiki-2022-12.tsv.gz,Black_Adam_(film),201359,1172611,43372,1417342,806627
hdfs://spark-nn.eemcs.utwente.nl/user/s1934538/clickstream/clickstream-enwiki-2022-12.tsv.gz,Michael_Jordan,75046,444151,4456,523653,159605
hdfs://spark-nn.eemcs.utwente.nl/user/s1934538/clickstream/clickstream-enwiki-2022-12.tsv.gz,Jeffrey_Dahmer,46676,1043283,9229,1099188,435002
hdfs://spark-nn.eemcs.utwente.nl/user/s1934538/clickstream/clickstream-enwiki-2022-12.tsv.gz,Indian_Premier_League,23100,115239,580,138919,99287
hdfs://spark-nn.eemcs.utwente.nl/user/s1934538/clickstream/clickstream-enwiki-2022-12.tsv.gz,Rami_Malek,71954,168372,894,241220,99933
hdfs://spark-nn.eemcs.utwente.nl/user/s1934538/clickstream/clickstream-enwiki-2022-12.tsv.gz,Spider-Man:_Far_From_Home,44368,55047,456,99871,41292
hdfs://spark-nn.eemcs.utwente.nl/user/s1934538/clickstream/clickstream-enwiki-2022-12.tsv.gz,Anthony_Bourdain,21378,205298,1520,228196,93962
hdfs://spark-nn.eemcs.utwente.nl/user/s1934538/clickstream/clickstream-enwiki-2022-12.tsv.gz,Adele,26992,172035,1951,200978,80500
hdfs://spark-nn.eemcs.utwente.nl/user/s1934538/clickstream/clickstream-enwiki-2022-12.tsv.gz,FIFA_World_Cup,941178,8134717,53158,9129053,8029649
hdfs://spark-nn.eemcs.utwente.nl/user/s1934538/clickstream/clickstream-enwiki-2022-12.tsv.gz,The_Umbrella_Academy_(TV_series),23351,97284,1723,122358,78222
hdfs://spark-nn.eemcs.utwente.nl/user/s1934538/clickstream/clickstream-enwiki-2022-12.tsv.gz,Parasite_(2019_film),30629,134568,1472,166669,69432
hdfs://spark-nn.eemcs.utwente.nl/user/s1934538/clickstream/clickstream-enwiki-2022-12.tsv.gz,Asia_Cup,5328,35929,241,41498,16788
hdfs://spark-nn.eemcs.utwente.nl/user/s1934538/clickstream/clickstream-enwiki-2022-12.tsv.gz,It_Chapter_Two,23403,32466,332,56201,35391
hdfs://spark-nn.eemcs.utwente.nl/user/s1934538/clickstream/clickstream-enwiki-2022-12.tsv.gz,Tina_Turner,31446,688235,6399,726080,189707
hdfs://spark-nn.eemcs.utwente.nl/user/s1934538/clickstream/clickstream-enwiki-2022-12.tsv.gz,2023_Cricket_World_Cup,45447,353631,268,399346,103300
hdfs://spark-nn.eemcs.utwente.nl/user/s1934538/clickstream/clickstream-enwiki-2022-12.tsv.gz,Loki_(TV_series),29273,48346,1087,78706,52118
hdfs://spark-nn.eemcs.utwente.nl/user/s1934538/clickstream/clickstream-enwiki-2022-12.tsv.gz,"Prince_Philip,_Duke_of_Edinburgh",217465,268696,2453,488614,302194
hdfs://spark-nn.eemcs.utwente.nl/user/s1934538/clickstream/clickstream-enwiki-2022-12.tsv.gz,Dune_(2021_film),65612,198343,4508,268463,190134
hdfs://spark-nn.eemcs.utwente.nl/user/s1934538/clickstream/clickstream-enwiki-2022-12.tsv.gz,Wikipedia,235737,1453983,1101,1690821,772099
hdfs://spark-nn.eemcs.utwente.nl/user/s1934538/clickstream/clickstream-enwiki-2022-12.tsv.gz,List_of_Queen_of_the_South_episodes,3526,2996,70,6592,119
hdfs://spark-nn.eemcs.utwente.nl/user/s1934538/clickstream/clickstream-enwiki-2022-12.tsv.gz,Chernobyl_disaster,38733,260456,2381,301570,125484
hdfs://spark-nn.eemcs.utwente.nl/user/s1934538/clickstream/clickstream-enwiki-2022-12.tsv.gz,Sinéad_O'Connor,22154,125670,1007,148831,42154
hdfs://spark-nn.eemcs.utwente.nl/user/s1934538/clickstream/clickstream-enwiki-2022-12.tsv.gz,Kate_Spade,25494,82959,398,108851,41128
hdfs://spark-nn.eemcs.utwente.nl/user/s1934538/clickstream/clickstream-enwiki-2022-12.tsv.gz,Sidharth_Shukla,11862,66373,398,78633,15461
hdfs://spark-nn.eemcs.utwente.nl/user/s1934538/clickstream/clickstream-enwiki-2022-12.tsv.gz,Jason_Momoa,82541,306221,1831,390593,197107
hdfs://spark-nn.eemcs.utwente.nl/user/s1934538/clickstream/clickstream-enwiki-2022-12.tsv.gz,Crazy_Rich_Asians_(film),30153,67577,793,98523,84944
hdfs://spark-nn.eemcs.utwente.nl/user/s1934538/clickstream/clickstream-enwiki-2018-04.tsv.gz,A_Quiet_Place_(film),222023,4885669,48498,5156190,1314253
hdfs://spark-nn.eemcs.utwente.nl/user/s1934538/clickstream/clickstream-enwiki-2018-04.tsv.gz,The_Shape_of_Water,46649,464698,6715,518062,208931
hdfs://spark-nn.eemcs.utwente.nl/user/s1934538/clickstream/clickstream-enwiki-2018-04.tsv.gz,Brie_Larson,325034,374179,2132,701345,246980
hdfs://spark-nn.eemcs.utwente.nl/user/s1934538/clickstream/clickstream-enwiki-2018-04.tsv.gz,Naomi_Osaka,1497,21352,75,22924,2463
hdfs://spark-nn.eemcs.utwente.nl/user/s1934538/clickstream/clickstream-enwiki-2018-04.tsv.gz,YouTube,91250,720295,10326,821871,157428
hdfs://spark-nn.eemcs.utwente.nl/user/s1934538/clickstream/clickstream-enwiki-2018-04.tsv.gz,XXX_(franchise),71445,3285715,968,3358128,552361
hdfs://spark-nn.eemcs.utwente.nl/user/s1934538/clickstream/clickstream-enwiki-2018-04.tsv.gz,List_of_most_popular_websites,24153,129606,146,153905,70542
hdfs://spark-nn.eemcs.utwente.nl/user/s1934538/clickstream/clickstream-enwiki-2018-04.tsv.gz,George_H._W._Bush,513092,1468800,8767,1990659,771969
hdfs://spark-nn.eemcs.utwente.nl/user/s1934538/clickstream/clickstream-enwiki-2018-04.tsv.gz,Juice_Wrld,157,6388,18,6563,743
hdfs://spark-nn.eemcs.utwente.nl/user/s1934538/clickstream/clickstream-enwiki-2018-04.tsv.gz,Central_Park_jogger_case,3098,36898,383,40379,3897
hdfs://spark-nn.eemcs.utwente.nl/user/s1934538/clickstream/clickstream-enwiki-2018-04.tsv.gz,Dennis_Nilsen,4084,25391,97,29572,5385
hdfs://spark-nn.eemcs.utwente.nl/user/s1934538/clickstream/clickstream-enwiki-2018-04.tsv.gz,Saaho,30873,61957,204,93034,53175
hdfs://spark-nn.eemcs.utwente.nl/user/s1934538/clickstream/clickstream-enwiki-2018-04.tsv.gz,Avicii,154289,7410695,119564,7684548,1511990
hdfs://spark-nn.eemcs.utwente.nl/user/s1934538/clickstream/clickstream-enwiki-2018-04.tsv.gz,Hamas,18554,58763,454,77771,23058
hdfs://spark-nn.eemcs.utwente.nl/user/s1934538/clickstream/clickstream-enwiki-2018-04.tsv.gz,Lionel_Messi,77227,758964,6227,842418,136363
hdfs://spark-nn.eemcs.utwente.nl/user/s1934538/clickstream/clickstream-enwiki-2018-04.tsv.gz,State_of_Palestine,42975,83065,117,126157,49197
hdfs://spark-nn.eemcs.utwente.nl/user/s1934538/clickstream/clickstream-enwiki-2018-04.tsv.gz,Luke_Perry,18229,46619,246,65094,9138
hdfs://spark-nn.eemcs.utwente.nl/user/s1934538/clickstream/clickstream-enwiki-2018-04.tsv.gz,Irrfan_Khan,35618,184485,345,220448,93776
hdfs://spark-nn.eemcs.utwente.nl/user/s1934538/clickstream/clickstream-enwiki-2018-04.tsv.gz,Wikipedia,41929,427085,1042,470056,186203
hdfs://spark-nn.eemcs.utwente.nl/user/s1934538/clickstream/clickstream-enwiki-2018-04.tsv.gz,Aretha_Franklin,12564,78318,729,91611,21294
hdfs://spark-nn.eemcs.utwente.nl/user/s1934538/clickstream/clickstream-enwiki-2018-04.tsv.gz,Death_of_Elisa_Lam,8157,75073,186,83416,16345
hdfs://spark-nn.eemcs.utwente.nl/user/s1934538/clickstream/clickstream-enwiki-2018-04.tsv.gz,Kamala_Harris,21963,185859,1132,208954,53413
hdfs://spark-nn.eemcs.utwente.nl/user/s1934538/clickstream/clickstream-enwiki-2018-04.tsv.gz,Simone_Biles,7131,44812,164,52107,10609
hdfs://spark-nn.eemcs.utwente.nl/user/s1934538/clickstream/clickstream-enwiki-2018-04.tsv.gz,Glass_(2019_film),69507,68041,143,137691,64848
hdfs://spark-nn.eemcs.utwente.nl/user/s1934538/clickstream/clickstream-enwiki-2018-04.tsv.gz,Cristiano_Ronaldo,103063,1139230,6636,1248929,219569
hdfs://spark-nn.eemcs.utwente.nl/user/s1934538/clickstream/clickstream-enwiki-2018-04.tsv.gz,Mac_Miller,38777,60229,199,99205,20865
hdfs://spark-nn.eemcs.utwente.nl/user/s1934538/clickstream/clickstream-enwiki-2018-04.tsv.gz,2018_Winter_Olympics,27398,102119,875,130392,52504
hdfs://spark-nn.eemcs.utwente.nl/user/s1934538/clickstream/clickstream-enwiki-2018-04.tsv.gz,Jason_Momoa,72616,398206,1189,472011,145553
hdfs://spark-nn.eemcs.utwente.nl/user/s1934538/clickstream/clickstream-enwiki-2018-04.tsv.gz,Sridevi,24580,191389,1553,217522,52929
hdfs://spark-nn.eemcs.utwente.nl/user/s1934538/clickstream/clickstream-enwiki-2018-04.tsv.gz,Johnny_Depp,78575,319117,2004,399696,202533
hdfs://spark-nn.eemcs.utwente.nl/user/s1934538/clickstream/clickstream-enwiki-2018-04.tsv.gz,Stan_Lee,104236,375227,3491,482954,141662
hdfs://spark-nn.eemcs.utwente.nl/user/s1934538/clickstream/clickstream-enwiki-2018-04.tsv.gz,FIFA_World_Cup,43659,236354,3396,283409,191803
hdfs://spark-nn.eemcs.utwente.nl/user/s1934538/clickstream/clickstream-enwiki-2018-04.tsv.gz,List_of_FIFA_World_Cup_finals,1799,115047,87,116933,24982
hdfs://spark-nn.eemcs.utwente.nl/user/s1934538/clickstream/clickstream-enwiki-2018-04.tsv.gz,Olivia_Newton-John,19336,116750,896,136982,43626
hdfs://spark-nn.eemcs.utwente.nl/user/s1934538/clickstream/clickstream-enwiki-2018-04.tsv.gz,The_Lion_King_(2019_film),57516,93056,545,151117,127501
hdfs://spark-nn.eemcs.utwente.nl/user/s1934538/clickstream/clickstream-enwiki-2018-04.tsv.gz,Sylvester_Stallone,62585,401321,2470,466376,197358
hdfs://spark-nn.eemcs.utwente.nl/user/s1934538/clickstream/clickstream-enwiki-2018-04.tsv.gz,Google_logo,914,16067,10,16991,2510
hdfs://spark-nn.eemcs.utwente.nl/user/s1934538/clickstream/clickstream-enwiki-2018-04.tsv.gz,Black_Panther_(film),290834,1571609,30699,1893142,922479
hdfs://spark-nn.eemcs.utwente.nl/user/s1934538/clickstream/clickstream-enwiki-2018-04.tsv.gz,Deaths_in_2018,1214412,2159794,7717,3381923,1803636
hdfs://spark-nn.eemcs.utwente.nl/user/s1934538/clickstream/clickstream-enwiki-2018-04.tsv.gz,George_VI,348494,414282,972,763748,373768
hdfs://spark-nn.eemcs.utwente.nl/user/s1934538/clickstream/clickstream-enwiki-2018-04.tsv.gz,2020_Summer_Olympics,39229,103418,1155,143802,57594
hdfs://spark-nn.eemcs.utwente.nl/user/s1934538/clickstream/clickstream-enwiki-2018-04.tsv.gz,Deion_Sanders,5837,65302,259,71398,12467
hdfs://spark-nn.eemcs.utwente.nl/user/s1934538/clickstream/clickstream-enwiki-2018-04.tsv.gz,Kate_Spade,9687,29809,75,39571,9663
hdfs://spark-nn.eemcs.utwente.nl/user/s1934538/clickstream/clickstream-enwiki-2018-04.tsv.gz,William_Murdoch,618,1704,20,2342,313
hdfs://spark-nn.eemcs.utwente.nl/user/s1934538/clickstream/clickstream-enwiki-2018-04.tsv.gz,Cecil_Hotel_(Los_Angeles),3738,29630,48,33416,9012
hdfs://spark-nn.eemcs.utwente.nl/user/s1934538/clickstream/clickstream-enwiki-2018-04.tsv.gz,Lists_of_deaths_by_year,7503,174265,168,181936,137783
hdfs://spark-nn.eemcs.utwente.nl/user/s1934538/clickstream/clickstream-enwiki-2018-04.tsv.gz,Lisa_Marie_Presley,111051,139881,216,251148,92058
hdfs://spark-nn.eemcs.utwente.nl/user/s1934538/clickstream/clickstream-enwiki-2018-04.tsv.gz,Cook's_Country,103,3493,18,3614,44
hdfs://spark-nn.eemcs.utwente.nl/user/s1934538/clickstream/clickstream-enwiki-2018-04.tsv.gz,Rami_Malek,35406,68478,414,104298,32149
hdfs://spark-nn.eemcs.utwente.nl/user/s1934538/clickstream/clickstream-enwiki-2018-04.tsv.gz,Murder_of_Dee_Dee_Blanchard,2501,37751,66,40318,6589
hdfs://spark-nn.eemcs.utwente.nl/user/s1934538/clickstream/clickstream-enwiki-2018-04.tsv.gz,Anthony_Bourdain,13004,120437,813,134254,37000
hdfs://spark-nn.eemcs.utwente.nl/user/s1934538/clickstream/clickstream-enwiki-2018-04.tsv.gz,Betty_White,32510,242267,1770,276547,42004
hdfs://spark-nn.eemcs.utwente.nl/user/s1934538/clickstream/clickstream-enwiki-2018-04.tsv.gz,Atal_Bihari_Vajpayee,19365,59551,95,79011,16825
hdfs://spark-nn.eemcs.utwente.nl/user/s1934538/clickstream/clickstream-enwiki-2018-04.tsv.gz,Donald_Trump,248812,1056923,12386,1318121,639764
hdfs://spark-nn.eemcs.utwente.nl/user/s1934538/clickstream/clickstream-enwiki-2018-04.tsv.gz,Vladimir_Putin,68338,361668,3698,433704,167815
hdfs://spark-nn.eemcs.utwente.nl/user/s1934538/clickstream/clickstream-enwiki-2018-04.tsv.gz,Priyanka_Chopra,51775,301897,1537,355209,82873
hdfs://spark-nn.eemcs.utwente.nl/user/s1934538/clickstream/clickstream-enwiki-2018-04.tsv.gz,Israel,70366,384197,6599,461162,177750
hdfs://spark-nn.eemcs.utwente.nl/user/s1934538/clickstream/clickstream-enwiki-2018-04.tsv.gz,Jimmy_Buffett,7288,75000,540,82828,18787
hdfs://spark-nn.eemcs.utwente.nl/user/s1934538/clickstream/clickstream-enwiki-2018-04.tsv.gz,Bob_Saget,14254,45300,375,59929,8828
hdfs://spark-nn.eemcs.utwente.nl/user/s1934538/clickstream/clickstream-enwiki-2018-04.tsv.gz,2018_FIFA_World_Cup,109651,739736,10698,860085,400251
hdfs://spark-nn.eemcs.utwente.nl/user/s1934538/clickstream/clickstream-enwiki-2018-04.tsv.gz,Ray_Liotta,26528,81002,348,107878,25816
hdfs://spark-nn.eemcs.utwente.nl/user/s1934538/clickstream/clickstream-enwiki-2018-04.tsv.gz,Keanu_Reeves,53357,485733,2939,542029,235929
hdfs://spark-nn.eemcs.utwente.nl/user/s1934538/clickstream/clickstream-enwiki-2018-04.tsv.gz,A_Star_Is_Born_(2018_film),25517,29747,175,55439,21950
hdfs://spark-nn.eemcs.utwente.nl/user/s1934538/clickstream/clickstream-enwiki-2018-04.tsv.gz,Area_51,12016,205370,2142,219528,49093
hdfs://spark-nn.eemcs.utwente.nl/user/s1934538/clickstream/clickstream-enwiki-2018-04.tsv.gz,Rishi_Sunak,2372,3647,27,6046,888
hdfs://spark-nn.eemcs.utwente.nl/user/s1934538/clickstream/clickstream-enwiki-2018-04.tsv.gz,Antifa_(United_States),6364,84601,102,91067,14639
hdfs://spark-nn.eemcs.utwente.nl/user/s1934538/clickstream/clickstream-enwiki-2018-04.tsv.gz,Burt_Reynolds,28138,164405,1272,193815,60109
hdfs://spark-nn.eemcs.utwente.nl/user/s1934538/clickstream/clickstream-enwiki-2018-04.tsv.gz,Afghanistan,41115,164702,2018,207835,106856
hdfs://spark-nn.eemcs.utwente.nl/user/s1934538/clickstream/clickstream-enwiki-2018-04.tsv.gz,List_of_highest-grossing_films,248495,1399392,6101,1653988,436688
hdfs://spark-nn.eemcs.utwente.nl/user/s1934538/clickstream/clickstream-enwiki-2018-04.tsv.gz,UEFA_Euro_2020,16449,47758,657,64864,26571
hdfs://spark-nn.eemcs.utwente.nl/user/s1934538/clickstream/clickstream-enwiki-2018-04.tsv.gz,2018_Asian_Games,27140,90811,408,118359,38901
hdfs://spark-nn.eemcs.utwente.nl/user/s1934538/clickstream/clickstream-enwiki-2018-04.tsv.gz,21_Savage,33980,138001,1508,173489,57152
hdfs://spark-nn.eemcs.utwente.nl/user/s1934538/clickstream/clickstream-enwiki-2018-04.tsv.gz,Puneeth_Rajkumar,8623,21053,44,29720,11790
hdfs://spark-nn.eemcs.utwente.nl/user/s1934538/clickstream/clickstream-enwiki-2018-04.tsv.gz,Bible,13952,102438,1625,118015,33466
hdfs://spark-nn.eemcs.utwente.nl/user/s1934538/clickstream/clickstream-enwiki-2018-04.tsv.gz,Deadpool_2,169305,506720,12526,688551,606877
hdfs://spark-nn.eemcs.utwente.nl/user/s1934538/clickstream/clickstream-enwiki-2018-04.tsv.gz,Chernobyl_disaster,28988,314854,1784,345626,80930
hdfs://spark-nn.eemcs.utwente.nl/user/s1934538/clickstream/clickstream-enwiki-2018-04.tsv.gz,Roe_v._Wade,9544,96510,816,106870,19229
hdfs://spark-nn.eemcs.utwente.nl/user/s1934538/clickstream/clickstream-enwiki-2018-04.tsv.gz,Charles_III,190,631,101,922,576
hdfs://spark-nn.eemcs.utwente.nl/user/s1934538/clickstream/clickstream-enwiki-2018-04.tsv.gz,Crazy_Rich_Asians_(film),81768,213820,1946,297534,365451
hdfs://spark-nn.eemcs.utwente.nl/user/s1934538/clickstream/clickstream-enwiki-2018-04.tsv.gz,Tina_Turner,11864,193260,1942,207066,43987
hdfs://spark-nn.eemcs.utwente.nl/user/s1934538/clickstream/clickstream-enwiki-2018-04.tsv.gz,Elizabeth_II,524927,1461885,5864,1992676,1122839
hdfs://spark-nn.eemcs.utwente.nl/user/s1934538/clickstream/clickstream-enwiki-2018-04.tsv.gz,Once_Upon_a_Time_in_Hollywood,59236,25090,10990,95316,807
hdfs://spark-nn.eemcs.utwente.nl/user/s1934538/clickstream/clickstream-enwiki-2018-04.tsv.gz,Jeffrey_Epstein,10149,40322,142,50613,13405
hdfs://spark-nn.eemcs.utwente.nl/user/s1934538/clickstream/clickstream-enwiki-2018-04.tsv.gz,The_Nun_(2018_film),48233,103087,448,151768,56735
hdfs://spark-nn.eemcs.utwente.nl/user/s1934538/clickstream/clickstream-enwiki-2018-04.tsv.gz,"Princess_Margaret,_Countess_of_Snowdon",132096,585110,2729,719935,289586
hdfs://spark-nn.eemcs.utwente.nl/user/s1934538/clickstream/clickstream-enwiki-2018-04.tsv.gz,The_Witcher_(TV_series),4665,27963,118,32746,8867
hdfs://spark-nn.eemcs.utwente.nl/user/s1934538/clickstream/clickstream-enwiki-2018-04.tsv.gz,Joaquin_Phoenix,77973,193905,1178,273056,153735
hdfs://spark-nn.eemcs.utwente.nl/user/s1934538/clickstream/clickstream-enwiki-2018-04.tsv.gz,R._Kelly,20013,174398,1478,195889,66038
hdfs://spark-nn.eemcs.utwente.nl/user/s1934538/clickstream/clickstream-enwiki-2018-04.tsv.gz,Ruth_Bader_Ginsburg,19215,94273,397,113885,30255
hdfs://spark-nn.eemcs.utwente.nl/user/s1934538/clickstream/clickstream-enwiki-2018-04.tsv.gz,Naya_Rivera,14737,38947,98,53782,9106
hdfs://spark-nn.eemcs.utwente.nl/user/s1934538/clickstream/clickstream-enwiki-2018-04.tsv.gz,September_11_attacks,63529,349214,2473,415216,146931
hdfs://spark-nn.eemcs.utwente.nl/user/s1934538/clickstream/clickstream-enwiki-2018-04.tsv.gz,Aquaman_(film),82599,82367,1229,166195,94314
hdfs://spark-nn.eemcs.utwente.nl/user/s1934538/clickstream/clickstream-enwiki-2019-05.tsv.gz,Stranger_Things,69359,307347,7310,384016,298694
hdfs://spark-nn.eemcs.utwente.nl/user/s1934538/clickstream/clickstream-enwiki-2019-05.tsv.gz,DMX_(rapper),12945,66952,360,80257,31110
hdfs://spark-nn.eemcs.utwente.nl/user/s1934538/clickstream/clickstream-enwiki-2019-05.tsv.gz,Game_of_Thrones_(season_8),820950,4806655,171210,5798815,1977669
hdfs://spark-nn.eemcs.utwente.nl/user/s1934538/clickstream/clickstream-enwiki-2019-05.tsv.gz,Brett_Kavanaugh,26427,62328,558,89313,29801
hdfs://spark-nn.eemcs.utwente.nl/user/s1934538/clickstream/clickstream-enwiki-2019-05.tsv.gz,Spanish_flu,20022,97962,723,118707,20226
hdfs://spark-nn.eemcs.utwente.nl/user/s1934538/clickstream/clickstream-enwiki-2019-05.tsv.gz,Lionel_Messi,117693,873225,11251,1002169,204039
hdfs://spark-nn.eemcs.utwente.nl/user/s1934538/clickstream/clickstream-enwiki-2019-05.tsv.gz,Main_Page,26576,506472809,4723697,511223082,33682873
hdfs://spark-nn.eemcs.utwente.nl/user/s1934538/clickstream/clickstream-enwiki-2019-05.tsv.gz,J._Robert_Oppenheimer,19445,81357,241,101043,30897
hdfs://spark-nn.eemcs.utwente.nl/user/s1934538/clickstream/clickstream-enwiki-2019-05.tsv.gz,XHamster,12506,51723,2271,66500,13374
hdfs://spark-nn.eemcs.utwente.nl/user/s1934538/clickstream/clickstream-enwiki-2019-05.tsv.gz,Grimes_(musician),65406,53792,285,119483,32380
hdfs://spark-nn.eemcs.utwente.nl/user/s1934538/clickstream/clickstream-enwiki-2019-05.tsv.gz,Joe_Biden,63022,384355,7047,454424,151801
hdfs://spark-nn.eemcs.utwente.nl/user/s1934538/clickstream/clickstream-enwiki-2019-05.tsv.gz,Joaquin_Phoenix,140504,156875,898,298277,206694
hdfs://spark-nn.eemcs.utwente.nl/user/s1934538/clickstream/clickstream-enwiki-2019-05.tsv.gz,1234,108,1427,20,1555,174
hdfs://spark-nn.eemcs.utwente.nl/user/s1934538/clickstream/clickstream-enwiki-2019-05.tsv.gz,QAnon,4573,103590,811,108974,25020
hdfs://spark-nn.eemcs.utwente.nl/user/s1934538/clickstream/clickstream-enwiki-2019-05.tsv.gz,Kelly_Preston,72003,52709,120,124832,36906
hdfs://spark-nn.eemcs.utwente.nl/user/s1934538/clickstream/clickstream-enwiki-2019-05.tsv.gz,Chadwick_Boseman,72904,120697,1230,194831,67063
hdfs://spark-nn.eemcs.utwente.nl/user/s1934538/clickstream/clickstream-enwiki-2019-05.tsv.gz,Stephen_Hawking,26932,336882,2456,366270,126829
hdfs://spark-nn.eemcs.utwente.nl/user/s1934538/clickstream/clickstream-enwiki-2019-05.tsv.gz,Us_(2019_film),83574,742448,4333,830355,175049
hdfs://spark-nn.eemcs.utwente.nl/user/s1934538/clickstream/clickstream-enwiki-2019-05.tsv.gz,Richard_Ramirez,10504,225349,1903,237756,52968
hdfs://spark-nn.eemcs.utwente.nl/user/s1934538/clickstream/clickstream-enwiki-2019-05.tsv.gz,YouTube,121527,907087,8011,1036625,135859
hdfs://spark-nn.eemcs.utwente.nl/user/s1934538/clickstream/clickstream-enwiki-2019-05.tsv.gz,It_Chapter_Two,151396,360115,6718,518229,436926
hdfs://spark-nn.eemcs.utwente.nl/user/s1934538/clickstream/clickstream-enwiki-2019-05.tsv.gz,Irrfan_Khan,23701,37001,73,60775,27334
hdfs://spark-nn.eemcs.utwente.nl/user/s1934538/clickstream/clickstream-enwiki-2019-05.tsv.gz,Ted_Bundy,286588,9002311,36328,9325227,1820873
hdfs://spark-nn.eemcs.utwente.nl/user/s1934538/clickstream/clickstream-enwiki-2019-05.tsv.gz,Chernobyl_disaster,630099,7212983,55121,7898203,3302639
hdfs://spark-nn.eemcs.utwente.nl/user/s1934538/clickstream/clickstream-enwiki-2019-05.tsv.gz,Croatia,40579,166637,1968,209184,64661
hdfs://spark-nn.eemcs.utwente.nl/user/s1934538/clickstream/clickstream-enwiki-2019-05.tsv.gz,Coronavirus,773,8459,37,9269,1149
hdfs://spark-nn.eemcs.utwente.nl/user/s1934538/clickstream/clickstream-enwiki-2019-05.tsv.gz,"Meghan,_Duchess_of_Sussex",307877,1411084,11701,1730662,990820
hdfs://spark-nn.eemcs.utwente.nl/user/s1934538/clickstream/clickstream-enwiki-2019-05.tsv.gz,2020_Summer_Olympics,48791,123539,2150,174480,127840
hdfs://spark-nn.eemcs.utwente.nl/user/s1934538/clickstream/clickstream-enwiki-2019-05.tsv.gz,Naomi_Osaka,21601,125340,693,147634,27316
hdfs://spark-nn.eemcs.utwente.nl/user/s1934538/clickstream/clickstream-enwiki-2019-05.tsv.gz,Cardi_B,54281,625568,11953,691802,241349
hdfs://spark-nn.eemcs.utwente.nl/user/s1934538/clickstream/clickstream-enwiki-2019-05.tsv.gz,Central_Park_jogger_case,42139,480417,1679,524235,62304
hdfs://spark-nn.eemcs.utwente.nl/user/s1934538/clickstream/clickstream-enwiki-2019-05.tsv.gz,Jason_Momoa,216018,770944,4106,991068,461058
hdfs://spark-nn.eemcs.utwente.nl/user/s1934538/clickstream/clickstream-enwiki-2019-05.tsv.gz,United_States_Senate,50727,69153,92,119972,44188
hdfs://spark-nn.eemcs.utwente.nl/user/s1934538/clickstream/clickstream-enwiki-2019-05.tsv.gz,Rami_Malek,98219,228571,1878,328668,109724
hdfs://spark-nn.eemcs.utwente.nl/user/s1934538/clickstream/clickstream-enwiki-2019-05.tsv.gz,The_Weeknd,48889,89946,906,139741,53523
hdfs://spark-nn.eemcs.utwente.nl/user/s1934538/clickstream/clickstream-enwiki-2019-05.tsv.gz,The_Irishman,58,245,92,395,510
hdfs://spark-nn.eemcs.utwente.nl/user/s1934538/clickstream/clickstream-enwiki-2019-05.tsv.gz,Once_Upon_a_Time_in_Hollywood,242040,721387,15705,979132,952568
hdfs://spark-nn.eemcs.utwente.nl/user/s1934538/clickstream/clickstream-enwiki-2019-05.tsv.gz,September_11_attacks,78484,366988,2775,448247,165641
hdfs://spark-nn.eemcs.utwente.nl/user/s1934538/clickstream/clickstream-enwiki-2019-05.tsv.gz,Pornhub,33525,383947,12231,429703,77457
hdfs://spark-nn.eemcs.utwente.nl/user/s1934538/clickstream/clickstream-enwiki-2019-05.tsv.gz,Mötley_Crüe,83304,356406,2889,442599,590714
hdfs://spark-nn.eemcs.utwente.nl/user/s1934538/clickstream/clickstream-enwiki-2019-05.tsv.gz,Louis_Tomlinson,27676,59169,291,87136,13134
hdfs://spark-nn.eemcs.utwente.nl/user/s1934538/clickstream/clickstream-enwiki-2019-05.tsv.gz,Alexander_Hamilton,62849,260279,1819,324947,144600
hdfs://spark-nn.eemcs.utwente.nl/user/s1934538/clickstream/clickstream-enwiki-2019-05.tsv.gz,Venom_(2018_film),67269,253328,3630,324227,164840
hdfs://spark-nn.eemcs.utwente.nl/user/s1934538/clickstream/clickstream-enwiki-2019-05.tsv.gz,Hamas,27450,62111,491,90052,33625
hdfs://spark-nn.eemcs.utwente.nl/user/s1934538/clickstream/clickstream-enwiki-2019-05.tsv.gz,Qasem_Soleimani,4819,10323,47,15189,7764
hdfs://spark-nn.eemcs.utwente.nl/user/s1934538/clickstream/clickstream-enwiki-2019-05.tsv.gz,Jeffrey_Epstein,8811,45464,176,54451,14041
hdfs://spark-nn.eemcs.utwente.nl/user/s1934538/clickstream/clickstream-enwiki-2019-05.tsv.gz,2020_United_States_presidential_election,80767,287945,7008,375720,277648
hdfs://spark-nn.eemcs.utwente.nl/user/s1934538/clickstream/clickstream-enwiki-2019-05.tsv.gz,Cook's_Country,292,2148,29,2469,652
hdfs://spark-nn.eemcs.utwente.nl/user/s1934538/clickstream/clickstream-enwiki-2019-05.tsv.gz,Kate_Spade,34154,80048,621,114823,36893
hdfs://spark-nn.eemcs.utwente.nl/user/s1934538/clickstream/clickstream-enwiki-2019-05.tsv.gz,List_of_Marvel_Cinematic_Universe_films,567527,3388748,9726,3966001,1362934
hdfs://spark-nn.eemcs.utwente.nl/user/s1934538/clickstream/clickstream-enwiki-2019-05.tsv.gz,Avengers:_Infinity_War,471973,765462,13101,1250536,792964
hdfs://spark-nn.eemcs.utwente.nl/user/s1934538/clickstream/clickstream-enwiki-2019-05.tsv.gz,Hamilton_(musical),28846,255532,1582,285960,129402
hdfs://spark-nn.eemcs.utwente.nl/user/s1934538/clickstream/clickstream-enwiki-2019-05.tsv.gz,Mulan_(2020_film),49250,93883,678,143811,172708
hdfs://spark-nn.eemcs.utwente.nl/user/s1934538/clickstream/clickstream-enwiki-2019-05.tsv.gz,XXX:_Return_of_Xander_Cage,34714,102215,909,137838,42565
hdfs://spark-nn.eemcs.utwente.nl/user/s1934538/clickstream/clickstream-enwiki-2019-05.tsv.gz,List_of_highest-grossing_films,2295575,7419468,31645,9746688,2227266
hdfs://spark-nn.eemcs.utwente.nl/user/s1934538/clickstream/clickstream-enwiki-2019-05.tsv.gz,Cristiano_Ronaldo,127297,706748,4566,838611,171203
hdfs://spark-nn.eemcs.utwente.nl/user/s1934538/clickstream/clickstream-enwiki-2019-05.tsv.gz,IPv4,14475,50445,183,65103,10884
hdfs://spark-nn.eemcs.utwente.nl/user/s1934538/clickstream/clickstream-enwiki-2019-05.tsv.gz,Meat_Loaf,20856,89147,917,110920,36544
hdfs://spark-nn.eemcs.utwente.nl/user/s1934538/clickstream/clickstream-enwiki-2019-05.tsv.gz,The_Umbrella_Academy_(TV_series),53689,257410,3524,314623,186800
hdfs://spark-nn.eemcs.utwente.nl/user/s1934538/clickstream/clickstream-enwiki-2019-05.tsv.gz,Aaron_Carter,19283,38512,251,58046,17103
hdfs://spark-nn.eemcs.utwente.nl/user/s1934538/clickstream/clickstream-enwiki-2019-05.tsv.gz,Royal_Rumble_(2018),7463,6235,42,13740,8878
hdfs://spark-nn.eemcs.utwente.nl/user/s1934538/clickstream/clickstream-enwiki-2019-05.tsv.gz,Key_frame,571,6477,16,7064,552
hdfs://spark-nn.eemcs.utwente.nl/user/s1934538/clickstream/clickstream-enwiki-2019-05.tsv.gz,Media,84,19545,454,20083,2414
hdfs://spark-nn.eemcs.utwente.nl/user/s1934538/clickstream/clickstream-enwiki-2019-05.tsv.gz,Murder_of_Dee_Dee_Blanchard,116666,1254165,2074,1372905,199583
hdfs://spark-nn.eemcs.utwente.nl/user/s1934538/clickstream/clickstream-enwiki-2019-05.tsv.gz,Antifa_(United_States),7634,96125,206,103965,15233
hdfs://spark-nn.eemcs.utwente.nl/user/s1934538/clickstream/clickstream-enwiki-2019-05.tsv.gz,"Princess_Margaret,_Countess_of_Snowdon",134002,277144,1661,412807,263045
hdfs://spark-nn.eemcs.utwente.nl/user/s1934538/clickstream/clickstream-enwiki-2019-05.tsv.gz,Ruth_Bader_Ginsburg,38970,241431,1232,281633,104002
hdfs://spark-nn.eemcs.utwente.nl/user/s1934538/clickstream/clickstream-enwiki-2019-05.tsv.gz,Roe_v._Wade,46926,978830,4825,1030581,222292
hdfs://spark-nn.eemcs.utwente.nl/user/s1934538/clickstream/clickstream-enwiki-2019-05.tsv.gz,Olivia_Newton-John,20211,86728,815,107754,46030
hdfs://spark-nn.eemcs.utwente.nl/user/s1934538/clickstream/clickstream-enwiki-2019-05.tsv.gz,Priyanka_Chopra,311009,572117,2347,885473,313181
hdfs://spark-nn.eemcs.utwente.nl/user/s1934538/clickstream/clickstream-enwiki-2019-05.tsv.gz,List_of_James_Bond_films,17525,232001,606,250132,105184
hdfs://spark-nn.eemcs.utwente.nl/user/s1934538/clickstream/clickstream-enwiki-2019-05.tsv.gz,Michael_Bloomberg,41398,51284,404,93086,35563
hdfs://spark-nn.eemcs.utwente.nl/user/s1934538/clickstream/clickstream-enwiki-2019-05.tsv.gz,The_Witcher_(TV_series),19960,76332,559,96851,54370
hdfs://spark-nn.eemcs.utwente.nl/user/s1934538/clickstream/clickstream-enwiki-2019-05.tsv.gz,Nipsey_Hussle,59063,397405,3267,459735,159365
hdfs://spark-nn.eemcs.utwente.nl/user/s1934538/clickstream/clickstream-enwiki-2019-05.tsv.gz,Jimmy_Buffett,9083,58940,468,68491,21391
hdfs://spark-nn.eemcs.utwente.nl/user/s1934538/clickstream/clickstream-enwiki-2019-05.tsv.gz,2018_Winter_Olympics,20593,30676,270,51539,25063
hdfs://spark-nn.eemcs.utwente.nl/user/s1934538/clickstream/clickstream-enwiki-2019-05.tsv.gz,Valentine's_Day,2865,28174,237,31276,2630
hdfs://spark-nn.eemcs.utwente.nl/user/s1934538/clickstream/clickstream-enwiki-2019-05.tsv.gz,Matthew_Perry,66978,164203,721,231902,101240
hdfs://spark-nn.eemcs.utwente.nl/user/s1934538/clickstream/clickstream-enwiki-2019-05.tsv.gz,Brie_Larson,291491,736679,5931,1034101,438939
hdfs://spark-nn.eemcs.utwente.nl/user/s1934538/clickstream/clickstream-enwiki-2019-05.tsv.gz,Ray_Liotta,31597,46911,279,78787,24611
hdfs://spark-nn.eemcs.utwente.nl/user/s1934538/clickstream/clickstream-enwiki-2019-05.tsv.gz,2.0_(film),32719,181872,844,215435,53849
hdfs://spark-nn.eemcs.utwente.nl/user/s1934538/clickstream/clickstream-enwiki-2019-05.tsv.gz,List_of_most_popular_websites,31367,73382,210,104959,49367
hdfs://spark-nn.eemcs.utwente.nl/user/s1934538/clickstream/clickstream-enwiki-2019-05.tsv.gz,Bipin_Rawat,5011,15048,29,20088,7216
hdfs://spark-nn.eemcs.utwente.nl/user/s1934538/clickstream/clickstream-enwiki-2019-05.tsv.gz,The_Shape_of_Water,25884,60925,825,87634,40129
hdfs://spark-nn.eemcs.utwente.nl/user/s1934538/clickstream/clickstream-enwiki-2019-05.tsv.gz,The_Lion_King_(2019_film),99777,201497,3222,304496,244508
hdfs://spark-nn.eemcs.utwente.nl/user/s1934538/clickstream/clickstream-enwiki-2019-05.tsv.gz,Bible,16727,2935702,1658,2954087,34741
hdfs://spark-nn.eemcs.utwente.nl/user/s1934538/clickstream/clickstream-enwiki-2019-05.tsv.gz,Game_of_Thrones,646859,4071647,106125,4824631,3893271
hdfs://spark-nn.eemcs.utwente.nl/user/s1934538/clickstream/clickstream-enwiki-2019-05.tsv.gz,Greta_Thunberg,6690,165919,1442,174051,51225
hdfs://spark-nn.eemcs.utwente.nl/user/s1934538/clickstream/clickstream-enwiki-2019-05.tsv.gz,Deion_Sanders,8517,97387,355,106259,27528
hdfs://spark-nn.eemcs.utwente.nl/user/s1934538/clickstream/clickstream-enwiki-2019-05.tsv.gz,Ghislaine_Maxwell,1709,1836,23,3568,1004
hdfs://spark-nn.eemcs.utwente.nl/user/s1934538/clickstream/clickstream-enwiki-2019-05.tsv.gz,Hyphen-minus,6102,53825098,8627981,62459181,989
hdfs://spark-nn.eemcs.utwente.nl/user/s1934538/clickstream/clickstream-enwiki-2019-05.tsv.gz,List_of_awards_and_nominations_received_by_Meryl_Streep,10460,8791,237,19488,5623
hdfs://spark-nn.eemcs.utwente.nl/user/s1934538/clickstream/clickstream-enwiki-2019-05.tsv.gz,Indian_Premier_League,47664,412379,759,460802,262282
hdfs://spark-nn.eemcs.utwente.nl/user/s1934538/clickstream/clickstream-enwiki-2019-05.tsv.gz,Juneteenth,2219,139734,324,142277,12986
hdfs://spark-nn.eemcs.utwente.nl/user/s1934538/clickstream/clickstream-enwiki-2019-05.tsv.gz,Simone_Biles,10056,41986,178,52220,10970
hdfs://spark-nn.eemcs.utwente.nl/user/s1934538/clickstream/clickstream-enwiki-2019-05.tsv.gz,Sinéad_O'Connor,11068,72016,760,83844,21595
hdfs://spark-nn.eemcs.utwente.nl/user/s1934538/clickstream/clickstream-enwiki-2019-05.tsv.gz,Aretha_Franklin,22291,159852,6140,188283,58515
hdfs://spark-nn.eemcs.utwente.nl/user/s1934538/clickstream/clickstream-enwiki-2019-05.tsv.gz,Sylvester_Stallone,78570,364119,2720,445409,303252
hdfs://spark-nn.eemcs.utwente.nl/user/s1934538/clickstream/clickstream-enwiki-2019-05.tsv.gz,Pelé,27597,134182,1106,162885,42712
hdfs://spark-nn.eemcs.utwente.nl/user/s1934538/clickstream/clickstream-enwiki-2019-05.tsv.gz,Elizabeth_II,615510,860052,7663,1483225,1180250
hdfs://spark-nn.eemcs.utwente.nl/user/s1934538/clickstream/clickstream-enwiki-2019-05.tsv.gz,Johnny_Depp,114836,293804,2405,411045,256677
hdfs://spark-nn.eemcs.utwente.nl/user/s1934538/clickstream/clickstream-enwiki-2019-05.tsv.gz,Donald_Trump,210168,791166,11689,1013023,573439
hdfs://spark-nn.eemcs.utwente.nl/user/s1934538/clickstream/clickstream-enwiki-2019-05.tsv.gz,Lists_of_deaths_by_year,7303,182168,394,189865,177873
hdfs://spark-nn.eemcs.utwente.nl/user/s1934538/clickstream/clickstream-enwiki-2019-05.tsv.gz,Saaho,38919,115037,816,154772,95735
hdfs://spark-nn.eemcs.utwente.nl/user/s1934538/clickstream/clickstream-enwiki-2019-05.tsv.gz,Luke_Perry,102237,341572,2935,446744,122276
hdfs://spark-nn.eemcs.utwente.nl/user/s1934538/clickstream/clickstream-enwiki-2019-05.tsv.gz,Line_shaft,505,1182,15,1702,87
hdfs://spark-nn.eemcs.utwente.nl/user/s1934538/clickstream/clickstream-enwiki-2019-08.tsv.gz,Ray_Liotta,42880,60979,384,104243,33473
hdfs://spark-nn.eemcs.utwente.nl/user/s1934538/clickstream/clickstream-enwiki-2019-08.tsv.gz,Hamilton_(musical),32204,238328,1738,272270,138476
hdfs://spark-nn.eemcs.utwente.nl/user/s1934538/clickstream/clickstream-enwiki-2019-08.tsv.gz,Line_shaft,532,4227797,43,4228372,150
hdfs://spark-nn.eemcs.utwente.nl/user/s1934538/clickstream/clickstream-enwiki-2019-08.tsv.gz,Aaron_Carter,20468,60880,367,81715,26202
hdfs://spark-nn.eemcs.utwente.nl/user/s1934538/clickstream/clickstream-enwiki-2019-08.tsv.gz,Chernobyl_(miniseries),43231,327401,7629,378261,370033
hdfs://spark-nn.eemcs.utwente.nl/user/s1934538/clickstream/clickstream-enwiki-2019-08.tsv.gz,FIFA_World_Cup,30697,126017,1570,158284,120723
hdfs://spark-nn.eemcs.utwente.nl/user/s1934538/clickstream/clickstream-enwiki-2019-08.tsv.gz,Stephen_Hawking,37089,446861,2756,486706,194836
hdfs://spark-nn.eemcs.utwente.nl/user/s1934538/clickstream/clickstream-enwiki-2019-08.tsv.gz,Mac_Miller,35936,225288,1872,263096,86002
hdfs://spark-nn.eemcs.utwente.nl/user/s1934538/clickstream/clickstream-enwiki-2019-08.tsv.gz,2016_United_States_presidential_election,113812,252679,9720,376211,285561
hdfs://spark-nn.eemcs.utwente.nl/user/s1934538/clickstream/clickstream-enwiki-2019-08.tsv.gz,Us_(2019_film),51239,337852,1876,390967,117137
hdfs://spark-nn.eemcs.utwente.nl/user/s1934538/clickstream/clickstream-enwiki-2019-08.tsv.gz,Vladimir_Putin,76324,219945,2775,299044,170528
hdfs://spark-nn.eemcs.utwente.nl/user/s1934538/clickstream/clickstream-enwiki-2019-08.tsv.gz,Deion_Sanders,12595,127005,644,140244,42985
hdfs://spark-nn.eemcs.utwente.nl/user/s1934538/clickstream/clickstream-enwiki-2019-08.tsv.gz,Stranger_Things_(season_3),83876,438116,7517,529509,398243
hdfs://spark-nn.eemcs.utwente.nl/user/s1934538/clickstream/clickstream-enwiki-2019-08.tsv.gz,Bird_Box_(film),24003,89950,1018,114971,38926
hdfs://spark-nn.eemcs.utwente.nl/user/s1934538/clickstream/clickstream-enwiki-2019-08.tsv.gz,Bible,17434,645338,1591,664363,35887
hdfs://spark-nn.eemcs.utwente.nl/user/s1934538/clickstream/clickstream-enwiki-2019-08.tsv.gz,QAnon,18319,284140,1737,304196,72270
hdfs://spark-nn.eemcs.utwente.nl/user/s1934538/clickstream/clickstream-enwiki-2019-08.tsv.gz,Coronavirus,690,4577,36,5303,713
hdfs://spark-nn.eemcs.utwente.nl/user/s1934538/clickstream/clickstream-enwiki-2019-08.tsv.gz,Dennis_Nilsen,6943,37508,218,44669,9701
hdfs://spark-nn.eemcs.utwente.nl/user/s1934538/clickstream/clickstream-enwiki-2019-08.tsv.gz,Bonnie_and_Clyde,30320,318187,2243,350750,88815
hdfs://spark-nn.eemcs.utwente.nl/user/s1934538/clickstream/clickstream-enwiki-2019-08.tsv.gz,The_Witcher_(TV_series),22481,174866,1494,198841,90640
hdfs://spark-nn.eemcs.utwente.nl/user/s1934538/clickstream/clickstream-enwiki-2019-08.tsv.gz,2.0_(film),43122,148824,4052,195998,43341
hdfs://spark-nn.eemcs.utwente.nl/user/s1934538/clickstream/clickstream-enwiki-2019-08.tsv.gz,Kamala_Harris,38076,440631,3497,482204,158285
hdfs://spark-nn.eemcs.utwente.nl/user/s1934538/clickstream/clickstream-enwiki-2019-08.tsv.gz,Pelé,23694,107189,949,131832,39578
hdfs://spark-nn.eemcs.utwente.nl/user/s1934538/clickstream/clickstream-enwiki-2019-08.tsv.gz,Cleopatra,50508,193592,2826,246926,124455
hdfs://spark-nn.eemcs.utwente.nl/user/s1934538/clickstream/clickstream-enwiki-2019-08.tsv.gz,United_States_Electoral_College,27385,122775,229,150389,18213
hdfs://spark-nn.eemcs.utwente.nl/user/s1934538/clickstream/clickstream-enwiki-2019-08.tsv.gz,2020_Summer_Olympics,76536,232970,5725,315231,298546
hdfs://spark-nn.eemcs.utwente.nl/user/s1934538/clickstream/clickstream-enwiki-2019-08.tsv.gz,Notre-Dame_de_Paris,14068,99750,1412,115230,25230
hdfs://spark-nn.eemcs.utwente.nl/user/s1934538/clickstream/clickstream-enwiki-2019-08.tsv.gz,Aquaman_(film),73780,407537,7253,488570,355906
hdfs://spark-nn.eemcs.utwente.nl/user/s1934538/clickstream/clickstream-enwiki-2019-08.tsv.gz,Atal_Bihari_Vajpayee,45742,150198,194,196134,41714
hdfs://spark-nn.eemcs.utwente.nl/user/s1934538/clickstream/clickstream-enwiki-2019-08.tsv.gz,Tunnel,4260,10224,106,14590,3669
hdfs://spark-nn.eemcs.utwente.nl/user/s1934538/clickstream/clickstream-enwiki-2019-08.tsv.gz,Key_frame,631,4536,17,5184,475
hdfs://spark-nn.eemcs.utwente.nl/user/s1934538/clickstream/clickstream-enwiki-2019-08.tsv.gz,Chadwick_Boseman,32677,68609,509,101795,36367
hdfs://spark-nn.eemcs.utwente.nl/user/s1934538/clickstream/clickstream-enwiki-2019-08.tsv.gz,Game_of_Thrones,70613,286458,8318,365389,263895
hdfs://spark-nn.eemcs.utwente.nl/user/s1934538/clickstream/clickstream-enwiki-2019-08.tsv.gz,Anthony_Bourdain,16159,243321,1911,261391,61508
hdfs://spark-nn.eemcs.utwente.nl/user/s1934538/clickstream/clickstream-enwiki-2019-08.tsv.gz,Ukraine,48792,140575,3152,192519,99548
hdfs://spark-nn.eemcs.utwente.nl/user/s1934538/clickstream/clickstream-enwiki-2019-08.tsv.gz,List_of_Queen_of_the_South_episodes,41858,23854,168,65880,2108
hdfs://spark-nn.eemcs.utwente.nl/user/s1934538/clickstream/clickstream-enwiki-2019-08.tsv.gz,Mötley_Crüe,46473,165626,1520,213619,272568
hdfs://spark-nn.eemcs.utwente.nl/user/s1934538/clickstream/clickstream-enwiki-2019-08.tsv.gz,21_Savage,25770,83326,1088,110184,34002
hdfs://spark-nn.eemcs.utwente.nl/user/s1934538/clickstream/clickstream-enwiki-2019-08.tsv.gz,George_H._W._Bush,130526,124990,917,256433,146664
hdfs://spark-nn.eemcs.utwente.nl/user/s1934538/clickstream/clickstream-enwiki-2019-08.tsv.gz,Elon_Musk,75367,613486,3701,692554,381960
hdfs://spark-nn.eemcs.utwente.nl/user/s1934538/clickstream/clickstream-enwiki-2019-08.tsv.gz,Amy_Coney_Barrett,1554,12363,182,14099,3034
hdfs://spark-nn.eemcs.utwente.nl/user/s1934538/clickstream/clickstream-enwiki-2019-08.tsv.gz,Murder_of_Dee_Dee_Blanchard,33569,351777,737,386083,61370
hdfs://spark-nn.eemcs.utwente.nl/user/s1934538/clickstream/clickstream-enwiki-2019-08.tsv.gz,Jenna_Ortega,9106,19070,937,29113,5492
hdfs://spark-nn.eemcs.utwente.nl/user/s1934538/clickstream/clickstream-enwiki-2019-08.tsv.gz,2018_Winter_Olympics,23243,21479,251,44973,27859
hdfs://spark-nn.eemcs.utwente.nl/user/s1934538/clickstream/clickstream-enwiki-2019-08.tsv.gz,Dark_Phoenix_(film),111416,446738,7103,565257,228035
hdfs://spark-nn.eemcs.utwente.nl/user/s1934538/clickstream/clickstream-enwiki-2019-08.tsv.gz,Johnny_Depp,133367,331105,2567,467039,280623
hdfs://spark-nn.eemcs.utwente.nl/user/s1934538/clickstream/clickstream-enwiki-2019-08.tsv.gz,Kelly_Preston,96840,52077,133,149050,41145
hdfs://spark-nn.eemcs.utwente.nl/user/s1934538/clickstream/clickstream-enwiki-2019-08.tsv.gz,2018_Asian_Games,9721,20390,93,30204,19328
hdfs://spark-nn.eemcs.utwente.nl/user/s1934538/clickstream/clickstream-enwiki-2019-08.tsv.gz,Critical_race_theory,1871,13308,36,15215,3393
hdfs://spark-nn.eemcs.utwente.nl/user/s1934538/clickstream/clickstream-enwiki-2019-08.tsv.gz,Charles_Sobhraj,3673,23307,71,27051,6445
hdfs://spark-nn.eemcs.utwente.nl/user/s1934538/clickstream/clickstream-enwiki-2019-08.tsv.gz,IPv4,12865,42441,96,55402,9816
hdfs://spark-nn.eemcs.utwente.nl/user/s1934538/clickstream/clickstream-enwiki-2019-08.tsv.gz,Eddie_Van_Halen,33460,44056,330,77846,38072
hdfs://spark-nn.eemcs.utwente.nl/user/s1934538/clickstream/clickstream-enwiki-2019-08.tsv.gz,Avengers:_Infinity_War,122291,187523,3290,313104,192016
hdfs://spark-nn.eemcs.utwente.nl/user/s1934538/clickstream/clickstream-enwiki-2019-08.tsv.gz,Richard_Jewell,9596,16174,111,25881,9246
hdfs://spark-nn.eemcs.utwente.nl/user/s1934538/clickstream/clickstream-enwiki-2019-08.tsv.gz,Greta_Thunberg,14184,383586,9179,406949,150890
hdfs://spark-nn.eemcs.utwente.nl/user/s1934538/clickstream/clickstream-enwiki-2019-08.tsv.gz,Stranger_Things,152963,830922,17093,1000978,1052005
hdfs://spark-nn.eemcs.utwente.nl/user/s1934538/clickstream/clickstream-enwiki-2019-08.tsv.gz,Game_of_Thrones_(season_8),24081,104470,2142,130693,48331
hdfs://spark-nn.eemcs.utwente.nl/user/s1934538/clickstream/clickstream-enwiki-2019-08.tsv.gz,Wonder_Woman_1984,103556,49313,575,153444,92855
hdfs://spark-nn.eemcs.utwente.nl/user/s1934538/clickstream/clickstream-enwiki-2019-08.tsv.gz,The_Umbrella_Academy_(TV_series),39007,176406,2707,218120,114126
hdfs://spark-nn.eemcs.utwente.nl/user/s1934538/clickstream/clickstream-enwiki-2019-08.tsv.gz,Shakira,19413,150016,1510,170939,76759
hdfs://spark-nn.eemcs.utwente.nl/user/s1934538/clickstream/clickstream-enwiki-2019-08.tsv.gz,Adele,23398,139914,2335,165647,58419
hdfs://spark-nn.eemcs.utwente.nl/user/s1934538/clickstream/clickstream-enwiki-2019-08.tsv.gz,Roe_v._Wade,9627,52957,371,62955,18836
hdfs://spark-nn.eemcs.utwente.nl/user/s1934538/clickstream/clickstream-enwiki-2019-08.tsv.gz,It_Chapter_Two,138599,475096,11723,625418,420383
hdfs://spark-nn.eemcs.utwente.nl/user/s1934538/clickstream/clickstream-enwiki-2019-08.tsv.gz,Donald_Glover,95216,257135,2019,354370,107107
hdfs://spark-nn.eemcs.utwente.nl/user/s1934538/clickstream/clickstream-enwiki-2019-08.tsv.gz,Royal_Rumble_(2018),9208,6714,93,16015,10396
hdfs://spark-nn.eemcs.utwente.nl/user/s1934538/clickstream/clickstream-enwiki-2019-08.tsv.gz,Rishi_Sunak,5439,10808,71,16318,4626
hdfs://spark-nn.eemcs.utwente.nl/user/s1934538/clickstream/clickstream-enwiki-2019-08.tsv.gz,2022_FIFA_World_Cup,46831,85896,1406,134133,66294
hdfs://spark-nn.eemcs.utwente.nl/user/s1934538/clickstream/clickstream-enwiki-2019-08.tsv.gz,Salman_Rushdie,22206,61141,412,83759,40049
hdfs://spark-nn.eemcs.utwente.nl/user/s1934538/clickstream/clickstream-enwiki-2019-08.tsv.gz,Charles_III,60,272,59,391,341
hdfs://spark-nn.eemcs.utwente.nl/user/s1934538/clickstream/clickstream-enwiki-2019-08.tsv.gz,Aaron_Hernandez,11865,132489,999,145353,47700
hdfs://spark-nn.eemcs.utwente.nl/user/s1934538/clickstream/clickstream-enwiki-2019-08.tsv.gz,"Meghan,_Duchess_of_Sussex",104822,299065,2450,406337,241268
hdfs://spark-nn.eemcs.utwente.nl/user/s1934538/clickstream/clickstream-enwiki-2019-08.tsv.gz,Burt_Reynolds,108141,199771,1741,309653,110032
hdfs://spark-nn.eemcs.utwente.nl/user/s1934538/clickstream/clickstream-enwiki-2019-08.tsv.gz,Naomi_Osaka,29344,284245,1365,314954,51828
hdfs://spark-nn.eemcs.utwente.nl/user/s1934538/clickstream/clickstream-enwiki-2019-08.tsv.gz,Luke_Perry,219428,564918,3622,787968,170503
hdfs://spark-nn.eemcs.utwente.nl/user/s1934538/clickstream/clickstream-enwiki-2019-08.tsv.gz,Lance_Reddick,56659,35544,126,92329,17240
hdfs://spark-nn.eemcs.utwente.nl/user/s1934538/clickstream/clickstream-enwiki-2019-08.tsv.gz,RRR_(film),72177,60150,144,132471,79200
hdfs://spark-nn.eemcs.utwente.nl/user/s1934538/clickstream/clickstream-enwiki-2019-08.tsv.gz,George_VI,371496,194035,892,566423,408178
hdfs://spark-nn.eemcs.utwente.nl/user/s1934538/clickstream/clickstream-enwiki-2019-08.tsv.gz,No_Time_to_Die,142275,146984,4020,293279,17963
hdfs://spark-nn.eemcs.utwente.nl/user/s1934538/clickstream/clickstream-enwiki-2019-08.tsv.gz,Joe_Biden,55498,397406,6201,459105,136678
hdfs://spark-nn.eemcs.utwente.nl/user/s1934538/clickstream/clickstream-enwiki-2019-08.tsv.gz,Kim_Jong-un,42989,108160,866,152015,91164
hdfs://spark-nn.eemcs.utwente.nl/user/s1934538/clickstream/clickstream-enwiki-2019-08.tsv.gz,Naya_Rivera,53741,66042,137,119920,23200
hdfs://spark-nn.eemcs.utwente.nl/user/s1934538/clickstream/clickstream-enwiki-2019-08.tsv.gz,Rihanna,73872,236870,3661,314403,160539
hdfs://spark-nn.eemcs.utwente.nl/user/s1934538/clickstream/clickstream-enwiki-2019-08.tsv.gz,List_of_highest-grossing_films,424326,892737,6056,1323119,512407
hdfs://spark-nn.eemcs.utwente.nl/user/s1934538/clickstream/clickstream-enwiki-2019-08.tsv.gz,Cardi_B,56489,407656,7381,471526,184927
hdfs://spark-nn.eemcs.utwente.nl/user/s1934538/clickstream/clickstream-enwiki-2019-08.tsv.gz,Ruth_Bader_Ginsburg,26910,230122,1943,258975,87161
hdfs://spark-nn.eemcs.utwente.nl/user/s1934538/clickstream/clickstream-enwiki-2019-08.tsv.gz,DMX_(rapper),15415,70686,427,86528,36760
hdfs://spark-nn.eemcs.utwente.nl/user/s1934538/clickstream/clickstream-enwiki-2019-08.tsv.gz,HTTP_cookie,5817,315164,125,321106,37671
hdfs://spark-nn.eemcs.utwente.nl/user/s1934538/clickstream/clickstream-enwiki-2019-08.tsv.gz,Pornhub,39548,368750,12786,421084,70447
hdfs://spark-nn.eemcs.utwente.nl/user/s1934538/clickstream/clickstream-enwiki-2019-08.tsv.gz,Henry_V_of_England,120097,136194,766,257057,168668
hdfs://spark-nn.eemcs.utwente.nl/user/s1934538/clickstream/clickstream-enwiki-2019-08.tsv.gz,Simone_Biles,28473,425467,3120,457060,109996
hdfs://spark-nn.eemcs.utwente.nl/user/s1934538/clickstream/clickstream-enwiki-2019-08.tsv.gz,Ghislaine_Maxwell,348556,789023,9234,1146813,478051
hdfs://spark-nn.eemcs.utwente.nl/user/s1934538/clickstream/clickstream-enwiki-2019-08.tsv.gz,Cameron_Boyce,110971,784558,5101,900630,317099
hdfs://spark-nn.eemcs.utwente.nl/user/s1934538/clickstream/clickstream-enwiki-2019-08.tsv.gz,Hyphen-minus,5912,47153290,8264991,55424193,953
hdfs://spark-nn.eemcs.utwente.nl/user/s1934538/clickstream/clickstream-enwiki-2019-08.tsv.gz,Olivia_Newton-John,29232,253717,2427,285376,126505
hdfs://spark-nn.eemcs.utwente.nl/user/s1934538/clickstream/clickstream-enwiki-2019-08.tsv.gz,List_of_Marvel_Cinematic_Universe_films,367540,1199933,4583,1572056,663917
hdfs://spark-nn.eemcs.utwente.nl/user/s1934538/clickstream/clickstream-enwiki-2019-08.tsv.gz,Sridevi,25071,114355,353,139779,46529
hdfs://spark-nn.eemcs.utwente.nl/user/s1934538/clickstream/clickstream-enwiki-2019-08.tsv.gz,Deadpool_2,87935,105927,2407,196269,134235
hdfs://spark-nn.eemcs.utwente.nl/user/s1934538/clickstream/clickstream-enwiki-2019-08.tsv.gz,Exo_(band),22003,101584,543,124130,139564
hdfs://spark-nn.eemcs.utwente.nl/user/s1934538/clickstream/clickstream-enwiki-2019-08.tsv.gz,Afghanistan,56146,160333,2761,219240,124458
hdfs://spark-nn.eemcs.utwente.nl/user/s1934538/clickstream/clickstream-enwiki-2019-08.tsv.gz,JSON_Web_Token,999,20151,28,21178,1915
hdfs://spark-nn.eemcs.utwente.nl/user/s1934538/clickstream/clickstream-enwiki-2019-08.tsv.gz,Sinéad_O'Connor,13511,78196,684,92391,24423
hdfs://spark-nn.eemcs.utwente.nl/user/s1934538/clickstream/clickstream-enwiki-2019-08.tsv.gz,R._Kelly,35063,157160,1963,194186,86515
hdfs://spark-nn.eemcs.utwente.nl/user/s1934538/clickstream/clickstream-enwiki-2019-09.tsv.gz,Alexander_Hamilton,63921,263428,1695,329044,143941
hdfs://spark-nn.eemcs.utwente.nl/user/s1934538/clickstream/clickstream-enwiki-2019-09.tsv.gz,When_They_See_Us,66278,278919,2500,347697,189083
hdfs://spark-nn.eemcs.utwente.nl/user/s1934538/clickstream/clickstream-enwiki-2019-09.tsv.gz,List_of_highest-grossing_Indian_films,110788,551797,2255,664840,293625
hdfs://spark-nn.eemcs.utwente.nl/user/s1934538/clickstream/clickstream-enwiki-2019-09.tsv.gz,Cristiano_Ronaldo,129429,925468,6789,1061686,242397
hdfs://spark-nn.eemcs.utwente.nl/user/s1934538/clickstream/clickstream-enwiki-2019-09.tsv.gz,List_of_highest-grossing_films,206714,503556,13372,723642,278037
hdfs://spark-nn.eemcs.utwente.nl/user/s1934538/clickstream/clickstream-enwiki-2019-09.tsv.gz,Pelé,25783,117811,938,144532,40593
hdfs://spark-nn.eemcs.utwente.nl/user/s1934538/clickstream/clickstream-enwiki-2019-09.tsv.gz,Aquaman_(film),54489,271194,3755,329438,206159
hdfs://spark-nn.eemcs.utwente.nl/user/s1934538/clickstream/clickstream-enwiki-2019-09.tsv.gz,Article_370_of_the_Constitution_of_India,12547,835904,653,849104,52478
hdfs://spark-nn.eemcs.utwente.nl/user/s1934538/clickstream/clickstream-enwiki-2019-09.tsv.gz,Bible,16558,672701,1613,690872,33590
hdfs://spark-nn.eemcs.utwente.nl/user/s1934538/clickstream/clickstream-enwiki-2019-09.tsv.gz,List_of_James_Bond_films,22195,203648,495,226338,102269
hdfs://spark-nn.eemcs.utwente.nl/user/s1934538/clickstream/clickstream-enwiki-2019-09.tsv.gz,Sylvester_Stallone,174659,965049,5508,1145216,665777
hdfs://spark-nn.eemcs.utwente.nl/user/s1934538/clickstream/clickstream-enwiki-2019-09.tsv.gz,XHamster,11864,47064,2465,61393,11775
hdfs://spark-nn.eemcs.utwente.nl/user/s1934538/clickstream/clickstream-enwiki-2019-09.tsv.gz,Simple_Mail_Transfer_Protocol,4269,29503,133,33905,3818
hdfs://spark-nn.eemcs.utwente.nl/user/s1934538/clickstream/clickstream-enwiki-2019-09.tsv.gz,Kobe_Bryant,27974,212610,1593,242177,56559
hdfs://spark-nn.eemcs.utwente.nl/user/s1934538/clickstream/clickstream-enwiki-2019-09.tsv.gz,2.0_(film),60386,205827,819,267032,57106
hdfs://spark-nn.eemcs.utwente.nl/user/s1934538/clickstream/clickstream-enwiki-2019-09.tsv.gz,It_Chapter_Two,406704,3309470,118363,3834537,2596323
hdfs://spark-nn.eemcs.utwente.nl/user/s1934538/clickstream/clickstream-enwiki-2019-09.tsv.gz,Luke_Perry,90166,237888,1566,329620,74978
hdfs://spark-nn.eemcs.utwente.nl/user/s1934538/clickstream/clickstream-enwiki-2019-09.tsv.gz,Tunnel,3912,11203,104,15219,3493
hdfs://spark-nn.eemcs.utwente.nl/user/s1934538/clickstream/clickstream-enwiki-2019-09.tsv.gz,John_McCain,34439,92156,909,127504,55268
hdfs://spark-nn.eemcs.utwente.nl/user/s1934538/clickstream/clickstream-enwiki-2019-09.tsv.gz,War_(2019_film),85243,413163,750,499156,188535
hdfs://spark-nn.eemcs.utwente.nl/user/s1934538/clickstream/clickstream-enwiki-2019-09.tsv.gz,Avengers:_Endgame,226206,748329,14449,988984,593937
hdfs://spark-nn.eemcs.utwente.nl/user/s1934538/clickstream/clickstream-enwiki-2019-09.tsv.gz,Chernobyl_(miniseries),42466,274259,5488,322213,268729
hdfs://spark-nn.eemcs.utwente.nl/user/s1934538/clickstream/clickstream-enwiki-2019-09.tsv.gz,Tonya_Harding,24547,114706,464,139717,30047
hdfs://spark-nn.eemcs.utwente.nl/user/s1934538/clickstream/clickstream-enwiki-2019-09.tsv.gz,Donald_Glover,48098,155663,1356,205117,68155
hdfs://spark-nn.eemcs.utwente.nl/user/s1934538/clickstream/clickstream-enwiki-2019-09.tsv.gz,Key_frame,596,5451,12,6059,461
hdfs://spark-nn.eemcs.utwente.nl/user/s1934538/clickstream/clickstream-enwiki-2019-09.tsv.gz,J._Robert_Oppenheimer,16076,70404,299,86779,27138
hdfs://spark-nn.eemcs.utwente.nl/user/s1934538/clickstream/clickstream-enwiki-2019-09.tsv.gz,Vladimir_Putin,71522,209469,2146,283137,151551
hdfs://spark-nn.eemcs.utwente.nl/user/s1934538/clickstream/clickstream-enwiki-2019-09.tsv.gz,The_Weeknd,40527,103866,999,145392,67306
hdfs://spark-nn.eemcs.utwente.nl/user/s1934538/clickstream/clickstream-enwiki-2019-09.tsv.gz,George_VI,383940,183322,806,568068,395078
hdfs://spark-nn.eemcs.utwente.nl/user/s1934538/clickstream/clickstream-enwiki-2019-09.tsv.gz,Aretha_Franklin,20067,94796,1029,115892,39656
hdfs://spark-nn.eemcs.utwente.nl/user/s1934538/clickstream/clickstream-enwiki-2019-09.tsv.gz,Mulan_(2020_film),29218,44066,2884,76168,66869
hdfs://spark-nn.eemcs.utwente.nl/user/s1934538/clickstream/clickstream-enwiki-2019-09.tsv.gz,"Diana,_Princess_of_Wales",123102,303485,3347,429934,268864
hdfs://spark-nn.eemcs.utwente.nl/user/s1934538/clickstream/clickstream-enwiki-2019-09.tsv.gz,Croatia,38632,159776,1900,200308,67486
hdfs://spark-nn.eemcs.utwente.nl/user/s1934538/clickstream/clickstream-enwiki-2019-09.tsv.gz,Roe_v._Wade,10773,67311,401,78485,21868
hdfs://spark-nn.eemcs.utwente.nl/user/s1934538/clickstream/clickstream-enwiki-2019-09.tsv.gz,XXXTentacion,89784,464867,5355,560006,109638
hdfs://spark-nn.eemcs.utwente.nl/user/s1934538/clickstream/clickstream-enwiki-2019-09.tsv.gz,Deion_Sanders,13609,154415,762,168786,49084
hdfs://spark-nn.eemcs.utwente.nl/user/s1934538/clickstream/clickstream-enwiki-2019-09.tsv.gz,Kylian_Mbappé,27792,134326,1553,163671,28241
hdfs://spark-nn.eemcs.utwente.nl/user/s1934538/clickstream/clickstream-enwiki-2019-09.tsv.gz,Brie_Larson,89355,222695,417,312467,124392
hdfs://spark-nn.eemcs.utwente.nl/user/s1934538/clickstream/clickstream-enwiki-2019-09.tsv.gz,Grimes_(musician),35098,72446,775,108319,47121
hdfs://spark-nn.eemcs.utwente.nl/user/s1934538/clickstream/clickstream-enwiki-2019-09.tsv.gz,Wikipedia,39668,7300913,1183,7341764,193278
hdfs://spark-nn.eemcs.utwente.nl/user/s1934538/clickstream/clickstream-enwiki-2019-09.tsv.gz,Godzilla_vs._Kong,95973,77043,3133,176149,122610
hdfs://spark-nn.eemcs.utwente.nl/user/s1934538/clickstream/clickstream-enwiki-2019-09.tsv.gz,Simone_Biles,10307,94808,575,105690,23283
hdfs://spark-nn.eemcs.utwente.nl/user/s1934538/clickstream/clickstream-enwiki-2019-09.tsv.gz,Main_Page,25778,463824827,4175529,468026134,32524649
hdfs://spark-nn.eemcs.utwente.nl/user/s1934538/clickstream/clickstream-enwiki-2019-09.tsv.gz,Lionel_Messi,88802,545739,6681,641222,138793
hdfs://spark-nn.eemcs.utwente.nl/user/s1934538/clickstream/clickstream-enwiki-2019-09.tsv.gz,Lists_of_deaths_by_year,7681,131384,294,139359,132100
hdfs://spark-nn.eemcs.utwente.nl/user/s1934538/clickstream/clickstream-enwiki-2019-09.tsv.gz,Adele,22507,213555,3566,239628,73153
hdfs://spark-nn.eemcs.utwente.nl/user/s1934538/clickstream/clickstream-enwiki-2019-09.tsv.gz,Wonder_Woman_1984,76685,40387,2116,119188,65640
hdfs://spark-nn.eemcs.utwente.nl/user/s1934538/clickstream/clickstream-enwiki-2019-09.tsv.gz,Kamala_Harris,33043,347479,2365,382887,110386
hdfs://spark-nn.eemcs.utwente.nl/user/s1934538/clickstream/clickstream-enwiki-2019-09.tsv.gz,Amber_Heard,121756,214184,782,336722,155008
hdfs://spark-nn.eemcs.utwente.nl/user/s1934538/clickstream/clickstream-enwiki-2019-09.tsv.gz,Irrfan_Khan,24576,44203,438,69217,31067
hdfs://spark-nn.eemcs.utwente.nl/user/s1934538/clickstream/clickstream-enwiki-2019-09.tsv.gz,Mac_Miller,32760,339262,2487,374509,103738
hdfs://spark-nn.eemcs.utwente.nl/user/s1934538/clickstream/clickstream-enwiki-2019-09.tsv.gz,State_of_Palestine,41412,111593,122,153127,66281
hdfs://spark-nn.eemcs.utwente.nl/user/s1934538/clickstream/clickstream-enwiki-2019-09.tsv.gz,Darth_Vader,27533,165475,950,193958,60859
hdfs://spark-nn.eemcs.utwente.nl/user/s1934538/clickstream/clickstream-enwiki-2019-09.tsv.gz,Khabib_Nurmagomedov,182796,847117,7329,1037242,530235
hdfs://spark-nn.eemcs.utwente.nl/user/s1934538/clickstream/clickstream-enwiki-2019-09.tsv.gz,Ray_Liotta,35058,51809,362,87229,27667
hdfs://spark-nn.eemcs.utwente.nl/user/s1934538/clickstream/clickstream-enwiki-2019-09.tsv.gz,Cook's_Country,280,2830,32,3142,764
hdfs://spark-nn.eemcs.utwente.nl/user/s1934538/clickstream/clickstream-enwiki-2019-09.tsv.gz,Venom_(2018_film),42517,152074,4260,198851,106892
hdfs://spark-nn.eemcs.utwente.nl/user/s1934538/clickstream/clickstream-enwiki-2019-09.tsv.gz,Kim_Jong-un,38895,102285,931,142111,77823
hdfs://spark-nn.eemcs.utwente.nl/user/s1934538/clickstream/clickstream-enwiki-2019-09.tsv.gz,Queen_(band),104983,374345,4425,483753,461050
hdfs://spark-nn.eemcs.utwente.nl/user/s1934538/clickstream/clickstream-enwiki-2019-09.tsv.gz,Jimmy_Buffett,8588,49452,476,58516,18487
hdfs://spark-nn.eemcs.utwente.nl/user/s1934538/clickstream/clickstream-enwiki-2019-09.tsv.gz,The_Mandalorian,55022,133541,2205,190768,139697
hdfs://spark-nn.eemcs.utwente.nl/user/s1934538/clickstream/clickstream-enwiki-2019-09.tsv.gz,Deadpool_2,73155,92319,1580,167054,103944
hdfs://spark-nn.eemcs.utwente.nl/user/s1934538/clickstream/clickstream-enwiki-2019-09.tsv.gz,Watts_family_murders,3510,101187,218,104915,17256
hdfs://spark-nn.eemcs.utwente.nl/user/s1934538/clickstream/clickstream-enwiki-2019-09.tsv.gz,"Meghan,_Duchess_of_Sussex",103737,322099,2156,427992,249002
hdfs://spark-nn.eemcs.utwente.nl/user/s1934538/clickstream/clickstream-enwiki-2019-09.tsv.gz,Henry_V_of_England,69748,67107,550,137405,90031
hdfs://spark-nn.eemcs.utwente.nl/user/s1934538/clickstream/clickstream-enwiki-2019-09.tsv.gz,Pornhub,35347,310826,12244,358417,63108
hdfs://spark-nn.eemcs.utwente.nl/user/s1934538/clickstream/clickstream-enwiki-2019-09.tsv.gz,YouTube,123960,915890,7563,1047413,157242
hdfs://spark-nn.eemcs.utwente.nl/user/s1934538/clickstream/clickstream-enwiki-2019-09.tsv.gz,Jenna_Ortega,6385,11716,930,19031,3458
hdfs://spark-nn.eemcs.utwente.nl/user/s1934538/clickstream/clickstream-enwiki-2019-09.tsv.gz,Naomi_Osaka,49577,570292,5236,625105,127289
hdfs://spark-nn.eemcs.utwente.nl/user/s1934538/clickstream/clickstream-enwiki-2019-09.tsv.gz,Brett_Kavanaugh,23568,109887,1136,134591,46502
hdfs://spark-nn.eemcs.utwente.nl/user/s1934538/clickstream/clickstream-enwiki-2019-09.tsv.gz,UEFA_Euro_2020,63862,324530,6992,395384,128066
hdfs://spark-nn.eemcs.utwente.nl/user/s1934538/clickstream/clickstream-enwiki-2019-09.tsv.gz,Kate_Spade,28062,71580,402,100044,32882
hdfs://spark-nn.eemcs.utwente.nl/user/s1934538/clickstream/clickstream-enwiki-2019-09.tsv.gz,Bird_Box_(film),22560,82430,872,105862,34370
hdfs://spark-nn.eemcs.utwente.nl/user/s1934538/clickstream/clickstream-enwiki-2019-09.tsv.gz,Stephen_Hawking,29981,401641,2660,434282,163064
hdfs://spark-nn.eemcs.utwente.nl/user/s1934538/clickstream/clickstream-enwiki-2019-09.tsv.gz,Lisa_Marie_Presley,112072,67888,196,180156,99269
hdfs://spark-nn.eemcs.utwente.nl/user/s1934538/clickstream/clickstream-enwiki-2019-09.tsv.gz,Saaho,156910,2775634,20593,2953137,607042
hdfs://spark-nn.eemcs.utwente.nl/user/s1934538/clickstream/clickstream-enwiki-2019-09.tsv.gz,Valentine's_Day,2614,28648,190,31452,2467
hdfs://spark-nn.eemcs.utwente.nl/user/s1934538/clickstream/clickstream-enwiki-2019-09.tsv.gz,Cleopatra,36213,156361,1725,194299,81939
hdfs://spark-nn.eemcs.utwente.nl/user/s1934538/clickstream/clickstream-enwiki-2019-09.tsv.gz,Gaza_Strip,19910,37809,230,57949,21942
hdfs://spark-nn.eemcs.utwente.nl/user/s1934538/clickstream/clickstream-enwiki-2019-09.tsv.gz,United_States_Senate,61676,110274,6895,178845,65983
hdfs://spark-nn.eemcs.utwente.nl/user/s1934538/clickstream/clickstream-enwiki-2019-09.tsv.gz,Spanish_flu,21994,86207,624,108825,24415
hdfs://spark-nn.eemcs.utwente.nl/user/s1934538/clickstream/clickstream-enwiki-2019-09.tsv.gz,Tina_Turner,24537,217139,2035,243711,71284
hdfs://spark-nn.eemcs.utwente.nl/user/s1934538/clickstream/clickstream-enwiki-2019-09.tsv.gz,Tasuku_Honjo,2325,3616,11,5952,1501
hdfs://spark-nn.eemcs.utwente.nl/user/s1934538/clickstream/clickstream-enwiki-2019-09.tsv.gz,A_Quiet_Place_(film),31449,135762,1247,168458,59773
hdfs://spark-nn.eemcs.utwente.nl/user/s1934538/clickstream/clickstream-enwiki-2019-09.tsv.gz,QAnon,7414,97669,527,105610,21931
hdfs://spark-nn.eemcs.utwente.nl/user/s1934538/clickstream/clickstream-enwiki-2019-09.tsv.gz,Aaron_Hernandez,14838,230404,976,246218,75774
hdfs://spark-nn.eemcs.utwente.nl/user/s1934538/clickstream/clickstream-enwiki-2019-09.tsv.gz,Lance_Reddick,52319,35914,134,88367,15299
hdfs://spark-nn.eemcs.utwente.nl/user/s1934538/clickstream/clickstream-enwiki-2019-09.tsv.gz,Afghanistan,52942,168963,2779,224684,152878
hdfs://spark-nn.eemcs.utwente.nl/user/s1934538/clickstream/clickstream-enwiki-2019-09.tsv.gz,Eddie_Van_Halen,32227,58463,503,91193,42758
hdfs://spark-nn.eemcs.utwente.nl/user/s1934538/clickstream/clickstream-enwiki-2019-09.tsv.gz,NATO,43436,104060,1468,148964,52369
hdfs://spark-nn.eemcs.utwente.nl/user/s1934538/clickstream/clickstream-enwiki-2019-09.tsv.gz,Captain_Marvel_(film),62550,190649,2689,255888,124822
hdfs://spark-nn.eemcs.utwente.nl/user/s1934538/clickstream/clickstream-enwiki-2019-09.tsv.gz,2023_Cricket_World_Cup,11094,21598,101,32793,9872
hdfs://spark-nn.eemcs.utwente.nl/user/s1934538/clickstream/clickstream-enwiki-2019-09.tsv.gz,2022_FIFA_World_Cup,73111,174139,4644,251894,137786
hdfs://spark-nn.eemcs.utwente.nl/user/s1934538/clickstream/clickstream-enwiki-2019-09.tsv.gz,Ukraine,51242,212712,5640,269594,124091
hdfs://spark-nn.eemcs.utwente.nl/user/s1934538/clickstream/clickstream-enwiki-2019-09.tsv.gz,Juneteenth,1894,18980,35,20909,2051
hdfs://spark-nn.eemcs.utwente.nl/user/s1934538/clickstream/clickstream-enwiki-2019-09.tsv.gz,Johnny_Depp,133302,372670,2330,508302,285934
hdfs://spark-nn.eemcs.utwente.nl/user/s1934538/clickstream/clickstream-enwiki-2019-09.tsv.gz,Matthew_Perry,83231,251571,968,335770,175435
hdfs://spark-nn.eemcs.utwente.nl/user/s1934538/clickstream/clickstream-enwiki-2019-09.tsv.gz,Sridevi,20662,93565,358,114585,39771
hdfs://spark-nn.eemcs.utwente.nl/user/s1934538/clickstream/clickstream-enwiki-2019-09.tsv.gz,Elizabeth_II,487890,622077,4652,1114619,835736
hdfs://spark-nn.eemcs.utwente.nl/user/s1934538/clickstream/clickstream-enwiki-2019-09.tsv.gz,Freddie_Mercury,154438,1289572,8461,1452471,499574
hdfs://spark-nn.eemcs.utwente.nl/user/s1934538/clickstream/clickstream-enwiki-2019-09.tsv.gz,Taliban,37608,174257,2431,214296,122179
hdfs://spark-nn.eemcs.utwente.nl/user/s1934538/clickstream/clickstream-enwiki-2019-09.tsv.gz,No_Time_to_Die,136682,95568,3893,236143,205644
hdfs://spark-nn.eemcs.utwente.nl/user/s1934538/clickstream/clickstream-enwiki-2019-09.tsv.gz,The_Irishman_(2019_film),115076,547267,11574,673917,497034
hdfs://spark-nn.eemcs.utwente.nl/user/s1934538/clickstream/clickstream-enwiki-2019-09.tsv.gz,The_Suicide_Squad_(film),55175,13859,442,69476,58273
hdfs://spark-nn.eemcs.utwente.nl/user/s1934538/clickstream/clickstream-enwiki-2019-12.tsv.gz,When_They_See_Us,31158,124759,895,156812,80830
hdfs://spark-nn.eemcs.utwente.nl/user/s1934538/clickstream/clickstream-enwiki-2019-12.tsv.gz,Exo_(band),27579,129535,681,157795,176284
hdfs://spark-nn.eemcs.utwente.nl/user/s1934538/clickstream/clickstream-enwiki-2019-12.tsv.gz,Death_of_Elisa_Lam,9092,76733,270,86095,21881
hdfs://spark-nn.eemcs.utwente.nl/user/s1934538/clickstream/clickstream-enwiki-2019-12.tsv.gz,Ghislaine_Maxwell,46716,192290,1246,240252,106249
hdfs://spark-nn.eemcs.utwente.nl/user/s1934538/clickstream/clickstream-enwiki-2019-12.tsv.gz,ICC_Men's_T20_World_Cup,13867,128415,158,142440,55144
hdfs://spark-nn.eemcs.utwente.nl/user/s1934538/clickstream/clickstream-enwiki-2019-12.tsv.gz,Stephen_Hawking,33742,387601,2152,423495,165264
hdfs://spark-nn.eemcs.utwente.nl/user/s1934538/clickstream/clickstream-enwiki-2019-12.tsv.gz,War_(2019_film),68695,639448,1361,709504,182723
hdfs://spark-nn.eemcs.utwente.nl/user/s1934538/clickstream/clickstream-enwiki-2019-12.tsv.gz,Shakira,20831,152889,1343,175063,79119
hdfs://spark-nn.eemcs.utwente.nl/user/s1934538/clickstream/clickstream-enwiki-2019-12.tsv.gz,Freddie_Mercury,119400,884113,5509,1009022,348269
hdfs://spark-nn.eemcs.utwente.nl/user/s1934538/clickstream/clickstream-enwiki-2019-12.tsv.gz,Simple_Mail_Transfer_Protocol,3917,29441,143,33501,3736
hdfs://spark-nn.eemcs.utwente.nl/user/s1934538/clickstream/clickstream-enwiki-2019-12.tsv.gz,Olivia_Newton-John,31757,182592,2216,216565,95887
hdfs://spark-nn.eemcs.utwente.nl/user/s1934538/clickstream/clickstream-enwiki-2019-12.tsv.gz,List_of_Queen_of_the_South_episodes,11060,9723,52,20835,508
hdfs://spark-nn.eemcs.utwente.nl/user/s1934538/clickstream/clickstream-enwiki-2019-12.tsv.gz,The_Weeknd,76315,226165,3100,305580,142676
hdfs://spark-nn.eemcs.utwente.nl/user/s1934538/clickstream/clickstream-enwiki-2019-12.tsv.gz,2016_United_States_presidential_election,116576,423134,3750,543460,288441
hdfs://spark-nn.eemcs.utwente.nl/user/s1934538/clickstream/clickstream-enwiki-2019-12.tsv.gz,John_McCain,37628,91133,2143,130904,58211
hdfs://spark-nn.eemcs.utwente.nl/user/s1934538/clickstream/clickstream-enwiki-2019-12.tsv.gz,Area_51,12955,173758,1093,187806,32662
hdfs://spark-nn.eemcs.utwente.nl/user/s1934538/clickstream/clickstream-enwiki-2019-12.tsv.gz,Indian_Premier_League,28942,140478,170,169590,102525
hdfs://spark-nn.eemcs.utwente.nl/user/s1934538/clickstream/clickstream-enwiki-2019-12.tsv.gz,The_Suicide_Squad_(film),106860,40081,1138,148079,131457
hdfs://spark-nn.eemcs.utwente.nl/user/s1934538/clickstream/clickstream-enwiki-2019-12.tsv.gz,Dennis_Nilsen,5347,35162,232,40741,8963
hdfs://spark-nn.eemcs.utwente.nl/user/s1934538/clickstream/clickstream-enwiki-2019-12.tsv.gz,List_of_most_popular_websites,13085,207630,181,220896,39737
hdfs://spark-nn.eemcs.utwente.nl/user/s1934538/clickstream/clickstream-enwiki-2019-12.tsv.gz,Cameron_Boyce,46294,453511,3352,503157,120300
hdfs://spark-nn.eemcs.utwente.nl/user/s1934538/clickstream/clickstream-enwiki-2019-12.tsv.gz,Bible,15595,403591,1389,420575,35109
hdfs://spark-nn.eemcs.utwente.nl/user/s1934538/clickstream/clickstream-enwiki-2019-12.tsv.gz,Grimes_(musician),59777,150650,926,211353,88738
hdfs://spark-nn.eemcs.utwente.nl/user/s1934538/clickstream/clickstream-enwiki-2019-12.tsv.gz,Kate_Spade,70424,97833,412,168669,51615
hdfs://spark-nn.eemcs.utwente.nl/user/s1934538/clickstream/clickstream-enwiki-2019-12.tsv.gz,R._Kelly,45540,236512,2271,284323,115957
hdfs://spark-nn.eemcs.utwente.nl/user/s1934538/clickstream/clickstream-enwiki-2019-12.tsv.gz,Rihanna,66982,248144,3936,319062,162766
hdfs://spark-nn.eemcs.utwente.nl/user/s1934538/clickstream/clickstream-enwiki-2019-12.tsv.gz,Joker_(2019_film),171146,1473472,26096,1670714,612409
hdfs://spark-nn.eemcs.utwente.nl/user/s1934538/clickstream/clickstream-enwiki-2019-12.tsv.gz,Richard_Jewell,324449,3337621,21509,3683579,957524
hdfs://spark-nn.eemcs.utwente.nl/user/s1934538/clickstream/clickstream-enwiki-2019-12.tsv.gz,Kim_Jong-un,51916,136845,1326,190087,117486
hdfs://spark-nn.eemcs.utwente.nl/user/s1934538/clickstream/clickstream-enwiki-2019-12.tsv.gz,2023_Cricket_World_Cup,10202,24959,100,35261,10008
hdfs://spark-nn.eemcs.utwente.nl/user/s1934538/clickstream/clickstream-enwiki-2019-12.tsv.gz,September_11_attacks,77219,316694,2494,396407,162095
hdfs://spark-nn.eemcs.utwente.nl/user/s1934538/clickstream/clickstream-enwiki-2019-12.tsv.gz,Charles_Sobhraj,4849,30334,88,35271,8143
hdfs://spark-nn.eemcs.utwente.nl/user/s1934538/clickstream/clickstream-enwiki-2019-12.tsv.gz,Spanish_flu,24306,87752,764,112822,26910
hdfs://spark-nn.eemcs.utwente.nl/user/s1934538/clickstream/clickstream-enwiki-2019-12.tsv.gz,"Meghan,_Duchess_of_Sussex",118675,228992,1489,349156,205967
hdfs://spark-nn.eemcs.utwente.nl/user/s1934538/clickstream/clickstream-enwiki-2019-12.tsv.gz,Luke_Perry,88506,338306,3252,430064,100938
hdfs://spark-nn.eemcs.utwente.nl/user/s1934538/clickstream/clickstream-enwiki-2019-12.tsv.gz,Queen_(band),76821,662388,2986,742195,318414
hdfs://spark-nn.eemcs.utwente.nl/user/s1934538/clickstream/clickstream-enwiki-2019-12.tsv.gz,Qasem_Soleimani,3039,6938,38,10015,4660
hdfs://spark-nn.eemcs.utwente.nl/user/s1934538/clickstream/clickstream-enwiki-2019-12.tsv.gz,George_H._W._Bush,136223,137873,1202,275298,155880
hdfs://spark-nn.eemcs.utwente.nl/user/s1934538/clickstream/clickstream-enwiki-2019-12.tsv.gz,Critical_race_theory,1640,20211,56,21907,4409
hdfs://spark-nn.eemcs.utwente.nl/user/s1934538/clickstream/clickstream-enwiki-2019-12.tsv.gz,Star_Wars:_The_Rise_of_Skywalker,1093265,6466066,231965,7791296,4092899
hdfs://spark-nn.eemcs.utwente.nl/user/s1934538/clickstream/clickstream-enwiki-2019-12.tsv.gz,Israel,76279,269798,4098,350175,162939
hdfs://spark-nn.eemcs.utwente.nl/user/s1934538/clickstream/clickstream-enwiki-2019-12.tsv.gz,Stranger_Things_(season_3),17515,65572,863,83950,53498
hdfs://spark-nn.eemcs.utwente.nl/user/s1934538/clickstream/clickstream-enwiki-2019-12.tsv.gz,Cecil_Hotel_(Los_Angeles),5421,28889,45,34355,12156
hdfs://spark-nn.eemcs.utwente.nl/user/s1934538/clickstream/clickstream-enwiki-2019-12.tsv.gz,Central_Park_jogger_case,46352,179808,448,226608,29597
hdfs://spark-nn.eemcs.utwente.nl/user/s1934538/clickstream/clickstream-enwiki-2019-12.tsv.gz,Google_logo,1393,37877,11,39281,1230
hdfs://spark-nn.eemcs.utwente.nl/user/s1934538/clickstream/clickstream-enwiki-2019-12.tsv.gz,Antifa_(United_States),6454,80385,143,86982,12972
hdfs://spark-nn.eemcs.utwente.nl/user/s1934538/clickstream/clickstream-enwiki-2019-12.tsv.gz,The_Haunting_of_Bly_Manor,59093,15541,29,74663,61662
hdfs://spark-nn.eemcs.utwente.nl/user/s1934538/clickstream/clickstream-enwiki-2019-12.tsv.gz,2022_FIFA_World_Cup,55588,124284,2419,182291,98126
hdfs://spark-nn.eemcs.utwente.nl/user/s1934538/clickstream/clickstream-enwiki-2019-12.tsv.gz,Kelly_Preston,87924,59524,240,147688,43712
hdfs://spark-nn.eemcs.utwente.nl/user/s1934538/clickstream/clickstream-enwiki-2019-12.tsv.gz,Sushant_Singh_Rajput,26009,64741,248,90998,48433
hdfs://spark-nn.eemcs.utwente.nl/user/s1934538/clickstream/clickstream-enwiki-2019-12.tsv.gz,Tunnel,3467,11350,104,14921,3279
hdfs://spark-nn.eemcs.utwente.nl/user/s1934538/clickstream/clickstream-enwiki-2019-12.tsv.gz,2018_Asian_Games,24283,39628,404,64315,53516
hdfs://spark-nn.eemcs.utwente.nl/user/s1934538/clickstream/clickstream-enwiki-2019-12.tsv.gz,Fantastic_Beasts:_The_Crimes_of_Grindelwald,73192,128150,1425,202767,107264
hdfs://spark-nn.eemcs.utwente.nl/user/s1934538/clickstream/clickstream-enwiki-2019-12.tsv.gz,List_of_FIFA_World_Cup_finals,2025,38334,67,40426,10686
hdfs://spark-nn.eemcs.utwente.nl/user/s1934538/clickstream/clickstream-enwiki-2019-12.tsv.gz,Henry_V_of_England,174091,499459,2272,675822,452445
hdfs://spark-nn.eemcs.utwente.nl/user/s1934538/clickstream/clickstream-enwiki-2019-12.tsv.gz,Afghanistan,50255,163513,2041,215809,103819
hdfs://spark-nn.eemcs.utwente.nl/user/s1934538/clickstream/clickstream-enwiki-2019-12.tsv.gz,Mötley_Crüe,33695,140192,1832,175719,192778
hdfs://spark-nn.eemcs.utwente.nl/user/s1934538/clickstream/clickstream-enwiki-2019-12.tsv.gz,Coronavirus,998,11337,47,12382,1476
hdfs://spark-nn.eemcs.utwente.nl/user/s1934538/clickstream/clickstream-enwiki-2019-12.tsv.gz,Game_of_Thrones,77084,287187,9559,373830,227387
hdfs://spark-nn.eemcs.utwente.nl/user/s1934538/clickstream/clickstream-enwiki-2019-12.tsv.gz,Murder_of_Dee_Dee_Blanchard,17545,157793,341,175679,30807
hdfs://spark-nn.eemcs.utwente.nl/user/s1934538/clickstream/clickstream-enwiki-2019-12.tsv.gz,Parasite_(2019_film),73297,890220,11487,975004,379738
hdfs://spark-nn.eemcs.utwente.nl/user/s1934538/clickstream/clickstream-enwiki-2019-12.tsv.gz,2018_Winter_Olympics,30373,33618,393,64384,40479
hdfs://spark-nn.eemcs.utwente.nl/user/s1934538/clickstream/clickstream-enwiki-2019-12.tsv.gz,Deion_Sanders,19884,198552,998,219434,65010
hdfs://spark-nn.eemcs.utwente.nl/user/s1934538/clickstream/clickstream-enwiki-2019-12.tsv.gz,Naya_Rivera,24867,32735,69,57671,11852
hdfs://spark-nn.eemcs.utwente.nl/user/s1934538/clickstream/clickstream-enwiki-2019-12.tsv.gz,XXX:_Return_of_Xander_Cage,36464,114713,491,151668,42931
hdfs://spark-nn.eemcs.utwente.nl/user/s1934538/clickstream/clickstream-enwiki-2019-12.tsv.gz,Elizabeth_II,971707,1685890,6995,2664592,2293975
hdfs://spark-nn.eemcs.utwente.nl/user/s1934538/clickstream/clickstream-enwiki-2019-12.tsv.gz,Keanu_Reeves,94300,499112,3885,597297,344498
hdfs://spark-nn.eemcs.utwente.nl/user/s1934538/clickstream/clickstream-enwiki-2019-12.tsv.gz,Deaths_in_2019,112010,2286110,1109671,3507791,2087421
hdfs://spark-nn.eemcs.utwente.nl/user/s1934538/clickstream/clickstream-enwiki-2019-12.tsv.gz,Saaho,35471,236674,2578,274723,89629
hdfs://spark-nn.eemcs.utwente.nl/user/s1934538/clickstream/clickstream-enwiki-2019-12.tsv.gz,Main_Page,29903,330274582,4274368,334578853,31094731
hdfs://spark-nn.eemcs.utwente.nl/user/s1934538/clickstream/clickstream-enwiki-2019-12.tsv.gz,21_Savage,20453,83120,1032,104605,32489
hdfs://spark-nn.eemcs.utwente.nl/user/s1934538/clickstream/clickstream-enwiki-2019-12.tsv.gz,Valentine's_Day,3408,50226,648,54282,4116
hdfs://spark-nn.eemcs.utwente.nl/user/s1934538/clickstream/clickstream-enwiki-2019-12.tsv.gz,State_of_Palestine,40094,97301,70,137465,55370
hdfs://spark-nn.eemcs.utwente.nl/user/s1934538/clickstream/clickstream-enwiki-2019-12.tsv.gz,Avengers:_Infinity_War,72449,135959,1847,210255,106715
hdfs://spark-nn.eemcs.utwente.nl/user/s1934538/clickstream/clickstream-enwiki-2019-12.tsv.gz,Jason_Momoa,104506,359097,2030,465633,199144
hdfs://spark-nn.eemcs.utwente.nl/user/s1934538/clickstream/clickstream-enwiki-2019-12.tsv.gz,Line_shaft,479,1079,13,1571,85
hdfs://spark-nn.eemcs.utwente.nl/user/s1934538/clickstream/clickstream-enwiki-2019-12.tsv.gz,Royal_Rumble_(2018),12948,7070,122,20140,13914
hdfs://spark-nn.eemcs.utwente.nl/user/s1934538/clickstream/clickstream-enwiki-2019-12.tsv.gz,2.0_(film),28445,63975,206,92626,22752
hdfs://spark-nn.eemcs.utwente.nl/user/s1934538/clickstream/clickstream-enwiki-2019-12.tsv.gz,NATO,45810,240095,4209,290114,98534
hdfs://spark-nn.eemcs.utwente.nl/user/s1934538/clickstream/clickstream-enwiki-2019-12.tsv.gz,Asia_Cup,1196,13545,79,14820,8505
hdfs://spark-nn.eemcs.utwente.nl/user/s1934538/clickstream/clickstream-enwiki-2019-12.tsv.gz,Bird_Box_(film),19862,101433,1113,122408,38771
hdfs://spark-nn.eemcs.utwente.nl/user/s1934538/clickstream/clickstream-enwiki-2019-12.tsv.gz,List_of_highest-grossing_films,263234,544749,4765,812748,347642
hdfs://spark-nn.eemcs.utwente.nl/user/s1934538/clickstream/clickstream-enwiki-2019-12.tsv.gz,Brie_Larson,89605,352502,2645,444752,169909
hdfs://spark-nn.eemcs.utwente.nl/user/s1934538/clickstream/clickstream-enwiki-2019-12.tsv.gz,Cook's_Country,360,2969,34,3363,847
hdfs://spark-nn.eemcs.utwente.nl/user/s1934538/clickstream/clickstream-enwiki-2019-12.tsv.gz,WandaVision,45448,30788,316,76552,41300
hdfs://spark-nn.eemcs.utwente.nl/user/s1934538/clickstream/clickstream-enwiki-2019-12.tsv.gz,Watts_family_murders,5536,267423,463,273422,66381
hdfs://spark-nn.eemcs.utwente.nl/user/s1934538/clickstream/clickstream-enwiki-2019-12.tsv.gz,Juneteenth,17812,25881,44,43737,4158
hdfs://spark-nn.eemcs.utwente.nl/user/s1934538/clickstream/clickstream-enwiki-2019-12.tsv.gz,A_Star_Is_Born_(2018_film),42224,235763,1087,279074,119891
hdfs://spark-nn.eemcs.utwente.nl/user/s1934538/clickstream/clickstream-enwiki-2019-12.tsv.gz,RRR_(film),53294,58834,69,112197,70827
hdfs://spark-nn.eemcs.utwente.nl/user/s1934538/clickstream/clickstream-enwiki-2019-12.tsv.gz,Charles_III,112,255,64,431,292
hdfs://spark-nn.eemcs.utwente.nl/user/s1934538/clickstream/clickstream-enwiki-2019-12.tsv.gz,William_Murdoch,546,2005,21,2572,363
hdfs://spark-nn.eemcs.utwente.nl/user/s1934538/clickstream/clickstream-enwiki-2019-12.tsv.gz,Cristiano_Ronaldo,115521,737065,5028,857614,197262
hdfs://spark-nn.eemcs.utwente.nl/user/s1934538/clickstream/clickstream-enwiki-2019-12.tsv.gz,No_Time_to_Die,257683,557967,14415,830065,779764
hdfs://spark-nn.eemcs.utwente.nl/user/s1934538/clickstream/clickstream-enwiki-2019-12.tsv.gz,Laal_Singh_Chaddha,58755,75640,99,134494,69905
hdfs://spark-nn.eemcs.utwente.nl/user/s1934538/clickstream/clickstream-enwiki-2019-12.tsv.gz,Top_Gun:_Maverick,82893,219847,5340,308080,257396
hdfs://spark-nn.eemcs.utwente.nl/user/s1934538/clickstream/clickstream-enwiki-2019-12.tsv.gz,"Citizenship_(Amendment)_Act,_2019",113223,4606715,49707,4769645,341408
hdfs://spark-nn.eemcs.utwente.nl/user/s1934538/clickstream/clickstream-enwiki-2019-12.tsv.gz,Once_Upon_a_Time_in_Hollywood,237674,1317319,22692,1577685,1833151
hdfs://spark-nn.eemcs.utwente.nl/user/s1934538/clickstream/clickstream-enwiki-2019-12.tsv.gz,Jenna_Ortega,155478,106896,1018,263392,36848
hdfs://spark-nn.eemcs.utwente.nl/user/s1934538/clickstream/clickstream-enwiki-2019-12.tsv.gz,XXXTentacion,120223,689339,7330,816892,187267
hdfs://spark-nn.eemcs.utwente.nl/user/s1934538/clickstream/clickstream-enwiki-2019-12.tsv.gz,Fyre_Festival,11563,98260,638,110461,54296
hdfs://spark-nn.eemcs.utwente.nl/user/s1934538/clickstream/clickstream-enwiki-2020-01.tsv.gz,Spider-Man:_Far_From_Home,103596,218461,3335,325392,185907
hdfs://spark-nn.eemcs.utwente.nl/user/s1934538/clickstream/clickstream-enwiki-2020-01.tsv.gz,Captain_Marvel_(film),57179,182089,2570,241838,133445
hdfs://spark-nn.eemcs.utwente.nl/user/s1934538/clickstream/clickstream-enwiki-2020-01.tsv.gz,List_of_Queen_of_the_South_episodes,11737,9741,57,21535,556
hdfs://spark-nn.eemcs.utwente.nl/user/s1934538/clickstream/clickstream-enwiki-2020-01.tsv.gz,Glass_(2019_film),64993,140295,1906,207194,68916
hdfs://spark-nn.eemcs.utwente.nl/user/s1934538/clickstream/clickstream-enwiki-2020-01.tsv.gz,Shakira,46281,424744,3604,474629,200206
hdfs://spark-nn.eemcs.utwente.nl/user/s1934538/clickstream/clickstream-enwiki-2020-01.tsv.gz,Richard_Ramirez,13676,125730,1071,140477,50051
hdfs://spark-nn.eemcs.utwente.nl/user/s1934538/clickstream/clickstream-enwiki-2020-01.tsv.gz,2022_FIFA_World_Cup,50217,115074,1873,167164,80234
hdfs://spark-nn.eemcs.utwente.nl/user/s1934538/clickstream/clickstream-enwiki-2020-01.tsv.gz,DMX_(rapper),14130,57636,431,72197,30756
hdfs://spark-nn.eemcs.utwente.nl/user/s1934538/clickstream/clickstream-enwiki-2020-01.tsv.gz,List_of_highest-grossing_Indian_films,82362,382147,3129,467638,244160
hdfs://spark-nn.eemcs.utwente.nl/user/s1934538/clickstream/clickstream-enwiki-2020-01.tsv.gz,Asia_Cup,2589,27692,138,30419,17355
hdfs://spark-nn.eemcs.utwente.nl/user/s1934538/clickstream/clickstream-enwiki-2020-01.tsv.gz,WandaVision,56119,59404,760,116283,59725
hdfs://spark-nn.eemcs.utwente.nl/user/s1934538/clickstream/clickstream-enwiki-2020-01.tsv.gz,Kobe_Bryant,592000,21652101,327627,22571728,4547308
hdfs://spark-nn.eemcs.utwente.nl/user/s1934538/clickstream/clickstream-enwiki-2020-01.tsv.gz,Jimmy_Hoffa,237684,1272670,10156,1520510,505101
hdfs://spark-nn.eemcs.utwente.nl/user/s1934538/clickstream/clickstream-enwiki-2020-01.tsv.gz,The_Mandalorian,234604,1370153,24187,1628944,1017180
hdfs://spark-nn.eemcs.utwente.nl/user/s1934538/clickstream/clickstream-enwiki-2020-01.tsv.gz,Ruth_Bader_Ginsburg,47340,276632,1537,325509,124371
hdfs://spark-nn.eemcs.utwente.nl/user/s1934538/clickstream/clickstream-enwiki-2020-01.tsv.gz,September_11_attacks,95954,388523,2764,487241,205309
hdfs://spark-nn.eemcs.utwente.nl/user/s1934538/clickstream/clickstream-enwiki-2020-01.tsv.gz,Johnny_Depp,128141,327720,2141,458002,305227
hdfs://spark-nn.eemcs.utwente.nl/user/s1934538/clickstream/clickstream-enwiki-2020-01.tsv.gz,War_(2019_film),52509,301141,632,354282,77833
hdfs://spark-nn.eemcs.utwente.nl/user/s1934538/clickstream/clickstream-enwiki-2020-01.tsv.gz,Manti_Te'o,6621,35848,411,42880,5066
hdfs://spark-nn.eemcs.utwente.nl/user/s1934538/clickstream/clickstream-enwiki-2020-01.tsv.gz,Army_of_the_Dead,32034,10209,58,42301,11482
hdfs://spark-nn.eemcs.utwente.nl/user/s1934538/clickstream/clickstream-enwiki-2020-01.tsv.gz,State_of_Palestine,64434,191568,248,256250,110633
hdfs://spark-nn.eemcs.utwente.nl/user/s1934538/clickstream/clickstream-enwiki-2020-01.tsv.gz,2020_United_States_presidential_election,145087,426141,6383,577611,350093
hdfs://spark-nn.eemcs.utwente.nl/user/s1934538/clickstream/clickstream-enwiki-2020-01.tsv.gz,Stephen_Hawking,37509,458169,11417,507095,206805
hdfs://spark-nn.eemcs.utwente.nl/user/s1934538/clickstream/clickstream-enwiki-2020-01.tsv.gz,Stranger_Things,71900,353123,7004,432027,345793
hdfs://spark-nn.eemcs.utwente.nl/user/s1934538/clickstream/clickstream-enwiki-2020-01.tsv.gz,Aaron_Hernandez,123697,7149280,34292,7307269,2112473
hdfs://spark-nn.eemcs.utwente.nl/user/s1934538/clickstream/clickstream-enwiki-2020-01.tsv.gz,Olivia_Newton-John,29919,97328,1098,128345,55159
hdfs://spark-nn.eemcs.utwente.nl/user/s1934538/clickstream/clickstream-enwiki-2020-01.tsv.gz,Anthony_Bourdain,16551,181876,1601,200028,55773
hdfs://spark-nn.eemcs.utwente.nl/user/s1934538/clickstream/clickstream-enwiki-2020-01.tsv.gz,Brie_Larson,97248,203009,1620,301877,116463
hdfs://spark-nn.eemcs.utwente.nl/user/s1934538/clickstream/clickstream-enwiki-2020-01.tsv.gz,Exo_(band),27559,128411,798,156768,183404
hdfs://spark-nn.eemcs.utwente.nl/user/s1934538/clickstream/clickstream-enwiki-2020-01.tsv.gz,21_Savage,18641,86195,1294,106130,34431
hdfs://spark-nn.eemcs.utwente.nl/user/s1934538/clickstream/clickstream-enwiki-2020-01.tsv.gz,Hyphen-minus,4798,49630726,7530529,57166053,672
hdfs://spark-nn.eemcs.utwente.nl/user/s1934538/clickstream/clickstream-enwiki-2020-01.tsv.gz,It_Chapter_Two,60854,222745,4074,287673,195194
hdfs://spark-nn.eemcs.utwente.nl/user/s1934538/clickstream/clickstream-enwiki-2020-01.tsv.gz,Gaza_Strip,27078,47151,290,74519,30043
hdfs://spark-nn.eemcs.utwente.nl/user/s1934538/clickstream/clickstream-enwiki-2020-01.tsv.gz,Microsoft_Office,9321,598291,722,608334,22636
hdfs://spark-nn.eemcs.utwente.nl/user/s1934538/clickstream/clickstream-enwiki-2020-01.tsv.gz,Key_frame,740,6792,12,7544,477
hdfs://spark-nn.eemcs.utwente.nl/user/s1934538/clickstream/clickstream-enwiki-2020-01.tsv.gz,R._Kelly,52368,388561,3582,444511,166688
hdfs://spark-nn.eemcs.utwente.nl/user/s1934538/clickstream/clickstream-enwiki-2020-01.tsv.gz,Israel,112269,417624,6414,536307,243245
hdfs://spark-nn.eemcs.utwente.nl/user/s1934538/clickstream/clickstream-enwiki-2020-01.tsv.gz,The_Irishman,236404,1304926,22676,1564006,1313307
hdfs://spark-nn.eemcs.utwente.nl/user/s1934538/clickstream/clickstream-enwiki-2020-01.tsv.gz,Jenna_Ortega,193251,202324,1813,397388,51184
hdfs://spark-nn.eemcs.utwente.nl/user/s1934538/clickstream/clickstream-enwiki-2020-01.tsv.gz,2.0_(film),31953,60374,262,92589,24535
hdfs://spark-nn.eemcs.utwente.nl/user/s1934538/clickstream/clickstream-enwiki-2020-01.tsv.gz,Godzilla_vs._Kong,86413,83325,1587,171325,110587
hdfs://spark-nn.eemcs.utwente.nl/user/s1934538/clickstream/clickstream-enwiki-2020-01.tsv.gz,Qasem_Soleimani,230456,4130078,223762,4584296,2036472
hdfs://spark-nn.eemcs.utwente.nl/user/s1934538/clickstream/clickstream-enwiki-2020-01.tsv.gz,Croatia,45091,165768,1968,212827,68046
hdfs://spark-nn.eemcs.utwente.nl/user/s1934538/clickstream/clickstream-enwiki-2020-01.tsv.gz,Tom_Brady,124027,769748,8770,902545,329165
hdfs://spark-nn.eemcs.utwente.nl/user/s1934538/clickstream/clickstream-enwiki-2020-01.tsv.gz,Ted_Bundy,49686,665414,6074,721174,153112
hdfs://spark-nn.eemcs.utwente.nl/user/s1934538/clickstream/clickstream-enwiki-2020-01.tsv.gz,Venom_(2018_film),50344,149133,1951,201428,107676
hdfs://spark-nn.eemcs.utwente.nl/user/s1934538/clickstream/clickstream-enwiki-2020-01.tsv.gz,Aretha_Franklin,25742,102132,867,128741,45475
hdfs://spark-nn.eemcs.utwente.nl/user/s1934538/clickstream/clickstream-enwiki-2020-01.tsv.gz,List_of_Marvel_Cinematic_Universe_films,122171,730366,2208,854745,365013
hdfs://spark-nn.eemcs.utwente.nl/user/s1934538/clickstream/clickstream-enwiki-2020-01.tsv.gz,J._Robert_Oppenheimer,22191,118792,458,141441,42806
hdfs://spark-nn.eemcs.utwente.nl/user/s1934538/clickstream/clickstream-enwiki-2020-01.tsv.gz,Aquaman_(film),44761,166693,2303,213757,125583
hdfs://spark-nn.eemcs.utwente.nl/user/s1934538/clickstream/clickstream-enwiki-2020-01.tsv.gz,Freddie_Mercury,90400,595928,4447,690775,249602
hdfs://spark-nn.eemcs.utwente.nl/user/s1934538/clickstream/clickstream-enwiki-2020-01.tsv.gz,List_of_FIFA_World_Cup_finals,1861,32517,63,34441,10217
hdfs://spark-nn.eemcs.utwente.nl/user/s1934538/clickstream/clickstream-enwiki-2020-01.tsv.gz,David_Beckham,38232,164303,1274,203809,65284
hdfs://spark-nn.eemcs.utwente.nl/user/s1934538/clickstream/clickstream-enwiki-2020-01.tsv.gz,Deaths_in_2020,1658745,1754361,11119,3424225,2117707
hdfs://spark-nn.eemcs.utwente.nl/user/s1934538/clickstream/clickstream-enwiki-2020-01.tsv.gz,William_Murdoch,653,1881,10,2544,315
hdfs://spark-nn.eemcs.utwente.nl/user/s1934538/clickstream/clickstream-enwiki-2020-01.tsv.gz,2019–20_Wuhan_coronavirus_outbreak,1515088,2410520,4496,3930104,1057532
hdfs://spark-nn.eemcs.utwente.nl/user/s1934538/clickstream/clickstream-enwiki-2020-01.tsv.gz,Grimes_(musician),177075,417160,2134,596369,223139
hdfs://spark-nn.eemcs.utwente.nl/user/s1934538/clickstream/clickstream-enwiki-2020-01.tsv.gz,Charles_Sobhraj,5196,31874,131,37201,8776
hdfs://spark-nn.eemcs.utwente.nl/user/s1934538/clickstream/clickstream-enwiki-2020-01.tsv.gz,Kim_Jong-un,67567,181551,1716,250834,155377
hdfs://spark-nn.eemcs.utwente.nl/user/s1934538/clickstream/clickstream-enwiki-2020-01.tsv.gz,Chernobyl_(miniseries),44704,229994,4595,279293,249586
hdfs://spark-nn.eemcs.utwente.nl/user/s1934538/clickstream/clickstream-enwiki-2020-01.tsv.gz,Cleopatra,39177,149462,1664,190303,78045
hdfs://spark-nn.eemcs.utwente.nl/user/s1934538/clickstream/clickstream-enwiki-2020-01.tsv.gz,Tunnel,3712,11691,153,15556,3548
hdfs://spark-nn.eemcs.utwente.nl/user/s1934538/clickstream/clickstream-enwiki-2020-01.tsv.gz,The_Umbrella_Academy_(TV_series),29139,152665,2382,184186,90219
hdfs://spark-nn.eemcs.utwente.nl/user/s1934538/clickstream/clickstream-enwiki-2020-01.tsv.gz,Burt_Reynolds,67367,146426,1196,214989,81242
hdfs://spark-nn.eemcs.utwente.nl/user/s1934538/clickstream/clickstream-enwiki-2020-01.tsv.gz,Amber_Heard,122986,167911,1078,291975,132516
hdfs://spark-nn.eemcs.utwente.nl/user/s1934538/clickstream/clickstream-enwiki-2020-01.tsv.gz,Avengers:_Endgame,195530,406637,8962,611129,409042
hdfs://spark-nn.eemcs.utwente.nl/user/s1934538/clickstream/clickstream-enwiki-2020-01.tsv.gz,The_Nun_(2018_film),18273,63576,375,82224,51885
hdfs://spark-nn.eemcs.utwente.nl/user/s1934538/clickstream/clickstream-enwiki-2020-01.tsv.gz,Notre-Dame_de_Paris,14541,95381,1086,111008,23542
hdfs://spark-nn.eemcs.utwente.nl/user/s1934538/clickstream/clickstream-enwiki-2020-01.tsv.gz,Cook's_Country,444,3343,18,3805,1014
hdfs://spark-nn.eemcs.utwente.nl/user/s1934538/clickstream/clickstream-enwiki-2020-01.tsv.gz,Star_Wars:_The_Rise_of_Skywalker,469407,1854664,66543,2390614,1293285
hdfs://spark-nn.eemcs.utwente.nl/user/s1934538/clickstream/clickstream-enwiki-2020-01.tsv.gz,Bipin_Rawat,26912,108189,227,135328,69928
hdfs://spark-nn.eemcs.utwente.nl/user/s1934538/clickstream/clickstream-enwiki-2020-01.tsv.gz,Avengers:_Infinity_War,67327,103473,1720,172520,99582
hdfs://spark-nn.eemcs.utwente.nl/user/s1934538/clickstream/clickstream-enwiki-2020-01.tsv.gz,2016_United_States_presidential_election,134918,351419,3622,489959,327553
hdfs://spark-nn.eemcs.utwente.nl/user/s1934538/clickstream/clickstream-enwiki-2020-01.tsv.gz,Matthew_Perry,66892,155938,710,223540,118676
hdfs://spark-nn.eemcs.utwente.nl/user/s1934538/clickstream/clickstream-enwiki-2020-01.tsv.gz,Lisa_Marie_Presley,128051,83709,312,212072,116812
hdfs://spark-nn.eemcs.utwente.nl/user/s1934538/clickstream/clickstream-enwiki-2020-01.tsv.gz,Coronavirus,120935,8097305,171607,8389847,1925372
hdfs://spark-nn.eemcs.utwente.nl/user/s1934538/clickstream/clickstream-enwiki-2020-01.tsv.gz,List_of_most_popular_websites,14446,202653,176,217275,40391
hdfs://spark-nn.eemcs.utwente.nl/user/s1934538/clickstream/clickstream-enwiki-2020-01.tsv.gz,Atal_Bihari_Vajpayee,24623,55529,461,80613,19443
hdfs://spark-nn.eemcs.utwente.nl/user/s1934538/clickstream/clickstream-enwiki-2020-01.tsv.gz,IPv4,12595,49195,127,61917,10385
hdfs://spark-nn.eemcs.utwente.nl/user/s1934538/clickstream/clickstream-enwiki-2020-01.tsv.gz,Mac_Miller,67324,604608,6184,678116,283758
hdfs://spark-nn.eemcs.utwente.nl/user/s1934538/clickstream/clickstream-enwiki-2020-01.tsv.gz,Louis_Tomlinson,39043,107616,837,147496,31335
hdfs://spark-nn.eemcs.utwente.nl/user/s1934538/clickstream/clickstream-enwiki-2020-01.tsv.gz,Ray_Liotta,47743,66993,534,115270,39708
hdfs://spark-nn.eemcs.utwente.nl/user/s1934538/clickstream/clickstream-enwiki-2020-01.tsv.gz,Cardi_B,60641,354936,5305,420882,119803
hdfs://spark-nn.eemcs.utwente.nl/user/s1934538/clickstream/clickstream-enwiki-2020-01.tsv.gz,Main_Page,34772,329126035,5269214,334430021,34908688
hdfs://spark-nn.eemcs.utwente.nl/user/s1934538/clickstream/clickstream-enwiki-2020-01.tsv.gz,Simple_Mail_Transfer_Protocol,4476,32530,125,37131,4223
hdfs://spark-nn.eemcs.utwente.nl/user/s1934538/clickstream/clickstream-enwiki-2020-01.tsv.gz,Puneeth_Rajkumar,9644,28718,105,38467,14386
hdfs://spark-nn.eemcs.utwente.nl/user/s1934538/clickstream/clickstream-enwiki-2020-01.tsv.gz,WrestleMania_34,32184,14726,176,47086,32992
hdfs://spark-nn.eemcs.utwente.nl/user/s1934538/clickstream/clickstream-enwiki-2020-01.tsv.gz,Donald_Glover,59709,165468,2251,227428,78590
hdfs://spark-nn.eemcs.utwente.nl/user/s1934538/clickstream/clickstream-enwiki-2020-01.tsv.gz,Area_51,13415,188104,1328,202847,37021
hdfs://spark-nn.eemcs.utwente.nl/user/s1934538/clickstream/clickstream-enwiki-2020-01.tsv.gz,Khabib_Nurmagomedov,216030,427629,3670,647329,331111
hdfs://spark-nn.eemcs.utwente.nl/user/s1934538/clickstream/clickstream-enwiki-2020-01.tsv.gz,HTTP_cookie,5450,363069,116,368635,25244
hdfs://spark-nn.eemcs.utwente.nl/user/s1934538/clickstream/clickstream-enwiki-2020-01.tsv.gz,Charles_III,104,343,88,535,397
hdfs://spark-nn.eemcs.utwente.nl/user/s1934538/clickstream/clickstream-enwiki-2020-01.tsv.gz,The_Weeknd,69920,202105,2327,274352,115214
hdfs://spark-nn.eemcs.utwente.nl/user/s1934538/clickstream/clickstream-enwiki-2020-01.tsv.gz,2020_Summer_Olympics,102620,452091,11041,565752,426873
hdfs://spark-nn.eemcs.utwente.nl/user/s1934538/clickstream/clickstream-enwiki-2022-01.tsv.gz,IPv4,9956,40967,135,51058,9109
hdfs://spark-nn.eemcs.utwente.nl/user/s1934538/clickstream/clickstream-enwiki-2022-01.tsv.gz,Lists_of_deaths_by_year,11484,646805,5520,663809,628707
hdfs://spark-nn.eemcs.utwente.nl/user/s1934538/clickstream/clickstream-enwiki-2022-01.tsv.gz,Area_51,15929,118117,1360,135406,40403
hdfs://spark-nn.eemcs.utwente.nl/user/s1934538/clickstream/clickstream-enwiki-2022-01.tsv.gz,Microsoft_Office,8746,1883344,786,1892876,20290
hdfs://spark-nn.eemcs.utwente.nl/user/s1934538/clickstream/clickstream-enwiki-2022-01.tsv.gz,Black_Panther:_Wakanda_Forever,177833,129577,1615,309025,245058
hdfs://spark-nn.eemcs.utwente.nl/user/s1934538/clickstream/clickstream-enwiki-2022-01.tsv.gz,The_Suicide_Squad_(film),186926,298743,6066,491735,396807
hdfs://spark-nn.eemcs.utwente.nl/user/s1934538/clickstream/clickstream-enwiki-2022-01.tsv.gz,Salman_Rushdie,28590,68761,498,97849,40175
hdfs://spark-nn.eemcs.utwente.nl/user/s1934538/clickstream/clickstream-enwiki-2022-01.tsv.gz,John_McCain,31357,58979,857,91193,44002
hdfs://spark-nn.eemcs.utwente.nl/user/s1934538/clickstream/clickstream-enwiki-2022-01.tsv.gz,Alexander_Hamilton,76053,234516,2271,312840,165536
hdfs://spark-nn.eemcs.utwente.nl/user/s1934538/clickstream/clickstream-enwiki-2022-01.tsv.gz,Hamas,23940,34979,274,59193,25845
hdfs://spark-nn.eemcs.utwente.nl/user/s1934538/clickstream/clickstream-enwiki-2022-01.tsv.gz,Spanish_flu,52389,451029,4913,508331,112689
hdfs://spark-nn.eemcs.utwente.nl/user/s1934538/clickstream/clickstream-enwiki-2022-01.tsv.gz,Media,62,3882,470,4414,1415
hdfs://spark-nn.eemcs.utwente.nl/user/s1934538/clickstream/clickstream-enwiki-2022-01.tsv.gz,Vladimir_Putin,148014,540713,8119,696846,452843
hdfs://spark-nn.eemcs.utwente.nl/user/s1934538/clickstream/clickstream-enwiki-2022-01.tsv.gz,Captain_Marvel_(film),65838,144249,1729,211816,109390
hdfs://spark-nn.eemcs.utwente.nl/user/s1934538/clickstream/clickstream-enwiki-2022-01.tsv.gz,Rami_Malek,82516,218475,1050,302041,129121
hdfs://spark-nn.eemcs.utwente.nl/user/s1934538/clickstream/clickstream-enwiki-2022-01.tsv.gz,Amber_Heard,112284,190662,1119,304065,108709
hdfs://spark-nn.eemcs.utwente.nl/user/s1934538/clickstream/clickstream-enwiki-2022-01.tsv.gz,Khabib_Nurmagomedov,52779,212217,12549,277545,147538
hdfs://spark-nn.eemcs.utwente.nl/user/s1934538/clickstream/clickstream-enwiki-2022-01.tsv.gz,The_Flash_(film),102755,92464,1835,197054,148493
hdfs://spark-nn.eemcs.utwente.nl/user/s1934538/clickstream/clickstream-enwiki-2022-01.tsv.gz,Adele,49080,380869,6560,436509,172233
hdfs://spark-nn.eemcs.utwente.nl/user/s1934538/clickstream/clickstream-enwiki-2022-01.tsv.gz,Loki_(TV_series),59034,195014,3842,257890,147862
hdfs://spark-nn.eemcs.utwente.nl/user/s1934538/clickstream/clickstream-enwiki-2022-01.tsv.gz,Kamala_Harris,83416,214272,2258,299946,121734
hdfs://spark-nn.eemcs.utwente.nl/user/s1934538/clickstream/clickstream-enwiki-2022-01.tsv.gz,Anna_Sorokin,38755,234057,812,273624,93267
hdfs://spark-nn.eemcs.utwente.nl/user/s1934538/clickstream/clickstream-enwiki-2022-01.tsv.gz,Notre-Dame_de_Paris,13777,92151,948,106876,20269
hdfs://spark-nn.eemcs.utwente.nl/user/s1934538/clickstream/clickstream-enwiki-2022-01.tsv.gz,Kim_Jong-un,76587,192811,2024,271422,154687
hdfs://spark-nn.eemcs.utwente.nl/user/s1934538/clickstream/clickstream-enwiki-2022-01.tsv.gz,Dark_Phoenix_(film),66441,58839,836,126116,74383
hdfs://spark-nn.eemcs.utwente.nl/user/s1934538/clickstream/clickstream-enwiki-2022-01.tsv.gz,Watts_family_murders,13325,152718,373,166416,41222
hdfs://spark-nn.eemcs.utwente.nl/user/s1934538/clickstream/clickstream-enwiki-2022-01.tsv.gz,R._Kelly,28143,158657,1829,188629,98835
hdfs://spark-nn.eemcs.utwente.nl/user/s1934538/clickstream/clickstream-enwiki-2022-01.tsv.gz,WrestleMania_34,21545,10713,207,32465,21282
hdfs://spark-nn.eemcs.utwente.nl/user/s1934538/clickstream/clickstream-enwiki-2022-01.tsv.gz,Croatia,56818,162364,2931,222113,81896
hdfs://spark-nn.eemcs.utwente.nl/user/s1934538/clickstream/clickstream-enwiki-2022-01.tsv.gz,COVID-19_pandemic,343058,410864,1857,755779,356086
hdfs://spark-nn.eemcs.utwente.nl/user/s1934538/clickstream/clickstream-enwiki-2022-01.tsv.gz,The_Falcon_and_the_Winter_Soldier,52585,112335,2021,166941,109453
hdfs://spark-nn.eemcs.utwente.nl/user/s1934538/clickstream/clickstream-enwiki-2022-01.tsv.gz,Cristiano_Ronaldo,116956,1168029,7001,1291986,290381
hdfs://spark-nn.eemcs.utwente.nl/user/s1934538/clickstream/clickstream-enwiki-2022-01.tsv.gz,Squid_Game,54381,481757,11487,547625,277705
hdfs://spark-nn.eemcs.utwente.nl/user/s1934538/clickstream/clickstream-enwiki-2022-01.tsv.gz,Russo-Ukrainian_War,113091,412868,5900,531859,289713
hdfs://spark-nn.eemcs.utwente.nl/user/s1934538/clickstream/clickstream-enwiki-2022-01.tsv.gz,Fantastic_Beasts:_The_Crimes_of_Grindelwald,114589,142394,2037,259020,173708
hdfs://spark-nn.eemcs.utwente.nl/user/s1934538/clickstream/clickstream-enwiki-2022-01.tsv.gz,Game_of_Thrones_(season_8),18057,47940,740,66737,25823
hdfs://spark-nn.eemcs.utwente.nl/user/s1934538/clickstream/clickstream-enwiki-2022-01.tsv.gz,Lance_Reddick,32551,35651,294,68496,14776
hdfs://spark-nn.eemcs.utwente.nl/user/s1934538/clickstream/clickstream-enwiki-2022-01.tsv.gz,Sylvester_Stallone,91943,233696,2062,327701,232945
hdfs://spark-nn.eemcs.utwente.nl/user/s1934538/clickstream/clickstream-enwiki-2022-01.tsv.gz,Matthew_Perry,58453,137729,762,196944,106435
hdfs://spark-nn.eemcs.utwente.nl/user/s1934538/clickstream/clickstream-enwiki-2022-01.tsv.gz,Key_frame,589,5712,10,6311,436
hdfs://spark-nn.eemcs.utwente.nl/user/s1934538/clickstream/clickstream-enwiki-2022-01.tsv.gz,Tenet_(film),74971,170732,2113,247816,131586
hdfs://spark-nn.eemcs.utwente.nl/user/s1934538/clickstream/clickstream-enwiki-2022-01.tsv.gz,Cricket_World_Cup,14182,76339,443,90964,50348
hdfs://spark-nn.eemcs.utwente.nl/user/s1934538/clickstream/clickstream-enwiki-2022-01.tsv.gz,Chernobyl_(miniseries),29151,104897,2167,136215,126559
hdfs://spark-nn.eemcs.utwente.nl/user/s1934538/clickstream/clickstream-enwiki-2022-01.tsv.gz,Main_Page,64485,156869811,5147063,162081359,36469302
hdfs://spark-nn.eemcs.utwente.nl/user/s1934538/clickstream/clickstream-enwiki-2022-01.tsv.gz,Mötley_Crüe,48455,115083,1474,165012,193563
hdfs://spark-nn.eemcs.utwente.nl/user/s1934538/clickstream/clickstream-enwiki-2022-01.tsv.gz,Burt_Reynolds,67908,184913,1731,254552,120730
hdfs://spark-nn.eemcs.utwente.nl/user/s1934538/clickstream/clickstream-enwiki-2022-01.tsv.gz,List_of_Marvel_Cinematic_Universe_films,471734,1279023,4192,1754949,961725
hdfs://spark-nn.eemcs.utwente.nl/user/s1934538/clickstream/clickstream-enwiki-2022-01.tsv.gz,List_of_highest-grossing_Indian_films,149419,404166,1136,554721,332221
hdfs://spark-nn.eemcs.utwente.nl/user/s1934538/clickstream/clickstream-enwiki-2022-01.tsv.gz,Jeffrey_Dahmer,27644,249230,3610,280484,126109
hdfs://spark-nn.eemcs.utwente.nl/user/s1934538/clickstream/clickstream-enwiki-2022-01.tsv.gz,George_H._W._Bush,134176,92562,783,227521,139031
hdfs://spark-nn.eemcs.utwente.nl/user/s1934538/clickstream/clickstream-enwiki-2022-01.tsv.gz,Mulan_(2020_film),23466,51495,857,75818,44945
hdfs://spark-nn.eemcs.utwente.nl/user/s1934538/clickstream/clickstream-enwiki-2022-01.tsv.gz,Israel,82183,239802,5400,327385,157068
hdfs://spark-nn.eemcs.utwente.nl/user/s1934538/clickstream/clickstream-enwiki-2022-01.tsv.gz,House_of_the_Dragon,35669,121060,1612,158341,104976
hdfs://spark-nn.eemcs.utwente.nl/user/s1934538/clickstream/clickstream-enwiki-2022-01.tsv.gz,The_Umbrella_Academy_(TV_series),40668,137806,2847,181321,100980
hdfs://spark-nn.eemcs.utwente.nl/user/s1934538/clickstream/clickstream-enwiki-2022-01.tsv.gz,Sinéad_O'Connor,28614,1046907,10407,1085928,358613
hdfs://spark-nn.eemcs.utwente.nl/user/s1934538/clickstream/clickstream-enwiki-2022-01.tsv.gz,Tom_Brady,212421,1757999,21898,1992318,816832
hdfs://spark-nn.eemcs.utwente.nl/user/s1934538/clickstream/clickstream-enwiki-2022-01.tsv.gz,The_Witcher_(TV_series),137076,1524668,31963,1693707,1032830
hdfs://spark-nn.eemcs.utwente.nl/user/s1934538/clickstream/clickstream-enwiki-2022-01.tsv.gz,Wonder_Woman_1984,52331,91043,1770,145144,74597
hdfs://spark-nn.eemcs.utwente.nl/user/s1934538/clickstream/clickstream-enwiki-2022-01.tsv.gz,Naomi_Osaka,48537,233822,8365,290724,78913
hdfs://spark-nn.eemcs.utwente.nl/user/s1934538/clickstream/clickstream-enwiki-2022-01.tsv.gz,Pornhub,63892,545232,14780,623904,113230
hdfs://spark-nn.eemcs.utwente.nl/user/s1934538/clickstream/clickstream-enwiki-2022-01.tsv.gz,1234,60,1319,23,1402,195
hdfs://spark-nn.eemcs.utwente.nl/user/s1934538/clickstream/clickstream-enwiki-2022-01.tsv.gz,Simone_Biles,10991,55587,479,67057,18388
hdfs://spark-nn.eemcs.utwente.nl/user/s1934538/clickstream/clickstream-enwiki-2022-01.tsv.gz,Chernobyl_disaster,61977,378726,4283,444986,191323
hdfs://spark-nn.eemcs.utwente.nl/user/s1934538/clickstream/clickstream-enwiki-2022-01.tsv.gz,Joe_Exotic,25535,127537,994,154066,71016
hdfs://spark-nn.eemcs.utwente.nl/user/s1934538/clickstream/clickstream-enwiki-2022-01.tsv.gz,The_Haunting_of_Bly_Manor,27445,53256,523,81224,41556
hdfs://spark-nn.eemcs.utwente.nl/user/s1934538/clickstream/clickstream-enwiki-2022-01.tsv.gz,Tunnel,6637,9111,107,15855,3999
hdfs://spark-nn.eemcs.utwente.nl/user/s1934538/clickstream/clickstream-enwiki-2022-01.tsv.gz,Ted_Bundy,44914,429410,26295,500619,125763
hdfs://spark-nn.eemcs.utwente.nl/user/s1934538/clickstream/clickstream-enwiki-2022-01.tsv.gz,Lionel_Messi,88682,471612,5420,565714,124448
hdfs://spark-nn.eemcs.utwente.nl/user/s1934538/clickstream/clickstream-enwiki-2022-01.tsv.gz,Avicii,21298,196138,1593,219029,68697
hdfs://spark-nn.eemcs.utwente.nl/user/s1934538/clickstream/clickstream-enwiki-2022-01.tsv.gz,Pelé,30148,136878,1203,168229,58468
hdfs://spark-nn.eemcs.utwente.nl/user/s1934538/clickstream/clickstream-enwiki-2022-01.tsv.gz,Central_Park_jogger_case,15227,46995,147,62369,9150
hdfs://spark-nn.eemcs.utwente.nl/user/s1934538/clickstream/clickstream-enwiki-2022-01.tsv.gz,The_Nun_(2018_film),18341,44971,347,63659,36319
hdfs://spark-nn.eemcs.utwente.nl/user/s1934538/clickstream/clickstream-enwiki-2022-01.tsv.gz,Bible,18154,4462418,2090,4482662,37734
hdfs://spark-nn.eemcs.utwente.nl/user/s1934538/clickstream/clickstream-enwiki-2022-01.tsv.gz,"Princess_Margaret,_Countess_of_Snowdon",122517,247389,2021,371927,214563
hdfs://spark-nn.eemcs.utwente.nl/user/s1934538/clickstream/clickstream-enwiki-2022-01.tsv.gz,The_Irishman,55205,95518,1701,152424,128277
hdfs://spark-nn.eemcs.utwente.nl/user/s1934538/clickstream/clickstream-enwiki-2022-01.tsv.gz,No_Time_to_Die,208553,724626,14230,947409,641707
hdfs://spark-nn.eemcs.utwente.nl/user/s1934538/clickstream/clickstream-enwiki-2022-01.tsv.gz,RRR_(film),99885,914133,2658,1016676,371405
hdfs://spark-nn.eemcs.utwente.nl/user/s1934538/clickstream/clickstream-enwiki-2022-01.tsv.gz,XXX:_Return_of_Xander_Cage,91569,667359,1518,760446,106622
hdfs://spark-nn.eemcs.utwente.nl/user/s1934538/clickstream/clickstream-enwiki-2022-01.tsv.gz,Us_(2019_film),22357,51441,231,74029,24903
hdfs://spark-nn.eemcs.utwente.nl/user/s1934538/clickstream/clickstream-enwiki-2022-01.tsv.gz,Luke_Perry,41416,126484,697,168597,64147
hdfs://spark-nn.eemcs.utwente.nl/user/s1934538/clickstream/clickstream-enwiki-2022-01.tsv.gz,Jimmy_Buffett,9227,71950,857,82034,24668
hdfs://spark-nn.eemcs.utwente.nl/user/s1934538/clickstream/clickstream-enwiki-2022-01.tsv.gz,Jason_Momoa,182942,758039,6349,947330,365594
hdfs://spark-nn.eemcs.utwente.nl/user/s1934538/clickstream/clickstream-enwiki-2022-01.tsv.gz,Bridgerton,45951,177949,3360,227260,175863
hdfs://spark-nn.eemcs.utwente.nl/user/s1934538/clickstream/clickstream-enwiki-2022-01.tsv.gz,When_They_See_Us,18923,29974,138,49035,21138
hdfs://spark-nn.eemcs.utwente.nl/user/s1934538/clickstream/clickstream-enwiki-2022-01.tsv.gz,George_VI,406498,167997,1073,575568,424391
hdfs://spark-nn.eemcs.utwente.nl/user/s1934538/clickstream/clickstream-enwiki-2022-01.tsv.gz,Atal_Bihari_Vajpayee,31458,60639,94,92191,30937
hdfs://spark-nn.eemcs.utwente.nl/user/s1934538/clickstream/clickstream-enwiki-2022-01.tsv.gz,"Diana,_Princess_of_Wales",167298,366046,3719,537063,331774
hdfs://spark-nn.eemcs.utwente.nl/user/s1934538/clickstream/clickstream-enwiki-2022-01.tsv.gz,Henry_V_of_England,114929,157853,539,273321,196050
hdfs://spark-nn.eemcs.utwente.nl/user/s1934538/clickstream/clickstream-enwiki-2022-01.tsv.gz,Zack_Snyder's_Justice_League,105186,140525,2259,247970,130217
hdfs://spark-nn.eemcs.utwente.nl/user/s1934538/clickstream/clickstream-enwiki-2022-01.tsv.gz,Irrfan_Khan,43656,89415,472,133543,59670
hdfs://spark-nn.eemcs.utwente.nl/user/s1934538/clickstream/clickstream-enwiki-2022-01.tsv.gz,Stephen_Hawking,39339,638418,4820,682577,259900
hdfs://spark-nn.eemcs.utwente.nl/user/s1934538/clickstream/clickstream-enwiki-2022-01.tsv.gz,Coronavirus,31484,177073,4707,213264,71764
hdfs://spark-nn.eemcs.utwente.nl/user/s1934538/clickstream/clickstream-enwiki-2022-01.tsv.gz,Carlos_Alcaraz,4407,53905,241,58553,16178
hdfs://spark-nn.eemcs.utwente.nl/user/s1934538/clickstream/clickstream-enwiki-2022-01.tsv.gz,Avengers:_Infinity_War,102815,132891,1741,237447,131486
hdfs://spark-nn.eemcs.utwente.nl/user/s1934538/clickstream/clickstream-enwiki-2022-01.tsv.gz,Doctor_Strange_in_the_Multiverse_of_Madness,251221,318646,6784,576651,332517
hdfs://spark-nn.eemcs.utwente.nl/user/s1934538/clickstream/clickstream-enwiki-2022-01.tsv.gz,Dennis_Nilsen,10891,147111,1314,159316,36145
hdfs://spark-nn.eemcs.utwente.nl/user/s1934538/clickstream/clickstream-enwiki-2022-01.tsv.gz,United_States_Senate,56952,59563,904,117419,56950
hdfs://spark-nn.eemcs.utwente.nl/user/s1934538/clickstream/clickstream-enwiki-2022-01.tsv.gz,A_Star_Is_Born_(2018_film),32604,111851,1088,145543,77095
hdfs://spark-nn.eemcs.utwente.nl/user/s1934538/clickstream/clickstream-enwiki-2022-01.tsv.gz,Hamilton_(musical),51489,207489,1954,260932,171175
hdfs://spark-nn.eemcs.utwente.nl/user/s1934538/clickstream/clickstream-enwiki-2022-01.tsv.gz,COVID-19_pandemic_by_country_and_territory,74052,180342,3825,258219,176217
hdfs://spark-nn.eemcs.utwente.nl/user/s1934538/clickstream/clickstream-enwiki-2022-01.tsv.gz,Elon_Musk,157318,1317415,12155,1486888,861968
hdfs://spark-nn.eemcs.utwente.nl/user/s1934538/clickstream/clickstream-enwiki-2022-01.tsv.gz,Brett_Kavanaugh,43477,49329,464,93270,29432
hdfs://spark-nn.eemcs.utwente.nl/user/s1934538/clickstream/clickstream-enwiki-2022-01.tsv.gz,Aquaman_(film),44776,83052,1211,129039,71206
hdfs://spark-nn.eemcs.utwente.nl/user/s1934538/clickstream/clickstream-enwiki-2022-01.tsv.gz,Sushant_Singh_Rajput,28995,131111,511,160617,70171
hdfs://spark-nn.eemcs.utwente.nl/user/s1934538/clickstream/clickstream-enwiki-2022-01.tsv.gz,Avengers:_Endgame,191853,286464,3697,482014,294893
hdfs://spark-nn.eemcs.utwente.nl/user/s1934538/clickstream/clickstream-enwiki-2022-01.tsv.gz,Puneeth_Rajkumar,23219,84439,1032,108690,51094
hdfs://spark-nn.eemcs.utwente.nl/user/s1934538/clickstream/clickstream-enwiki-2022-01.tsv.gz,Kobe_Bryant,66286,506105,8004,580395,162325
hdfs://spark-nn.eemcs.utwente.nl/user/s1934538/clickstream/clickstream-enwiki-2022-01.tsv.gz,Shinzo_Abe,24531,22210,1092,47833,26609
hdfs://spark-nn.eemcs.utwente.nl/user/s1934538/clickstream/clickstream-enwiki-2022-01.tsv.gz,Black_Widow_(2021_film),99330,265995,4501,369826,241853
hdfs://spark-nn.eemcs.utwente.nl/user/s1934538/clickstream/clickstream-enwiki-2022-01.tsv.gz,State_of_Palestine,40686,95022,330,136038,59552
hdfs://spark-nn.eemcs.utwente.nl/user/s1934538/clickstream/clickstream-enwiki-2022-01.tsv.gz,NATO,107292,674175,13114,794581,289533
hdfs://spark-nn.eemcs.utwente.nl/user/s1934538/clickstream/clickstream-enwiki-2022-01.tsv.gz,Ponniyin_Selvan:_I,73129,55467,105,128701,120042
hdfs://spark-nn.eemcs.utwente.nl/user/s1934538/clickstream/clickstream-enwiki-2022-04.tsv.gz,Squid_Game,25285,165741,4346,195372,100394
hdfs://spark-nn.eemcs.utwente.nl/user/s1934538/clickstream/clickstream-enwiki-2022-04.tsv.gz,Loki_(TV_series),40733,108545,2396,151674,80155
hdfs://spark-nn.eemcs.utwente.nl/user/s1934538/clickstream/clickstream-enwiki-2022-04.tsv.gz,Shakira,22460,157825,1937,182222,88009
hdfs://spark-nn.eemcs.utwente.nl/user/s1934538/clickstream/clickstream-enwiki-2022-04.tsv.gz,The_Batman_(film),370903,2468593,66117,2905613,1724124
hdfs://spark-nn.eemcs.utwente.nl/user/s1934538/clickstream/clickstream-enwiki-2022-04.tsv.gz,Cameron_Boyce,29073,227683,733,257489,70151
hdfs://spark-nn.eemcs.utwente.nl/user/s1934538/clickstream/clickstream-enwiki-2022-04.tsv.gz,Kim_Jong-un,58594,135772,1765,196131,110456
hdfs://spark-nn.eemcs.utwente.nl/user/s1934538/clickstream/clickstream-enwiki-2022-04.tsv.gz,Joe_Exotic,18229,89468,654,108351,48904
hdfs://spark-nn.eemcs.utwente.nl/user/s1934538/clickstream/clickstream-enwiki-2022-04.tsv.gz,2020_United_States_presidential_election,125062,185906,4734,315702,286707
hdfs://spark-nn.eemcs.utwente.nl/user/s1934538/clickstream/clickstream-enwiki-2022-04.tsv.gz,Sushant_Singh_Rajput,19427,125140,334,144901,56587
hdfs://spark-nn.eemcs.utwente.nl/user/s1934538/clickstream/clickstream-enwiki-2022-04.tsv.gz,Microsoft_Office,7075,2373998,759,2381832,17616
hdfs://spark-nn.eemcs.utwente.nl/user/s1934538/clickstream/clickstream-enwiki-2022-04.tsv.gz,The_Kashmir_Files,51719,526333,6235,584287,164566
hdfs://spark-nn.eemcs.utwente.nl/user/s1934538/clickstream/clickstream-enwiki-2022-04.tsv.gz,Aaron_Carter,17921,48644,323,66888,31379
hdfs://spark-nn.eemcs.utwente.nl/user/s1934538/clickstream/clickstream-enwiki-2022-04.tsv.gz,Olivia_Newton-John,28101,79390,1092,108583,49967
hdfs://spark-nn.eemcs.utwente.nl/user/s1934538/clickstream/clickstream-enwiki-2022-04.tsv.gz,September_11_attacks,85454,229501,3286,318241,180961
hdfs://spark-nn.eemcs.utwente.nl/user/s1934538/clickstream/clickstream-enwiki-2022-04.tsv.gz,Anthony_Bourdain,27405,313520,2911,343836,110723
hdfs://spark-nn.eemcs.utwente.nl/user/s1934538/clickstream/clickstream-enwiki-2022-04.tsv.gz,Godzilla_vs._Kong,49969,78028,1450,129447,67925
hdfs://spark-nn.eemcs.utwente.nl/user/s1934538/clickstream/clickstream-enwiki-2022-04.tsv.gz,Bridgerton,187476,1748045,38266,1973787,2125821
hdfs://spark-nn.eemcs.utwente.nl/user/s1934538/clickstream/clickstream-enwiki-2022-04.tsv.gz,Kylian_Mbappé,36897,204655,2182,243734,52197
hdfs://spark-nn.eemcs.utwente.nl/user/s1934538/clickstream/clickstream-enwiki-2022-04.tsv.gz,Eddie_Van_Halen,44724,84056,990,129770,51042
hdfs://spark-nn.eemcs.utwente.nl/user/s1934538/clickstream/clickstream-enwiki-2022-04.tsv.gz,Valentine's_Day,3367,28379,298,32044,3250
hdfs://spark-nn.eemcs.utwente.nl/user/s1934538/clickstream/clickstream-enwiki-2022-04.tsv.gz,Stranger_Things,87462,341993,9558,439013,356235
hdfs://spark-nn.eemcs.utwente.nl/user/s1934538/clickstream/clickstream-enwiki-2022-04.tsv.gz,Mortal_Kombat_(2021_film),21688,61705,1023,84416,71538
hdfs://spark-nn.eemcs.utwente.nl/user/s1934538/clickstream/clickstream-enwiki-2022-04.tsv.gz,Ray_Liotta,32244,46858,397,79499,29392
hdfs://spark-nn.eemcs.utwente.nl/user/s1934538/clickstream/clickstream-enwiki-2022-04.tsv.gz,Fyre_Festival,14946,115918,893,131757,73833
hdfs://spark-nn.eemcs.utwente.nl/user/s1934538/clickstream/clickstream-enwiki-2022-04.tsv.gz,Bible,19675,1802241,1962,1823878,35040
hdfs://spark-nn.eemcs.utwente.nl/user/s1934538/clickstream/clickstream-enwiki-2022-04.tsv.gz,William_Murdoch,569,1278,35,1882,299
hdfs://spark-nn.eemcs.utwente.nl/user/s1934538/clickstream/clickstream-enwiki-2022-04.tsv.gz,Russo-Ukrainian_War,333010,943373,27244,1303627,683289
hdfs://spark-nn.eemcs.utwente.nl/user/s1934538/clickstream/clickstream-enwiki-2022-04.tsv.gz,Greta_Thunberg,8684,110916,1103,120703,26725
hdfs://spark-nn.eemcs.utwente.nl/user/s1934538/clickstream/clickstream-enwiki-2022-04.tsv.gz,The_Shape_of_Water,24322,45843,607,70772,32168
hdfs://spark-nn.eemcs.utwente.nl/user/s1934538/clickstream/clickstream-enwiki-2022-04.tsv.gz,Guardians_of_the_Galaxy_Vol._3,94722,49986,611,145319,85709
hdfs://spark-nn.eemcs.utwente.nl/user/s1934538/clickstream/clickstream-enwiki-2022-04.tsv.gz,Black_Panther:_Wakanda_Forever,127289,96145,1060,224494,179747
hdfs://spark-nn.eemcs.utwente.nl/user/s1934538/clickstream/clickstream-enwiki-2022-04.tsv.gz,Richard_Ramirez,19789,213352,1960,235101,70129
hdfs://spark-nn.eemcs.utwente.nl/user/s1934538/clickstream/clickstream-enwiki-2022-04.tsv.gz,House_of_the_Dragon,34195,84703,1374,120272,96337
hdfs://spark-nn.eemcs.utwente.nl/user/s1934538/clickstream/clickstream-enwiki-2022-04.tsv.gz,John_Wick:_Chapter_4,48567,54047,695,103309,57458
hdfs://spark-nn.eemcs.utwente.nl/user/s1934538/clickstream/clickstream-enwiki-2022-04.tsv.gz,Pelé,32600,112844,1095,146539,53084
hdfs://spark-nn.eemcs.utwente.nl/user/s1934538/clickstream/clickstream-enwiki-2022-04.tsv.gz,Puneeth_Rajkumar,53156,125961,1106,180223,90051
hdfs://spark-nn.eemcs.utwente.nl/user/s1934538/clickstream/clickstream-enwiki-2022-04.tsv.gz,Kenosha_unrest_shooting,6651,62142,734,69527,12368
hdfs://spark-nn.eemcs.utwente.nl/user/s1934538/clickstream/clickstream-enwiki-2022-04.tsv.gz,Avengers:_Infinity_War,52747,70671,1115,124533,65305
hdfs://spark-nn.eemcs.utwente.nl/user/s1934538/clickstream/clickstream-enwiki-2022-04.tsv.gz,Deadpool_2,54321,47565,1408,103294,73863
hdfs://spark-nn.eemcs.utwente.nl/user/s1934538/clickstream/clickstream-enwiki-2022-04.tsv.gz,Gaza_Strip,19775,34479,186,54440,22537
hdfs://spark-nn.eemcs.utwente.nl/user/s1934538/clickstream/clickstream-enwiki-2022-04.tsv.gz,Keanu_Reeves,78567,375091,2979,456637,268666
hdfs://spark-nn.eemcs.utwente.nl/user/s1934538/clickstream/clickstream-enwiki-2022-04.tsv.gz,Chernobyl_disaster,64433,389083,5426,458942,201211
hdfs://spark-nn.eemcs.utwente.nl/user/s1934538/clickstream/clickstream-enwiki-2022-04.tsv.gz,Thor:_Love_and_Thunder,227105,583998,14319,825422,667059
hdfs://spark-nn.eemcs.utwente.nl/user/s1934538/clickstream/clickstream-enwiki-2022-04.tsv.gz,Israel,91750,258176,5648,355574,177208
hdfs://spark-nn.eemcs.utwente.nl/user/s1934538/clickstream/clickstream-enwiki-2022-04.tsv.gz,Charles_III,101,174,45,320,258
hdfs://spark-nn.eemcs.utwente.nl/user/s1934538/clickstream/clickstream-enwiki-2022-04.tsv.gz,Elon_Musk,651567,5828856,15970,6496393,4241377
hdfs://spark-nn.eemcs.utwente.nl/user/s1934538/clickstream/clickstream-enwiki-2022-04.tsv.gz,Black_Widow_(2021_film),50107,102683,1863,154653,89135
hdfs://spark-nn.eemcs.utwente.nl/user/s1934538/clickstream/clickstream-enwiki-2022-04.tsv.gz,The_Sandman_(TV_series),20886,24565,281,45732,33935
hdfs://spark-nn.eemcs.utwente.nl/user/s1934538/clickstream/clickstream-enwiki-2022-04.tsv.gz,Black_Adam_(film),67909,52755,1477,122141,72147
hdfs://spark-nn.eemcs.utwente.nl/user/s1934538/clickstream/clickstream-enwiki-2022-04.tsv.gz,When_They_See_Us,10604,28345,366,39315,18038
hdfs://spark-nn.eemcs.utwente.nl/user/s1934538/clickstream/clickstream-enwiki-2022-04.tsv.gz,NATO,125240,517145,24529,666914,280053
hdfs://spark-nn.eemcs.utwente.nl/user/s1934538/clickstream/clickstream-enwiki-2022-04.tsv.gz,Freddie_Mercury,84588,469019,4601,558208,220699
hdfs://spark-nn.eemcs.utwente.nl/user/s1934538/clickstream/clickstream-enwiki-2022-04.tsv.gz,Grover,1074,4040,39,5153,1065
hdfs://spark-nn.eemcs.utwente.nl/user/s1934538/clickstream/clickstream-enwiki-2022-04.tsv.gz,The_Weeknd,74419,234432,2939,311790,150932
hdfs://spark-nn.eemcs.utwente.nl/user/s1934538/clickstream/clickstream-enwiki-2022-04.tsv.gz,2023_Cricket_World_Cup,24107,53234,89,77430,22225
hdfs://spark-nn.eemcs.utwente.nl/user/s1934538/clickstream/clickstream-enwiki-2022-04.tsv.gz,The_Nun_(2018_film),14419,39075,343,53837,33456
hdfs://spark-nn.eemcs.utwente.nl/user/s1934538/clickstream/clickstream-enwiki-2022-04.tsv.gz,No_Time_to_Die,125186,303332,6279,434797,295643
hdfs://spark-nn.eemcs.utwente.nl/user/s1934538/clickstream/clickstream-enwiki-2022-04.tsv.gz,The_Irishman,45524,91787,2073,139384,125196
hdfs://spark-nn.eemcs.utwente.nl/user/s1934538/clickstream/clickstream-enwiki-2022-04.tsv.gz,The_Haunting_of_Bly_Manor,19135,40152,393,59680,31207
hdfs://spark-nn.eemcs.utwente.nl/user/s1934538/clickstream/clickstream-enwiki-2022-04.tsv.gz,K.G.F:_Chapter_2,621448,7603506,54948,8279902,2680507
hdfs://spark-nn.eemcs.utwente.nl/user/s1934538/clickstream/clickstream-enwiki-2022-04.tsv.gz,ICC_Men's_T20_World_Cup,12016,76008,407,88431,57829
hdfs://spark-nn.eemcs.utwente.nl/user/s1934538/clickstream/clickstream-enwiki-2022-04.tsv.gz,Avatar:_The_Way_of_Water,122079,214530,3688,340297,95819
hdfs://spark-nn.eemcs.utwente.nl/user/s1934538/clickstream/clickstream-enwiki-2022-04.tsv.gz,XXX:_Return_of_Xander_Cage,79669,1157273,1180,1238122,128133
hdfs://spark-nn.eemcs.utwente.nl/user/s1934538/clickstream/clickstream-enwiki-2022-04.tsv.gz,Jenna_Ortega,91211,109186,933,201330,65031
hdfs://spark-nn.eemcs.utwente.nl/user/s1934538/clickstream/clickstream-enwiki-2022-04.tsv.gz,Google_logo,602,20153,10,20765,855
hdfs://spark-nn.eemcs.utwente.nl/user/s1934538/clickstream/clickstream-enwiki-2022-04.tsv.gz,David_Beckham,150449,313264,2814,466527,221254
hdfs://spark-nn.eemcs.utwente.nl/user/s1934538/clickstream/clickstream-enwiki-2022-04.tsv.gz,2018_FIFA_World_Cup,147212,189511,2053,338776,197927
hdfs://spark-nn.eemcs.utwente.nl/user/s1934538/clickstream/clickstream-enwiki-2022-04.tsv.gz,Top_Gun:_Maverick,103763,188929,6834,299526,220183
hdfs://spark-nn.eemcs.utwente.nl/user/s1934538/clickstream/clickstream-enwiki-2022-04.tsv.gz,2020_Summer_Olympics,41146,49077,1483,91706,80014
hdfs://spark-nn.eemcs.utwente.nl/user/s1934538/clickstream/clickstream-enwiki-2022-04.tsv.gz,Kobe_Bryant,73543,331059,3651,408253,138433
hdfs://spark-nn.eemcs.utwente.nl/user/s1934538/clickstream/clickstream-enwiki-2022-04.tsv.gz,Luke_Perry,31549,88626,410,120585,46569
hdfs://spark-nn.eemcs.utwente.nl/user/s1934538/clickstream/clickstream-enwiki-2022-04.tsv.gz,A_Star_Is_Born_(2018_film),23689,68222,516,92427,44230
hdfs://spark-nn.eemcs.utwente.nl/user/s1934538/clickstream/clickstream-enwiki-2022-04.tsv.gz,Dennis_Nilsen,9570,76843,465,86878,23279
hdfs://spark-nn.eemcs.utwente.nl/user/s1934538/clickstream/clickstream-enwiki-2022-04.tsv.gz,Shinzo_Abe,23691,26914,194,50799,27601
hdfs://spark-nn.eemcs.utwente.nl/user/s1934538/clickstream/clickstream-enwiki-2022-04.tsv.gz,"Princess_Margaret,_Countess_of_Snowdon",76223,149163,1107,226493,131155
hdfs://spark-nn.eemcs.utwente.nl/user/s1934538/clickstream/clickstream-enwiki-2022-04.tsv.gz,Nipsey_Hussle,20406,101491,630,122527,38239
hdfs://spark-nn.eemcs.utwente.nl/user/s1934538/clickstream/clickstream-enwiki-2022-04.tsv.gz,Anna_Sorokin,115726,1086591,4344,1206661,484568
hdfs://spark-nn.eemcs.utwente.nl/user/s1934538/clickstream/clickstream-enwiki-2022-04.tsv.gz,Lionel_Messi,109953,532696,6222,648871,145106
hdfs://spark-nn.eemcs.utwente.nl/user/s1934538/clickstream/clickstream-enwiki-2022-04.tsv.gz,List_of_highest-grossing_Indian_films,595725,3350676,2531,3948932,1487512
hdfs://spark-nn.eemcs.utwente.nl/user/s1934538/clickstream/clickstream-enwiki-2022-04.tsv.gz,2022_Russian_invasion_of_Ukraine,2224084,3983976,15595,6223655,3068803
hdfs://spark-nn.eemcs.utwente.nl/user/s1934538/clickstream/clickstream-enwiki-2022-04.tsv.gz,Spider-Man:_No_Way_Home,255462,728077,15774,999313,563629
hdfs://spark-nn.eemcs.utwente.nl/user/s1934538/clickstream/clickstream-enwiki-2022-04.tsv.gz,R._Kelly,25379,142396,1668,169443,91331
hdfs://spark-nn.eemcs.utwente.nl/user/s1934538/clickstream/clickstream-enwiki-2022-04.tsv.gz,Aaron_Hernandez,7501,90332,498,98331,32298
hdfs://spark-nn.eemcs.utwente.nl/user/s1934538/clickstream/clickstream-enwiki-2022-04.tsv.gz,Key_frame,574,4142,15,4731,359
hdfs://spark-nn.eemcs.utwente.nl/user/s1934538/clickstream/clickstream-enwiki-2022-04.tsv.gz,Qasem_Soleimani,12287,19114,407,31808,17919
hdfs://spark-nn.eemcs.utwente.nl/user/s1934538/clickstream/clickstream-enwiki-2022-04.tsv.gz,Cristiano_Ronaldo,136229,1809077,13255,1958561,415379
hdfs://spark-nn.eemcs.utwente.nl/user/s1934538/clickstream/clickstream-enwiki-2022-04.tsv.gz,Betty_White,42082,136267,2280,180629,49506
hdfs://spark-nn.eemcs.utwente.nl/user/s1934538/clickstream/clickstream-enwiki-2022-04.tsv.gz,Juice_Wrld,37946,198830,3087,239863,106890
hdfs://spark-nn.eemcs.utwente.nl/user/s1934538/clickstream/clickstream-enwiki-2022-04.tsv.gz,The_Queen's_Gambit_(miniseries),27837,80546,875,109258,55535
hdfs://spark-nn.eemcs.utwente.nl/user/s1934538/clickstream/clickstream-enwiki-2022-04.tsv.gz,Sinéad_O'Connor,16097,66781,657,83535,27087
hdfs://spark-nn.eemcs.utwente.nl/user/s1934538/clickstream/clickstream-enwiki-2022-04.tsv.gz,Asia_Cup,1647,12762,32,14441,10522
hdfs://spark-nn.eemcs.utwente.nl/user/s1934538/clickstream/clickstream-enwiki-2022-04.tsv.gz,Avengers:_Endgame,105598,163874,3210,272682,147009
hdfs://spark-nn.eemcs.utwente.nl/user/s1934538/clickstream/clickstream-enwiki-2022-04.tsv.gz,Salman_Rushdie,28853,58595,361,87809,36259
hdfs://spark-nn.eemcs.utwente.nl/user/s1934538/clickstream/clickstream-enwiki-2022-04.tsv.gz,Emma_Raducanu,10823,106220,906,117949,25329
hdfs://spark-nn.eemcs.utwente.nl/user/s1934538/clickstream/clickstream-enwiki-2022-04.tsv.gz,The_Last_of_Us_(TV_series),31133,46522,232,77887,58943
hdfs://spark-nn.eemcs.utwente.nl/user/s1934538/clickstream/clickstream-enwiki-2022-04.tsv.gz,Michael_Jordan,102716,490170,5507,598393,197747
hdfs://spark-nn.eemcs.utwente.nl/user/s1934538/clickstream/clickstream-enwiki-2022-04.tsv.gz,Mulan_(2020_film),16574,35025,490,52089,29547
hdfs://spark-nn.eemcs.utwente.nl/user/s1934538/clickstream/clickstream-enwiki-2022-04.tsv.gz,Meat_Loaf,24421,116728,1390,142539,49286
hdfs://spark-nn.eemcs.utwente.nl/user/s1934538/clickstream/clickstream-enwiki-2022-04.tsv.gz,Croatia,56651,185883,2489,245023,83144
hdfs://spark-nn.eemcs.utwente.nl/user/s1934538/clickstream/clickstream-enwiki-2022-04.tsv.gz,Joe_Biden,194042,488275,8955,691272,340132
hdfs://spark-nn.eemcs.utwente.nl/user/s1934538/clickstream/clickstream-enwiki-2022-04.tsv.gz,COVID-19_pandemic,189462,254067,1003,444532,170253
hdfs://spark-nn.eemcs.utwente.nl/user/s1934538/clickstream/clickstream-enwiki-2022-04.tsv.gz,Vikram_(2022_film),40260,53190,1286,94736,54856
hdfs://spark-nn.eemcs.utwente.nl/user/s1934538/clickstream/clickstream-enwiki-2022-04.tsv.gz,Elizabeth_II,410545,763577,5908,1180030,774714
hdfs://spark-nn.eemcs.utwente.nl/user/s1934538/clickstream/clickstream-enwiki-2022-04.tsv.gz,John_McCain,27893,55266,678,83837,41112
hdfs://spark-nn.eemcs.utwente.nl/user/s1934538/clickstream/clickstream-enwiki-2022-04.tsv.gz,The_Matrix_Resurrections,79482,148245,3652,231379,114709
hdfs://spark-nn.eemcs.utwente.nl/user/s1934538/clickstream/clickstream-enwiki-2022-04.tsv.gz,Ghislaine_Maxwell,74063,226349,1496,301908,118428
hdfs://spark-nn.eemcs.utwente.nl/user/s1934538/clickstream/clickstream-enwiki-2022-04.tsv.gz,The_Witcher_(TV_series),25577,174797,4054,204428,115293
hdfs://spark-nn.eemcs.utwente.nl/user/s1934538/clickstream/clickstream-enwiki-2022-04.tsv.gz,Us_(2019_film),27835,61350,315,89500,32173
hdfs://spark-nn.eemcs.utwente.nl/user/s1934538/clickstream/clickstream-enwiki-2022-04.tsv.gz,Game_of_Thrones_(season_8),14295,36806,741,51842,19865
hdfs://spark-nn.eemcs.utwente.nl/user/s1934538/clickstream/clickstream-enwiki-2022-04.tsv.gz,Kamala_Harris,76071,198798,1856,276725,119205
hdfs://spark-nn.eemcs.utwente.nl/user/s1934538/clickstream/clickstream-enwiki-2022-04.tsv.gz,List_of_Marvel_Cinematic_Universe_films,248357,712143,2761,963261,523969
hdfs://spark-nn.eemcs.utwente.nl/user/s1934538/clickstream/clickstream-enwiki-2022-04.tsv.gz,List_of_FIFA_World_Cup_finals,5254,89438,82,94774,27284
hdfs://spark-nn.eemcs.utwente.nl/user/s1934538/clickstream/clickstream-enwiki-2022-04.tsv.gz,Matthew_Perry,46735,107128,833,154696,106669
hdfs://spark-nn.eemcs.utwente.nl/user/s1934538/clickstream/clickstream-enwiki-2022-04.tsv.gz,Michael_Bloomberg,29951,32385,207,62543,27542
hdfs://spark-nn.eemcs.utwente.nl/user/s1934538/clickstream/clickstream-enwiki-2022-04.tsv.gz,Zack_Snyder's_Justice_League,126871,110598,1801,239270,118301
hdfs://spark-nn.eemcs.utwente.nl/user/s1934538/clickstream/clickstream-enwiki-2022-04.tsv.gz,Article_370_of_the_Constitution_of_India,4671,89361,54,94086,4717
hdfs://spark-nn.eemcs.utwente.nl/user/s1934538/clickstream/clickstream-enwiki-2022-04.tsv.gz,The_Lion_King_(2019_film),45976,72217,1159,119352,66838
hdfs://spark-nn.eemcs.utwente.nl/user/s1934538/clickstream/clickstream-enwiki-2022-04.tsv.gz,Captain_Marvel_(film),34300,105436,1537,141273,74171
hdfs://spark-nn.eemcs.utwente.nl/user/s1934538/clickstream/clickstream-enwiki-2022-04.tsv.gz,Khabib_Nurmagomedov,51228,195061,1805,248094,135882
hdfs://spark-nn.eemcs.utwente.nl/user/s1934538/clickstream/clickstream-enwiki-2022-04.tsv.gz,Bird_Box_(film),17479,57379,599,75457,29665
hdfs://spark-nn.eemcs.utwente.nl/user/s1934538/clickstream/clickstream-enwiki-2022-04.tsv.gz,Naya_Rivera,60081,70589,267,130937,53739
hdfs://spark-nn.eemcs.utwente.nl/user/s1934538/clickstream/clickstream-enwiki-2022-04.tsv.gz,Brie_Larson,68857,159391,1571,229819,95670
hdfs://spark-nn.eemcs.utwente.nl/user/s1934538/clickstream/clickstream-enwiki-2022-04.tsv.gz,Royal_Rumble_(2018),8162,8413,115,16690,9570
hdfs://spark-nn.eemcs.utwente.nl/user/s1934538/clickstream/clickstream-enwiki-2022-04.tsv.gz,Cook's_Country,371,2340,40,2751,807
hdfs://spark-nn.eemcs.utwente.nl/user/s1934538/clickstream/clickstream-enwiki-2022-04.tsv.gz,RRR_(film),421729,4163716,23372,4608817,1693862
hdfs://spark-nn.eemcs.utwente.nl/user/s1934538/clickstream/clickstream-enwiki-2022-04.tsv.gz,Louis_Tomlinson,39692,57813,301,97806,30364
hdfs://spark-nn.eemcs.utwente.nl/user/s1934538/clickstream/clickstream-enwiki-2022-04.tsv.gz,Doctor_Strange_in_the_Multiverse_of_Madness,243190,809485,26744,1079419,525226
hdfs://spark-nn.eemcs.utwente.nl/user/s1934538/clickstream/clickstream-enwiki-2022-04.tsv.gz,Oppenheimer_(film),162502,134218,2120,298840,323874
hdfs://spark-nn.eemcs.utwente.nl/user/s1934538/clickstream/clickstream-enwiki-2022-04.tsv.gz,Elliot_Page,65745,288015,1508,355268,159240
hdfs://spark-nn.eemcs.utwente.nl/user/s1934538/clickstream/clickstream-enwiki-2022-04.tsv.gz,Sidharth_Shukla,6413,36850,216,43479,9236
hdfs://spark-nn.eemcs.utwente.nl/user/s1934538/clickstream/clickstream-enwiki-2022-04.tsv.gz,List_of_awards_and_nominations_received_by_Meryl_Streep,8693,10153,105,18951,8484
hdfs://spark-nn.eemcs.utwente.nl/user/s1934538/clickstream/clickstream-enwiki-2022-04.tsv.gz,Dune_(2021_film),149287,645955,21041,816283,607580
hdfs://spark-nn.eemcs.utwente.nl/user/s1934538/clickstream/clickstream-enwiki-2022-04.tsv.gz,21_Savage,13409,63700,650,77759,25508
hdfs://spark-nn.eemcs.utwente.nl/user/s1934538/clickstream/clickstream-enwiki-2022-04.tsv.gz,Cleopatra,66279,2262906,2887,2332072,252257
hdfs://spark-nn.eemcs.utwente.nl/user/s1934538/clickstream/clickstream-enwiki-2022-04.tsv.gz,Pornhub,43882,393094,13518,450494,85806
hdfs://spark-nn.eemcs.utwente.nl/user/s1934538/clickstream/clickstream-enwiki-2022-04.tsv.gz,Chadwick_Boseman,59318,213197,1081,273596,77829
hdfs://spark-nn.eemcs.utwente.nl/user/s1934538/clickstream/clickstream-enwiki-2022-04.tsv.gz,Lance_Reddick,22934,27911,196,51041,11206
hdfs://spark-nn.eemcs.utwente.nl/user/s1934538/clickstream/clickstream-enwiki-2022-04.tsv.gz,1234,26,1159,19,1204,200
hdfs://spark-nn.eemcs.utwente.nl/user/s1934538/clickstream/clickstream-enwiki-2022-04.tsv.gz,State_of_Palestine,51516,120275,266,172057,83745
hdfs://spark-nn.eemcs.utwente.nl/user/s1934538/clickstream/clickstream-enwiki-2022-04.tsv.gz,The_Mandalorian,58517,123637,2848,185002,128507
hdfs://spark-nn.eemcs.utwente.nl/user/s1934538/clickstream/clickstream-enwiki-2022-04.tsv.gz,Star_Wars:_The_Rise_of_Skywalker,78334,71229,1864,151427,88514
hdfs://spark-nn.eemcs.utwente.nl/user/s1934538/clickstream/clickstream-enwiki-2022-04.tsv.gz,War_(2019_film),32925,51109,97,84131,22260
hdfs://spark-nn.eemcs.utwente.nl/user/s1934538/clickstream/clickstream-enwiki-2022-04.tsv.gz,2016_United_States_presidential_election,93907,80813,1056,175776,138489
hdfs://spark-nn.eemcs.utwente.nl/user/s1934538/clickstream/clickstream-enwiki-2022-04.tsv.gz,Murder_of_Dee_Dee_Blanchard,17458,136712,605,154775,35016
hdfs://spark-nn.eemcs.utwente.nl/user/s1934538/clickstream/clickstream-enwiki-2022-04.tsv.gz,Tonya_Harding,19207,62872,313,82392,20696
hdfs://spark-nn.eemcs.utwente.nl/user/s1934538/clickstream/clickstream-enwiki-2022-05.tsv.gz,The_Flash_(film),81332,45411,808,127551,77375
hdfs://spark-nn.eemcs.utwente.nl/user/s1934538/clickstream/clickstream-enwiki-2022-05.tsv.gz,XXX:_Return_of_Xander_Cage,68101,1189142,1234,1258477,141934
hdfs://spark-nn.eemcs.utwente.nl/user/s1934538/clickstream/clickstream-enwiki-2022-05.tsv.gz,Kobe_Bryant,76836,332788,3277,412901,133286
hdfs://spark-nn.eemcs.utwente.nl/user/s1934538/clickstream/clickstream-enwiki-2022-05.tsv.gz,Antifa_(United_States),9855,66574,324,76753,13398
hdfs://spark-nn.eemcs.utwente.nl/user/s1934538/clickstream/clickstream-enwiki-2022-05.tsv.gz,WrestleMania_34,14479,7223,104,21806,14224
hdfs://spark-nn.eemcs.utwente.nl/user/s1934538/clickstream/clickstream-enwiki-2022-05.tsv.gz,Rishi_Sunak,14754,72593,510,87857,45943
hdfs://spark-nn.eemcs.utwente.nl/user/s1934538/clickstream/clickstream-enwiki-2022-05.tsv.gz,Godzilla_vs._Kong,58981,86156,1659,146796,78177
hdfs://spark-nn.eemcs.utwente.nl/user/s1934538/clickstream/clickstream-enwiki-2022-05.tsv.gz,Lance_Reddick,26065,38477,379,64921,17184
hdfs://spark-nn.eemcs.utwente.nl/user/s1934538/clickstream/clickstream-enwiki-2022-05.tsv.gz,WandaVision,161441,414007,6120,581568,285175
hdfs://spark-nn.eemcs.utwente.nl/user/s1934538/clickstream/clickstream-enwiki-2022-05.tsv.gz,Donald_Trump,192622,386757,6735,586114,330335
hdfs://spark-nn.eemcs.utwente.nl/user/s1934538/clickstream/clickstream-enwiki-2022-05.tsv.gz,Burt_Reynolds,52089,141279,1298,194666,91069
hdfs://spark-nn.eemcs.utwente.nl/user/s1934538/clickstream/clickstream-enwiki-2022-05.tsv.gz,Joker_(2019_film),43485,147338,2014,192837,90626
hdfs://spark-nn.eemcs.utwente.nl/user/s1934538/clickstream/clickstream-enwiki-2022-05.tsv.gz,IPv4,10292,38093,211,48596,8851
hdfs://spark-nn.eemcs.utwente.nl/user/s1934538/clickstream/clickstream-enwiki-2022-05.tsv.gz,NATO,119633,624635,22080,766348,337579
hdfs://spark-nn.eemcs.utwente.nl/user/s1934538/clickstream/clickstream-enwiki-2022-05.tsv.gz,Top_Gun:_Maverick,601508,2618570,87791,3307869,2615296
hdfs://spark-nn.eemcs.utwente.nl/user/s1934538/clickstream/clickstream-enwiki-2022-05.tsv.gz,Avengers:_Infinity_War,75492,87979,1464,164935,89737
hdfs://spark-nn.eemcs.utwente.nl/user/s1934538/clickstream/clickstream-enwiki-2022-05.tsv.gz,Ponniyin_Selvan:_I,58272,85234,391,143897,133834
hdfs://spark-nn.eemcs.utwente.nl/user/s1934538/clickstream/clickstream-enwiki-2022-05.tsv.gz,"Citizenship_(Amendment)_Act,_2019",2987,31649,110,34746,3614
hdfs://spark-nn.eemcs.utwente.nl/user/s1934538/clickstream/clickstream-enwiki-2022-05.tsv.gz,Cricket_World_Cup,11065,72817,327,84209,63644
hdfs://spark-nn.eemcs.utwente.nl/user/s1934538/clickstream/clickstream-enwiki-2022-05.tsv.gz,Pornhub,45349,351302,14304,410955,85641
hdfs://spark-nn.eemcs.utwente.nl/user/s1934538/clickstream/clickstream-enwiki-2022-05.tsv.gz,Kamala_Harris,73652,153674,1361,228687,99228
hdfs://spark-nn.eemcs.utwente.nl/user/s1934538/clickstream/clickstream-enwiki-2022-05.tsv.gz,Mötley_Crüe,35181,109437,1332,145950,170062
hdfs://spark-nn.eemcs.utwente.nl/user/s1934538/clickstream/clickstream-enwiki-2022-05.tsv.gz,Dark_Phoenix_(film),46231,44730,517,91478,54166
hdfs://spark-nn.eemcs.utwente.nl/user/s1934538/clickstream/clickstream-enwiki-2022-05.tsv.gz,Vikram_(2022_film),93500,524668,2496,620664,430621
hdfs://spark-nn.eemcs.utwente.nl/user/s1934538/clickstream/clickstream-enwiki-2022-05.tsv.gz,Freddie_Mercury,73286,419159,3570,496015,198596
hdfs://spark-nn.eemcs.utwente.nl/user/s1934538/clickstream/clickstream-enwiki-2022-05.tsv.gz,Hamas,27191,37175,342,64708,30944
hdfs://spark-nn.eemcs.utwente.nl/user/s1934538/clickstream/clickstream-enwiki-2022-05.tsv.gz,2022_FIFA_World_Cup,145929,552932,9491,708352,467805
hdfs://spark-nn.eemcs.utwente.nl/user/s1934538/clickstream/clickstream-enwiki-2022-05.tsv.gz,Juneteenth,8652,327788,1459,337899,21511
hdfs://spark-nn.eemcs.utwente.nl/user/s1934538/clickstream/clickstream-enwiki-2022-05.tsv.gz,1917_(2019_film),20999,91888,1659,114546,65790
hdfs://spark-nn.eemcs.utwente.nl/user/s1934538/clickstream/clickstream-enwiki-2022-05.tsv.gz,The_Falcon_and_the_Winter_Soldier,39522,61474,1095,102091,62780
hdfs://spark-nn.eemcs.utwente.nl/user/s1934538/clickstream/clickstream-enwiki-2022-05.tsv.gz,Bob_Saget,30752,129718,1489,161959,34777
hdfs://spark-nn.eemcs.utwente.nl/user/s1934538/clickstream/clickstream-enwiki-2022-05.tsv.gz,Anna_Sorokin,53525,453410,1962,508897,204165
hdfs://spark-nn.eemcs.utwente.nl/user/s1934538/clickstream/clickstream-enwiki-2022-05.tsv.gz,State_of_Palestine,52010,122483,179,174672,87199
hdfs://spark-nn.eemcs.utwente.nl/user/s1934538/clickstream/clickstream-enwiki-2022-05.tsv.gz,The_Idol_(TV_series),14393,5284,18,19695,12150
hdfs://spark-nn.eemcs.utwente.nl/user/s1934538/clickstream/clickstream-enwiki-2022-05.tsv.gz,The_Irishman,47521,83641,1845,133007,125317
hdfs://spark-nn.eemcs.utwente.nl/user/s1934538/clickstream/clickstream-enwiki-2022-05.tsv.gz,Chernobyl_disaster,58269,316494,3865,378628,158356
hdfs://spark-nn.eemcs.utwente.nl/user/s1934538/clickstream/clickstream-enwiki-2022-05.tsv.gz,2018_FIFA_World_Cup,82695,79385,881,162961,105647
hdfs://spark-nn.eemcs.utwente.nl/user/s1934538/clickstream/clickstream-enwiki-2022-05.tsv.gz,1234,49,1225,22,1296,154
hdfs://spark-nn.eemcs.utwente.nl/user/s1934538/clickstream/clickstream-enwiki-2022-05.tsv.gz,Laal_Singh_Chaddha,66507,350219,939,417665,270646
hdfs://spark-nn.eemcs.utwente.nl/user/s1934538/clickstream/clickstream-enwiki-2022-05.tsv.gz,Spider-Man:_Far_From_Home,72370,90628,1144,164142,72847
hdfs://spark-nn.eemcs.utwente.nl/user/s1934538/clickstream/clickstream-enwiki-2022-05.tsv.gz,Hamilton_(musical),25971,144800,1614,172385,105239
hdfs://spark-nn.eemcs.utwente.nl/user/s1934538/clickstream/clickstream-enwiki-2022-05.tsv.gz,Coronavirus,7813,55671,1726,65210,19703
hdfs://spark-nn.eemcs.utwente.nl/user/s1934538/clickstream/clickstream-enwiki-2022-05.tsv.gz,Ant-Man_and_the_Wasp:_Quantumania,131601,46735,440,178776,114411
hdfs://spark-nn.eemcs.utwente.nl/user/s1934538/clickstream/clickstream-enwiki-2022-05.tsv.gz,A_Star_Is_Born_(2018_film),21624,55654,471,77749,35865
hdfs://spark-nn.eemcs.utwente.nl/user/s1934538/clickstream/clickstream-enwiki-2022-05.tsv.gz,FIFA_World_Cup,56087,212407,3643,272137,134585
hdfs://spark-nn.eemcs.utwente.nl/user/s1934538/clickstream/clickstream-enwiki-2022-05.tsv.gz,Darth_Vader,73314,116216,4628,194158,147106
hdfs://spark-nn.eemcs.utwente.nl/user/s1934538/clickstream/clickstream-enwiki-2022-05.tsv.gz,Grover,1099,3871,59,5029,1230
hdfs://spark-nn.eemcs.utwente.nl/user/s1934538/clickstream/clickstream-enwiki-2022-05.tsv.gz,Anne_Heche,28817,57543,286,86646,28387
hdfs://spark-nn.eemcs.utwente.nl/user/s1934538/clickstream/clickstream-enwiki-2022-05.tsv.gz,Vivek_Ramaswamy,371,14807,52,15230,2633
hdfs://spark-nn.eemcs.utwente.nl/user/s1934538/clickstream/clickstream-enwiki-2022-05.tsv.gz,Valentine's_Day,3380,29570,193,33143,3008
hdfs://spark-nn.eemcs.utwente.nl/user/s1934538/clickstream/clickstream-enwiki-2022-05.tsv.gz,Avicii,19661,165004,1500,186165,56200
hdfs://spark-nn.eemcs.utwente.nl/user/s1934538/clickstream/clickstream-enwiki-2022-05.tsv.gz,Meat_Loaf,20896,82814,1184,104894,38545
hdfs://spark-nn.eemcs.utwente.nl/user/s1934538/clickstream/clickstream-enwiki-2022-05.tsv.gz,Naya_Rivera,56270,78436,341,135047,56234
hdfs://spark-nn.eemcs.utwente.nl/user/s1934538/clickstream/clickstream-enwiki-2022-05.tsv.gz,Roe_v._Wade,96228,3206301,25149,3327678,1053090
hdfs://spark-nn.eemcs.utwente.nl/user/s1934538/clickstream/clickstream-enwiki-2022-05.tsv.gz,Watts_family_murders,10933,184078,354,195365,52473
hdfs://spark-nn.eemcs.utwente.nl/user/s1934538/clickstream/clickstream-enwiki-2022-05.tsv.gz,John_McCain,32778,86376,1103,120257,60432
hdfs://spark-nn.eemcs.utwente.nl/user/s1934538/clickstream/clickstream-enwiki-2022-05.tsv.gz,Game_of_Thrones_(season_8),15904,36154,652,52710,19705
hdfs://spark-nn.eemcs.utwente.nl/user/s1934538/clickstream/clickstream-enwiki-2022-05.tsv.gz,YouTube,129500,2724394,9953,2863847,120200
hdfs://spark-nn.eemcs.utwente.nl/user/s1934538/clickstream/clickstream-enwiki-2022-05.tsv.gz,Zack_Snyder's_Justice_League,102154,73152,893,176199,79876
hdfs://spark-nn.eemcs.utwente.nl/user/s1934538/clickstream/clickstream-enwiki-2022-05.tsv.gz,HTTP_cookie,2990,260642,119,263751,23171
hdfs://spark-nn.eemcs.utwente.nl/user/s1934538/clickstream/clickstream-enwiki-2022-05.tsv.gz,JSON_Web_Token,789,28028,52,28869,2039
hdfs://spark-nn.eemcs.utwente.nl/user/s1934538/clickstream/clickstream-enwiki-2022-05.tsv.gz,Olivia_Newton-John,27154,72748,1074,100976,45091
hdfs://spark-nn.eemcs.utwente.nl/user/s1934538/clickstream/clickstream-enwiki-2022-05.tsv.gz,QAnon,35399,139457,1134,175990,54392
hdfs://spark-nn.eemcs.utwente.nl/user/s1934538/clickstream/clickstream-enwiki-2022-05.tsv.gz,United_States_Electoral_College,11768,35753,74,47595,7823
hdfs://spark-nn.eemcs.utwente.nl/user/s1934538/clickstream/clickstream-enwiki-2022-05.tsv.gz,Microsoft_Office,7354,2418998,699,2427051,18807
hdfs://spark-nn.eemcs.utwente.nl/user/s1934538/clickstream/clickstream-enwiki-2022-05.tsv.gz,Everything_Everywhere_All_at_Once,168215,1534773,25798,1728786,888202
hdfs://spark-nn.eemcs.utwente.nl/user/s1934538/clickstream/clickstream-enwiki-2022-05.tsv.gz,The_Matrix_Resurrections,75920,200278,4617,280815,143651
hdfs://spark-nn.eemcs.utwente.nl/user/s1934538/clickstream/clickstream-enwiki-2022-05.tsv.gz,Betty_White,39130,118737,1732,159599,42482
hdfs://spark-nn.eemcs.utwente.nl/user/s1934538/clickstream/clickstream-enwiki-2022-05.tsv.gz,Guardians_of_the_Galaxy_Vol._3,124123,54294,872,179289,110915
hdfs://spark-nn.eemcs.utwente.nl/user/s1934538/clickstream/clickstream-enwiki-2022-05.tsv.gz,COVID-19_pandemic_by_country_and_territory,35109,88158,2451,125718,64849
hdfs://spark-nn.eemcs.utwente.nl/user/s1934538/clickstream/clickstream-enwiki-2022-05.tsv.gz,Elon_Musk,343501,2973516,47942,3364959,2053511
hdfs://spark-nn.eemcs.utwente.nl/user/s1934538/clickstream/clickstream-enwiki-2022-05.tsv.gz,Vladimir_Putin,156563,657336,12468,826367,399932
hdfs://spark-nn.eemcs.utwente.nl/user/s1934538/clickstream/clickstream-enwiki-2022-05.tsv.gz,House_of_the_Dragon,51757,270975,5304,328036,307166
hdfs://spark-nn.eemcs.utwente.nl/user/s1934538/clickstream/clickstream-enwiki-2022-05.tsv.gz,Black_Widow_(2021_film),72444,110087,2397,184928,102936
hdfs://spark-nn.eemcs.utwente.nl/user/s1934538/clickstream/clickstream-enwiki-2022-05.tsv.gz,War_(2019_film),30605,38657,66,69328,18744
hdfs://spark-nn.eemcs.utwente.nl/user/s1934538/clickstream/clickstream-enwiki-2022-05.tsv.gz,Luke_Perry,35222,90341,596,126159,46884
hdfs://spark-nn.eemcs.utwente.nl/user/s1934538/clickstream/clickstream-enwiki-2022-05.tsv.gz,Simple_Mail_Transfer_Protocol,3060,37100,193,40353,3462
hdfs://spark-nn.eemcs.utwente.nl/user/s1934538/clickstream/clickstream-enwiki-2022-05.tsv.gz,Queen_(band),52788,180341,2953,236082,221164
hdfs://spark-nn.eemcs.utwente.nl/user/s1934538/clickstream/clickstream-enwiki-2022-05.tsv.gz,Aretha_Franklin,35273,324640,2423,362336,189897
hdfs://spark-nn.eemcs.utwente.nl/user/s1934538/clickstream/clickstream-enwiki-2022-05.tsv.gz,2018_Winter_Olympics,7835,8012,69,15916,9248
hdfs://spark-nn.eemcs.utwente.nl/user/s1934538/clickstream/clickstream-enwiki-2022-05.tsv.gz,Cook's_Country,334,1709,21,2064,591
hdfs://spark-nn.eemcs.utwente.nl/user/s1934538/clickstream/clickstream-enwiki-2022-05.tsv.gz,Game_of_Thrones,77672,238548,7033,323253,225884
hdfs://spark-nn.eemcs.utwente.nl/user/s1934538/clickstream/clickstream-enwiki-2022-05.tsv.gz,The_Umbrella_Academy_(TV_series),30707,147918,4029,182654,122591
hdfs://spark-nn.eemcs.utwente.nl/user/s1934538/clickstream/clickstream-enwiki-2022-05.tsv.gz,Russo-Ukrainian_War,236058,754889,20056,1011003,506427
hdfs://spark-nn.eemcs.utwente.nl/user/s1934538/clickstream/clickstream-enwiki-2022-05.tsv.gz,Sylvester_Stallone,82381,229922,2363,314666,221392
hdfs://spark-nn.eemcs.utwente.nl/user/s1934538/clickstream/clickstream-enwiki-2022-05.tsv.gz,Avatar:_The_Way_of_Water,206191,532013,11773,749977,569341
hdfs://spark-nn.eemcs.utwente.nl/user/s1934538/clickstream/clickstream-enwiki-2022-05.tsv.gz,Doctor_Strange_in_the_Multiverse_of_Madness,872742,6893430,200743,7966915,5313782
hdfs://spark-nn.eemcs.utwente.nl/user/s1934538/clickstream/clickstream-enwiki-2022-05.tsv.gz,Rihanna,80684,386142,5223,472049,242453
hdfs://spark-nn.eemcs.utwente.nl/user/s1934538/clickstream/clickstream-enwiki-2022-05.tsv.gz,Squid_Game,20158,151419,3475,175052,87327
hdfs://spark-nn.eemcs.utwente.nl/user/s1934538/clickstream/clickstream-enwiki-2022-05.tsv.gz,Rami_Malek,57129,131675,6997,195801,88138
hdfs://spark-nn.eemcs.utwente.nl/user/s1934538/clickstream/clickstream-enwiki-2022-05.tsv.gz,Sridevi,29015,61453,180,90648,44227
hdfs://spark-nn.eemcs.utwente.nl/user/s1934538/clickstream/clickstream-enwiki-2022-05.tsv.gz,Sinéad_O'Connor,13722,65196,639,79557,25369
hdfs://spark-nn.eemcs.utwente.nl/user/s1934538/clickstream/clickstream-enwiki-2022-05.tsv.gz,Qasem_Soleimani,12336,23832,137,36305,21105
hdfs://spark-nn.eemcs.utwente.nl/user/s1934538/clickstream/clickstream-enwiki-2022-05.tsv.gz,Captain_Marvel_(film),58400,119854,1500,179754,88707
hdfs://spark-nn.eemcs.utwente.nl/user/s1934538/clickstream/clickstream-enwiki-2022-05.tsv.gz,Stan_Lee,56943,205196,1366,263505,67804
hdfs://spark-nn.eemcs.utwente.nl/user/s1934538/clickstream/clickstream-enwiki-2022-05.tsv.gz,Glass_(2019_film),41732,40795,327,82854,28360
hdfs://spark-nn.eemcs.utwente.nl/user/s1934538/clickstream/clickstream-enwiki-2022-05.tsv.gz,William_Murdoch,689,1318,22,2029,379
hdfs://spark-nn.eemcs.utwente.nl/user/s1934538/clickstream/clickstream-enwiki-2022-05.tsv.gz,Jenna_Ortega,63330,81681,1370,146381,51513
hdfs://spark-nn.eemcs.utwente.nl/user/s1934538/clickstream/clickstream-enwiki-2022-05.tsv.gz,Death_of_Elisa_Lam,15160,71167,364,86691,25348
hdfs://spark-nn.eemcs.utwente.nl/user/s1934538/clickstream/clickstream-enwiki-2022-05.tsv.gz,Joe_Biden,195947,527653,2258,725858,339291
hdfs://spark-nn.eemcs.utwente.nl/user/s1934538/clickstream/clickstream-enwiki-2022-05.tsv.gz,Saaho,33987,35347,176,69510,19046
hdfs://spark-nn.eemcs.utwente.nl/user/s1934538/clickstream/clickstream-enwiki-2022-05.tsv.gz,Manti_Te'o,3061,11397,69,14527,1629
hdfs://spark-nn.eemcs.utwente.nl/user/s1934538/clickstream/clickstream-enwiki-2022-05.tsv.gz,Richard_Ramirez,17516,253422,1789,272727,72821
hdfs://spark-nn.eemcs.utwente.nl/user/s1934538/clickstream/clickstream-enwiki-2022-05.tsv.gz,2020_Summer_Olympics,49687,55303,1364,106354,99964
hdfs://spark-nn.eemcs.utwente.nl/user/s1934538/clickstream/clickstream-enwiki-2022-05.tsv.gz,Us_(2019_film),26343,56454,274,83071,29711
hdfs://spark-nn.eemcs.utwente.nl/user/s1934538/clickstream/clickstream-enwiki-2022-05.tsv.gz,Critical_race_theory,19346,211616,1454,232416,25159
hdfs://spark-nn.eemcs.utwente.nl/user/s1934538/clickstream/clickstream-enwiki-2022-05.tsv.gz,Ruth_Bader_Ginsburg,39404,118388,1267,159059,60901
hdfs://spark-nn.eemcs.utwente.nl/user/s1934538/clickstream/clickstream-enwiki-2022-05.tsv.gz,Parasite_(2019_film),27480,157818,2269,187567,80130
hdfs://spark-nn.eemcs.utwente.nl/user/s1934538/clickstream/clickstream-enwiki-2022-05.tsv.gz,Mulan_(2020_film),17513,38298,639,56450,29599
hdfs://spark-nn.eemcs.utwente.nl/user/s1934538/clickstream/clickstream-enwiki-2022-05.tsv.gz,Alexander_Hamilton,58749,181084,1712,241545,125336
hdfs://spark-nn.eemcs.utwente.nl/user/s1934538/clickstream/clickstream-enwiki-2022-05.tsv.gz,Thor:_Love_and_Thunder,282147,593820,15065,891032,648960
hdfs://spark-nn.eemcs.utwente.nl/user/s1934538/clickstream/clickstream-enwiki-2022-05.tsv.gz,Ghislaine_Maxwell,34305,130479,803,165587,59889
hdfs://spark-nn.eemcs.utwente.nl/user/s1934538/clickstream/clickstream-enwiki-2022-05.tsv.gz,Shinzo_Abe,25444,33940,223,59607,32533
hdfs://spark-nn.eemcs.utwente.nl/user/s1934538/clickstream/clickstream-enwiki-2022-05.tsv.gz,Richard_Jewell,8332,30504,176,39012,14638
hdfs://spark-nn.eemcs.utwente.nl/user/s1934538/clickstream/clickstream-enwiki-2022-05.tsv.gz,Tom_Brady,50307,245626,2936,298869,105962
hdfs://spark-nn.eemcs.utwente.nl/user/s1934538/clickstream/clickstream-enwiki-2022-05.tsv.gz,XXXTentacion,89596,727775,7409,824780,154671
hdfs://spark-nn.eemcs.utwente.nl/user/s1934538/clickstream/clickstream-enwiki-2022-05.tsv.gz,Donald_Glover,45483,141523,1400,188406,82194
hdfs://spark-nn.eemcs.utwente.nl/user/s1934538/clickstream/clickstream-enwiki-2022-05.tsv.gz,Bonnie_and_Clyde,23137,204093,1849,229079,63272
hdfs://spark-nn.eemcs.utwente.nl/user/s1934538/clickstream/clickstream-enwiki-2022-05.tsv.gz,No_Time_to_Die,114716,238783,5004,358503,235826
hdfs://spark-nn.eemcs.utwente.nl/user/s1934538/clickstream/clickstream-enwiki-2022-05.tsv.gz,Murder_of_Dee_Dee_Blanchard,20478,101935,452,122865,31262
hdfs://spark-nn.eemcs.utwente.nl/user/s1934538/clickstream/clickstream-enwiki-2022-05.tsv.gz,Puneeth_Rajkumar,25091,80063,700,105854,50998
hdfs://spark-nn.eemcs.utwente.nl/user/s1934538/clickstream/clickstream-enwiki-2022-05.tsv.gz,Carlos_Alcaraz,47192,427679,2392,477263,126795
hdfs://spark-nn.eemcs.utwente.nl/user/s1934538/clickstream/clickstream-enwiki-2022-05.tsv.gz,Jurassic_World_Dominion,150135,324542,11091,485768,285494
hdfs://spark-nn.eemcs.utwente.nl/user/s1934538/clickstream/clickstream-enwiki-2022-05.tsv.gz,Hyphen-minus,797,6073970,22160,6096927,738
hdfs://spark-nn.eemcs.utwente.nl/user/s1934538/clickstream/clickstream-enwiki-2022-05.tsv.gz,Avengers:_Endgame,144153,200441,3859,348453,191255
hdfs://spark-nn.eemcs.utwente.nl/user/s1934538/clickstream/clickstream-enwiki-2022-05.tsv.gz,The_Kashmir_Files,48975,402394,3808,455177,195746
hdfs://spark-nn.eemcs.utwente.nl/user/s1934538/clickstream/clickstream-enwiki-2022-05.tsv.gz,K.G.F:_Chapter_2,359106,3408235,25344,3792685,1322966
hdfs://spark-nn.eemcs.utwente.nl/user/s1934538/clickstream/clickstream-enwiki-2022-05.tsv.gz,Tunnel,4228,8485,152,12865,3529
hdfs://spark-nn.eemcs.utwente.nl/user/s1934538/clickstream/clickstream-enwiki-2022-09.tsv.gz,ICC_Men's_T20_World_Cup,18561,376169,1445,396175,245177
hdfs://spark-nn.eemcs.utwente.nl/user/s1934538/clickstream/clickstream-enwiki-2022-09.tsv.gz,Bird_Box_(film),13217,56299,403,69919,21951
hdfs://spark-nn.eemcs.utwente.nl/user/s1934538/clickstream/clickstream-enwiki-2022-09.tsv.gz,Godzilla_vs._Kong,30625,54384,657,85666,44930
hdfs://spark-nn.eemcs.utwente.nl/user/s1934538/clickstream/clickstream-enwiki-2022-09.tsv.gz,Wikipedia,238351,1458175,2225,1698751,739968
hdfs://spark-nn.eemcs.utwente.nl/user/s1934538/clickstream/clickstream-enwiki-2022-09.tsv.gz,Luke_Perry,34819,123867,803,159489,59804
hdfs://spark-nn.eemcs.utwente.nl/user/s1934538/clickstream/clickstream-enwiki-2022-09.tsv.gz,The_Matrix_Resurrections,57029,101745,1625,160399,76714
hdfs://spark-nn.eemcs.utwente.nl/user/s1934538/clickstream/clickstream-enwiki-2022-09.tsv.gz,When_They_See_Us,12126,23977,116,36219,14735
hdfs://spark-nn.eemcs.utwente.nl/user/s1934538/clickstream/clickstream-enwiki-2022-09.tsv.gz,Kim_Jong-un,61813,148526,1242,211581,113105
hdfs://spark-nn.eemcs.utwente.nl/user/s1934538/clickstream/clickstream-enwiki-2022-09.tsv.gz,Louis_Tomlinson,35777,75790,513,112080,36999
hdfs://spark-nn.eemcs.utwente.nl/user/s1934538/clickstream/clickstream-enwiki-2022-09.tsv.gz,Ray_Liotta,63423,248363,2057,313843,61454
hdfs://spark-nn.eemcs.utwente.nl/user/s1934538/clickstream/clickstream-enwiki-2022-09.tsv.gz,A_Star_Is_Born_(2018_film),23617,84216,459,108292,47520
hdfs://spark-nn.eemcs.utwente.nl/user/s1934538/clickstream/clickstream-enwiki-2022-09.tsv.gz,Lionel_Messi,107531,835352,5912,948795,182284
hdfs://spark-nn.eemcs.utwente.nl/user/s1934538/clickstream/clickstream-enwiki-2022-09.tsv.gz,Shakira,24208,276004,2605,302817,118754
hdfs://spark-nn.eemcs.utwente.nl/user/s1934538/clickstream/clickstream-enwiki-2022-09.tsv.gz,Kobe_Bryant,44973,323084,2587,370644,100151
hdfs://spark-nn.eemcs.utwente.nl/user/s1934538/clickstream/clickstream-enwiki-2022-09.tsv.gz,Gaza_Strip,15522,28119,137,43778,16686
hdfs://spark-nn.eemcs.utwente.nl/user/s1934538/clickstream/clickstream-enwiki-2022-09.tsv.gz,2.0_(film),48796,45428,62,94286,22062
hdfs://spark-nn.eemcs.utwente.nl/user/s1934538/clickstream/clickstream-enwiki-2022-09.tsv.gz,UEFA_Euro_2020,43809,66665,1298,111772,58297
hdfs://spark-nn.eemcs.utwente.nl/user/s1934538/clickstream/clickstream-enwiki-2022-09.tsv.gz,Guardians_of_the_Galaxy_Vol._3,82098,46127,413,128638,95002
hdfs://spark-nn.eemcs.utwente.nl/user/s1934538/clickstream/clickstream-enwiki-2022-09.tsv.gz,Critical_race_theory,11952,130296,677,142925,15770
hdfs://spark-nn.eemcs.utwente.nl/user/s1934538/clickstream/clickstream-enwiki-2022-09.tsv.gz,Watts_family_murders,9880,189452,348,199680,47857
hdfs://spark-nn.eemcs.utwente.nl/user/s1934538/clickstream/clickstream-enwiki-2022-09.tsv.gz,Brahmāstra:_Part_One_–_Shiva,239829,5952016,22279,6214124,1401894
hdfs://spark-nn.eemcs.utwente.nl/user/s1934538/clickstream/clickstream-enwiki-2022-09.tsv.gz,Main_Page,77598,131841425,5014918,136933941,33242127
hdfs://spark-nn.eemcs.utwente.nl/user/s1934538/clickstream/clickstream-enwiki-2022-09.tsv.gz,Charles_III,7575029,7701747,354269,15631045,10966604
hdfs://spark-nn.eemcs.utwente.nl/user/s1934538/clickstream/clickstream-enwiki-2022-09.tsv.gz,Henry_V_of_England,248549,99448,337,348334,282210
hdfs://spark-nn.eemcs.utwente.nl/user/s1934538/clickstream/clickstream-enwiki-2022-09.tsv.gz,United_States_Electoral_College,11459,28864,70,40393,6940
hdfs://spark-nn.eemcs.utwente.nl/user/s1934538/clickstream/clickstream-enwiki-2022-09.tsv.gz,Stephen_Hawking,28522,322297,1881,352700,114945
hdfs://spark-nn.eemcs.utwente.nl/user/s1934538/clickstream/clickstream-enwiki-2022-09.tsv.gz,Puneeth_Rajkumar,14829,83833,542,99204,37693
hdfs://spark-nn.eemcs.utwente.nl/user/s1934538/clickstream/clickstream-enwiki-2022-09.tsv.gz,Ant-Man_and_the_Wasp:_Quantumania,80151,48435,876,129462,76438
hdfs://spark-nn.eemcs.utwente.nl/user/s1934538/clickstream/clickstream-enwiki-2022-09.tsv.gz,Laal_Singh_Chaddha,54653,456221,4160,515034,111905
hdfs://spark-nn.eemcs.utwente.nl/user/s1934538/clickstream/clickstream-enwiki-2022-09.tsv.gz,Nipsey_Hussle,19065,87708,837,107610,33515
hdfs://spark-nn.eemcs.utwente.nl/user/s1934538/clickstream/clickstream-enwiki-2022-09.tsv.gz,Richard_Ramirez,21782,362092,2508,386382,108889
hdfs://spark-nn.eemcs.utwente.nl/user/s1934538/clickstream/clickstream-enwiki-2022-09.tsv.gz,Aretha_Franklin,25234,160489,1020,186743,85337
hdfs://spark-nn.eemcs.utwente.nl/user/s1934538/clickstream/clickstream-enwiki-2022-09.tsv.gz,Cardi_B,36112,225039,2461,263612,77076
hdfs://spark-nn.eemcs.utwente.nl/user/s1934538/clickstream/clickstream-enwiki-2022-09.tsv.gz,Game_of_Thrones,174326,656987,13205,844518,599082
hdfs://spark-nn.eemcs.utwente.nl/user/s1934538/clickstream/clickstream-enwiki-2022-09.tsv.gz,Vikram_(2022_film),66952,381039,1880,449871,185929
hdfs://spark-nn.eemcs.utwente.nl/user/s1934538/clickstream/clickstream-enwiki-2022-09.tsv.gz,The_Nun_(2018_film),15966,50554,508,67028,34244
hdfs://spark-nn.eemcs.utwente.nl/user/s1934538/clickstream/clickstream-enwiki-2022-09.tsv.gz,2018_FIFA_World_Cup,107558,109628,939,218125,121835
hdfs://spark-nn.eemcs.utwente.nl/user/s1934538/clickstream/clickstream-enwiki-2022-09.tsv.gz,Elizabeth_II,5600701,20852308,534861,26987870,19177602
hdfs://spark-nn.eemcs.utwente.nl/user/s1934538/clickstream/clickstream-enwiki-2022-09.tsv.gz,Jason_Momoa,64217,341770,1854,407841,168922
hdfs://spark-nn.eemcs.utwente.nl/user/s1934538/clickstream/clickstream-enwiki-2022-09.tsv.gz,Jenna_Ortega,112596,136049,1337,249982,76846
hdfs://spark-nn.eemcs.utwente.nl/user/s1934538/clickstream/clickstream-enwiki-2022-09.tsv.gz,Doctor_Strange_in_the_Multiverse_of_Madness,95242,237892,4364,337498,182076
hdfs://spark-nn.eemcs.utwente.nl/user/s1934538/clickstream/clickstream-enwiki-2022-09.tsv.gz,Joe_Biden,191749,601980,9701,803430,357858
hdfs://spark-nn.eemcs.utwente.nl/user/s1934538/clickstream/clickstream-enwiki-2022-09.tsv.gz,Adele,26288,148389,3651,178328,72253
hdfs://spark-nn.eemcs.utwente.nl/user/s1934538/clickstream/clickstream-enwiki-2022-09.tsv.gz,Manti_Te'o,20176,909356,2947,932479,107206
hdfs://spark-nn.eemcs.utwente.nl/user/s1934538/clickstream/clickstream-enwiki-2022-09.tsv.gz,Death_of_Elisa_Lam,14293,80675,220,95188,26458
hdfs://spark-nn.eemcs.utwente.nl/user/s1934538/clickstream/clickstream-enwiki-2022-09.tsv.gz,2016_United_States_presidential_election,87951,65367,1631,154949,133332
hdfs://spark-nn.eemcs.utwente.nl/user/s1934538/clickstream/clickstream-enwiki-2022-09.tsv.gz,List_of_Queen_of_the_South_episodes,6070,4939,84,11093,192
hdfs://spark-nn.eemcs.utwente.nl/user/s1934538/clickstream/clickstream-enwiki-2022-09.tsv.gz,The_Falcon_and_the_Winter_Soldier,25411,37351,687,63449,39086
hdfs://spark-nn.eemcs.utwente.nl/user/s1934538/clickstream/clickstream-enwiki-2022-09.tsv.gz,Keanu_Reeves,73589,495639,3080,572308,333791
hdfs://spark-nn.eemcs.utwente.nl/user/s1934538/clickstream/clickstream-enwiki-2022-09.tsv.gz,Rihanna,61780,312993,3467,378240,208736
hdfs://spark-nn.eemcs.utwente.nl/user/s1934538/clickstream/clickstream-enwiki-2022-09.tsv.gz,The_Flash_(film),51830,42437,466,94733,52068
hdfs://spark-nn.eemcs.utwente.nl/user/s1934538/clickstream/clickstream-enwiki-2022-09.tsv.gz,Avatar:_The_Way_of_Water,139703,570688,5324,715715,291706
hdfs://spark-nn.eemcs.utwente.nl/user/s1934538/clickstream/clickstream-enwiki-2022-09.tsv.gz,Matthew_Perry,41657,122389,851,164897,99162
hdfs://spark-nn.eemcs.utwente.nl/user/s1934538/clickstream/clickstream-enwiki-2022-09.tsv.gz,Johnny_Depp,84780,299022,2223,386025,180964
hdfs://spark-nn.eemcs.utwente.nl/user/s1934538/clickstream/clickstream-enwiki-2022-09.tsv.gz,Black_Panther_(film),37817,110917,1798,150532,74107
hdfs://spark-nn.eemcs.utwente.nl/user/s1934538/clickstream/clickstream-enwiki-2022-09.tsv.gz,Fantastic_Beasts:_The_Crimes_of_Grindelwald,42352,56770,398,99520,46185
hdfs://spark-nn.eemcs.utwente.nl/user/s1934538/clickstream/clickstream-enwiki-2022-09.tsv.gz,Darth_Vader,23341,74134,636,98111,50813
hdfs://spark-nn.eemcs.utwente.nl/user/s1934538/clickstream/clickstream-enwiki-2022-09.tsv.gz,Bob_Saget,26029,94394,879,121302,25591
hdfs://spark-nn.eemcs.utwente.nl/user/s1934538/clickstream/clickstream-enwiki-2022-09.tsv.gz,The_Idol_(TV_series),34378,49924,187,84489,42597
hdfs://spark-nn.eemcs.utwente.nl/user/s1934538/clickstream/clickstream-enwiki-2022-09.tsv.gz,Adipurush,72219,165808,3654,241681,194486
hdfs://spark-nn.eemcs.utwente.nl/user/s1934538/clickstream/clickstream-enwiki-2022-09.tsv.gz,1234,80,1828,26,1934,269
hdfs://spark-nn.eemcs.utwente.nl/user/s1934538/clickstream/clickstream-enwiki-2022-09.tsv.gz,Notre-Dame_de_Paris,14463,84778,797,100038,18212
hdfs://spark-nn.eemcs.utwente.nl/user/s1934538/clickstream/clickstream-enwiki-2022-09.tsv.gz,2022_FIFA_World_Cup,255120,1071599,13585,1340304,660962
hdfs://spark-nn.eemcs.utwente.nl/user/s1934538/clickstream/clickstream-enwiki-2022-09.tsv.gz,Ruth_Bader_Ginsburg,15690,71315,473,87478,27502
hdfs://spark-nn.eemcs.utwente.nl/user/s1934538/clickstream/clickstream-enwiki-2022-09.tsv.gz,Parasite_(2019_film),24612,139629,1310,165551,63503
hdfs://spark-nn.eemcs.utwente.nl/user/s1934538/clickstream/clickstream-enwiki-2022-09.tsv.gz,Salman_Rushdie,29570,164128,1868,195566,80457
hdfs://spark-nn.eemcs.utwente.nl/user/s1934538/clickstream/clickstream-enwiki-2022-09.tsv.gz,Mac_Miller,21887,186622,1653,210162,58433
hdfs://spark-nn.eemcs.utwente.nl/user/s1934538/clickstream/clickstream-enwiki-2022-09.tsv.gz,Coronavirus,5704,35276,1143,42123,12604
hdfs://spark-nn.eemcs.utwente.nl/user/s1934538/clickstream/clickstream-enwiki-2022-09.tsv.gz,Jawan_(film),81670,42119,93,123882,90898
hdfs://spark-nn.eemcs.utwente.nl/user/s1934538/clickstream/clickstream-enwiki-2022-09.tsv.gz,Taliban,45131,65393,2661,113185,79144
hdfs://spark-nn.eemcs.utwente.nl/user/s1934538/clickstream/clickstream-enwiki-2022-09.tsv.gz,Asia_Cup,35807,2351254,1344,2388405,433896
hdfs://spark-nn.eemcs.utwente.nl/user/s1934538/clickstream/clickstream-enwiki-2022-09.tsv.gz,RRR_(film),81256,523919,4506,609681,287403
hdfs://spark-nn.eemcs.utwente.nl/user/s1934538/clickstream/clickstream-enwiki-2022-09.tsv.gz,Black_Panther:_Wakanda_Forever,127795,198566,4249,330610,222165
hdfs://spark-nn.eemcs.utwente.nl/user/s1934538/clickstream/clickstream-enwiki-2022-09.tsv.gz,Shang-Chi_and_the_Legend_of_the_Ten_Rings,57676,106919,1112,165707,84295
hdfs://spark-nn.eemcs.utwente.nl/user/s1934538/clickstream/clickstream-enwiki-2022-09.tsv.gz,Jurassic_World_Dominion,149798,430368,9802,589968,377523
hdfs://spark-nn.eemcs.utwente.nl/user/s1934538/clickstream/clickstream-enwiki-2022-09.tsv.gz,Cleopatra,61341,7245641,2409,7309391,576584
hdfs://spark-nn.eemcs.utwente.nl/user/s1934538/clickstream/clickstream-enwiki-2022-09.tsv.gz,Antifa_(United_States),7512,60406,316,68234,13060
hdfs://spark-nn.eemcs.utwente.nl/user/s1934538/clickstream/clickstream-enwiki-2022-09.tsv.gz,Zack_Snyder's_Justice_League,42358,66847,561,109766,49487
hdfs://spark-nn.eemcs.utwente.nl/user/s1934538/clickstream/clickstream-enwiki-2022-09.tsv.gz,September_11_attacks,184752,870333,13439,1068524,594040
hdfs://spark-nn.eemcs.utwente.nl/user/s1934538/clickstream/clickstream-enwiki-2022-09.tsv.gz,Ghislaine_Maxwell,86037,128103,535,214675,80361
hdfs://spark-nn.eemcs.utwente.nl/user/s1934538/clickstream/clickstream-enwiki-2022-09.tsv.gz,Loki_(TV_series),33124,68974,1443,103541,65933
hdfs://spark-nn.eemcs.utwente.nl/user/s1934538/clickstream/clickstream-enwiki-2022-09.tsv.gz,Area_51,14759,112876,8546,136181,49063
hdfs://spark-nn.eemcs.utwente.nl/user/s1934538/clickstream/clickstream-enwiki-2022-09.tsv.gz,Mulan_(2020_film),19234,49503,603,69340,34095
hdfs://spark-nn.eemcs.utwente.nl/user/s1934538/clickstream/clickstream-enwiki-2022-09.tsv.gz,Priyanka_Chopra,68336,204675,643,273654,90802
hdfs://spark-nn.eemcs.utwente.nl/user/s1934538/clickstream/clickstream-enwiki-2022-09.tsv.gz,Hamilton_(musical),26260,166469,1435,194164,111813
hdfs://spark-nn.eemcs.utwente.nl/user/s1934538/clickstream/clickstream-enwiki-2022-09.tsv.gz,Jimmy_Buffett,7888,45786,543,54217,20090
hdfs://spark-nn.eemcs.utwente.nl/user/s1934538/clickstream/clickstream-enwiki-2022-09.tsv.gz,List_of_highest-grossing_films,136244,421857,4211,562312,265557
hdfs://spark-nn.eemcs.utwente.nl/user/s1934538/clickstream/clickstream-enwiki-2022-09.tsv.gz,Burt_Reynolds,52046,135363,1117,188526,92599
hdfs://spark-nn.eemcs.utwente.nl/user/s1934538/clickstream/clickstream-enwiki-2022-09.tsv.gz,Deion_Sanders,23428,219636,1414,244478,79430
hdfs://spark-nn.eemcs.utwente.nl/user/s1934538/clickstream/clickstream-enwiki-2022-09.tsv.gz,Sushma_Swaraj,8869,14102,62,23033,6026
hdfs://spark-nn.eemcs.utwente.nl/user/s1934538/clickstream/clickstream-enwiki-2022-09.tsv.gz,Sridevi,32493,73181,192,105866,46036
hdfs://spark-nn.eemcs.utwente.nl/user/s1934538/clickstream/clickstream-enwiki-2022-09.tsv.gz,Sushant_Singh_Rajput,19193,98008,550,117751,54738
hdfs://spark-nn.eemcs.utwente.nl/user/s1934538/clickstream/clickstream-enwiki-2022-09.tsv.gz,Venom_(2018_film),14975,59414,681,75070,31240
hdfs://spark-nn.eemcs.utwente.nl/user/s1934538/clickstream/clickstream-enwiki-2022-09.tsv.gz,Once_Upon_a_Time_in_Hollywood,96106,146704,2689,245499,238552
hdfs://spark-nn.eemcs.utwente.nl/user/s1934538/clickstream/clickstream-enwiki-2022-09.tsv.gz,Qasem_Soleimani,12254,24874,141,37269,20884
hdfs://spark-nn.eemcs.utwente.nl/user/s1934538/clickstream/clickstream-enwiki-2022-09.tsv.gz,JSON_Web_Token,708,25597,38,26343,2032
hdfs://spark-nn.eemcs.utwente.nl/user/s1934538/clickstream/clickstream-enwiki-2022-09.tsv.gz,"Diana,_Princess_of_Wales",2365703,4401244,27399,6794346,4715280
hdfs://spark-nn.eemcs.utwente.nl/user/s1934538/clickstream/clickstream-enwiki-2022-09.tsv.gz,Aaron_Hernandez,10174,122594,580,133348,46986
hdfs://spark-nn.eemcs.utwente.nl/user/s1934538/clickstream/clickstream-enwiki-2022-09.tsv.gz,"Meghan,_Duchess_of_Sussex",881304,1799359,9430,2690093,1636598
hdfs://spark-nn.eemcs.utwente.nl/user/s1934538/clickstream/clickstream-enwiki-2022-09.tsv.gz,Cameron_Boyce,25623,161454,362,187439,46953
hdfs://spark-nn.eemcs.utwente.nl/user/s1934538/clickstream/clickstream-enwiki-2022-09.tsv.gz,Freddie_Mercury,82317,520838,4023,607178,210856
hdfs://spark-nn.eemcs.utwente.nl/user/s1934538/clickstream/clickstream-enwiki-2022-09.tsv.gz,Sinéad_O'Connor,14690,105724,972,121386,36714
hdfs://spark-nn.eemcs.utwente.nl/user/s1934538/clickstream/clickstream-enwiki-2022-09.tsv.gz,Tonya_Harding,19114,76635,301,96050,26132
hdfs://spark-nn.eemcs.utwente.nl/user/s1934538/clickstream/clickstream-enwiki-2022-09.tsv.gz,Meat_Loaf,25136,113031,1192,139359,45076
hdfs://spark-nn.eemcs.utwente.nl/user/s1934538/clickstream/clickstream-enwiki-2022-09.tsv.gz,Juneteenth,3706,35585,118,39409,4095
hdfs://spark-nn.eemcs.utwente.nl/user/s1934538/clickstream/clickstream-enwiki-2022-09.tsv.gz,J._Robert_Oppenheimer,47027,116099,282,163408,53556
hdfs://spark-nn.eemcs.utwente.nl/user/s1934538/clickstream/clickstream-enwiki-2022-09.tsv.gz,Top_Gun:_Maverick,275516,1177406,23460,1476382,1077785
hdfs://spark-nn.eemcs.utwente.nl/user/s1934538/clickstream/clickstream-enwiki-2022-09.tsv.gz,Russo-Ukrainian_War,211918,722676,11827,946421,509269
hdfs://spark-nn.eemcs.utwente.nl/user/s1934538/clickstream/clickstream-enwiki-2022-09.tsv.gz,United_States_Senate,47900,43819,569,92288,41805
hdfs://spark-nn.eemcs.utwente.nl/user/s1934538/clickstream/clickstream-enwiki-2022-09.tsv.gz,Ted_Bundy,78929,720706,12415,812050,181191
hdfs://spark-nn.eemcs.utwente.nl/user/s1934538/clickstream/clickstream-enwiki-2022-09.tsv.gz,Simple_Mail_Transfer_Protocol,2521,29926,104,32551,2898
hdfs://spark-nn.eemcs.utwente.nl/user/s1934538/clickstream/clickstream-enwiki-2022-09.tsv.gz,2022_Russian_invasion_of_Ukraine,1356805,1760221,9405,3126431,1582580
hdfs://spark-nn.eemcs.utwente.nl/user/s1934538/clickstream/clickstream-enwiki-2022-09.tsv.gz,Stranger_Things_(season_3),25816,62266,743,88825,46046
hdfs://spark-nn.eemcs.utwente.nl/user/s1934538/clickstream/clickstream-enwiki-2022-09.tsv.gz,Bonnie_and_Clyde,17114,168275,1030,186419,45428
hdfs://spark-nn.eemcs.utwente.nl/user/s1934538/clickstream/clickstream-enwiki-2022-09.tsv.gz,Eddie_Van_Halen,57656,107887,998,166541,65240
hdfs://spark-nn.eemcs.utwente.nl/user/s1934538/clickstream/clickstream-enwiki-2022-09.tsv.gz,Lisa_Marie_Presley,550311,624502,1078,1175891,674373
hdfs://spark-nn.eemcs.utwente.nl/user/s1934538/clickstream/clickstream-enwiki-2022-09.tsv.gz,Bridgerton,26991,142850,2505,172346,126980
hdfs://spark-nn.eemcs.utwente.nl/user/s1934538/clickstream/clickstream-enwiki-2022-09.tsv.gz,Grover,1166,5129,33,6328,1109
hdfs://spark-nn.eemcs.utwente.nl/user/s1934538/clickstream/clickstream-enwiki-2022-09.tsv.gz,Rami_Malek,55808,135380,592,191780,80631
hdfs://spark-nn.eemcs.utwente.nl/user/s1934538/clickstream/clickstream-enwiki-2022-09.tsv.gz,Army_of_the_Dead,36730,35009,356,72095,36652
hdfs://spark-nn.eemcs.utwente.nl/user/s1934538/clickstream/clickstream-enwiki-2022-09.tsv.gz,Central_Park_jogger_case,11454,48188,259,59901,7934
hdfs://spark-nn.eemcs.utwente.nl/user/s1934538/clickstream/clickstream-enwiki-2022-09.tsv.gz,Naomi_Osaka,38363,108600,608,147571,37118
hdfs://spark-nn.eemcs.utwente.nl/user/s1934538/clickstream/clickstream-enwiki-2022-09.tsv.gz,Donald_Glover,40581,131814,798,173193,70311
hdfs://spark-nn.eemcs.utwente.nl/user/s1934538/clickstream/clickstream-enwiki-2022-09.tsv.gz,Tunnel,3780,8066,72,11918,2829
hdfs://spark-nn.eemcs.utwente.nl/user/s1934538/clickstream/clickstream-enwiki-2022-09.tsv.gz,Hyphen-minus,674,25486312,20430,25507416,726
hdfs://spark-nn.eemcs.utwente.nl/user/s1934538/clickstream/clickstream-enwiki-2022-09.tsv.gz,Pelé,32926,135101,940,168967,55745
hdfs://spark-nn.eemcs.utwente.nl/user/s1934538/clickstream/clickstream-enwiki-2022-09.tsv.gz,Croatia,48840,197370,2036,248246,78057
hdfs://spark-nn.eemcs.utwente.nl/user/s1934538/clickstream/clickstream-enwiki-2022-10.tsv.gz,Shakira,25760,257578,2234,285572,116230
hdfs://spark-nn.eemcs.utwente.nl/user/s1934538/clickstream/clickstream-enwiki-2022-10.tsv.gz,2020_Summer_Olympics,42848,39698,875,83421,69637
hdfs://spark-nn.eemcs.utwente.nl/user/s1934538/clickstream/clickstream-enwiki-2022-10.tsv.gz,United_States_Electoral_College,13450,37795,105,51350,8787
hdfs://spark-nn.eemcs.utwente.nl/user/s1934538/clickstream/clickstream-enwiki-2022-10.tsv.gz,Death_of_Elisa_Lam,12596,67216,203,80015,23635
hdfs://spark-nn.eemcs.utwente.nl/user/s1934538/clickstream/clickstream-enwiki-2022-10.tsv.gz,The_Umbrella_Academy_(TV_series),21929,113527,2394,137850,86243
hdfs://spark-nn.eemcs.utwente.nl/user/s1934538/clickstream/clickstream-enwiki-2022-10.tsv.gz,Chernobyl_disaster,43446,310696,2756,356898,144345
hdfs://spark-nn.eemcs.utwente.nl/user/s1934538/clickstream/clickstream-enwiki-2022-10.tsv.gz,2022_FIFA_World_Cup,269153,1759296,21075,2049524,872366
hdfs://spark-nn.eemcs.utwente.nl/user/s1934538/clickstream/clickstream-enwiki-2022-10.tsv.gz,Manti_Te'o,7209,206379,602,214190,24889
hdfs://spark-nn.eemcs.utwente.nl/user/s1934538/clickstream/clickstream-enwiki-2022-10.tsv.gz,Dark_Phoenix_(film),46822,51993,634,99449,54286
hdfs://spark-nn.eemcs.utwente.nl/user/s1934538/clickstream/clickstream-enwiki-2022-10.tsv.gz,2018_Winter_Olympics,8565,7160,94,15819,10583
hdfs://spark-nn.eemcs.utwente.nl/user/s1934538/clickstream/clickstream-enwiki-2022-10.tsv.gz,The_Shape_of_Water,40909,49697,637,91243,40188
hdfs://spark-nn.eemcs.utwente.nl/user/s1934538/clickstream/clickstream-enwiki-2022-10.tsv.gz,1234,48,2069,36,2153,291
hdfs://spark-nn.eemcs.utwente.nl/user/s1934538/clickstream/clickstream-enwiki-2022-10.tsv.gz,Bob_Saget,24963,115448,841,141252,27964
hdfs://spark-nn.eemcs.utwente.nl/user/s1934538/clickstream/clickstream-enwiki-2022-10.tsv.gz,Louis_Tomlinson,29369,55071,337,84777,27138
hdfs://spark-nn.eemcs.utwente.nl/user/s1934538/clickstream/clickstream-enwiki-2022-10.tsv.gz,Microsoft_Office,8100,732051,702,740853,21260
hdfs://spark-nn.eemcs.utwente.nl/user/s1934538/clickstream/clickstream-enwiki-2022-10.tsv.gz,The_Flash_(film),86741,63162,658,150561,84995
hdfs://spark-nn.eemcs.utwente.nl/user/s1934538/clickstream/clickstream-enwiki-2022-10.tsv.gz,Kamala_Harris,77321,198826,7360,283507,126361
hdfs://spark-nn.eemcs.utwente.nl/user/s1934538/clickstream/clickstream-enwiki-2022-10.tsv.gz,J._Robert_Oppenheimer,50368,147793,437,198598,69261
hdfs://spark-nn.eemcs.utwente.nl/user/s1934538/clickstream/clickstream-enwiki-2022-10.tsv.gz,The_Suicide_Squad_(film),78217,75699,1005,154921,80532
hdfs://spark-nn.eemcs.utwente.nl/user/s1934538/clickstream/clickstream-enwiki-2022-10.tsv.gz,Volodymyr_Zelenskyy,127142,274739,3093,404974,214346
hdfs://spark-nn.eemcs.utwente.nl/user/s1934538/clickstream/clickstream-enwiki-2022-10.tsv.gz,It_Chapter_Two,49371,83856,822,134049,86801
hdfs://spark-nn.eemcs.utwente.nl/user/s1934538/clickstream/clickstream-enwiki-2022-10.tsv.gz,Deion_Sanders,29173,446593,2624,478390,148793
hdfs://spark-nn.eemcs.utwente.nl/user/s1934538/clickstream/clickstream-enwiki-2022-10.tsv.gz,Vivek_Ramaswamy,418,13939,53,14410,1899
hdfs://spark-nn.eemcs.utwente.nl/user/s1934538/clickstream/clickstream-enwiki-2022-10.tsv.gz,The_Batman_(film),85214,227497,4452,317163,161581
hdfs://spark-nn.eemcs.utwente.nl/user/s1934538/clickstream/clickstream-enwiki-2022-10.tsv.gz,Jimmy_Hoffa,26024,82270,650,108944,40840
hdfs://spark-nn.eemcs.utwente.nl/user/s1934538/clickstream/clickstream-enwiki-2022-10.tsv.gz,Wonder_Woman_1984,35424,74772,1365,111561,50583
hdfs://spark-nn.eemcs.utwente.nl/user/s1934538/clickstream/clickstream-enwiki-2022-10.tsv.gz,Lance_Reddick,26580,25964,148,52692,10507
hdfs://spark-nn.eemcs.utwente.nl/user/s1934538/clickstream/clickstream-enwiki-2022-10.tsv.gz,Kobe_Bryant,72255,504831,3255,580341,168782
hdfs://spark-nn.eemcs.utwente.nl/user/s1934538/clickstream/clickstream-enwiki-2022-10.tsv.gz,The_Idol_(TV_series),29798,61283,408,91489,60947
hdfs://spark-nn.eemcs.utwente.nl/user/s1934538/clickstream/clickstream-enwiki-2022-10.tsv.gz,Asia_Cup,10205,115563,441,126209,43180
hdfs://spark-nn.eemcs.utwente.nl/user/s1934538/clickstream/clickstream-enwiki-2022-10.tsv.gz,Puneeth_Rajkumar,46104,219013,524,265641,96877
hdfs://spark-nn.eemcs.utwente.nl/user/s1934538/clickstream/clickstream-enwiki-2022-10.tsv.gz,JSON_Web_Token,678,24211,43,24932,1938
hdfs://spark-nn.eemcs.utwente.nl/user/s1934538/clickstream/clickstream-enwiki-2022-10.tsv.gz,The_Haunting_of_Bly_Manor,50290,98375,1010,149675,79869
hdfs://spark-nn.eemcs.utwente.nl/user/s1934538/clickstream/clickstream-enwiki-2022-10.tsv.gz,Chadwick_Boseman,80538,315372,1244,397154,102141
hdfs://spark-nn.eemcs.utwente.nl/user/s1934538/clickstream/clickstream-enwiki-2022-10.tsv.gz,Critical_race_theory,14267,148259,714,163240,16610
hdfs://spark-nn.eemcs.utwente.nl/user/s1934538/clickstream/clickstream-enwiki-2022-10.tsv.gz,Gaza_Strip,17997,30213,141,48351,18670
hdfs://spark-nn.eemcs.utwente.nl/user/s1934538/clickstream/clickstream-enwiki-2022-10.tsv.gz,Indian_Premier_League,15727,58295,210,74232,48493
hdfs://spark-nn.eemcs.utwente.nl/user/s1934538/clickstream/clickstream-enwiki-2022-10.tsv.gz,Avengers:_Infinity_War,37328,62030,771,100129,46609
hdfs://spark-nn.eemcs.utwente.nl/user/s1934538/clickstream/clickstream-enwiki-2022-10.tsv.gz,No_Time_to_Die,108387,184706,2822,295915,173729
hdfs://spark-nn.eemcs.utwente.nl/user/s1934538/clickstream/clickstream-enwiki-2022-10.tsv.gz,Joe_Exotic,13067,55012,238,68317,29227
hdfs://spark-nn.eemcs.utwente.nl/user/s1934538/clickstream/clickstream-enwiki-2022-10.tsv.gz,Hamas,23289,25682,266,49237,22384
hdfs://spark-nn.eemcs.utwente.nl/user/s1934538/clickstream/clickstream-enwiki-2022-10.tsv.gz,Loki_(TV_series),33244,63082,1143,97469,61333
hdfs://spark-nn.eemcs.utwente.nl/user/s1934538/clickstream/clickstream-enwiki-2022-10.tsv.gz,Ant-Man_and_the_Wasp:_Quantumania,133581,245403,6777,385761,315304
hdfs://spark-nn.eemcs.utwente.nl/user/s1934538/clickstream/clickstream-enwiki-2022-10.tsv.gz,Bridgerton,27606,128360,2459,158425,116458
hdfs://spark-nn.eemcs.utwente.nl/user/s1934538/clickstream/clickstream-enwiki-2022-10.tsv.gz,Wikipedia,246579,1487787,1189,1735555,775624
hdfs://spark-nn.eemcs.utwente.nl/user/s1934538/clickstream/clickstream-enwiki-2022-10.tsv.gz,Avicii,17315,179894,1103,198312,54518
hdfs://spark-nn.eemcs.utwente.nl/user/s1934538/clickstream/clickstream-enwiki-2022-10.tsv.gz,Juice_Wrld,32715,188238,2742,223695,89371
hdfs://spark-nn.eemcs.utwente.nl/user/s1934538/clickstream/clickstream-enwiki-2022-10.tsv.gz,Christopher_Scarver,3219158,1926656,27882,5173696,1143991
hdfs://spark-nn.eemcs.utwente.nl/user/s1934538/clickstream/clickstream-enwiki-2022-10.tsv.gz,Zack_Snyder's_Justice_League,61693,81067,580,143340,61074
hdfs://spark-nn.eemcs.utwente.nl/user/s1934538/clickstream/clickstream-enwiki-2022-10.tsv.gz,House_of_the_Dragon,425560,4774109,129553,5329222,2782561
hdfs://spark-nn.eemcs.utwente.nl/user/s1934538/clickstream/clickstream-enwiki-2022-10.tsv.gz,Mission:_Impossible_–_Dead_Reckoning_Part_One,55718,33422,415,89555,67289
hdfs://spark-nn.eemcs.utwente.nl/user/s1934538/clickstream/clickstream-enwiki-2022-10.tsv.gz,Khabib_Nurmagomedov,129159,416909,2415,548483,291543
hdfs://spark-nn.eemcs.utwente.nl/user/s1934538/clickstream/clickstream-enwiki-2022-10.tsv.gz,The_Irishman,40423,64506,1123,106052,87005
hdfs://spark-nn.eemcs.utwente.nl/user/s1934538/clickstream/clickstream-enwiki-2022-10.tsv.gz,"Princess_Margaret,_Countess_of_Snowdon",189309,630835,3979,824123,497222
hdfs://spark-nn.eemcs.utwente.nl/user/s1934538/clickstream/clickstream-enwiki-2022-10.tsv.gz,Guardians_of_the_Galaxy_Vol._3,94188,48891,642,143721,104715
hdfs://spark-nn.eemcs.utwente.nl/user/s1934538/clickstream/clickstream-enwiki-2022-10.tsv.gz,Notre-Dame_de_Paris,14649,99365,721,114735,21794
hdfs://spark-nn.eemcs.utwente.nl/user/s1934538/clickstream/clickstream-enwiki-2022-10.tsv.gz,Pornhub,41364,449197,12709,503270,80122
hdfs://spark-nn.eemcs.utwente.nl/user/s1934538/clickstream/clickstream-enwiki-2022-10.tsv.gz,Royal_Rumble_(2018),5973,3677,76,9726,7653
hdfs://spark-nn.eemcs.utwente.nl/user/s1934538/clickstream/clickstream-enwiki-2022-10.tsv.gz,Cameron_Boyce,28544,176918,569,206031,49290
hdfs://spark-nn.eemcs.utwente.nl/user/s1934538/clickstream/clickstream-enwiki-2022-10.tsv.gz,Spider-Man:_Far_From_Home,33880,50730,377,84987,32065
hdfs://spark-nn.eemcs.utwente.nl/user/s1934538/clickstream/clickstream-enwiki-2022-10.tsv.gz,Ukraine,170220,639315,17102,826637,414458
hdfs://spark-nn.eemcs.utwente.nl/user/s1934538/clickstream/clickstream-enwiki-2022-10.tsv.gz,Burt_Reynolds,54011,149524,1219,204754,95061
hdfs://spark-nn.eemcs.utwente.nl/user/s1934538/clickstream/clickstream-enwiki-2022-10.tsv.gz,Murder_of_Dee_Dee_Blanchard,14249,119809,391,134449,26544
hdfs://spark-nn.eemcs.utwente.nl/user/s1934538/clickstream/clickstream-enwiki-2022-10.tsv.gz,The_Witcher_(TV_series),44629,264556,11132,320317,169977
hdfs://spark-nn.eemcs.utwente.nl/user/s1934538/clickstream/clickstream-enwiki-2022-10.tsv.gz,Joe_Biden,206637,546556,2527,755720,361811
hdfs://spark-nn.eemcs.utwente.nl/user/s1934538/clickstream/clickstream-enwiki-2022-10.tsv.gz,Henry_V_of_England,95226,81333,315,176874,129144
hdfs://spark-nn.eemcs.utwente.nl/user/s1934538/clickstream/clickstream-enwiki-2022-10.tsv.gz,Elliot_Page,53825,206677,1030,261532,100628
hdfs://spark-nn.eemcs.utwente.nl/user/s1934538/clickstream/clickstream-enwiki-2022-10.tsv.gz,State_of_Palestine,51725,123316,288,175329,76885
hdfs://spark-nn.eemcs.utwente.nl/user/s1934538/clickstream/clickstream-enwiki-2022-10.tsv.gz,Juneteenth,4455,35288,127,39870,4087
hdfs://spark-nn.eemcs.utwente.nl/user/s1934538/clickstream/clickstream-enwiki-2022-10.tsv.gz,2016_United_States_presidential_election,101172,74404,971,176547,147860
hdfs://spark-nn.eemcs.utwente.nl/user/s1934538/clickstream/clickstream-enwiki-2022-10.tsv.gz,George_VI,521685,258201,1696,781582,581570
hdfs://spark-nn.eemcs.utwente.nl/user/s1934538/clickstream/clickstream-enwiki-2022-10.tsv.gz,UEFA_Euro_2020,42288,57213,1082,100583,54999
hdfs://spark-nn.eemcs.utwente.nl/user/s1934538/clickstream/clickstream-enwiki-2022-10.tsv.gz,NATO,85605,286053,7445,379103,179371
hdfs://spark-nn.eemcs.utwente.nl/user/s1934538/clickstream/clickstream-enwiki-2022-10.tsv.gz,Stranger_Things_(season_4),39843,167875,2565,210283,116026
hdfs://spark-nn.eemcs.utwente.nl/user/s1934538/clickstream/clickstream-enwiki-2022-10.tsv.gz,1917_(2019_film),20013,68444,1383,89840,44314
hdfs://spark-nn.eemcs.utwente.nl/user/s1934538/clickstream/clickstream-enwiki-2022-10.tsv.gz,George_H._W._Bush,144816,98632,847,244295,147831
hdfs://spark-nn.eemcs.utwente.nl/user/s1934538/clickstream/clickstream-enwiki-2022-10.tsv.gz,Naomi_Osaka,9741,37856,5289,52886,11920
hdfs://spark-nn.eemcs.utwente.nl/user/s1934538/clickstream/clickstream-enwiki-2022-10.tsv.gz,2020_United_States_presidential_election,131344,202776,4685,338805,298580
hdfs://spark-nn.eemcs.utwente.nl/user/s1934538/clickstream/clickstream-enwiki-2022-10.tsv.gz,Anthony_Bourdain,23508,255107,1934,280549,111947
hdfs://spark-nn.eemcs.utwente.nl/user/s1934538/clickstream/clickstream-enwiki-2022-10.tsv.gz,WandaVision,54090,68664,972,123726,46172
hdfs://spark-nn.eemcs.utwente.nl/user/s1934538/clickstream/clickstream-enwiki-2022-10.tsv.gz,Simple_Mail_Transfer_Protocol,2740,31050,136,33926,3239
hdfs://spark-nn.eemcs.utwente.nl/user/s1934538/clickstream/clickstream-enwiki-2022-10.tsv.gz,Tunnel,3985,9330,95,13410,3154
hdfs://spark-nn.eemcs.utwente.nl/user/s1934538/clickstream/clickstream-enwiki-2022-10.tsv.gz,Army_of_the_Dead,42418,45283,440,88141,45597
hdfs://spark-nn.eemcs.utwente.nl/user/s1934538/clickstream/clickstream-enwiki-2022-10.tsv.gz,FIFA_World_Cup,85753,393671,7254,486678,387622
hdfs://spark-nn.eemcs.utwente.nl/user/s1934538/clickstream/clickstream-enwiki-2022-10.tsv.gz,Darth_Vader,23166,73062,521,96749,47450
hdfs://spark-nn.eemcs.utwente.nl/user/s1934538/clickstream/clickstream-enwiki-2022-10.tsv.gz,Lionel_Messi,144265,1137778,8008,1290051,234858
hdfs://spark-nn.eemcs.utwente.nl/user/s1934538/clickstream/clickstream-enwiki-2022-10.tsv.gz,Cristiano_Ronaldo,150110,1309957,6736,1466803,266240
hdfs://spark-nn.eemcs.utwente.nl/user/s1934538/clickstream/clickstream-enwiki-2022-10.tsv.gz,Cecil_Hotel_(Los_Angeles),8091,61314,149,69554,16269
hdfs://spark-nn.eemcs.utwente.nl/user/s1934538/clickstream/clickstream-enwiki-2022-10.tsv.gz,Ponniyin_Selvan:_I,315260,4692017,23525,5030802,2497081
hdfs://spark-nn.eemcs.utwente.nl/user/s1934538/clickstream/clickstream-enwiki-2022-10.tsv.gz,Lists_of_deaths_by_year,2550,147144,1177,150871,167705
hdfs://spark-nn.eemcs.utwente.nl/user/s1934538/clickstream/clickstream-enwiki-2022-10.tsv.gz,Tenet_(film),48791,148235,1871,198897,100537
hdfs://spark-nn.eemcs.utwente.nl/user/s1934538/clickstream/clickstream-enwiki-2022-10.tsv.gz,Aaron_Hernandez,12840,158278,687,171805,64625
hdfs://spark-nn.eemcs.utwente.nl/user/s1934538/clickstream/clickstream-enwiki-2022-10.tsv.gz,Deaths_in_2022,1415977,2480681,19718,3916376,2349238
hdfs://spark-nn.eemcs.utwente.nl/user/s1934538/clickstream/clickstream-enwiki-2022-10.tsv.gz,Vladimir_Putin,164753,666176,12039,842968,434319
hdfs://spark-nn.eemcs.utwente.nl/user/s1934538/clickstream/clickstream-enwiki-2022-10.tsv.gz,United_States_Senate,63208,59523,3015,125746,55959
hdfs://spark-nn.eemcs.utwente.nl/user/s1934538/clickstream/clickstream-enwiki-2022-10.tsv.gz,Thor:_Love_and_Thunder,105919,422660,8791,537370,289470
hdfs://spark-nn.eemcs.utwente.nl/user/s1934538/clickstream/clickstream-enwiki-2022-10.tsv.gz,Amber_Heard,68234,199658,1410,269302,101603
hdfs://spark-nn.eemcs.utwente.nl/user/s1934538/clickstream/clickstream-enwiki-2022-10.tsv.gz,Jimmy_Buffett,7959,39405,454,47818,17844
hdfs://spark-nn.eemcs.utwente.nl/user/s1934538/clickstream/clickstream-enwiki-2022-10.tsv.gz,The_Matrix_Resurrections,55594,87300,1776,144670,69161
hdfs://spark-nn.eemcs.utwente.nl/user/s1934538/clickstream/clickstream-enwiki-2022-10.tsv.gz,Emma_Raducanu,4100,65152,371,69623,11480
hdfs://spark-nn.eemcs.utwente.nl/user/s1934538/clickstream/clickstream-enwiki-2022-10.tsv.gz,Saaho,34429,47391,109,81929,21135
hdfs://spark-nn.eemcs.utwente.nl/user/s1934538/clickstream/clickstream-enwiki-2022-10.tsv.gz,Adele,32044,157442,5927,195413,84560
hdfs://spark-nn.eemcs.utwente.nl/user/s1934538/clickstream/clickstream-enwiki-2022-10.tsv.gz,Game_of_Thrones_(season_8),31559,68501,884,100944,40978
hdfs://spark-nn.eemcs.utwente.nl/user/s1934538/clickstream/clickstream-enwiki-2022-10.tsv.gz,Donald_Glover,42923,132648,1102,176673,73449
hdfs://spark-nn.eemcs.utwente.nl/user/s1934538/clickstream/clickstream-enwiki-2022-10.tsv.gz,Fantastic_Beasts:_The_Crimes_of_Grindelwald,34674,39617,355,74646,37061
hdfs://spark-nn.eemcs.utwente.nl/user/s1934538/clickstream/clickstream-enwiki-2022-10.tsv.gz,Central_Park_jogger_case,9797,51400,234,61431,7745
hdfs://spark-nn.eemcs.utwente.nl/user/s1934538/clickstream/clickstream-enwiki-2022-10.tsv.gz,Black_Panther_(film),60575,319661,4276,384512,198123
hdfs://spark-nn.eemcs.utwente.nl/user/s1934538/clickstream/clickstream-enwiki-2022-10.tsv.gz,Vikram_(2022_film),100370,367422,2505,470297,171769
hdfs://spark-nn.eemcs.utwente.nl/user/s1934538/clickstream/clickstream-enwiki-2022-10.tsv.gz,Tina_Turner,20964,253404,2212,276580,72571
hdfs://spark-nn.eemcs.utwente.nl/user/s1934538/clickstream/clickstream-enwiki-2022-10.tsv.gz,COVID-19_pandemic,92023,230852,7575,330450,104013
hdfs://spark-nn.eemcs.utwente.nl/user/s1934538/clickstream/clickstream-enwiki-2022-10.tsv.gz,The_Sandman_(TV_series),50619,257666,4860,313145,211981
hdfs://spark-nn.eemcs.utwente.nl/user/s1934538/clickstream/clickstream-enwiki-2022-10.tsv.gz,Nipsey_Hussle,15648,61580,444,77672,25770
hdfs://spark-nn.eemcs.utwente.nl/user/s1934538/clickstream/clickstream-enwiki-2022-10.tsv.gz,Shang-Chi_and_the_Legend_of_the_Ten_Rings,49023,87234,940,137197,70088
hdfs://spark-nn.eemcs.utwente.nl/user/s1934538/clickstream/clickstream-enwiki-2022-10.tsv.gz,Freddie_Mercury,68959,421124,3490,493573,180365
hdfs://spark-nn.eemcs.utwente.nl/user/s1934538/clickstream/clickstream-enwiki-2022-10.tsv.gz,List_of_highest-grossing_films,114522,292585,3774,410881,213326
hdfs://spark-nn.eemcs.utwente.nl/user/s1934538/clickstream/clickstream-enwiki-2022-10.tsv.gz,Matthew_Perry,64996,642174,5544,712714,418553
hdfs://spark-nn.eemcs.utwente.nl/user/s1934538/clickstream/clickstream-enwiki-2022-10.tsv.gz,XNXX,19844,1989393,8603,2017840,172428
hdfs://spark-nn.eemcs.utwente.nl/user/s1934538/clickstream/clickstream-enwiki-2022-10.tsv.gz,Mortal_Kombat_(2021_film),19714,62725,931,83370,64596
hdfs://spark-nn.eemcs.utwente.nl/user/s1934538/clickstream/clickstream-enwiki-2022-10.tsv.gz,Spider-Man:_Across_the_Spider-Verse,52087,59874,545,112506,44543
hdfs://spark-nn.eemcs.utwente.nl/user/s1934538/clickstream/clickstream-enwiki-2022-10.tsv.gz,Crazy_Rich_Asians_(film),34199,62321,730,97250,72184
hdfs://spark-nn.eemcs.utwente.nl/user/s1934538/clickstream/clickstream-enwiki-2022-10.tsv.gz,List_of_FIFA_World_Cup_finals,4854,134487,100,139441,34154
hdfs://spark-nn.eemcs.utwente.nl/user/s1934538/clickstream/clickstream-enwiki-2022-10.tsv.gz,HTTP_cookie,2784,330701,83,333568,18583
hdfs://spark-nn.eemcs.utwente.nl/user/s1934538/clickstream/clickstream-enwiki-2022-10.tsv.gz,List_of_Marvel_Cinematic_Universe_films,213460,525553,3497,742510,471288
hdfs://spark-nn.eemcs.utwente.nl/user/s1934538/clickstream/clickstream-enwiki-2022-10.tsv.gz,Lisa_Marie_Presley,233243,273377,696,507316,288002
hdfs://spark-nn.eemcs.utwente.nl/user/s1934538/clickstream/clickstream-enwiki-2022-10.tsv.gz,QAnon,39561,204208,1411,245180,64177
hdfs://spark-nn.eemcs.utwente.nl/user/s1934538/clickstream/clickstream-enwiki-2022-10.tsv.gz,The_Kashmir_Files,20128,54352,545,75025,26478
hdfs://spark-nn.eemcs.utwente.nl/user/s1934538/clickstream/clickstream-enwiki-2022-10.tsv.gz,The_Weeknd,67711,180663,1680,250054,106748
hdfs://spark-nn.eemcs.utwente.nl/user/s1934538/clickstream/clickstream-enwiki-2022-10.tsv.gz,Pathaan_(film),79961,66331,799,147091,61284
hdfs://spark-nn.eemcs.utwente.nl/user/s1934538/clickstream/clickstream-enwiki-2022-10.tsv.gz,Rishi_Sunak,767489,7719210,185179,8671878,4422705
hdfs://spark-nn.eemcs.utwente.nl/user/s1934538/clickstream/clickstream-enwiki-2022-10.tsv.gz,The_Lion_King_(2019_film),55879,43827,518,100224,40527
hdfs://spark-nn.eemcs.utwente.nl/user/s1934538/clickstream/clickstream-enwiki-2023-01.tsv.gz,List_of_Queen_of_the_South_episodes,5056,4305,45,9406,243
hdfs://spark-nn.eemcs.utwente.nl/user/s1934538/clickstream/clickstream-enwiki-2023-01.tsv.gz,Indian_Premier_League,27897,91793,814,120504,90072
hdfs://spark-nn.eemcs.utwente.nl/user/s1934538/clickstream/clickstream-enwiki-2023-01.tsv.gz,XXXTentacion,72208,1662651,6116,1740975,141832
hdfs://spark-nn.eemcs.utwente.nl/user/s1934538/clickstream/clickstream-enwiki-2023-01.tsv.gz,The_Last_of_Us_(TV_series),721071,4997636,85041,5803748,3370700
hdfs://spark-nn.eemcs.utwente.nl/user/s1934538/clickstream/clickstream-enwiki-2023-01.tsv.gz,FIFA_World_Cup,102124,400710,5168,508002,390260
hdfs://spark-nn.eemcs.utwente.nl/user/s1934538/clickstream/clickstream-enwiki-2023-01.tsv.gz,Emma_Raducanu,19136,193825,1719,214680,39828
hdfs://spark-nn.eemcs.utwente.nl/user/s1934538/clickstream/clickstream-enwiki-2023-01.tsv.gz,The_Weeknd,65374,224371,2329,292074,135508
hdfs://spark-nn.eemcs.utwente.nl/user/s1934538/clickstream/clickstream-enwiki-2023-01.tsv.gz,United_States_Senate,100329,87743,2976,191048,116589
hdfs://spark-nn.eemcs.utwente.nl/user/s1934538/clickstream/clickstream-enwiki-2023-01.tsv.gz,2020_United_States_presidential_election,120624,141247,3443,265314,281699
hdfs://spark-nn.eemcs.utwente.nl/user/s1934538/clickstream/clickstream-enwiki-2023-01.tsv.gz,2022_Russian_invasion_of_Ukraine,710540,849418,4420,1564378,844460
hdfs://spark-nn.eemcs.utwente.nl/user/s1934538/clickstream/clickstream-enwiki-2023-01.tsv.gz,Aretha_Franklin,36026,217627,1360,255013,121002
hdfs://spark-nn.eemcs.utwente.nl/user/s1934538/clickstream/clickstream-enwiki-2023-01.tsv.gz,Antifa_(United_States),9307,113914,460,123681,20028
hdfs://spark-nn.eemcs.utwente.nl/user/s1934538/clickstream/clickstream-enwiki-2023-01.tsv.gz,Darth_Vader,28035,63644,2542,94221,60526
hdfs://spark-nn.eemcs.utwente.nl/user/s1934538/clickstream/clickstream-enwiki-2023-01.tsv.gz,Queen_(band),61627,200264,3672,265563,264669
hdfs://spark-nn.eemcs.utwente.nl/user/s1934538/clickstream/clickstream-enwiki-2023-01.tsv.gz,Glass_(2019_film),77572,62185,375,140132,43676
hdfs://spark-nn.eemcs.utwente.nl/user/s1934538/clickstream/clickstream-enwiki-2023-01.tsv.gz,Brahmāstra:_Part_One_–_Shiva,74810,197146,4501,276457,69935
hdfs://spark-nn.eemcs.utwente.nl/user/s1934538/clickstream/clickstream-enwiki-2023-01.tsv.gz,Spider-Man:_Across_the_Spider-Verse,75560,79260,1453,156273,86213
hdfs://spark-nn.eemcs.utwente.nl/user/s1934538/clickstream/clickstream-enwiki-2023-01.tsv.gz,Vikram_(2022_film),74467,172154,1201,247822,117309
hdfs://spark-nn.eemcs.utwente.nl/user/s1934538/clickstream/clickstream-enwiki-2023-01.tsv.gz,The_Kashmir_Files,24253,69469,395,94117,37841
hdfs://spark-nn.eemcs.utwente.nl/user/s1934538/clickstream/clickstream-enwiki-2023-01.tsv.gz,Royal_Rumble_(2018),34360,19235,250,53845,39537
hdfs://spark-nn.eemcs.utwente.nl/user/s1934538/clickstream/clickstream-enwiki-2023-01.tsv.gz,Sylvester_Stallone,157793,709152,4121,871066,621788
hdfs://spark-nn.eemcs.utwente.nl/user/s1934538/clickstream/clickstream-enwiki-2023-01.tsv.gz,Tom_Brady,141786,915989,10531,1068306,390164
hdfs://spark-nn.eemcs.utwente.nl/user/s1934538/clickstream/clickstream-enwiki-2023-01.tsv.gz,Roe_v._Wade,15439,131019,4276,150734,46120
hdfs://spark-nn.eemcs.utwente.nl/user/s1934538/clickstream/clickstream-enwiki-2023-01.tsv.gz,Richard_Ramirez,15940,147778,1405,165123,44951
hdfs://spark-nn.eemcs.utwente.nl/user/s1934538/clickstream/clickstream-enwiki-2023-01.tsv.gz,Stephen_Hawking,26387,352402,2247,381036,146406
hdfs://spark-nn.eemcs.utwente.nl/user/s1934538/clickstream/clickstream-enwiki-2023-01.tsv.gz,Kobe_Bryant_sexual_assault_case,8449,36740,63,45252,4049
hdfs://spark-nn.eemcs.utwente.nl/user/s1934538/clickstream/clickstream-enwiki-2023-01.tsv.gz,Game_of_Thrones_(season_8),16141,37554,492,54187,23663
hdfs://spark-nn.eemcs.utwente.nl/user/s1934538/clickstream/clickstream-enwiki-2023-01.tsv.gz,"Princess_Margaret,_Countess_of_Snowdon",123855,418224,2675,544754,298254
hdfs://spark-nn.eemcs.utwente.nl/user/s1934538/clickstream/clickstream-enwiki-2023-01.tsv.gz,Alexander_Hamilton,69774,212998,1783,284555,154934
hdfs://spark-nn.eemcs.utwente.nl/user/s1934538/clickstream/clickstream-enwiki-2023-01.tsv.gz,Death_of_Elisa_Lam,11528,70843,202,82573,25840
hdfs://spark-nn.eemcs.utwente.nl/user/s1934538/clickstream/clickstream-enwiki-2023-01.tsv.gz,Michael_Bloomberg,29644,29209,1332,60185,29504
hdfs://spark-nn.eemcs.utwente.nl/user/s1934538/clickstream/clickstream-enwiki-2023-01.tsv.gz,Rihanna,92527,345404,3874,441805,258615
hdfs://spark-nn.eemcs.utwente.nl/user/s1934538/clickstream/clickstream-enwiki-2023-01.tsv.gz,John_Wick:_Chapter_4,113833,153248,2833,269914,193333
hdfs://spark-nn.eemcs.utwente.nl/user/s1934538/clickstream/clickstream-enwiki-2023-01.tsv.gz,Ruth_Bader_Ginsburg,17602,84283,956,102841,40884
hdfs://spark-nn.eemcs.utwente.nl/user/s1934538/clickstream/clickstream-enwiki-2023-01.tsv.gz,Godzilla_vs._Kong,40939,60716,1020,102675,59481
hdfs://spark-nn.eemcs.utwente.nl/user/s1934538/clickstream/clickstream-enwiki-2023-01.tsv.gz,Lisa_Marie_Presley,1520794,6942347,89969,8553110,5133501
hdfs://spark-nn.eemcs.utwente.nl/user/s1934538/clickstream/clickstream-enwiki-2023-01.tsv.gz,Lists_of_deaths_by_year,7483,704162,8675,720320,753390
hdfs://spark-nn.eemcs.utwente.nl/user/s1934538/clickstream/clickstream-enwiki-2023-01.tsv.gz,Bird_Box_(film),15136,66830,760,82726,31613
hdfs://spark-nn.eemcs.utwente.nl/user/s1934538/clickstream/clickstream-enwiki-2023-01.tsv.gz,Aaron_Carter,31974,168875,2081,202930,74545
hdfs://spark-nn.eemcs.utwente.nl/user/s1934538/clickstream/clickstream-enwiki-2023-01.tsv.gz,2022_FIFA_World_Cup,262626,529490,8236,800352,483816
hdfs://spark-nn.eemcs.utwente.nl/user/s1934538/clickstream/clickstream-enwiki-2023-01.tsv.gz,Tenet_(film),71272,170623,2106,244001,140595
hdfs://spark-nn.eemcs.utwente.nl/user/s1934538/clickstream/clickstream-enwiki-2023-01.tsv.gz,The_Nun_(2018_film),26164,59142,436,85742,52744
hdfs://spark-nn.eemcs.utwente.nl/user/s1934538/clickstream/clickstream-enwiki-2023-01.tsv.gz,COVID-19_pandemic_by_country_and_territory,11156,33604,1371,46131,21754
hdfs://spark-nn.eemcs.utwente.nl/user/s1934538/clickstream/clickstream-enwiki-2023-01.tsv.gz,Wonder_Woman_1984,38935,60517,1657,101109,50109
hdfs://spark-nn.eemcs.utwente.nl/user/s1934538/clickstream/clickstream-enwiki-2023-01.tsv.gz,Elliot_Page,70139,272921,1646,344706,142538
hdfs://spark-nn.eemcs.utwente.nl/user/s1934538/clickstream/clickstream-enwiki-2023-01.tsv.gz,Star_Wars:_The_Rise_of_Skywalker,82958,58798,1286,143042,77312
hdfs://spark-nn.eemcs.utwente.nl/user/s1934538/clickstream/clickstream-enwiki-2023-01.tsv.gz,List_of_James_Bond_films,77165,396112,1811,475088,313885
hdfs://spark-nn.eemcs.utwente.nl/user/s1934538/clickstream/clickstream-enwiki-2023-01.tsv.gz,Juice_Wrld,31707,175243,2009,208959,85120
hdfs://spark-nn.eemcs.utwente.nl/user/s1934538/clickstream/clickstream-enwiki-2023-01.tsv.gz,"Prince_Philip,_Duke_of_Edinburgh",195489,219897,2191,417577,266793
hdfs://spark-nn.eemcs.utwente.nl/user/s1934538/clickstream/clickstream-enwiki-2023-01.tsv.gz,Priyanka_Chopra,90436,279505,848,370789,136353
hdfs://spark-nn.eemcs.utwente.nl/user/s1934538/clickstream/clickstream-enwiki-2023-01.tsv.gz,Spanish_flu,21340,62946,1228,85514,24014
hdfs://spark-nn.eemcs.utwente.nl/user/s1934538/clickstream/clickstream-enwiki-2023-01.tsv.gz,Fantastic_Beasts:_The_Crimes_of_Grindelwald,49220,55931,753,105904,59995
hdfs://spark-nn.eemcs.utwente.nl/user/s1934538/clickstream/clickstream-enwiki-2023-01.tsv.gz,Rishi_Sunak,146623,342500,4237,493360,244509
hdfs://spark-nn.eemcs.utwente.nl/user/s1934538/clickstream/clickstream-enwiki-2023-01.tsv.gz,Anne_Heche,52797,236503,2276,291576,98064
hdfs://spark-nn.eemcs.utwente.nl/user/s1934538/clickstream/clickstream-enwiki-2023-01.tsv.gz,Amy_Coney_Barrett,19110,18349,114,37573,12856
hdfs://spark-nn.eemcs.utwente.nl/user/s1934538/clickstream/clickstream-enwiki-2023-01.tsv.gz,A_Star_Is_Born_(2018_film),27913,107880,795,136588,66230
hdfs://spark-nn.eemcs.utwente.nl/user/s1934538/clickstream/clickstream-enwiki-2023-01.tsv.gz,The_Idol_(TV_series),32021,58337,211,90569,56154
hdfs://spark-nn.eemcs.utwente.nl/user/s1934538/clickstream/clickstream-enwiki-2023-01.tsv.gz,No_Time_to_Die,136549,256817,4456,397822,248560
hdfs://spark-nn.eemcs.utwente.nl/user/s1934538/clickstream/clickstream-enwiki-2023-01.tsv.gz,Thor:_Love_and_Thunder,85604,155258,3078,243940,130203
hdfs://spark-nn.eemcs.utwente.nl/user/s1934538/clickstream/clickstream-enwiki-2023-01.tsv.gz,Fyre_Festival,12853,59064,676,72593,44617
hdfs://spark-nn.eemcs.utwente.nl/user/s1934538/clickstream/clickstream-enwiki-2023-01.tsv.gz,XNXX,14340,535530,7301,557171,42141
hdfs://spark-nn.eemcs.utwente.nl/user/s1934538/clickstream/clickstream-enwiki-2023-01.tsv.gz,Tina_Turner,28604,444511,3262,476377,102621
hdfs://spark-nn.eemcs.utwente.nl/user/s1934538/clickstream/clickstream-enwiki-2023-01.tsv.gz,Critical_race_theory,14896,186536,1060,202492,21002
hdfs://spark-nn.eemcs.utwente.nl/user/s1934538/clickstream/clickstream-enwiki-2023-01.tsv.gz,House_of_the_Dragon,83708,403040,11683,498431,324343
hdfs://spark-nn.eemcs.utwente.nl/user/s1934538/clickstream/clickstream-enwiki-2023-01.tsv.gz,Manti_Te'o,6045,100049,307,106401,14010
hdfs://spark-nn.eemcs.utwente.nl/user/s1934538/clickstream/clickstream-enwiki-2023-01.tsv.gz,Elizabeth_II,471573,732661,6321,1210555,851689
hdfs://spark-nn.eemcs.utwente.nl/user/s1934538/clickstream/clickstream-enwiki-2023-01.tsv.gz,The_Flash_(film),77352,78989,1644,157985,92728
hdfs://spark-nn.eemcs.utwente.nl/user/s1934538/clickstream/clickstream-enwiki-2023-01.tsv.gz,Kelly_Preston,131797,151175,632,283604,81946
hdfs://spark-nn.eemcs.utwente.nl/user/s1934538/clickstream/clickstream-enwiki-2023-01.tsv.gz,Barbie_(film),99906,85572,1800,187278,133775
hdfs://spark-nn.eemcs.utwente.nl/user/s1934538/clickstream/clickstream-enwiki-2023-01.tsv.gz,Brett_Kavanaugh,15003,28048,286,43337,15905
hdfs://spark-nn.eemcs.utwente.nl/user/s1934538/clickstream/clickstream-enwiki-2023-01.tsv.gz,Ant-Man_and_the_Wasp:_Quantumania,201200,380793,13703,595696,414913
hdfs://spark-nn.eemcs.utwente.nl/user/s1934538/clickstream/clickstream-enwiki-2023-01.tsv.gz,Irrfan_Khan,29701,88588,336,118625,45905
hdfs://spark-nn.eemcs.utwente.nl/user/s1934538/clickstream/clickstream-enwiki-2023-01.tsv.gz,Elon_Musk,126909,1081027,9531,1217467,555313
hdfs://spark-nn.eemcs.utwente.nl/user/s1934538/clickstream/clickstream-enwiki-2023-01.tsv.gz,Joaquin_Phoenix,170432,210192,1247,381871,255757
hdfs://spark-nn.eemcs.utwente.nl/user/s1934538/clickstream/clickstream-enwiki-2023-01.tsv.gz,Betty_White,48084,187236,2010,237330,54865
hdfs://spark-nn.eemcs.utwente.nl/user/s1934538/clickstream/clickstream-enwiki-2023-01.tsv.gz,COVID-19_pandemic,94785,214271,7391,316447,105766
hdfs://spark-nn.eemcs.utwente.nl/user/s1934538/clickstream/clickstream-enwiki-2023-01.tsv.gz,Gaza_Strip,24441,45270,311,70022,30790
hdfs://spark-nn.eemcs.utwente.nl/user/s1934538/clickstream/clickstream-enwiki-2023-01.tsv.gz,Brie_Larson,75351,127362,863,203576,84052
hdfs://spark-nn.eemcs.utwente.nl/user/s1934538/clickstream/clickstream-enwiki-2023-01.tsv.gz,Saltburn_(film),29644,5624,17,35285,16913
hdfs://spark-nn.eemcs.utwente.nl/user/s1934538/clickstream/clickstream-enwiki-2023-01.tsv.gz,Black_Widow_(2021_film),48712,71296,975,120983,57796
hdfs://spark-nn.eemcs.utwente.nl/user/s1934538/clickstream/clickstream-enwiki-2023-01.tsv.gz,Main_Page,90431,142885669,5591743,148567843,35476138
hdfs://spark-nn.eemcs.utwente.nl/user/s1934538/clickstream/clickstream-enwiki-2023-01.tsv.gz,Avicii,18929,183652,1359,203940,60196
hdfs://spark-nn.eemcs.utwente.nl/user/s1934538/clickstream/clickstream-enwiki-2023-01.tsv.gz,Bonnie_and_Clyde,22148,200711,1332,224191,58849
hdfs://spark-nn.eemcs.utwente.nl/user/s1934538/clickstream/clickstream-enwiki-2023-01.tsv.gz,Captain_Marvel_(film),29776,53147,731,83654,40201
hdfs://spark-nn.eemcs.utwente.nl/user/s1934538/clickstream/clickstream-enwiki-2023-01.tsv.gz,Mortal_Kombat_(2021_film),22203,67477,1030,90710,85637
hdfs://spark-nn.eemcs.utwente.nl/user/s1934538/clickstream/clickstream-enwiki-2023-01.tsv.gz,Chernobyl_(miniseries),52283,112073,2417,166773,175521
hdfs://spark-nn.eemcs.utwente.nl/user/s1934538/clickstream/clickstream-enwiki-2023-01.tsv.gz,John_McCain,33051,68509,896,102456,57057
hdfs://spark-nn.eemcs.utwente.nl/user/s1934538/clickstream/clickstream-enwiki-2023-01.tsv.gz,List_of_awards_and_nominations_received_by_Meryl_Streep,10174,10858,44,21076,10061
hdfs://spark-nn.eemcs.utwente.nl/user/s1934538/clickstream/clickstream-enwiki-2023-01.tsv.gz,The_Mandalorian,92184,199611,4803,296598,199908
hdfs://spark-nn.eemcs.utwente.nl/user/s1934538/clickstream/clickstream-enwiki-2023-01.tsv.gz,Afghanistan,123145,219135,4346,346626,250745
hdfs://spark-nn.eemcs.utwente.nl/user/s1934538/clickstream/clickstream-enwiki-2023-01.tsv.gz,Tunnel,6595,11347,560,18502,3908
hdfs://spark-nn.eemcs.utwente.nl/user/s1934538/clickstream/clickstream-enwiki-2023-01.tsv.gz,Mac_Miller,28171,181472,1261,210904,68578
hdfs://spark-nn.eemcs.utwente.nl/user/s1934538/clickstream/clickstream-enwiki-2023-01.tsv.gz,Zack_Snyder's_Justice_League,48763,65323,677,114763,54389
hdfs://spark-nn.eemcs.utwente.nl/user/s1934538/clickstream/clickstream-enwiki-2023-01.tsv.gz,The_Matrix_Resurrections,68211,73842,1141,143194,69426
hdfs://spark-nn.eemcs.utwente.nl/user/s1934538/clickstream/clickstream-enwiki-2023-01.tsv.gz,Deadpool_2,93499,40547,1027,135073,72886
hdfs://spark-nn.eemcs.utwente.nl/user/s1934538/clickstream/clickstream-enwiki-2023-01.tsv.gz,RRR_(film),174270,1080319,11251,1265840,792606
hdfs://spark-nn.eemcs.utwente.nl/user/s1934538/clickstream/clickstream-enwiki-2023-01.tsv.gz,Bridgerton,39605,131326,2436,173367,136881
hdfs://spark-nn.eemcs.utwente.nl/user/s1934538/clickstream/clickstream-enwiki-2023-01.tsv.gz,List_of_highest-grossing_films,922614,2107552,10017,3040183,1118512
hdfs://spark-nn.eemcs.utwente.nl/user/s1934538/clickstream/clickstream-enwiki-2023-01.tsv.gz,2.0_(film),38202,42896,122,81220,17839
hdfs://spark-nn.eemcs.utwente.nl/user/s1934538/clickstream/clickstream-enwiki-2023-01.tsv.gz,Top_Gun:_Maverick,303831,661545,14519,979895,746377
hdfs://spark-nn.eemcs.utwente.nl/user/s1934538/clickstream/clickstream-enwiki-2023-01.tsv.gz,Spider-Man:_No_Way_Home,156172,213873,3113,373158,164511
hdfs://spark-nn.eemcs.utwente.nl/user/s1934538/clickstream/clickstream-enwiki-2023-01.tsv.gz,The_Haunting_of_Bly_Manor,18535,38206,252,56993,29942
hdfs://spark-nn.eemcs.utwente.nl/user/s1934538/clickstream/clickstream-enwiki-2023-01.tsv.gz,Lance_Reddick,47039,60658,385,108082,23065
hdfs://spark-nn.eemcs.utwente.nl/user/s1934538/clickstream/clickstream-enwiki-2023-01.tsv.gz,The_Irishman,56291,96559,1785,154635,137509
hdfs://spark-nn.eemcs.utwente.nl/user/s1934538/clickstream/clickstream-enwiki-2023-01.tsv.gz,Tonya_Harding,30922,111914,7920,150756,40428
hdfs://spark-nn.eemcs.utwente.nl/user/s1934538/clickstream/clickstream-enwiki-2023-01.tsv.gz,Valentine's_Day,7708,320855,998,329561,18365
hdfs://spark-nn.eemcs.utwente.nl/user/s1934538/clickstream/clickstream-enwiki-2023-01.tsv.gz,Jenna_Ortega,343689,2208364,17929,2569982,660188
hdfs://spark-nn.eemcs.utwente.nl/user/s1934538/clickstream/clickstream-enwiki-2023-01.tsv.gz,Carlos_Alcaraz,79163,179101,747,259011,68651
hdfs://spark-nn.eemcs.utwente.nl/user/s1934538/clickstream/clickstream-enwiki-2023-01.tsv.gz,War_(2019_film),191072,229725,249,421046,120852
hdfs://spark-nn.eemcs.utwente.nl/user/s1934538/clickstream/clickstream-enwiki-2023-01.tsv.gz,Stan_Lee,35911,122570,920,159401,44076
hdfs://spark-nn.eemcs.utwente.nl/user/s1934538/clickstream/clickstream-enwiki-2023-01.tsv.gz,George_VI,393447,148284,586,542317,391424
hdfs://spark-nn.eemcs.utwente.nl/user/s1934538/clickstream/clickstream-enwiki-2023-01.tsv.gz,UEFA_Euro_2020,65295,64256,1146,130697,80130
hdfs://spark-nn.eemcs.utwente.nl/user/s1934538/clickstream/clickstream-enwiki-2023-01.tsv.gz,Donald_Glover,52107,183596,1013,236716,99464
hdfs://spark-nn.eemcs.utwente.nl/user/s1934538/clickstream/clickstream-enwiki-2023-01.tsv.gz,XXX:_Return_of_Xander_Cage,58462,5403173,1808,5463443,283684
hdfs://spark-nn.eemcs.utwente.nl/user/s1934538/clickstream/clickstream-enwiki-2023-01.tsv.gz,Mulan_(2020_film),19704,47035,574,67313,38945
hdfs://spark-nn.eemcs.utwente.nl/user/s1934538/clickstream/clickstream-enwiki-2023-01.tsv.gz,Anna_Sorokin,24478,244332,715,269525,95868
hdfs://spark-nn.eemcs.utwente.nl/user/s1934538/clickstream/clickstream-enwiki-2023-01.tsv.gz,NATO,73325,202816,6064,282205,138861
hdfs://spark-nn.eemcs.utwente.nl/user/s1934538/clickstream/clickstream-enwiki-2023-01.tsv.gz,Olivia_Newton-John,43682,226565,2460,272707,100812
hdfs://spark-nn.eemcs.utwente.nl/user/s1934538/clickstream/clickstream-enwiki-2023-01.tsv.gz,1917_(2019_film),23986,80661,1853,106500,54985
hdfs://spark-nn.eemcs.utwente.nl/user/s1934538/clickstream/clickstream-enwiki-2023-01.tsv.gz,Ghislaine_Maxwell,72097,170479,1173,243749,106190
hdfs://spark-nn.eemcs.utwente.nl/user/s1934538/clickstream/clickstream-enwiki-2023-01.tsv.gz,Kenosha_unrest_shooting,10712,32103,52,42867,9590
hdfs://spark-nn.eemcs.utwente.nl/user/s1934538/clickstream/clickstream-enwiki-2023-01.tsv.gz,Line_shaft,366,825,75,1266,120
hdfs://spark-nn.eemcs.utwente.nl/user/s1934538/clickstream/clickstream-enwiki-2023-01.tsv.gz,Mötley_Crüe,35873,102007,1381,139261,163411
hdfs://spark-nn.eemcs.utwente.nl/user/s1934538/clickstream/clickstream-enwiki-2023-01.tsv.gz,Khabib_Nurmagomedov,44874,180394,1316,226584,125012
hdfs://spark-nn.eemcs.utwente.nl/user/s1934538/clickstream/clickstream-enwiki-2023-01.tsv.gz,Loki_(TV_series),46053,60692,1335,108080,73557
hdfs://spark-nn.eemcs.utwente.nl/user/s1934538/clickstream/clickstream-enwiki-2023-01.tsv.gz,Vivek_Ramaswamy,559,16612,40,17211,2861
hdfs://spark-nn.eemcs.utwente.nl/user/s1934538/clickstream/clickstream-enwiki-2023-01.tsv.gz,Naya_Rivera,74565,174273,734,249572,107137
hdfs://spark-nn.eemcs.utwente.nl/user/s1934538/clickstream/clickstream-enwiki-2023-01.tsv.gz,Army_of_the_Dead,54550,44566,434,99550,54400
hdfs://spark-nn.eemcs.utwente.nl/user/s1934538/clickstream/clickstream-enwiki-2023-01.tsv.gz,Greta_Thunberg,43256,746753,5827,795836,224724
hdfs://spark-nn.eemcs.utwente.nl/user/s1934538/clickstream/clickstream-enwiki-2023-01.tsv.gz,Kobe_Bryant,69062,482758,4755,556575,160924
hdfs://spark-nn.eemcs.utwente.nl/user/s1934538/clickstream/clickstream-enwiki-2023-01.tsv.gz,When_They_See_Us,14784,21848,290,36922,15852
hdfs://spark-nn.eemcs.utwente.nl/user/s1934538/clickstream/clickstream-enwiki-2023-01.tsv.gz,Jimmy_Hoffa,34509,114532,1016,150057,60848
hdfs://spark-nn.eemcs.utwente.nl/user/s1934538/clickstream/clickstream-enwiki-2023-01.tsv.gz,"Diana,_Princess_of_Wales",273132,592908,5848,871888,544633
hdfs://spark-nn.eemcs.utwente.nl/user/s1934538/clickstream/clickstream-enwiki-2023-02.tsv.gz,Olivia_Newton-John,43719,389544,2813,436076,178686
hdfs://spark-nn.eemcs.utwente.nl/user/s1934538/clickstream/clickstream-enwiki-2023-02.tsv.gz,Black_Panther_(film),91018,335262,2571,428851,229568
hdfs://spark-nn.eemcs.utwente.nl/user/s1934538/clickstream/clickstream-enwiki-2023-02.tsv.gz,Hamilton_(musical),23903,146012,1301,171216,100580
hdfs://spark-nn.eemcs.utwente.nl/user/s1934538/clickstream/clickstream-enwiki-2023-02.tsv.gz,Sylvester_Stallone,130962,650131,3447,784540,458933
hdfs://spark-nn.eemcs.utwente.nl/user/s1934538/clickstream/clickstream-enwiki-2023-02.tsv.gz,Central_Park_jogger_case,9205,41705,176,51086,7159
hdfs://spark-nn.eemcs.utwente.nl/user/s1934538/clickstream/clickstream-enwiki-2023-02.tsv.gz,Sushma_Swaraj,11093,21393,27,32513,8589
hdfs://spark-nn.eemcs.utwente.nl/user/s1934538/clickstream/clickstream-enwiki-2023-02.tsv.gz,ChatGPT,56892,5856863,19336,5933091,602809
hdfs://spark-nn.eemcs.utwente.nl/user/s1934538/clickstream/clickstream-enwiki-2023-02.tsv.gz,Loki_(TV_series),72151,96824,1964,170939,126464
hdfs://spark-nn.eemcs.utwente.nl/user/s1934538/clickstream/clickstream-enwiki-2023-02.tsv.gz,Juneteenth,5197,73992,310,79499,7175
hdfs://spark-nn.eemcs.utwente.nl/user/s1934538/clickstream/clickstream-enwiki-2023-02.tsv.gz,2023_Asia_Cup,9748,42273,113,52134,12647
hdfs://spark-nn.eemcs.utwente.nl/user/s1934538/clickstream/clickstream-enwiki-2023-02.tsv.gz,2022_Russian_invasion_of_Ukraine,651796,916374,3768,1571938,793934
hdfs://spark-nn.eemcs.utwente.nl/user/s1934538/clickstream/clickstream-enwiki-2023-02.tsv.gz,Taliban,36546,64118,727,101391,73179
hdfs://spark-nn.eemcs.utwente.nl/user/s1934538/clickstream/clickstream-enwiki-2023-02.tsv.gz,Royal_Rumble_(2018),10919,7221,92,18232,14071
hdfs://spark-nn.eemcs.utwente.nl/user/s1934538/clickstream/clickstream-enwiki-2023-02.tsv.gz,The_Umbrella_Academy_(TV_series),20915,91755,1855,114525,70020
hdfs://spark-nn.eemcs.utwente.nl/user/s1934538/clickstream/clickstream-enwiki-2023-02.tsv.gz,Tonya_Harding,19977,96973,582,117532,32405
hdfs://spark-nn.eemcs.utwente.nl/user/s1934538/clickstream/clickstream-enwiki-2023-02.tsv.gz,Louis_Tomlinson,44220,65728,295,110243,29254
hdfs://spark-nn.eemcs.utwente.nl/user/s1934538/clickstream/clickstream-enwiki-2023-02.tsv.gz,Cecil_Hotel_(Los_Angeles),5462,38659,121,44242,11056
hdfs://spark-nn.eemcs.utwente.nl/user/s1934538/clickstream/clickstream-enwiki-2023-02.tsv.gz,Russo-Ukrainian_War,154892,452275,5688,612855,397348
hdfs://spark-nn.eemcs.utwente.nl/user/s1934538/clickstream/clickstream-enwiki-2023-02.tsv.gz,Spider-Man:_Far_From_Home,37258,45526,364,83148,30022
hdfs://spark-nn.eemcs.utwente.nl/user/s1934538/clickstream/clickstream-enwiki-2023-02.tsv.gz,Oppenheimer_(film),125068,127004,2547,254619,200063
hdfs://spark-nn.eemcs.utwente.nl/user/s1934538/clickstream/clickstream-enwiki-2023-02.tsv.gz,2018_Winter_Olympics,14179,10508,123,24810,15190
hdfs://spark-nn.eemcs.utwente.nl/user/s1934538/clickstream/clickstream-enwiki-2023-02.tsv.gz,Area_51,16659,123598,1260,141517,45319
hdfs://spark-nn.eemcs.utwente.nl/user/s1934538/clickstream/clickstream-enwiki-2023-02.tsv.gz,Aquaman_(film),25228,59334,898,85460,38741
hdfs://spark-nn.eemcs.utwente.nl/user/s1934538/clickstream/clickstream-enwiki-2023-02.tsv.gz,Darth_Vader,22276,64679,593,87548,46019
hdfs://spark-nn.eemcs.utwente.nl/user/s1934538/clickstream/clickstream-enwiki-2023-02.tsv.gz,Tunnel,3594,8353,91,12038,2922
hdfs://spark-nn.eemcs.utwente.nl/user/s1934538/clickstream/clickstream-enwiki-2023-02.tsv.gz,Cleopatra,53284,4601881,4456,4659621,349062
hdfs://spark-nn.eemcs.utwente.nl/user/s1934538/clickstream/clickstream-enwiki-2023-02.tsv.gz,Naya_Rivera,58999,64516,182,123697,48308
hdfs://spark-nn.eemcs.utwente.nl/user/s1934538/clickstream/clickstream-enwiki-2023-02.tsv.gz,Shinzo_Abe,38774,64013,882,103669,70596
hdfs://spark-nn.eemcs.utwente.nl/user/s1934538/clickstream/clickstream-enwiki-2023-02.tsv.gz,Notre-Dame_de_Paris,11305,72273,893,84471,17177
hdfs://spark-nn.eemcs.utwente.nl/user/s1934538/clickstream/clickstream-enwiki-2023-02.tsv.gz,War_(2019_film),108670,139165,147,247982,71075
hdfs://spark-nn.eemcs.utwente.nl/user/s1934538/clickstream/clickstream-enwiki-2023-02.tsv.gz,List_of_Marvel_Cinematic_Universe_films,281330,612712,2459,896501,655392
hdfs://spark-nn.eemcs.utwente.nl/user/s1934538/clickstream/clickstream-enwiki-2023-02.tsv.gz,Elliot_Page,61235,217015,1363,279613,117590
hdfs://spark-nn.eemcs.utwente.nl/user/s1934538/clickstream/clickstream-enwiki-2023-02.tsv.gz,John_Wick:_Chapter_4,104230,227364,5123,336717,216550
hdfs://spark-nn.eemcs.utwente.nl/user/s1934538/clickstream/clickstream-enwiki-2023-02.tsv.gz,Charles_III,382691,270445,3949,657085,433787
hdfs://spark-nn.eemcs.utwente.nl/user/s1934538/clickstream/clickstream-enwiki-2023-02.tsv.gz,Ted_Bundy,24991,249965,3192,278148,63207
hdfs://spark-nn.eemcs.utwente.nl/user/s1934538/clickstream/clickstream-enwiki-2023-02.tsv.gz,Avatar:_The_Way_of_Water,306218,1644965,37959,1989142,978237
hdfs://spark-nn.eemcs.utwente.nl/user/s1934538/clickstream/clickstream-enwiki-2023-02.tsv.gz,The_Queen's_Gambit_(miniseries),21438,103298,935,125671,60648
hdfs://spark-nn.eemcs.utwente.nl/user/s1934538/clickstream/clickstream-enwiki-2023-02.tsv.gz,Chernobyl_disaster,55228,454771,3866,513865,217215
hdfs://spark-nn.eemcs.utwente.nl/user/s1934538/clickstream/clickstream-enwiki-2023-02.tsv.gz,Deaths_in_2023,1555530,2277179,16858,3849567,2461632
hdfs://spark-nn.eemcs.utwente.nl/user/s1934538/clickstream/clickstream-enwiki-2023-02.tsv.gz,Dune_(2021_film),52774,157168,3520,213462,143100
hdfs://spark-nn.eemcs.utwente.nl/user/s1934538/clickstream/clickstream-enwiki-2023-02.tsv.gz,Death_of_Elisa_Lam,10323,52847,186,63356,20193
hdfs://spark-nn.eemcs.utwente.nl/user/s1934538/clickstream/clickstream-enwiki-2023-02.tsv.gz,Ray_Liotta,181246,470792,3616,655654,157720
hdfs://spark-nn.eemcs.utwente.nl/user/s1934538/clickstream/clickstream-enwiki-2023-02.tsv.gz,Captain_Marvel_(film),31685,58916,840,91441,44030
hdfs://spark-nn.eemcs.utwente.nl/user/s1934538/clickstream/clickstream-enwiki-2023-02.tsv.gz,Tina_Turner,34364,308472,2028,344864,108627
hdfs://spark-nn.eemcs.utwente.nl/user/s1934538/clickstream/clickstream-enwiki-2023-02.tsv.gz,The_Falcon_and_the_Winter_Soldier,23858,31018,525,55401,32678
hdfs://spark-nn.eemcs.utwente.nl/user/s1934538/clickstream/clickstream-enwiki-2023-02.tsv.gz,FIFA_World_Cup,57309,227210,3156,287675,183744
hdfs://spark-nn.eemcs.utwente.nl/user/s1934538/clickstream/clickstream-enwiki-2023-02.tsv.gz,Avicii,17355,164681,1139,183175,55017
hdfs://spark-nn.eemcs.utwente.nl/user/s1934538/clickstream/clickstream-enwiki-2023-02.tsv.gz,Burt_Reynolds,69088,175400,1635,246123,115044
hdfs://spark-nn.eemcs.utwente.nl/user/s1934538/clickstream/clickstream-enwiki-2023-02.tsv.gz,David_Beckham,42726,182239,1015,225980,84461
hdfs://spark-nn.eemcs.utwente.nl/user/s1934538/clickstream/clickstream-enwiki-2023-02.tsv.gz,List_of_highest-grossing_Indian_films,653882,1766333,5263,2425478,931838
hdfs://spark-nn.eemcs.utwente.nl/user/s1934538/clickstream/clickstream-enwiki-2023-02.tsv.gz,The_Lion_King_(2019_film),54283,53753,464,108500,43282
hdfs://spark-nn.eemcs.utwente.nl/user/s1934538/clickstream/clickstream-enwiki-2023-02.tsv.gz,Naomi_Osaka,13671,48328,237,62236,16664
hdfs://spark-nn.eemcs.utwente.nl/user/s1934538/clickstream/clickstream-enwiki-2023-02.tsv.gz,Jeffrey_Epstein,45625,227695,2166,275486,119706
hdfs://spark-nn.eemcs.utwente.nl/user/s1934538/clickstream/clickstream-enwiki-2023-02.tsv.gz,Ant-Man_and_the_Wasp:_Quantumania,678259,3403219,113076,4194554,2447510
hdfs://spark-nn.eemcs.utwente.nl/user/s1934538/clickstream/clickstream-enwiki-2023-02.tsv.gz,Mortal_Kombat_(2021_film),18179,60163,862,79204,70879
hdfs://spark-nn.eemcs.utwente.nl/user/s1934538/clickstream/clickstream-enwiki-2023-02.tsv.gz,J._Robert_Oppenheimer,56204,173054,577,229835,78796
hdfs://spark-nn.eemcs.utwente.nl/user/s1934538/clickstream/clickstream-enwiki-2023-02.tsv.gz,"Meghan,_Duchess_of_Sussex",74617,289580,2575,366772,192051
hdfs://spark-nn.eemcs.utwente.nl/user/s1934538/clickstream/clickstream-enwiki-2023-02.tsv.gz,Henry_V_of_England,73668,88124,344,162136,112933
hdfs://spark-nn.eemcs.utwente.nl/user/s1934538/clickstream/clickstream-enwiki-2023-02.tsv.gz,Google_logo,1931,16766,12,18709,1498
hdfs://spark-nn.eemcs.utwente.nl/user/s1934538/clickstream/clickstream-enwiki-2023-02.tsv.gz,K.G.F:_Chapter_2,68106,252479,1139,321724,81931
hdfs://spark-nn.eemcs.utwente.nl/user/s1934538/clickstream/clickstream-enwiki-2023-02.tsv.gz,2020_United_States_presidential_election,120863,141289,3710,265862,279607
hdfs://spark-nn.eemcs.utwente.nl/user/s1934538/clickstream/clickstream-enwiki-2023-02.tsv.gz,Aretha_Franklin,30852,194826,1195,226873,96114
hdfs://spark-nn.eemcs.utwente.nl/user/s1934538/clickstream/clickstream-enwiki-2023-02.tsv.gz,Coronavirus,5554,30516,712,36782,11070
hdfs://spark-nn.eemcs.utwente.nl/user/s1934538/clickstream/clickstream-enwiki-2023-02.tsv.gz,2016_United_States_presidential_election,89683,55072,827,145582,133443
hdfs://spark-nn.eemcs.utwente.nl/user/s1934538/clickstream/clickstream-enwiki-2023-02.tsv.gz,Bridgerton,34316,119135,1994,155445,117724
hdfs://spark-nn.eemcs.utwente.nl/user/s1934538/clickstream/clickstream-enwiki-2023-02.tsv.gz,Lionel_Messi,130154,1062296,8456,1200906,248947
hdfs://spark-nn.eemcs.utwente.nl/user/s1934538/clickstream/clickstream-enwiki-2023-02.tsv.gz,Amber_Heard,66019,161242,914,228175,90770
hdfs://spark-nn.eemcs.utwente.nl/user/s1934538/clickstream/clickstream-enwiki-2023-02.tsv.gz,Fantastic_Beasts:_The_Crimes_of_Grindelwald,48818,50050,653,99521,51055
hdfs://spark-nn.eemcs.utwente.nl/user/s1934538/clickstream/clickstream-enwiki-2023-02.tsv.gz,Joe_Biden,203912,608638,9891,822441,367636
hdfs://spark-nn.eemcs.utwente.nl/user/s1934538/clickstream/clickstream-enwiki-2023-02.tsv.gz,RRR_(film),104714,470585,5408,580707,296006
hdfs://spark-nn.eemcs.utwente.nl/user/s1934538/clickstream/clickstream-enwiki-2023-02.tsv.gz,Barbie_(film),71026,59647,966,131639,83287
hdfs://spark-nn.eemcs.utwente.nl/user/s1934538/clickstream/clickstream-enwiki-2023-02.tsv.gz,NATO,68336,212494,5731,286561,136212
hdfs://spark-nn.eemcs.utwente.nl/user/s1934538/clickstream/clickstream-enwiki-2023-02.tsv.gz,Alexander_Hamilton,61491,190851,1413,253755,146714
hdfs://spark-nn.eemcs.utwente.nl/user/s1934538/clickstream/clickstream-enwiki-2023-02.tsv.gz,Laal_Singh_Chaddha,30645,67176,297,98118,31768
hdfs://spark-nn.eemcs.utwente.nl/user/s1934538/clickstream/clickstream-enwiki-2023-02.tsv.gz,Shakira,41930,432212,3303,477445,201676
hdfs://spark-nn.eemcs.utwente.nl/user/s1934538/clickstream/clickstream-enwiki-2023-02.tsv.gz,Crazy_Rich_Asians_(film),30303,78529,1192,110024,98785
hdfs://spark-nn.eemcs.utwente.nl/user/s1934538/clickstream/clickstream-enwiki-2023-02.tsv.gz,Adipurush,50490,62138,198,112826,53417
hdfs://spark-nn.eemcs.utwente.nl/user/s1934538/clickstream/clickstream-enwiki-2023-02.tsv.gz,House_of_the_Dragon,43444,248687,5899,298030,176535
hdfs://spark-nn.eemcs.utwente.nl/user/s1934538/clickstream/clickstream-enwiki-2023-02.tsv.gz,Stranger_Things_(season_4),25228,83836,991,110055,62586
hdfs://spark-nn.eemcs.utwente.nl/user/s1934538/clickstream/clickstream-enwiki-2023-02.tsv.gz,George_VI,262877,116735,2680,382292,271008
hdfs://spark-nn.eemcs.utwente.nl/user/s1934538/clickstream/clickstream-enwiki-2023-02.tsv.gz,"Diana,_Princess_of_Wales",120651,292445,2484,415580,228806
hdfs://spark-nn.eemcs.utwente.nl/user/s1934538/clickstream/clickstream-enwiki-2023-02.tsv.gz,Cristiano_Ronaldo,139255,1587520,8669,1735444,334547
hdfs://spark-nn.eemcs.utwente.nl/user/s1934538/clickstream/clickstream-enwiki-2023-02.tsv.gz,Vikram_(2022_film),70009,176462,610,247081,112686
hdfs://spark-nn.eemcs.utwente.nl/user/s1934538/clickstream/clickstream-enwiki-2023-02.tsv.gz,2022_FIFA_World_Cup,141832,357841,4041,503714,272475
hdfs://spark-nn.eemcs.utwente.nl/user/s1934538/clickstream/clickstream-enwiki-2023-02.tsv.gz,Matthew_Perry,46526,151168,1223,198917,98248
hdfs://spark-nn.eemcs.utwente.nl/user/s1934538/clickstream/clickstream-enwiki-2023-02.tsv.gz,List_of_James_Bond_films,71736,361332,1935,435003,289557
hdfs://spark-nn.eemcs.utwente.nl/user/s1934538/clickstream/clickstream-enwiki-2023-02.tsv.gz,Glass_(2019_film),81374,80397,439,162210,48083
hdfs://spark-nn.eemcs.utwente.nl/user/s1934538/clickstream/clickstream-enwiki-2023-02.tsv.gz,William_Murdoch,589,1367,60,2016,310
hdfs://spark-nn.eemcs.utwente.nl/user/s1934538/clickstream/clickstream-enwiki-2023-02.tsv.gz,Lance_Reddick,41779,46872,206,88857,19253
hdfs://spark-nn.eemcs.utwente.nl/user/s1934538/clickstream/clickstream-enwiki-2023-02.tsv.gz,Tenet_(film),46201,99582,1113,146896,73854
hdfs://spark-nn.eemcs.utwente.nl/user/s1934538/clickstream/clickstream-enwiki-2023-02.tsv.gz,Asia_Cup,2503,25952,102,28557,14948
hdfs://spark-nn.eemcs.utwente.nl/user/s1934538/clickstream/clickstream-enwiki-2023-02.tsv.gz,Gaza_Strip,22731,51122,678,74531,30317
hdfs://spark-nn.eemcs.utwente.nl/user/s1934538/clickstream/clickstream-enwiki-2023-02.tsv.gz,The_Sandman_(TV_series),34469,101123,1542,137134,90171
hdfs://spark-nn.eemcs.utwente.nl/user/s1934538/clickstream/clickstream-enwiki-2023-02.tsv.gz,The_Haunting_of_Bly_Manor,19550,37118,323,56991,27201
hdfs://spark-nn.eemcs.utwente.nl/user/s1934538/clickstream/clickstream-enwiki-2023-02.tsv.gz,Squid_Game,16930,139164,2502,158596,66495
hdfs://spark-nn.eemcs.utwente.nl/user/s1934538/clickstream/clickstream-enwiki-2023-02.tsv.gz,Venom_(2018_film),11934,50857,440,63231,23251
hdfs://spark-nn.eemcs.utwente.nl/user/s1934538/clickstream/clickstream-enwiki-2023-02.tsv.gz,Ruth_Bader_Ginsburg,15710,84721,591,101022,35827
hdfs://spark-nn.eemcs.utwente.nl/user/s1934538/clickstream/clickstream-enwiki-2023-02.tsv.gz,1917_(2019_film),18351,61440,1230,81021,38008
hdfs://spark-nn.eemcs.utwente.nl/user/s1934538/clickstream/clickstream-enwiki-2023-02.tsv.gz,Sushant_Singh_Rajput,19736,89337,250,109323,52067
hdfs://spark-nn.eemcs.utwente.nl/user/s1934538/clickstream/clickstream-enwiki-2023-02.tsv.gz,Bob_Saget,22966,81817,600,105383,20129
hdfs://spark-nn.eemcs.utwente.nl/user/s1934538/clickstream/clickstream-enwiki-2023-02.tsv.gz,Game_of_Thrones,80278,237385,5278,322941,184266
hdfs://spark-nn.eemcs.utwente.nl/user/s1934538/clickstream/clickstream-enwiki-2023-02.tsv.gz,Israel,89569,270838,5653,366060,191962
hdfs://spark-nn.eemcs.utwente.nl/user/s1934538/clickstream/clickstream-enwiki-2023-02.tsv.gz,HTTP_cookie,2154,300772,118,303044,14994
hdfs://spark-nn.eemcs.utwente.nl/user/s1934538/clickstream/clickstream-enwiki-2023-02.tsv.gz,Qasem_Soleimani,11075,21715,99,32889,18839
hdfs://spark-nn.eemcs.utwente.nl/user/s1934538/clickstream/clickstream-enwiki-2023-02.tsv.gz,Mulan_(2020_film),15463,42527,432,58422,29252
hdfs://spark-nn.eemcs.utwente.nl/user/s1934538/clickstream/clickstream-enwiki-2023-02.tsv.gz,Deion_Sanders,27509,165762,818,194089,49897
hdfs://spark-nn.eemcs.utwente.nl/user/s1934538/clickstream/clickstream-enwiki-2023-02.tsv.gz,Everything_Everywhere_All_at_Once,178890,775734,13023,967647,505218
hdfs://spark-nn.eemcs.utwente.nl/user/s1934538/clickstream/clickstream-enwiki-2023-02.tsv.gz,Christopher_Scarver,70986,36587,33,107606,34102
hdfs://spark-nn.eemcs.utwente.nl/user/s1934538/clickstream/clickstream-enwiki-2023-02.tsv.gz,2023_Indian_Premier_League,26306,146053,507,172866,74893
hdfs://spark-nn.eemcs.utwente.nl/user/s1934538/clickstream/clickstream-enwiki-2023-02.tsv.gz,YouTube,135724,2603208,10133,2749065,168022
hdfs://spark-nn.eemcs.utwente.nl/user/s1934538/clickstream/clickstream-enwiki-2023-02.tsv.gz,Lists_of_deaths_by_year,2945,297337,1656,301938,333386
hdfs://spark-nn.eemcs.utwente.nl/user/s1934538/clickstream/clickstream-enwiki-2023-02.tsv.gz,2023_Cricket_World_Cup,35164,301095,238,336497,73869
hdfs://spark-nn.eemcs.utwente.nl/user/s1934538/clickstream/clickstream-enwiki-2023-02.tsv.gz,Black_Panther:_Wakanda_Forever,269645,1589686,27669,1887000,1605473
hdfs://spark-nn.eemcs.utwente.nl/user/s1934538/clickstream/clickstream-enwiki-2023-02.tsv.gz,Kate_Spade,26148,61940,309,88397,34426
hdfs://spark-nn.eemcs.utwente.nl/user/s1934538/clickstream/clickstream-enwiki-2023-02.tsv.gz,Ukraine,113837,425981,13290,553108,261328
hdfs://spark-nn.eemcs.utwente.nl/user/s1934538/clickstream/clickstream-enwiki-2023-02.tsv.gz,Michael_Jordan,156481,935072,7870,1099423,310505
hdfs://spark-nn.eemcs.utwente.nl/user/s1934538/clickstream/clickstream-enwiki-2023-02.tsv.gz,Keanu_Reeves,81138,525119,2945,609202,371384
hdfs://spark-nn.eemcs.utwente.nl/user/s1934538/clickstream/clickstream-enwiki-2023-02.tsv.gz,Brett_Kavanaugh,14201,20118,139,34458,12546
hdfs://spark-nn.eemcs.utwente.nl/user/s1934538/clickstream/clickstream-enwiki-2023-02.tsv.gz,Priyanka_Chopra,100220,292384,712,393316,147760
hdfs://spark-nn.eemcs.utwente.nl/user/s1934538/clickstream/clickstream-enwiki-2023-02.tsv.gz,2020_Summer_Olympics,38574,39282,1163,79019,67393
hdfs://spark-nn.eemcs.utwente.nl/user/s1934538/clickstream/clickstream-enwiki-2023-02.tsv.gz,The_Matrix_Resurrections,55216,61994,979,118189,55262
hdfs://spark-nn.eemcs.utwente.nl/user/s1934538/clickstream/clickstream-enwiki-2023-02.tsv.gz,Indian_Premier_League,22842,133154,1415,157411,90276
hdfs://spark-nn.eemcs.utwente.nl/user/s1934538/clickstream/clickstream-enwiki-2023-02.tsv.gz,COVID-19_pandemic,83643,194852,8104,286599,90876
hdfs://spark-nn.eemcs.utwente.nl/user/s1934538/clickstream/clickstream-enwiki-2023-02.tsv.gz,Dennis_Nilsen,6799,41246,254,48299,11639
hdfs://spark-nn.eemcs.utwente.nl/user/s1934538/clickstream/clickstream-enwiki-2023-02.tsv.gz,Greta_Thunberg,14086,220624,1518,236228,54837
hdfs://spark-nn.eemcs.utwente.nl/user/s1934538/clickstream/clickstream-enwiki-2023-02.tsv.gz,Cameron_Boyce,21359,197133,551,219043,53294
hdfs://spark-nn.eemcs.utwente.nl/user/s1934538/clickstream/clickstream-enwiki-2023-02.tsv.gz,Afghanistan,108241,192277,3663,304181,214281
hdfs://spark-nn.eemcs.utwente.nl/user/s1934538/clickstream/clickstream-enwiki-2023-02.tsv.gz,Watts_family_murders,5899,123628,287,129814,33888
hdfs://spark-nn.eemcs.utwente.nl/user/s1934538/clickstream/clickstream-enwiki-2023-02.tsv.gz,Elizabeth_II,306341,493128,9519,808988,532764
hdfs://spark-nn.eemcs.utwente.nl/user/s1934538/clickstream/clickstream-enwiki-2023-02.tsv.gz,Brie_Larson,85156,169001,1669,255826,106978
hdfs://spark-nn.eemcs.utwente.nl/user/s1934538/clickstream/clickstream-enwiki-2023-02.tsv.gz,Betty_White,38715,108053,902,147670,37309
hdfs://spark-nn.eemcs.utwente.nl/user/s1934538/clickstream/clickstream-enwiki-2023-02.tsv.gz,Luke_Perry,31944,107018,464,139426,56100
hdfs://spark-nn.eemcs.utwente.nl/user/s1934538/clickstream/clickstream-enwiki-2023-02.tsv.gz,Jurassic_World_Dominion,62609,134895,2723,200227,143794
hdfs://spark-nn.eemcs.utwente.nl/user/s1934538/clickstream/clickstream-enwiki-2023-02.tsv.gz,The_Suicide_Squad_(film),68626,74375,1039,144040,81376
hdfs://spark-nn.eemcs.utwente.nl/user/s1934538/clickstream/clickstream-enwiki-2023-02.tsv.gz,Joker_(2019_film),51878,134697,2010,188585,91372
hdfs://spark-nn.eemcs.utwente.nl/user/s1934538/clickstream/clickstream-enwiki-2023-02.tsv.gz,Kenosha_unrest_shooting,11214,37744,66,49024,10248
hdfs://spark-nn.eemcs.utwente.nl/user/s1934538/clickstream/clickstream-enwiki-2023-02.tsv.gz,The_Irishman,45061,87401,1351,133813,108352
hdfs://spark-nn.eemcs.utwente.nl/user/s1934538/clickstream/clickstream-enwiki-2023-02.tsv.gz,Us_(2019_film),26862,78331,512,105705,31165
hdfs://spark-nn.eemcs.utwente.nl/user/s1934538/clickstream/clickstream-enwiki-2023-02.tsv.gz,No_Time_to_Die,85716,115657,1751,203124,114751
hdfs://spark-nn.eemcs.utwente.nl/user/s1934538/clickstream/clickstream-enwiki-2023-02.tsv.gz,Antifa_(United_States),7408,49843,200,57451,10539
hdfs://spark-nn.eemcs.utwente.nl/user/s1934538/clickstream/clickstream-enwiki-2018-06.tsv.gz,Jenna_Ortega,6832,31437,260,38529,4874
hdfs://spark-nn.eemcs.utwente.nl/user/s1934538/clickstream/clickstream-enwiki-2018-06.tsv.gz,Central_Park_jogger_case,3632,32721,262,36615,4158
hdfs://spark-nn.eemcs.utwente.nl/user/s1934538/clickstream/clickstream-enwiki-2018-06.tsv.gz,Hamilton_(musical),29285,292335,1579,323199,149755
hdfs://spark-nn.eemcs.utwente.nl/user/s1934538/clickstream/clickstream-enwiki-2018-06.tsv.gz,Game_of_Thrones_(season_8),53613,400163,1200,454976,130102
hdfs://spark-nn.eemcs.utwente.nl/user/s1934538/clickstream/clickstream-enwiki-2018-06.tsv.gz,Wonder_Woman_1984,86688,81681,1145,169514,102051
hdfs://spark-nn.eemcs.utwente.nl/user/s1934538/clickstream/clickstream-enwiki-2018-06.tsv.gz,Aaron_Carter,13730,39111,226,53067,14365
hdfs://spark-nn.eemcs.utwente.nl/user/s1934538/clickstream/clickstream-enwiki-2018-06.tsv.gz,Spanish_flu,15402,76719,745,92866,7047
hdfs://spark-nn.eemcs.utwente.nl/user/s1934538/clickstream/clickstream-enwiki-2018-06.tsv.gz,Darth_Vader,20793,2419482,672,2440947,44588
hdfs://spark-nn.eemcs.utwente.nl/user/s1934538/clickstream/clickstream-enwiki-2018-06.tsv.gz,Brie_Larson,110348,155762,1445,267555,96861
hdfs://spark-nn.eemcs.utwente.nl/user/s1934538/clickstream/clickstream-enwiki-2018-06.tsv.gz,Alexander_Hamilton,59991,295313,1770,357074,141693
hdfs://spark-nn.eemcs.utwente.nl/user/s1934538/clickstream/clickstream-enwiki-2018-06.tsv.gz,Sridevi,25808,202642,1040,229490,51535
hdfs://spark-nn.eemcs.utwente.nl/user/s1934538/clickstream/clickstream-enwiki-2018-06.tsv.gz,Line_shaft,463,2247,18,2728,186
hdfs://spark-nn.eemcs.utwente.nl/user/s1934538/clickstream/clickstream-enwiki-2018-06.tsv.gz,Cardi_B,83815,1164298,10253,1258366,377044
hdfs://spark-nn.eemcs.utwente.nl/user/s1934538/clickstream/clickstream-enwiki-2018-06.tsv.gz,Notre-Dame_de_Paris,8094,80938,349,89381,14152
hdfs://spark-nn.eemcs.utwente.nl/user/s1934538/clickstream/clickstream-enwiki-2018-06.tsv.gz,Roe_v._Wade,14024,290243,1613,305880,61325
hdfs://spark-nn.eemcs.utwente.nl/user/s1934538/clickstream/clickstream-enwiki-2018-06.tsv.gz,State_of_Palestine,40254,83856,178,124288,50487
hdfs://spark-nn.eemcs.utwente.nl/user/s1934538/clickstream/clickstream-enwiki-2018-06.tsv.gz,Tina_Turner,13997,229401,1709,245107,52776
hdfs://spark-nn.eemcs.utwente.nl/user/s1934538/clickstream/clickstream-enwiki-2018-06.tsv.gz,Eddie_Van_Halen,29903,55449,375,85727,33601
hdfs://spark-nn.eemcs.utwente.nl/user/s1934538/clickstream/clickstream-enwiki-2018-06.tsv.gz,Afghanistan,39509,146939,1793,188241,123211
hdfs://spark-nn.eemcs.utwente.nl/user/s1934538/clickstream/clickstream-enwiki-2018-06.tsv.gz,List_of_most_popular_websites,17837,125690,127,143654,52873
hdfs://spark-nn.eemcs.utwente.nl/user/s1934538/clickstream/clickstream-enwiki-2018-06.tsv.gz,YouTube,91118,557820,7378,656316,105544
hdfs://spark-nn.eemcs.utwente.nl/user/s1934538/clickstream/clickstream-enwiki-2018-06.tsv.gz,Manti_Te'o,2133,10251,37,12421,365
hdfs://spark-nn.eemcs.utwente.nl/user/s1934538/clickstream/clickstream-enwiki-2018-06.tsv.gz,Burt_Reynolds,37739,162013,1302,201054,66828
hdfs://spark-nn.eemcs.utwente.nl/user/s1934538/clickstream/clickstream-enwiki-2018-06.tsv.gz,"Diana,_Princess_of_Wales",135300,397691,2613,535604,292161
hdfs://spark-nn.eemcs.utwente.nl/user/s1934538/clickstream/clickstream-enwiki-2018-06.tsv.gz,Puneeth_Rajkumar,7987,21445,56,29488,12521
hdfs://spark-nn.eemcs.utwente.nl/user/s1934538/clickstream/clickstream-enwiki-2018-06.tsv.gz,Simple_Mail_Transfer_Protocol,4480,38162,161,42803,5401
hdfs://spark-nn.eemcs.utwente.nl/user/s1934538/clickstream/clickstream-enwiki-2018-06.tsv.gz,Kamala_Harris,16061,136248,1042,153351,45541
hdfs://spark-nn.eemcs.utwente.nl/user/s1934538/clickstream/clickstream-enwiki-2018-06.tsv.gz,Charles_Sobhraj,2752,19743,42,22537,3115
hdfs://spark-nn.eemcs.utwente.nl/user/s1934538/clickstream/clickstream-enwiki-2018-06.tsv.gz,2018_Winter_Olympics,30539,70878,771,102188,39281
hdfs://spark-nn.eemcs.utwente.nl/user/s1934538/clickstream/clickstream-enwiki-2018-06.tsv.gz,FIFA_World_Cup,653540,3194742,46530,3894812,2771914
hdfs://spark-nn.eemcs.utwente.nl/user/s1934538/clickstream/clickstream-enwiki-2018-06.tsv.gz,Dark_Phoenix_(film),140372,86276,594,227242,144302
hdfs://spark-nn.eemcs.utwente.nl/user/s1934538/clickstream/clickstream-enwiki-2018-06.tsv.gz,Bonnie_and_Clyde,12890,150051,914,163855,31552
hdfs://spark-nn.eemcs.utwente.nl/user/s1934538/clickstream/clickstream-enwiki-2018-06.tsv.gz,QAnon,2655,98477,476,101608,16761
hdfs://spark-nn.eemcs.utwente.nl/user/s1934538/clickstream/clickstream-enwiki-2018-06.tsv.gz,Avengers:_Infinity_War,444451,2301003,55701,2801155,1364207
hdfs://spark-nn.eemcs.utwente.nl/user/s1934538/clickstream/clickstream-enwiki-2018-06.tsv.gz,IPv4,11002,45179,146,56327,10508
hdfs://spark-nn.eemcs.utwente.nl/user/s1934538/clickstream/clickstream-enwiki-2018-06.tsv.gz,Meghan_Markle,85393,794627,5745,885765,319671
hdfs://spark-nn.eemcs.utwente.nl/user/s1934538/clickstream/clickstream-enwiki-2018-06.tsv.gz,A_Star_Is_Born_(2018_film),50313,403457,2905,456675,207636
hdfs://spark-nn.eemcs.utwente.nl/user/s1934538/clickstream/clickstream-enwiki-2018-06.tsv.gz,Black_Panther_(film),130567,589034,11245,730846,481298
hdfs://spark-nn.eemcs.utwente.nl/user/s1934538/clickstream/clickstream-enwiki-2018-06.tsv.gz,Royal_Rumble_(2018),14433,37476,192,52101,23278
hdfs://spark-nn.eemcs.utwente.nl/user/s1934538/clickstream/clickstream-enwiki-2018-06.tsv.gz,Grover,1148,6168,37,7353,1179
hdfs://spark-nn.eemcs.utwente.nl/user/s1934538/clickstream/clickstream-enwiki-2018-06.tsv.gz,Atal_Bihari_Vajpayee,26003,363417,456,389876,53418
hdfs://spark-nn.eemcs.utwente.nl/user/s1934538/clickstream/clickstream-enwiki-2018-06.tsv.gz,Death_of_Elisa_Lam,8272,66979,237,75488,17097
hdfs://spark-nn.eemcs.utwente.nl/user/s1934538/clickstream/clickstream-enwiki-2018-06.tsv.gz,Salman_Rushdie,19772,65723,416,85911,35015
hdfs://spark-nn.eemcs.utwente.nl/user/s1934538/clickstream/clickstream-enwiki-2018-06.tsv.gz,Murder_of_Dee_Dee_Blanchard,3735,43402,74,47211,7928
hdfs://spark-nn.eemcs.utwente.nl/user/s1934538/clickstream/clickstream-enwiki-2018-06.tsv.gz,Jason_Momoa,75707,358962,1547,436216,158755
hdfs://spark-nn.eemcs.utwente.nl/user/s1934538/clickstream/clickstream-enwiki-2018-06.tsv.gz,Microsoft_Office,8360,83415,571,92346,20721
hdfs://spark-nn.eemcs.utwente.nl/user/s1934538/clickstream/clickstream-enwiki-2018-06.tsv.gz,George_VI,409777,378442,1108,789327,515235
hdfs://spark-nn.eemcs.utwente.nl/user/s1934538/clickstream/clickstream-enwiki-2018-06.tsv.gz,Adele,17463,150412,2029,169904,47736
hdfs://spark-nn.eemcs.utwente.nl/user/s1934538/clickstream/clickstream-enwiki-2018-06.tsv.gz,Cricket_World_Cup,8819,108935,896,118650,61675
hdfs://spark-nn.eemcs.utwente.nl/user/s1934538/clickstream/clickstream-enwiki-2018-06.tsv.gz,Elon_Musk,95004,699766,5457,800227,390594
hdfs://spark-nn.eemcs.utwente.nl/user/s1934538/clickstream/clickstream-enwiki-2018-06.tsv.gz,Anne_Heche,24860,41933,201,66994,17710
hdfs://spark-nn.eemcs.utwente.nl/user/s1934538/clickstream/clickstream-enwiki-2018-06.tsv.gz,Keanu_Reeves,60012,397876,2839,460727,235892
hdfs://spark-nn.eemcs.utwente.nl/user/s1934538/clickstream/clickstream-enwiki-2018-06.tsv.gz,HTTP_cookie,5150,428411,170,433731,29534
hdfs://spark-nn.eemcs.utwente.nl/user/s1934538/clickstream/clickstream-enwiki-2018-06.tsv.gz,Aquaman_(film),93402,99467,2323,195192,125949
hdfs://spark-nn.eemcs.utwente.nl/user/s1934538/clickstream/clickstream-enwiki-2018-06.tsv.gz,DMX_(rapper),11883,80386,430,92699,31842
hdfs://spark-nn.eemcs.utwente.nl/user/s1934538/clickstream/clickstream-enwiki-2018-06.tsv.gz,Glass_(2019_film),91007,106702,298,198007,106985
hdfs://spark-nn.eemcs.utwente.nl/user/s1934538/clickstream/clickstream-enwiki-2018-06.tsv.gz,A_Quiet_Place_(film),51651,585190,7478,644319,184761
hdfs://spark-nn.eemcs.utwente.nl/user/s1934538/clickstream/clickstream-enwiki-2018-06.tsv.gz,Aaron_Hernandez,8370,108794,446,117610,28869
hdfs://spark-nn.eemcs.utwente.nl/user/s1934538/clickstream/clickstream-enwiki-2018-06.tsv.gz,2018_FIFA_World_Cup,1900328,11199916,45189,13145433,5727654
hdfs://spark-nn.eemcs.utwente.nl/user/s1934538/clickstream/clickstream-enwiki-2018-06.tsv.gz,Dennis_Nilsen,4043,29369,357,33769,5809
hdfs://spark-nn.eemcs.utwente.nl/user/s1934538/clickstream/clickstream-enwiki-2018-06.tsv.gz,Cleopatra,36927,192211,1957,231095,84822
hdfs://spark-nn.eemcs.utwente.nl/user/s1934538/clickstream/clickstream-enwiki-2018-06.tsv.gz,Juneteenth,5852,1078758,12568,1097178,85489
hdfs://spark-nn.eemcs.utwente.nl/user/s1934538/clickstream/clickstream-enwiki-2018-06.tsv.gz,2018_Asian_Games,15862,101850,588,118300,53892
hdfs://spark-nn.eemcs.utwente.nl/user/s1934538/clickstream/clickstream-enwiki-2018-06.tsv.gz,Media,58,18946,595,19599,3146
hdfs://spark-nn.eemcs.utwente.nl/user/s1934538/clickstream/clickstream-enwiki-2018-06.tsv.gz,The_Weeknd,36671,140454,2762,179887,64649
hdfs://spark-nn.eemcs.utwente.nl/user/s1934538/clickstream/clickstream-enwiki-2018-06.tsv.gz,Indian_Premier_League,10112,68752,104,78968,29556
hdfs://spark-nn.eemcs.utwente.nl/user/s1934538/clickstream/clickstream-enwiki-2018-06.tsv.gz,Naya_Rivera,29896,42054,122,72072,12892
hdfs://spark-nn.eemcs.utwente.nl/user/s1934538/clickstream/clickstream-enwiki-2018-06.tsv.gz,Deaths_in_2018,1202549,2078438,8839,3289826,1758842
hdfs://spark-nn.eemcs.utwente.nl/user/s1934538/clickstream/clickstream-enwiki-2018-06.tsv.gz,Luke_Perry,27401,52331,331,80063,11883
hdfs://spark-nn.eemcs.utwente.nl/user/s1934538/clickstream/clickstream-enwiki-2018-06.tsv.gz,Sylvester_Stallone,92047,428546,2706,523299,281030
hdfs://spark-nn.eemcs.utwente.nl/user/s1934538/clickstream/clickstream-enwiki-2018-06.tsv.gz,Mac_Miller,70079,96360,802,167241,31708
hdfs://spark-nn.eemcs.utwente.nl/user/s1934538/clickstream/clickstream-enwiki-2018-06.tsv.gz,George_H._W._Bush,95505,157025,1348,253878,121098
hdfs://spark-nn.eemcs.utwente.nl/user/s1934538/clickstream/clickstream-enwiki-2018-06.tsv.gz,2.0_(film),46553,170231,3042,219826,61718
hdfs://spark-nn.eemcs.utwente.nl/user/s1934538/clickstream/clickstream-enwiki-2018-06.tsv.gz,Khabib_Nurmagomedov,21416,85122,667,107205,41708
hdfs://spark-nn.eemcs.utwente.nl/user/s1934538/clickstream/clickstream-enwiki-2018-06.tsv.gz,Area_51,11967,187880,25563,225410,66657
hdfs://spark-nn.eemcs.utwente.nl/user/s1934538/clickstream/clickstream-enwiki-2018-06.tsv.gz,Cecil_Hotel_(Los_Angeles),4190,17172,24,21386,6985
hdfs://spark-nn.eemcs.utwente.nl/user/s1934538/clickstream/clickstream-enwiki-2018-06.tsv.gz,Bird_Box_(film),14438,6035,106,20579,8300
hdfs://spark-nn.eemcs.utwente.nl/user/s1934538/clickstream/clickstream-enwiki-2018-06.tsv.gz,Richard_Ramirez,10192,126308,1011,137511,28098
hdfs://spark-nn.eemcs.utwente.nl/user/s1934538/clickstream/clickstream-enwiki-2018-06.tsv.gz,Jeffrey_Dahmer,26711,372526,2980,402217,143354
hdfs://spark-nn.eemcs.utwente.nl/user/s1934538/clickstream/clickstream-enwiki-2018-06.tsv.gz,Charles_III,136,504,77,717,440
hdfs://spark-nn.eemcs.utwente.nl/user/s1934538/clickstream/clickstream-enwiki-2018-06.tsv.gz,The_Umbrella_Academy_(TV_series),5736,7743,22,13501,5580
hdfs://spark-nn.eemcs.utwente.nl/user/s1934538/clickstream/clickstream-enwiki-2018-06.tsv.gz,Naomi_Osaka,2293,23517,134,25944,4041
hdfs://spark-nn.eemcs.utwente.nl/user/s1934538/clickstream/clickstream-enwiki-2018-06.tsv.gz,UEFA_Euro_2020,119074,460653,6505,586232,175883
hdfs://spark-nn.eemcs.utwente.nl/user/s1934538/clickstream/clickstream-enwiki-2018-06.tsv.gz,Sushant_Singh_Rajput,20350,58232,216,78798,42739
hdfs://spark-nn.eemcs.utwente.nl/user/s1934538/clickstream/clickstream-enwiki-2018-06.tsv.gz,Lists_of_deaths_by_year,7281,141902,194,149377,130053
hdfs://spark-nn.eemcs.utwente.nl/user/s1934538/clickstream/clickstream-enwiki-2018-06.tsv.gz,Cristiano_Ronaldo,375723,3741641,18254,4135618,858302
hdfs://spark-nn.eemcs.utwente.nl/user/s1934538/clickstream/clickstream-enwiki-2018-06.tsv.gz,Main_Page,20318,407526608,2915944,410462870,31700801
hdfs://spark-nn.eemcs.utwente.nl/user/s1934538/clickstream/clickstream-enwiki-2018-07.tsv.gz,Ruth_Bader_Ginsburg,109656,527085,3298,640039,218412
hdfs://spark-nn.eemcs.utwente.nl/user/s1934538/clickstream/clickstream-enwiki-2018-07.tsv.gz,Pornhub,35821,328192,9882,373895,61585
hdfs://spark-nn.eemcs.utwente.nl/user/s1934538/clickstream/clickstream-enwiki-2018-07.tsv.gz,List_of_James_Bond_films,18803,200081,288,219172,94214
hdfs://spark-nn.eemcs.utwente.nl/user/s1934538/clickstream/clickstream-enwiki-2018-07.tsv.gz,The_Lion_King_(2019_film),58052,79793,706,138551,125721
hdfs://spark-nn.eemcs.utwente.nl/user/s1934538/clickstream/clickstream-enwiki-2018-07.tsv.gz,XXXTentacion,114583,1057109,20082,1191774,334564
hdfs://spark-nn.eemcs.utwente.nl/user/s1934538/clickstream/clickstream-enwiki-2018-07.tsv.gz,Deion_Sanders,7581,53085,319,60985,13802
hdfs://spark-nn.eemcs.utwente.nl/user/s1934538/clickstream/clickstream-enwiki-2018-07.tsv.gz,Cameron_Boyce,13970,41424,184,55578,11006
hdfs://spark-nn.eemcs.utwente.nl/user/s1934538/clickstream/clickstream-enwiki-2018-07.tsv.gz,Grover,1276,7670,35,8981,1358
hdfs://spark-nn.eemcs.utwente.nl/user/s1934538/clickstream/clickstream-enwiki-2018-07.tsv.gz,Royal_Rumble_(2018),15114,27520,222,42856,22503
hdfs://spark-nn.eemcs.utwente.nl/user/s1934538/clickstream/clickstream-enwiki-2018-07.tsv.gz,Brett_Kavanaugh,38281,1924439,16440,1979160,432032
hdfs://spark-nn.eemcs.utwente.nl/user/s1934538/clickstream/clickstream-enwiki-2018-07.tsv.gz,William_Murdoch,446,1187,10,1643,202
hdfs://spark-nn.eemcs.utwente.nl/user/s1934538/clickstream/clickstream-enwiki-2018-07.tsv.gz,A_Quiet_Place_(film),65685,990434,10177,1066296,326785
hdfs://spark-nn.eemcs.utwente.nl/user/s1934538/clickstream/clickstream-enwiki-2018-07.tsv.gz,Anne_Heche,27499,47671,261,75431,20460
hdfs://spark-nn.eemcs.utwente.nl/user/s1934538/clickstream/clickstream-enwiki-2018-07.tsv.gz,Jason_Momoa,131473,667259,2833,801565,320021
hdfs://spark-nn.eemcs.utwente.nl/user/s1934538/clickstream/clickstream-enwiki-2018-07.tsv.gz,Tonya_Harding,62683,507449,1948,572080,130085
hdfs://spark-nn.eemcs.utwente.nl/user/s1934538/clickstream/clickstream-enwiki-2018-07.tsv.gz,Juneteenth,2118,78613,180,80911,7870
hdfs://spark-nn.eemcs.utwente.nl/user/s1934538/clickstream/clickstream-enwiki-2018-07.tsv.gz,Betty_White,46944,233367,1862,282173,58384
hdfs://spark-nn.eemcs.utwente.nl/user/s1934538/clickstream/clickstream-enwiki-2018-07.tsv.gz,Sushma_Swaraj,3928,35897,98,39923,8484
hdfs://spark-nn.eemcs.utwente.nl/user/s1934538/clickstream/clickstream-enwiki-2018-07.tsv.gz,Joaquin_Phoenix,97961,236659,2476,337096,235613
hdfs://spark-nn.eemcs.utwente.nl/user/s1934538/clickstream/clickstream-enwiki-2018-07.tsv.gz,Kamala_Harris,17192,171903,1332,190427,56743
hdfs://spark-nn.eemcs.utwente.nl/user/s1934538/clickstream/clickstream-enwiki-2018-07.tsv.gz,Amy_Coney_Barrett,11269,512516,4939,528724,157300
hdfs://spark-nn.eemcs.utwente.nl/user/s1934538/clickstream/clickstream-enwiki-2018-07.tsv.gz,Asia_Cup,10817,39076,347,50240,19038
hdfs://spark-nn.eemcs.utwente.nl/user/s1934538/clickstream/clickstream-enwiki-2018-07.tsv.gz,Naomi_Osaka,2668,42003,203,44874,6697
hdfs://spark-nn.eemcs.utwente.nl/user/s1934538/clickstream/clickstream-enwiki-2018-07.tsv.gz,J._Robert_Oppenheimer,14925,66707,237,81869,25005
hdfs://spark-nn.eemcs.utwente.nl/user/s1934538/clickstream/clickstream-enwiki-2018-07.tsv.gz,Jimmy_Hoffa,27100,158073,1252,186425,71638
hdfs://spark-nn.eemcs.utwente.nl/user/s1934538/clickstream/clickstream-enwiki-2018-07.tsv.gz,Richard_Jewell,2595,6831,38,9464,2537
hdfs://spark-nn.eemcs.utwente.nl/user/s1934538/clickstream/clickstream-enwiki-2018-07.tsv.gz,Hamas,13190,42735,381,56306,18992
hdfs://spark-nn.eemcs.utwente.nl/user/s1934538/clickstream/clickstream-enwiki-2018-07.tsv.gz,List_of_highest-grossing_Indian_films,155781,803977,1234,960992,357855
hdfs://spark-nn.eemcs.utwente.nl/user/s1934538/clickstream/clickstream-enwiki-2018-07.tsv.gz,Donald_Glover,82677,422674,3570,508921,149415
hdfs://spark-nn.eemcs.utwente.nl/user/s1934538/clickstream/clickstream-enwiki-2018-07.tsv.gz,2020_Summer_Olympics,62499,151013,2776,216288,139541
hdfs://spark-nn.eemcs.utwente.nl/user/s1934538/clickstream/clickstream-enwiki-2018-07.tsv.gz,QAnon,2903,146719,618,150240,37535
hdfs://spark-nn.eemcs.utwente.nl/user/s1934538/clickstream/clickstream-enwiki-2018-07.tsv.gz,Area_51,13911,200019,1444,215374,52406
hdfs://spark-nn.eemcs.utwente.nl/user/s1934538/clickstream/clickstream-enwiki-2018-07.tsv.gz,Amber_Heard,147825,240198,1360,389383,189934
hdfs://spark-nn.eemcs.utwente.nl/user/s1934538/clickstream/clickstream-enwiki-2018-07.tsv.gz,R._Kelly,27105,140999,1310,169414,81336
hdfs://spark-nn.eemcs.utwente.nl/user/s1934538/clickstream/clickstream-enwiki-2018-07.tsv.gz,Eddie_Van_Halen,27332,73017,337,100686,28220
hdfs://spark-nn.eemcs.utwente.nl/user/s1934538/clickstream/clickstream-enwiki-2018-07.tsv.gz,Lists_of_deaths_by_year,7067,131389,290,138746,122628
hdfs://spark-nn.eemcs.utwente.nl/user/s1934538/clickstream/clickstream-enwiki-2018-07.tsv.gz,List_of_most_popular_websites,18773,178007,126,196906,54057
hdfs://spark-nn.eemcs.utwente.nl/user/s1934538/clickstream/clickstream-enwiki-2018-07.tsv.gz,List_of_awards_and_nominations_received_by_Meryl_Streep,20350,14862,152,35364,11370
hdfs://spark-nn.eemcs.utwente.nl/user/s1934538/clickstream/clickstream-enwiki-2018-07.tsv.gz,Game_of_Thrones_(season_8),60075,407006,1449,468530,147359
hdfs://spark-nn.eemcs.utwente.nl/user/s1934538/clickstream/clickstream-enwiki-2018-07.tsv.gz,Aquaman_(film),149679,334163,8758,492600,398028
hdfs://spark-nn.eemcs.utwente.nl/user/s1934538/clickstream/clickstream-enwiki-2018-07.tsv.gz,The_Umbrella_Academy_(TV_series),8795,15816,76,24687,14040
hdfs://spark-nn.eemcs.utwente.nl/user/s1934538/clickstream/clickstream-enwiki-2018-07.tsv.gz,Nipsey_Hussle,11899,38282,149,50330,21590
hdfs://spark-nn.eemcs.utwente.nl/user/s1934538/clickstream/clickstream-enwiki-2018-07.tsv.gz,Shakira,15695,423423,3063,442181,194815
hdfs://spark-nn.eemcs.utwente.nl/user/s1934538/clickstream/clickstream-enwiki-2018-07.tsv.gz,1234,66,2681,12,2759,174
hdfs://spark-nn.eemcs.utwente.nl/user/s1934538/clickstream/clickstream-enwiki-2018-07.tsv.gz,Bible,13650,93130,1590,108370,30693
hdfs://spark-nn.eemcs.utwente.nl/user/s1934538/clickstream/clickstream-enwiki-2018-07.tsv.gz,Spider-Man:_Far_From_Home,190100,134205,2255,326560,162068
hdfs://spark-nn.eemcs.utwente.nl/user/s1934538/clickstream/clickstream-enwiki-2018-07.tsv.gz,A_Star_Is_Born_(2018_film),30912,111398,1649,143959,57705
hdfs://spark-nn.eemcs.utwente.nl/user/s1934538/clickstream/clickstream-enwiki-2018-07.tsv.gz,Freddie_Mercury,146994,886355,6188,1039537,349327
hdfs://spark-nn.eemcs.utwente.nl/user/s1934538/clickstream/clickstream-enwiki-2018-07.tsv.gz,Luke_Perry,29728,54343,392,84463,13405
hdfs://spark-nn.eemcs.utwente.nl/user/s1934538/clickstream/clickstream-enwiki-2018-07.tsv.gz,The_Irishman,73,734,26,833,543
hdfs://spark-nn.eemcs.utwente.nl/user/s1934538/clickstream/clickstream-enwiki-2018-07.tsv.gz,List_of_highest-grossing_films,238957,705218,4029,948204,332932
hdfs://spark-nn.eemcs.utwente.nl/user/s1934538/clickstream/clickstream-enwiki-2018-07.tsv.gz,Israel,65486,301363,5332,372181,155984
hdfs://spark-nn.eemcs.utwente.nl/user/s1934538/clickstream/clickstream-enwiki-2018-07.tsv.gz,Glass_(2019_film),203974,440834,6141,650949,418280
hdfs://spark-nn.eemcs.utwente.nl/user/s1934538/clickstream/clickstream-enwiki-2018-07.tsv.gz,Kate_Spade,30913,122385,1572,154870,48114
hdfs://spark-nn.eemcs.utwente.nl/user/s1934538/clickstream/clickstream-enwiki-2018-07.tsv.gz,Rami_Malek,96605,191048,1205,288858,88659
hdfs://spark-nn.eemcs.utwente.nl/user/s1934538/clickstream/clickstream-enwiki-2018-07.tsv.gz,Chadwick_Boseman,57948,150342,1016,209306,52953
hdfs://spark-nn.eemcs.utwente.nl/user/s1934538/clickstream/clickstream-enwiki-2018-07.tsv.gz,Wikipedia,39543,466536,768,506847,181560
hdfs://spark-nn.eemcs.utwente.nl/user/s1934538/clickstream/clickstream-enwiki-2018-07.tsv.gz,Henry_V_of_England,41685,28350,154,70189,43403
hdfs://spark-nn.eemcs.utwente.nl/user/s1934538/clickstream/clickstream-enwiki-2018-07.tsv.gz,Article_370_of_the_Constitution_of_India,4662,41230,24,45916,3417
hdfs://spark-nn.eemcs.utwente.nl/user/s1934538/clickstream/clickstream-enwiki-2018-07.tsv.gz,Spanish_flu,13810,73116,982,87908,18622
hdfs://spark-nn.eemcs.utwente.nl/user/s1934538/clickstream/clickstream-enwiki-2018-07.tsv.gz,Burt_Reynolds,47231,192619,1464,241314,80126
hdfs://spark-nn.eemcs.utwente.nl/user/s1934538/clickstream/clickstream-enwiki-2018-07.tsv.gz,Stranger_Things,57637,423776,9911,491324,299217
hdfs://spark-nn.eemcs.utwente.nl/user/s1934538/clickstream/clickstream-enwiki-2018-07.tsv.gz,Chernobyl_disaster,27475,253685,1332,282492,73385
hdfs://spark-nn.eemcs.utwente.nl/user/s1934538/clickstream/clickstream-enwiki-2018-07.tsv.gz,Charles_III,152,467,64,683,402
hdfs://spark-nn.eemcs.utwente.nl/user/s1934538/clickstream/clickstream-enwiki-2018-07.tsv.gz,Notre-Dame_de_Paris,9328,82974,384,92686,15929
hdfs://spark-nn.eemcs.utwente.nl/user/s1934538/clickstream/clickstream-enwiki-2018-07.tsv.gz,Michael_Jordan,63702,466874,3791,534367,159582
hdfs://spark-nn.eemcs.utwente.nl/user/s1934538/clickstream/clickstream-enwiki-2018-07.tsv.gz,Dennis_Nilsen,5285,33980,233,39498,7091
hdfs://spark-nn.eemcs.utwente.nl/user/s1934538/clickstream/clickstream-enwiki-2018-07.tsv.gz,Saaho,39852,50720,662,91234,61044
hdfs://spark-nn.eemcs.utwente.nl/user/s1934538/clickstream/clickstream-enwiki-2018-07.tsv.gz,NATO,48036,413456,7029,468521,139268
hdfs://spark-nn.eemcs.utwente.nl/user/s1934538/clickstream/clickstream-enwiki-2018-07.tsv.gz,Murder_of_Dee_Dee_Blanchard,5642,123447,234,129323,27354
hdfs://spark-nn.eemcs.utwente.nl/user/s1934538/clickstream/clickstream-enwiki-2018-07.tsv.gz,Cleopatra,43815,188819,2023,234657,95066
hdfs://spark-nn.eemcs.utwente.nl/user/s1934538/clickstream/clickstream-enwiki-2018-07.tsv.gz,Olivia_Newton-John,22949,130271,1027,154247,56831
hdfs://spark-nn.eemcs.utwente.nl/user/s1934538/clickstream/clickstream-enwiki-2018-07.tsv.gz,Croatia,238589,4618677,47139,4904405,1233433
hdfs://spark-nn.eemcs.utwente.nl/user/s1934538/clickstream/clickstream-enwiki-2018-07.tsv.gz,21_Savage,24049,92724,1730,118503,45496
hdfs://spark-nn.eemcs.utwente.nl/user/s1934538/clickstream/clickstream-enwiki-2018-07.tsv.gz,Fyre_Festival,5077,54653,350,60080,31566
hdfs://spark-nn.eemcs.utwente.nl/user/s1934538/clickstream/clickstream-enwiki-2018-07.tsv.gz,Jimmy_Buffett,9146,114383,1215,124744,30187
hdfs://spark-nn.eemcs.utwente.nl/user/s1934538/clickstream/clickstream-enwiki-2018-07.tsv.gz,Alexander_Hamilton,68898,340762,5949,415609,169461
hdfs://spark-nn.eemcs.utwente.nl/user/s1934538/clickstream/clickstream-enwiki-2018-07.tsv.gz,Stephen_Hawking,25415,422960,2912,451287,142776
hdfs://spark-nn.eemcs.utwente.nl/user/s1934538/clickstream/clickstream-enwiki-2018-07.tsv.gz,Once_Upon_a_Time_in_Hollywood,154469,99352,828,254649,266519
hdfs://spark-nn.eemcs.utwente.nl/user/s1934538/clickstream/clickstream-enwiki-2018-07.tsv.gz,HTTP_cookie,5417,515948,235,521600,35711
hdfs://spark-nn.eemcs.utwente.nl/user/s1934538/clickstream/clickstream-enwiki-2018-07.tsv.gz,Line_shaft,634,1314,40,1988,142
hdfs://spark-nn.eemcs.utwente.nl/user/s1934538/clickstream/clickstream-enwiki-2018-07.tsv.gz,Donald_Trump,257729,1128126,15322,1401177,821402
hdfs://spark-nn.eemcs.utwente.nl/user/s1934538/clickstream/clickstream-enwiki-2018-07.tsv.gz,Kobe_Bryant,49635,382427,2667,434729,95177
hdfs://spark-nn.eemcs.utwente.nl/user/s1934538/clickstream/clickstream-enwiki-2018-07.tsv.gz,Death_of_Elisa_Lam,10714,75023,294,86031,21374
hdfs://spark-nn.eemcs.utwente.nl/user/s1934538/clickstream/clickstream-enwiki-2018-07.tsv.gz,Taliban,15320,65223,670,81213,36685
hdfs://spark-nn.eemcs.utwente.nl/user/s1934538/clickstream/clickstream-enwiki-2018-07.tsv.gz,David_Beckham,78056,605613,3668,687337,207228
hdfs://spark-nn.eemcs.utwente.nl/user/s1934538/clickstream/clickstream-enwiki-2018-07.tsv.gz,Simple_Mail_Transfer_Protocol,4702,38620,142,43464,5351
hdfs://spark-nn.eemcs.utwente.nl/user/s1934538/clickstream/clickstream-enwiki-2018-07.tsv.gz,Juice_Wrld,7889,163669,1385,172943,28882
hdfs://spark-nn.eemcs.utwente.nl/user/s1934538/clickstream/clickstream-enwiki-2018-07.tsv.gz,John_McCain,29151,163988,1884,195023,67601
hdfs://spark-nn.eemcs.utwente.nl/user/s1934538/clickstream/clickstream-enwiki-2018-07.tsv.gz,Salman_Rushdie,20746,59053,321,80120,34490
hdfs://spark-nn.eemcs.utwente.nl/user/s1934538/clickstream/clickstream-enwiki-2018-07.tsv.gz,Simone_Biles,11894,57476,255,69625,19841
hdfs://spark-nn.eemcs.utwente.nl/user/s1934538/clickstream/clickstream-enwiki-2018-07.tsv.gz,2018_Winter_Olympics,36766,67607,612,104985,45286
hdfs://spark-nn.eemcs.utwente.nl/user/s1934538/clickstream/clickstream-enwiki-2018-07.tsv.gz,The_Irishman_(2019_film),63386,60510,424,124320,97947
hdfs://spark-nn.eemcs.utwente.nl/user/s1934538/clickstream/clickstream-enwiki-2018-07.tsv.gz,UEFA_Euro_2020,163885,1064438,6677,1235000,282985
hdfs://spark-nn.eemcs.utwente.nl/user/s1934538/clickstream/clickstream-enwiki-2018-07.tsv.gz,Richard_Ramirez,10480,135870,1407,147757,33002
hdfs://spark-nn.eemcs.utwente.nl/user/s1934538/clickstream/clickstream-enwiki-2018-07.tsv.gz,Avicii,21382,270666,3372,295420,66333
hdfs://spark-nn.eemcs.utwente.nl/user/s1934538/clickstream/clickstream-enwiki-2018-07.tsv.gz,September_11_attacks,69528,262745,2391,334664,159473
hdfs://spark-nn.eemcs.utwente.nl/user/s1934538/clickstream/clickstream-enwiki-2018-07.tsv.gz,Roe_v._Wade,34853,716331,4235,755419,166431
hdfs://spark-nn.eemcs.utwente.nl/user/s1934538/clickstream/clickstream-enwiki-2018-07.tsv.gz,Ray_Liotta,34408,483027,2285,519720,99148
hdfs://spark-nn.eemcs.utwente.nl/user/s1934538/clickstream/clickstream-enwiki-2018-07.tsv.gz,Media,41,11412,371,11824,2514
hdfs://spark-nn.eemcs.utwente.nl/user/s1934538/clickstream/clickstream-enwiki-2018-07.tsv.gz,Bob_Saget,18496,51539,276,70311,12729
hdfs://spark-nn.eemcs.utwente.nl/user/s1934538/clickstream/clickstream-enwiki-2018-07.tsv.gz,Ted_Bundy,38195,451678,4907,494780,110249
hdfs://spark-nn.eemcs.utwente.nl/user/s1934538/clickstream/clickstream-enwiki-2018-07.tsv.gz,Sridevi,26982,184681,832,212495,59881
hdfs://spark-nn.eemcs.utwente.nl/user/s1934538/clickstream/clickstream-enwiki-2018-07.tsv.gz,Cook's_Country,155,3213,18,3386,37
hdfs://spark-nn.eemcs.utwente.nl/user/s1934538/clickstream/clickstream-enwiki-2018-07.tsv.gz,Black_Panther_(film),101567,384985,8166,494718,310106
hdfs://spark-nn.eemcs.utwente.nl/user/s1934538/clickstream/clickstream-enwiki-2018-10.tsv.gz,Glass_(2019_film),99874,173999,2509,276382,156493
hdfs://spark-nn.eemcs.utwente.nl/user/s1934538/clickstream/clickstream-enwiki-2018-10.tsv.gz,Critical_race_theory,2132,19294,26,21452,3821
hdfs://spark-nn.eemcs.utwente.nl/user/s1934538/clickstream/clickstream-enwiki-2018-10.tsv.gz,Khabib_Nurmagomedov,386523,3725948,23731,4136202,2120100
hdfs://spark-nn.eemcs.utwente.nl/user/s1934538/clickstream/clickstream-enwiki-2018-10.tsv.gz,Hyphen-minus,6741,106313499,8518474,114838714,1045
hdfs://spark-nn.eemcs.utwente.nl/user/s1934538/clickstream/clickstream-enwiki-2018-10.tsv.gz,Cameron_Boyce,11721,25151,120,36992,7119
hdfs://spark-nn.eemcs.utwente.nl/user/s1934538/clickstream/clickstream-enwiki-2018-10.tsv.gz,Jeffrey_Dahmer,31641,443660,4230,479531,185478
hdfs://spark-nn.eemcs.utwente.nl/user/s1934538/clickstream/clickstream-enwiki-2018-10.tsv.gz,Notre-Dame_de_Paris,10459,78215,505,89179,14736
hdfs://spark-nn.eemcs.utwente.nl/user/s1934538/clickstream/clickstream-enwiki-2018-10.tsv.gz,Wonder_Woman_1984,80708,54873,3586,139167,76984
hdfs://spark-nn.eemcs.utwente.nl/user/s1934538/clickstream/clickstream-enwiki-2018-10.tsv.gz,Game_of_Thrones,78050,418928,11835,508813,336175
hdfs://spark-nn.eemcs.utwente.nl/user/s1934538/clickstream/clickstream-enwiki-2018-10.tsv.gz,XXXTentacion,130892,832222,11686,974800,259914
hdfs://spark-nn.eemcs.utwente.nl/user/s1934538/clickstream/clickstream-enwiki-2018-10.tsv.gz,Dennis_Nilsen,5039,38372,191,43602,9346
hdfs://spark-nn.eemcs.utwente.nl/user/s1934538/clickstream/clickstream-enwiki-2018-10.tsv.gz,The_Nun_(2018_film),86068,459380,6552,552000,304578
hdfs://spark-nn.eemcs.utwente.nl/user/s1934538/clickstream/clickstream-enwiki-2018-10.tsv.gz,George_H._W._Bush,141114,179159,1108,321381,162363
hdfs://spark-nn.eemcs.utwente.nl/user/s1934538/clickstream/clickstream-enwiki-2018-10.tsv.gz,Afghanistan,44893,152166,2181,199240,119913
hdfs://spark-nn.eemcs.utwente.nl/user/s1934538/clickstream/clickstream-enwiki-2018-10.tsv.gz,Burt_Reynolds,48012,197930,2289,248231,95552
hdfs://spark-nn.eemcs.utwente.nl/user/s1934538/clickstream/clickstream-enwiki-2018-10.tsv.gz,Ted_Bundy,39236,518562,5548,563346,121383
hdfs://spark-nn.eemcs.utwente.nl/user/s1934538/clickstream/clickstream-enwiki-2018-10.tsv.gz,Joaquin_Phoenix,142830,208810,1594,353234,254148
hdfs://spark-nn.eemcs.utwente.nl/user/s1934538/clickstream/clickstream-enwiki-2018-10.tsv.gz,Top_Gun:_Maverick,63813,49990,5753,119556,97449
hdfs://spark-nn.eemcs.utwente.nl/user/s1934538/clickstream/clickstream-enwiki-2018-10.tsv.gz,List_of_most_popular_websites,24120,96419,214,120753,48544
hdfs://spark-nn.eemcs.utwente.nl/user/s1934538/clickstream/clickstream-enwiki-2018-10.tsv.gz,Key_frame,666,6355,20,7041,594
hdfs://spark-nn.eemcs.utwente.nl/user/s1934538/clickstream/clickstream-enwiki-2018-10.tsv.gz,2018_Winter_Olympics,24886,56956,520,82362,34794
hdfs://spark-nn.eemcs.utwente.nl/user/s1934538/clickstream/clickstream-enwiki-2018-10.tsv.gz,Sushma_Swaraj,3869,27077,54,31000,6817
hdfs://spark-nn.eemcs.utwente.nl/user/s1934538/clickstream/clickstream-enwiki-2018-10.tsv.gz,Spanish_flu,23160,116627,1312,141099,27623
hdfs://spark-nn.eemcs.utwente.nl/user/s1934538/clickstream/clickstream-enwiki-2018-10.tsv.gz,List_of_Marvel_Cinematic_Universe_films,101137,712145,2875,816157,259737
hdfs://spark-nn.eemcs.utwente.nl/user/s1934538/clickstream/clickstream-enwiki-2018-10.tsv.gz,Exo_(band),26052,410959,609,437620,165721
hdfs://spark-nn.eemcs.utwente.nl/user/s1934538/clickstream/clickstream-enwiki-2018-10.tsv.gz,Aquaman_(film),80989,196831,6206,284026,181200
hdfs://spark-nn.eemcs.utwente.nl/user/s1934538/clickstream/clickstream-enwiki-2018-10.tsv.gz,Joe_Biden,40388,158889,4217,203494,60438
hdfs://spark-nn.eemcs.utwente.nl/user/s1934538/clickstream/clickstream-enwiki-2018-10.tsv.gz,Indian_Premier_League,12046,37688,83,49817,25849
hdfs://spark-nn.eemcs.utwente.nl/user/s1934538/clickstream/clickstream-enwiki-2018-10.tsv.gz,Wikipedia,46594,443703,1235,491532,218522
hdfs://spark-nn.eemcs.utwente.nl/user/s1934538/clickstream/clickstream-enwiki-2018-10.tsv.gz,Death_of_Elisa_Lam,10766,73027,281,84074,22162
hdfs://spark-nn.eemcs.utwente.nl/user/s1934538/clickstream/clickstream-enwiki-2018-10.tsv.gz,Avengers:_Infinity_War,188251,465133,13227,666611,460111
hdfs://spark-nn.eemcs.utwente.nl/user/s1934538/clickstream/clickstream-enwiki-2018-10.tsv.gz,Donald_Glover,63389,256214,2837,322440,90164
hdfs://spark-nn.eemcs.utwente.nl/user/s1934538/clickstream/clickstream-enwiki-2018-10.tsv.gz,Naya_Rivera,16472,24180,76,40728,8030
hdfs://spark-nn.eemcs.utwente.nl/user/s1934538/clickstream/clickstream-enwiki-2018-10.tsv.gz,List_of_highest-grossing_films,120305,321617,1922,443844,194506
hdfs://spark-nn.eemcs.utwente.nl/user/s1934538/clickstream/clickstream-enwiki-2018-10.tsv.gz,Kim_Jong-un,29454,116701,1118,147273,63160
hdfs://spark-nn.eemcs.utwente.nl/user/s1934538/clickstream/clickstream-enwiki-2018-10.tsv.gz,Tina_Turner,20269,456910,4718,481897,107275
hdfs://spark-nn.eemcs.utwente.nl/user/s1934538/clickstream/clickstream-enwiki-2018-10.tsv.gz,Roe_v._Wade,31436,409138,2159,442733,101010
hdfs://spark-nn.eemcs.utwente.nl/user/s1934538/clickstream/clickstream-enwiki-2018-10.tsv.gz,Main_Page,28901,462169705,4340160,466538766,35198915
hdfs://spark-nn.eemcs.utwente.nl/user/s1934538/clickstream/clickstream-enwiki-2018-10.tsv.gz,HTTP_cookie,10251,373493,222,383966,42010
hdfs://spark-nn.eemcs.utwente.nl/user/s1934538/clickstream/clickstream-enwiki-2018-10.tsv.gz,Sushant_Singh_Rajput,24381,68883,437,93701,59516
hdfs://spark-nn.eemcs.utwente.nl/user/s1934538/clickstream/clickstream-enwiki-2018-10.tsv.gz,Freddie_Mercury,415486,2425513,18951,2859950,1103597
hdfs://spark-nn.eemcs.utwente.nl/user/s1934538/clickstream/clickstream-enwiki-2018-10.tsv.gz,Aretha_Franklin,20490,252730,1665,274885,46006
hdfs://spark-nn.eemcs.utwente.nl/user/s1934538/clickstream/clickstream-enwiki-2018-10.tsv.gz,The_Umbrella_Academy_(TV_series),11923,12750,202,24875,12543
hdfs://spark-nn.eemcs.utwente.nl/user/s1934538/clickstream/clickstream-enwiki-2018-10.tsv.gz,Jenna_Ortega,5700,19842,143,25685,3721
hdfs://spark-nn.eemcs.utwente.nl/user/s1934538/clickstream/clickstream-enwiki-2018-10.tsv.gz,Lance_Reddick,27179,19416,105,46700,8150
hdfs://spark-nn.eemcs.utwente.nl/user/s1934538/clickstream/clickstream-enwiki-2018-10.tsv.gz,Kobe_Bryant_sexual_assault_case,5498,51639,87,57224,5677
hdfs://spark-nn.eemcs.utwente.nl/user/s1934538/clickstream/clickstream-enwiki-2018-10.tsv.gz,Betty_White,39831,203070,1749,244650,50636
hdfs://spark-nn.eemcs.utwente.nl/user/s1934538/clickstream/clickstream-enwiki-2018-10.tsv.gz,Michael_Bloomberg,34799,127039,1200,163038,56749
hdfs://spark-nn.eemcs.utwente.nl/user/s1934538/clickstream/clickstream-enwiki-2018-10.tsv.gz,Dark_Phoenix_(film),98547,94322,2020,194889,135158
hdfs://spark-nn.eemcs.utwente.nl/user/s1934538/clickstream/clickstream-enwiki-2018-10.tsv.gz,The_Weeknd,46540,136901,1237,184678,70668
hdfs://spark-nn.eemcs.utwente.nl/user/s1934538/clickstream/clickstream-enwiki-2018-10.tsv.gz,Ray_Liotta,31107,251532,1094,283733,57951
hdfs://spark-nn.eemcs.utwente.nl/user/s1934538/clickstream/clickstream-enwiki-2018-10.tsv.gz,Area_51,12230,183065,1184,196479,47771
hdfs://spark-nn.eemcs.utwente.nl/user/s1934538/clickstream/clickstream-enwiki-2018-10.tsv.gz,YouTube,104135,921517,8493,1034145,151194
hdfs://spark-nn.eemcs.utwente.nl/user/s1934538/clickstream/clickstream-enwiki-2018-10.tsv.gz,Atal_Bihari_Vajpayee,18559,114011,194,132764,19267
hdfs://spark-nn.eemcs.utwente.nl/user/s1934538/clickstream/clickstream-enwiki-2018-10.tsv.gz,Kamala_Harris,40761,362930,3070,406761,133514
hdfs://spark-nn.eemcs.utwente.nl/user/s1934538/clickstream/clickstream-enwiki-2018-10.tsv.gz,Michael_Jordan,53230,390647,3521,447398,130651
hdfs://spark-nn.eemcs.utwente.nl/user/s1934538/clickstream/clickstream-enwiki-2018-10.tsv.gz,Article_370_of_the_Constitution_of_India,3730,25921,109,29760,2245
hdfs://spark-nn.eemcs.utwente.nl/user/s1934538/clickstream/clickstream-enwiki-2018-10.tsv.gz,UEFA_Euro_2020,31084,94115,1175,126374,43932
hdfs://spark-nn.eemcs.utwente.nl/user/s1934538/clickstream/clickstream-enwiki-2018-10.tsv.gz,2023_Cricket_World_Cup,15607,18676,14,34297,11611
hdfs://spark-nn.eemcs.utwente.nl/user/s1934538/clickstream/clickstream-enwiki-2018-10.tsv.gz,Kelly_Preston,58498,41710,161,100369,27865
hdfs://spark-nn.eemcs.utwente.nl/user/s1934538/clickstream/clickstream-enwiki-2018-10.tsv.gz,Lisa_Marie_Presley,113008,75130,238,188376,92995
hdfs://spark-nn.eemcs.utwente.nl/user/s1934538/clickstream/clickstream-enwiki-2018-10.tsv.gz,Charles_Sobhraj,3545,36918,141,40604,5793
hdfs://spark-nn.eemcs.utwente.nl/user/s1934538/clickstream/clickstream-enwiki-2018-10.tsv.gz,J._Robert_Oppenheimer,16643,66310,225,83178,26105
hdfs://spark-nn.eemcs.utwente.nl/user/s1934538/clickstream/clickstream-enwiki-2018-10.tsv.gz,Captain_Marvel_(film),106833,154654,2443,263930,168723
hdfs://spark-nn.eemcs.utwente.nl/user/s1934538/clickstream/clickstream-enwiki-2018-10.tsv.gz,Elon_Musk,91981,1114396,8540,1214917,542295
hdfs://spark-nn.eemcs.utwente.nl/user/s1934538/clickstream/clickstream-enwiki-2018-10.tsv.gz,Queen_(band),182726,736120,9190,928036,887661
hdfs://spark-nn.eemcs.utwente.nl/user/s1934538/clickstream/clickstream-enwiki-2018-10.tsv.gz,Bipin_Rawat,4408,17922,28,22358,6727
hdfs://spark-nn.eemcs.utwente.nl/user/s1934538/clickstream/clickstream-enwiki-2018-10.tsv.gz,United_States_Electoral_College,27093,123491,195,150779,20389
hdfs://spark-nn.eemcs.utwente.nl/user/s1934538/clickstream/clickstream-enwiki-2018-10.tsv.gz,The_Irishman,62,386,23,471,485
hdfs://spark-nn.eemcs.utwente.nl/user/s1934538/clickstream/clickstream-enwiki-2018-10.tsv.gz,Richard_Jewell,3370,16596,172,20138,4885
hdfs://spark-nn.eemcs.utwente.nl/user/s1934538/clickstream/clickstream-enwiki-2018-10.tsv.gz,Us_(2019_film),23140,10776,52,33968,16654
hdfs://spark-nn.eemcs.utwente.nl/user/s1934538/clickstream/clickstream-enwiki-2018-10.tsv.gz,Croatia,35141,129069,1872,166082,58909
hdfs://spark-nn.eemcs.utwente.nl/user/s1934538/clickstream/clickstream-enwiki-2018-10.tsv.gz,Aaron_Carter,13945,31206,272,45423,13176
hdfs://spark-nn.eemcs.utwente.nl/user/s1934538/clickstream/clickstream-enwiki-2018-10.tsv.gz,"Diana,_Princess_of_Wales",152835,271562,2255,426652,235754
hdfs://spark-nn.eemcs.utwente.nl/user/s1934538/clickstream/clickstream-enwiki-2018-10.tsv.gz,Donald_Trump,298182,1225056,14930,1538168,832291
hdfs://spark-nn.eemcs.utwente.nl/user/s1934538/clickstream/clickstream-enwiki-2018-10.tsv.gz,NATO,36800,134479,2421,173700,58299
hdfs://spark-nn.eemcs.utwente.nl/user/s1934538/clickstream/clickstream-enwiki-2018-10.tsv.gz,Rami_Malek,209932,855657,6468,1072057,293938
hdfs://spark-nn.eemcs.utwente.nl/user/s1934538/clickstream/clickstream-enwiki-2018-10.tsv.gz,Hamas,13706,32355,246,46307,15329
hdfs://spark-nn.eemcs.utwente.nl/user/s1934538/clickstream/clickstream-enwiki-2018-10.tsv.gz,Central_Park_jogger_case,5887,82419,468,88774,7753
hdfs://spark-nn.eemcs.utwente.nl/user/s1934538/clickstream/clickstream-enwiki-2018-10.tsv.gz,Richard_Ramirez,11458,141486,1659,154603,34080
hdfs://spark-nn.eemcs.utwente.nl/user/s1934538/clickstream/clickstream-enwiki-2018-10.tsv.gz,Valentine's_Day,3007,40134,243,43384,575
hdfs://spark-nn.eemcs.utwente.nl/user/s1934538/clickstream/clickstream-enwiki-2019-07.tsv.gz,"Diana,_Princess_of_Wales",144045,306635,2549,453229,291495
hdfs://spark-nn.eemcs.utwente.nl/user/s1934538/clickstream/clickstream-enwiki-2019-07.tsv.gz,Cameron_Boyce,262261,6982283,73556,7318100,1441509
hdfs://spark-nn.eemcs.utwente.nl/user/s1934538/clickstream/clickstream-enwiki-2019-07.tsv.gz,Cook's_Country,324,2996,26,3346,799
hdfs://spark-nn.eemcs.utwente.nl/user/s1934538/clickstream/clickstream-enwiki-2019-07.tsv.gz,Burt_Reynolds,76572,148592,1296,226460,85702
hdfs://spark-nn.eemcs.utwente.nl/user/s1934538/clickstream/clickstream-enwiki-2019-07.tsv.gz,Godzilla_vs._Kong,126477,56212,461,183150,121936
hdfs://spark-nn.eemcs.utwente.nl/user/s1934538/clickstream/clickstream-enwiki-2019-07.tsv.gz,Article_370_of_the_Constitution_of_India,19512,92260,51,111823,8161
hdfs://spark-nn.eemcs.utwente.nl/user/s1934538/clickstream/clickstream-enwiki-2019-07.tsv.gz,Grover,1315,5530,36,6881,1357
hdfs://spark-nn.eemcs.utwente.nl/user/s1934538/clickstream/clickstream-enwiki-2019-07.tsv.gz,Joker_(2019_film),100829,172448,3205,276482,176394
hdfs://spark-nn.eemcs.utwente.nl/user/s1934538/clickstream/clickstream-enwiki-2019-07.tsv.gz,Sridevi,21845,92949,246,115040,37456
hdfs://spark-nn.eemcs.utwente.nl/user/s1934538/clickstream/clickstream-enwiki-2019-07.tsv.gz,WrestleMania_34,19390,10463,219,30072,20408
hdfs://spark-nn.eemcs.utwente.nl/user/s1934538/clickstream/clickstream-enwiki-2019-07.tsv.gz,Mac_Miller,35295,238944,1944,276183,81920
hdfs://spark-nn.eemcs.utwente.nl/user/s1934538/clickstream/clickstream-enwiki-2019-07.tsv.gz,List_of_FIFA_World_Cup_finals,4263,171488,2994,178745,36815
hdfs://spark-nn.eemcs.utwente.nl/user/s1934538/clickstream/clickstream-enwiki-2019-07.tsv.gz,2018_Winter_Olympics,26809,24732,238,51779,31517
hdfs://spark-nn.eemcs.utwente.nl/user/s1934538/clickstream/clickstream-enwiki-2019-07.tsv.gz,Alexander_Hamilton,75669,271890,5722,353281,179421
hdfs://spark-nn.eemcs.utwente.nl/user/s1934538/clickstream/clickstream-enwiki-2019-07.tsv.gz,Crazy_Rich_Asians_(film),58034,199672,2642,260348,258708
hdfs://spark-nn.eemcs.utwente.nl/user/s1934538/clickstream/clickstream-enwiki-2019-07.tsv.gz,Central_Park_jogger_case,294273,767214,1906,1063393,108406
hdfs://spark-nn.eemcs.utwente.nl/user/s1934538/clickstream/clickstream-enwiki-2019-07.tsv.gz,United_States_Electoral_College,24876,112369,195,137440,16166
hdfs://spark-nn.eemcs.utwente.nl/user/s1934538/clickstream/clickstream-enwiki-2019-07.tsv.gz,Darth_Vader,25305,168787,775,194867,54693
hdfs://spark-nn.eemcs.utwente.nl/user/s1934538/clickstream/clickstream-enwiki-2019-07.tsv.gz,Greta_Thunberg,8433,136984,1485,146902,50491
hdfs://spark-nn.eemcs.utwente.nl/user/s1934538/clickstream/clickstream-enwiki-2019-07.tsv.gz,Tenet_(film),85919,71969,529,158417,144104
hdfs://spark-nn.eemcs.utwente.nl/user/s1934538/clickstream/clickstream-enwiki-2019-07.tsv.gz,Tunnel,3824,10250,93,14167,3304
hdfs://spark-nn.eemcs.utwente.nl/user/s1934538/clickstream/clickstream-enwiki-2019-07.tsv.gz,George_VI,348974,181261,2574,532809,386176
hdfs://spark-nn.eemcs.utwente.nl/user/s1934538/clickstream/clickstream-enwiki-2019-07.tsv.gz,FIFA_World_Cup,81121,398790,4500,484411,356279
hdfs://spark-nn.eemcs.utwente.nl/user/s1934538/clickstream/clickstream-enwiki-2019-07.tsv.gz,Lists_of_deaths_by_year,7691,169729,583,178003,152576
hdfs://spark-nn.eemcs.utwente.nl/user/s1934538/clickstream/clickstream-enwiki-2019-07.tsv.gz,Kobe_Bryant_sexual_assault_case,3502,24116,15,27633,3371
hdfs://spark-nn.eemcs.utwente.nl/user/s1934538/clickstream/clickstream-enwiki-2019-07.tsv.gz,Kim_Jong-un,49839,158552,1437,209828,127040
hdfs://spark-nn.eemcs.utwente.nl/user/s1934538/clickstream/clickstream-enwiki-2019-07.tsv.gz,Betty_White,60514,292855,2312,355681,83081
hdfs://spark-nn.eemcs.utwente.nl/user/s1934538/clickstream/clickstream-enwiki-2019-07.tsv.gz,Chernobyl_(miniseries),72103,692773,13342,778218,730749
hdfs://spark-nn.eemcs.utwente.nl/user/s1934538/clickstream/clickstream-enwiki-2019-07.tsv.gz,Glass_(2019_film),67297,148905,1745,217947,80516
hdfs://spark-nn.eemcs.utwente.nl/user/s1934538/clickstream/clickstream-enwiki-2019-07.tsv.gz,Grimes_(musician),39725,78140,476,118341,42295
hdfs://spark-nn.eemcs.utwente.nl/user/s1934538/clickstream/clickstream-enwiki-2019-07.tsv.gz,Spider-Man:_Far_From_Home,694298,4079615,104842,4878755,3080799
hdfs://spark-nn.eemcs.utwente.nl/user/s1934538/clickstream/clickstream-enwiki-2019-07.tsv.gz,Tina_Turner,21495,188344,1687,211526,56949
hdfs://spark-nn.eemcs.utwente.nl/user/s1934538/clickstream/clickstream-enwiki-2019-07.tsv.gz,1234,106,1691,14,1811,176
hdfs://spark-nn.eemcs.utwente.nl/user/s1934538/clickstream/clickstream-enwiki-2019-07.tsv.gz,Charles_Sobhraj,3149,24106,92,27347,6422
hdfs://spark-nn.eemcs.utwente.nl/user/s1934538/clickstream/clickstream-enwiki-2019-07.tsv.gz,Salman_Rushdie,24065,51878,377,76320,33853
hdfs://spark-nn.eemcs.utwente.nl/user/s1934538/clickstream/clickstream-enwiki-2019-07.tsv.gz,Parasite_(2019_film),42653,193334,1075,237062,91655
hdfs://spark-nn.eemcs.utwente.nl/user/s1934538/clickstream/clickstream-enwiki-2019-07.tsv.gz,"Prince_Philip,_Duke_of_Edinburgh",227328,224569,3790,455687,286018
hdfs://spark-nn.eemcs.utwente.nl/user/s1934538/clickstream/clickstream-enwiki-2019-07.tsv.gz,Amy_Coney_Barrett,1557,5827,142,7526,1981
hdfs://spark-nn.eemcs.utwente.nl/user/s1934538/clickstream/clickstream-enwiki-2019-07.tsv.gz,Queen_(band),175430,687972,7202,870604,904449
hdfs://spark-nn.eemcs.utwente.nl/user/s1934538/clickstream/clickstream-enwiki-2019-07.tsv.gz,Jimmy_Hoffa,66732,137746,1210,205688,79390
hdfs://spark-nn.eemcs.utwente.nl/user/s1934538/clickstream/clickstream-enwiki-2019-07.tsv.gz,Joe_Biden,48979,244673,6450,300102,99728
hdfs://spark-nn.eemcs.utwente.nl/user/s1934538/clickstream/clickstream-enwiki-2019-07.tsv.gz,Game_of_Thrones,85580,382669,10064,478313,348549
hdfs://spark-nn.eemcs.utwente.nl/user/s1934538/clickstream/clickstream-enwiki-2019-07.tsv.gz,Elizabeth_II,481428,589493,4443,1075364,889119
hdfs://spark-nn.eemcs.utwente.nl/user/s1934538/clickstream/clickstream-enwiki-2019-07.tsv.gz,2018_FIFA_World_Cup,137507,270854,3129,411490,179463
hdfs://spark-nn.eemcs.utwente.nl/user/s1934538/clickstream/clickstream-enwiki-2019-07.tsv.gz,Matthew_Perry,76075,221559,912,298546,151711
hdfs://spark-nn.eemcs.utwente.nl/user/s1934538/clickstream/clickstream-enwiki-2019-07.tsv.gz,Lance_Reddick,32728,29865,162,62755,13199
hdfs://spark-nn.eemcs.utwente.nl/user/s1934538/clickstream/clickstream-enwiki-2019-07.tsv.gz,It_Chapter_Two,135549,259919,6108,401576,390021
hdfs://spark-nn.eemcs.utwente.nl/user/s1934538/clickstream/clickstream-enwiki-2019-07.tsv.gz,Top_Gun:_Maverick,137690,492574,13011,643275,593537
hdfs://spark-nn.eemcs.utwente.nl/user/s1934538/clickstream/clickstream-enwiki-2019-07.tsv.gz,Royal_Rumble_(2018),8550,6075,38,14663,10301
hdfs://spark-nn.eemcs.utwente.nl/user/s1934538/clickstream/clickstream-enwiki-2019-07.tsv.gz,When_They_See_Us,66973,537130,3975,608078,482868
hdfs://spark-nn.eemcs.utwente.nl/user/s1934538/clickstream/clickstream-enwiki-2019-07.tsv.gz,Freddie_Mercury,285473,2337043,12041,2634557,924282
hdfs://spark-nn.eemcs.utwente.nl/user/s1934538/clickstream/clickstream-enwiki-2019-07.tsv.gz,State_of_Palestine,34719,84250,52,119021,50663
hdfs://spark-nn.eemcs.utwente.nl/user/s1934538/clickstream/clickstream-enwiki-2019-07.tsv.gz,Sylvester_Stallone,100148,466210,2928,569286,388112
hdfs://spark-nn.eemcs.utwente.nl/user/s1934538/clickstream/clickstream-enwiki-2019-07.tsv.gz,Black_Panther_(film),72198,151329,2972,226499,141384
hdfs://spark-nn.eemcs.utwente.nl/user/s1934538/clickstream/clickstream-enwiki-2019-07.tsv.gz,Donald_Glover,218664,576879,3973,799516,203875
hdfs://spark-nn.eemcs.utwente.nl/user/s1934538/clickstream/clickstream-enwiki-2019-07.tsv.gz,Aaron_Carter,16401,35065,212,51678,15838
hdfs://spark-nn.eemcs.utwente.nl/user/s1934538/clickstream/clickstream-enwiki-2019-07.tsv.gz,Simone_Biles,14391,64553,526,79470,20023
hdfs://spark-nn.eemcs.utwente.nl/user/s1934538/clickstream/clickstream-enwiki-2019-07.tsv.gz,Juneteenth,2313,88382,212,90907,9002
hdfs://spark-nn.eemcs.utwente.nl/user/s1934538/clickstream/clickstream-enwiki-2019-07.tsv.gz,Irrfan_Khan,23971,39468,66,63505,28483
hdfs://spark-nn.eemcs.utwente.nl/user/s1934538/clickstream/clickstream-enwiki-2019-07.tsv.gz,Lionel_Messi,88877,491593,6374,586844,133880
hdfs://spark-nn.eemcs.utwente.nl/user/s1934538/clickstream/clickstream-enwiki-2019-07.tsv.gz,War_(2019_film),76036,252006,211,328253,223618
hdfs://spark-nn.eemcs.utwente.nl/user/s1934538/clickstream/clickstream-enwiki-2019-07.tsv.gz,XXX:_Return_of_Xander_Cage,35420,101901,965,138286,48241
hdfs://spark-nn.eemcs.utwente.nl/user/s1934538/clickstream/clickstream-enwiki-2019-07.tsv.gz,Dennis_Nilsen,4843,21705,135,26683,6261
hdfs://spark-nn.eemcs.utwente.nl/user/s1934538/clickstream/clickstream-enwiki-2019-07.tsv.gz,Cricket_World_Cup,108369,1582052,11278,1701699,939510
hdfs://spark-nn.eemcs.utwente.nl/user/s1934538/clickstream/clickstream-enwiki-2019-07.tsv.gz,YouTube,126518,825205,7166,958889,133588
hdfs://spark-nn.eemcs.utwente.nl/user/s1934538/clickstream/clickstream-enwiki-2019-07.tsv.gz,The_Irishman_(2019_film),102298,264044,3963,370305,351061
hdfs://spark-nn.eemcs.utwente.nl/user/s1934538/clickstream/clickstream-enwiki-2019-07.tsv.gz,Kelly_Preston,70872,43336,105,114313,31604
hdfs://spark-nn.eemcs.utwente.nl/user/s1934538/clickstream/clickstream-enwiki-2019-07.tsv.gz,Elon_Musk,88667,771514,4393,864574,480042
hdfs://spark-nn.eemcs.utwente.nl/user/s1934538/clickstream/clickstream-enwiki-2019-07.tsv.gz,Key_frame,650,5167,15,5832,512
hdfs://spark-nn.eemcs.utwente.nl/user/s1934538/clickstream/clickstream-enwiki-2019-07.tsv.gz,Death_of_Elisa_Lam,7405,100066,241,107712,25905
hdfs://spark-nn.eemcs.utwente.nl/user/s1934538/clickstream/clickstream-enwiki-2019-07.tsv.gz,Vladimir_Putin,79329,212317,2936,294582,171336
hdfs://spark-nn.eemcs.utwente.nl/user/s1934538/clickstream/clickstream-enwiki-2019-07.tsv.gz,Valentine's_Day,2748,22541,137,25426,2130
hdfs://spark-nn.eemcs.utwente.nl/user/s1934538/clickstream/clickstream-enwiki-2019-07.tsv.gz,Avicii,25881,342449,2594,370924,136582
hdfs://spark-nn.eemcs.utwente.nl/user/s1934538/clickstream/clickstream-enwiki-2019-07.tsv.gz,Naomi_Osaka,49817,203257,1197,254271,46204
hdfs://spark-nn.eemcs.utwente.nl/user/s1934538/clickstream/clickstream-enwiki-2019-07.tsv.gz,Jenna_Ortega,7901,19169,731,27801,5527
hdfs://spark-nn.eemcs.utwente.nl/user/s1934538/clickstream/clickstream-enwiki-2019-07.tsv.gz,The_Witcher_(TV_series),62532,412121,4583,479236,252515
hdfs://spark-nn.eemcs.utwente.nl/user/s1934538/clickstream/clickstream-enwiki-2019-07.tsv.gz,David_Beckham,42439,188827,1648,232914,80996
hdfs://spark-nn.eemcs.utwente.nl/user/s1934538/clickstream/clickstream-enwiki-2019-07.tsv.gz,List_of_Marvel_Cinematic_Universe_films,637668,1509710,15023,2162401,1011045
hdfs://spark-nn.eemcs.utwente.nl/user/s1934538/clickstream/clickstream-enwiki-2019-07.tsv.gz,Main_Page,23322,517348769,4357688,521729779,34461655
hdfs://spark-nn.eemcs.utwente.nl/user/s1934538/clickstream/clickstream-enwiki-2019-07.tsv.gz,Asia_Cup,4974,69076,876,74926,49516
hdfs://spark-nn.eemcs.utwente.nl/user/s1934538/clickstream/clickstream-enwiki-2019-07.tsv.gz,List_of_Queen_of_the_South_episodes,42833,15329,136,58298,2015
hdfs://spark-nn.eemcs.utwente.nl/user/s1934538/clickstream/clickstream-enwiki-2019-07.tsv.gz,Charles_III,91,326,66,483,458
hdfs://spark-nn.eemcs.utwente.nl/user/s1934538/clickstream/clickstream-enwiki-2019-07.tsv.gz,Olivia_Newton-John,21973,102465,870,125308,55525
hdfs://spark-nn.eemcs.utwente.nl/user/s1934538/clickstream/clickstream-enwiki-2019-07.tsv.gz,Donald_Trump,270616,936676,13804,1221096,835025
hdfs://spark-nn.eemcs.utwente.nl/user/s1934538/clickstream/clickstream-enwiki-2019-07.tsv.gz,Notre-Dame_de_Paris,15449,100512,1233,117194,28255
hdfs://spark-nn.eemcs.utwente.nl/user/s1934538/clickstream/clickstream-enwiki-2019-07.tsv.gz,Rishi_Sunak,11870,62217,378,74465,22200
hdfs://spark-nn.eemcs.utwente.nl/user/s1934538/clickstream/clickstream-enwiki-2019-07.tsv.gz,Pornhub,33140,337806,12494,383440,63693
hdfs://spark-nn.eemcs.utwente.nl/user/s1934538/clickstream/clickstream-enwiki-2019-07.tsv.gz,Jimmy_Buffett,10846,78167,753,89766,29233
hdfs://spark-nn.eemcs.utwente.nl/user/s1934538/clickstream/clickstream-enwiki-2019-07.tsv.gz,Star_Wars:_The_Rise_of_Skywalker,163999,162756,5135,331890,224057
hdfs://spark-nn.eemcs.utwente.nl/user/s1934538/clickstream/clickstream-enwiki-2019-07.tsv.gz,Brett_Kavanaugh,25351,47100,352,72803,27890
hdfs://spark-nn.eemcs.utwente.nl/user/s1934538/clickstream/clickstream-enwiki-2019-07.tsv.gz,Keanu_Reeves,178051,1435377,8793,1622221,697960
hdfs://spark-nn.eemcs.utwente.nl/user/s1934538/clickstream/clickstream-enwiki-2019-07.tsv.gz,Eddie_Van_Halen,33255,46400,360,80015,39854
hdfs://spark-nn.eemcs.utwente.nl/user/s1934538/clickstream/clickstream-enwiki-2019-07.tsv.gz,XXXTentacion,84018,475955,10471,570444,115083
hdfs://spark-nn.eemcs.utwente.nl/user/s1934538/clickstream/clickstream-enwiki-2019-07.tsv.gz,The_Lion_King_(2019_film),427926,3593087,61515,4082528,2699791
hdfs://spark-nn.eemcs.utwente.nl/user/s1934538/clickstream/clickstream-enwiki-2019-07.tsv.gz,"Princess_Margaret,_Countess_of_Snowdon",111846,237061,1528,350435,228604
hdfs://spark-nn.eemcs.utwente.nl/user/s1934538/clickstream/clickstream-enwiki-2019-07.tsv.gz,Nipsey_Hussle,37141,198864,2129,238134,90315
hdfs://spark-nn.eemcs.utwente.nl/user/s1934538/clickstream/clickstream-enwiki-2019-07.tsv.gz,Ray_Liotta,35936,55059,351,91346,28973
hdfs://spark-nn.eemcs.utwente.nl/user/s1934538/clickstream/clickstream-enwiki-2019-07.tsv.gz,List_of_most_popular_websites,35973,71315,205,107493,50798
hdfs://spark-nn.eemcs.utwente.nl/user/s1934538/clickstream/clickstream-enwiki-2019-07.tsv.gz,List_of_awards_and_nominations_received_by_Meryl_Streep,20210,14697,107,35014,10902
hdfs://spark-nn.eemcs.utwente.nl/user/s1934538/clickstream/clickstream-enwiki-2019-07.tsv.gz,Shakira,20872,164477,1659,187008,84350
hdfs://spark-nn.eemcs.utwente.nl/user/s1934538/clickstream/clickstream-enwiki-2019-07.tsv.gz,Anne_Heche,38100,65626,359,104085,28987
hdfs://spark-nn.eemcs.utwente.nl/user/s1934538/clickstream/clickstream-enwiki-2019-07.tsv.gz,Kamala_Harris,48085,932549,8431,989065,320854
hdfs://spark-nn.eemcs.utwente.nl/user/s1934538/clickstream/clickstream-enwiki-2019-07.tsv.gz,Stranger_Things,727832,3583192,76092,4387116,5298934
hdfs://spark-nn.eemcs.utwente.nl/user/s1934538/clickstream/clickstream-enwiki-2019-07.tsv.gz,Ted_Bundy,52556,853671,5589,911816,209931
hdfs://spark-nn.eemcs.utwente.nl/user/s1934538/clickstream/clickstream-enwiki-2019-07.tsv.gz,Kate_Spade,38733,92112,652,131497,46460
hdfs://spark-nn.eemcs.utwente.nl/user/s1934538/clickstream/clickstream-enwiki-2019-07.tsv.gz,2020_United_States_presidential_election,90317,272249,4904,367470,266611
hdfs://spark-nn.eemcs.utwente.nl/user/s1934538/clickstream/clickstream-enwiki-2019-07.tsv.gz,George_H._W._Bush,122176,113406,779,236361,135332
hdfs://spark-nn.eemcs.utwente.nl/user/s1934538/clickstream/clickstream-enwiki-2019-07.tsv.gz,Aaron_Hernandez,7115,76576,494,84185,29335
hdfs://spark-nn.eemcs.utwente.nl/user/s1934538/clickstream/clickstream-enwiki-2020-03.tsv.gz,NATO,87088,209845,396,297329,96242
hdfs://spark-nn.eemcs.utwente.nl/user/s1934538/clickstream/clickstream-enwiki-2020-03.tsv.gz,The_Batman_(film),128850,132321,4152,265323,293737
hdfs://spark-nn.eemcs.utwente.nl/user/s1934538/clickstream/clickstream-enwiki-2020-03.tsv.gz,Grimes_(musician),120833,209349,1208,331390,130455
hdfs://spark-nn.eemcs.utwente.nl/user/s1934538/clickstream/clickstream-enwiki-2020-03.tsv.gz,Burt_Reynolds,55644,150304,1301,207249,81075
hdfs://spark-nn.eemcs.utwente.nl/user/s1934538/clickstream/clickstream-enwiki-2020-03.tsv.gz,Matthew_Perry,68512,168078,739,237329,137808
hdfs://spark-nn.eemcs.utwente.nl/user/s1934538/clickstream/clickstream-enwiki-2020-03.tsv.gz,Tenet_(film),96228,91245,1880,189353,122844
hdfs://spark-nn.eemcs.utwente.nl/user/s1934538/clickstream/clickstream-enwiki-2020-03.tsv.gz,Betty_White,57953,254266,3603,315822,91339
hdfs://spark-nn.eemcs.utwente.nl/user/s1934538/clickstream/clickstream-enwiki-2020-03.tsv.gz,2019–20_coronavirus_pandemic,8016260,22548219,144659,30709138,14333580
hdfs://spark-nn.eemcs.utwente.nl/user/s1934538/clickstream/clickstream-enwiki-2020-03.tsv.gz,QAnon,35309,996106,1371,1032786,162485
hdfs://spark-nn.eemcs.utwente.nl/user/s1934538/clickstream/clickstream-enwiki-2020-03.tsv.gz,Fantastic_Beasts:_The_Crimes_of_Grindelwald,60615,90780,1192,152587,80299
hdfs://spark-nn.eemcs.utwente.nl/user/s1934538/clickstream/clickstream-enwiki-2020-03.tsv.gz,Rami_Malek,78189,158965,911,238065,95372
hdfs://spark-nn.eemcs.utwente.nl/user/s1934538/clickstream/clickstream-enwiki-2020-03.tsv.gz,Anna_Sorokin,9893,57413,225,67531,15874
hdfs://spark-nn.eemcs.utwente.nl/user/s1934538/clickstream/clickstream-enwiki-2020-03.tsv.gz,Naomi_Osaka,7474,24338,183,31995,8587
hdfs://spark-nn.eemcs.utwente.nl/user/s1934538/clickstream/clickstream-enwiki-2020-03.tsv.gz,Coronavirus,460279,10424292,189968,11074539,3216129
hdfs://spark-nn.eemcs.utwente.nl/user/s1934538/clickstream/clickstream-enwiki-2020-03.tsv.gz,Media,91,5945,346,6382,1906
hdfs://spark-nn.eemcs.utwente.nl/user/s1934538/clickstream/clickstream-enwiki-2020-03.tsv.gz,Cardi_B,41239,282561,4329,328129,102780
hdfs://spark-nn.eemcs.utwente.nl/user/s1934538/clickstream/clickstream-enwiki-2020-03.tsv.gz,The_Weeknd,110009,607867,9339,727215,405291
hdfs://spark-nn.eemcs.utwente.nl/user/s1934538/clickstream/clickstream-enwiki-2020-03.tsv.gz,Deion_Sanders,10681,97700,503,108884,35198
hdfs://spark-nn.eemcs.utwente.nl/user/s1934538/clickstream/clickstream-enwiki-2020-03.tsv.gz,Mötley_Crüe,29815,96617,1350,127782,160692
hdfs://spark-nn.eemcs.utwente.nl/user/s1934538/clickstream/clickstream-enwiki-2020-03.tsv.gz,"Meghan,_Duchess_of_Sussex",124546,368566,2760,495872,285269
hdfs://spark-nn.eemcs.utwente.nl/user/s1934538/clickstream/clickstream-enwiki-2020-03.tsv.gz,Elon_Musk,120048,758819,4746,883613,538911
hdfs://spark-nn.eemcs.utwente.nl/user/s1934538/clickstream/clickstream-enwiki-2020-03.tsv.gz,Mulan_(2020_film),67961,506416,22838,597215,384227
hdfs://spark-nn.eemcs.utwente.nl/user/s1934538/clickstream/clickstream-enwiki-2020-03.tsv.gz,Kobe_Bryant_sexual_assault_case,6925,74983,146,82054,5236
hdfs://spark-nn.eemcs.utwente.nl/user/s1934538/clickstream/clickstream-enwiki-2020-03.tsv.gz,Ted_Bundy,37708,449311,4428,491447,105693
hdfs://spark-nn.eemcs.utwente.nl/user/s1934538/clickstream/clickstream-enwiki-2020-03.tsv.gz,2022_FIFA_World_Cup,43905,84264,1428,129597,65396
hdfs://spark-nn.eemcs.utwente.nl/user/s1934538/clickstream/clickstream-enwiki-2020-03.tsv.gz,List_of_most_popular_websites,13901,283422,165,297488,55608
hdfs://spark-nn.eemcs.utwente.nl/user/s1934538/clickstream/clickstream-enwiki-2020-03.tsv.gz,War_(2019_film),52882,320067,426,373375,82427
hdfs://spark-nn.eemcs.utwente.nl/user/s1934538/clickstream/clickstream-enwiki-2020-03.tsv.gz,Glass_(2019_film),59757,133973,820,194550,63745
hdfs://spark-nn.eemcs.utwente.nl/user/s1934538/clickstream/clickstream-enwiki-2020-03.tsv.gz,It_Chapter_Two,52948,131660,1543,186151,125942
hdfs://spark-nn.eemcs.utwente.nl/user/s1934538/clickstream/clickstream-enwiki-2020-03.tsv.gz,Louis_Tomlinson,42093,61221,673,103987,21246
hdfs://spark-nn.eemcs.utwente.nl/user/s1934538/clickstream/clickstream-enwiki-2020-03.tsv.gz,Shang-Chi_and_the_Legend_of_the_Ten_Rings,99693,19582,675,119950,85358
hdfs://spark-nn.eemcs.utwente.nl/user/s1934538/clickstream/clickstream-enwiki-2020-03.tsv.gz,September_11_attacks,86160,358924,3762,448846,159195
hdfs://spark-nn.eemcs.utwente.nl/user/s1934538/clickstream/clickstream-enwiki-2020-03.tsv.gz,2016_United_States_presidential_election,216888,408787,4480,630155,473067
hdfs://spark-nn.eemcs.utwente.nl/user/s1934538/clickstream/clickstream-enwiki-2020-03.tsv.gz,The_Shape_of_Water,30778,61599,676,93053,38893
hdfs://spark-nn.eemcs.utwente.nl/user/s1934538/clickstream/clickstream-enwiki-2020-03.tsv.gz,Anne_Heche,37234,55953,263,93450,27849
hdfs://spark-nn.eemcs.utwente.nl/user/s1934538/clickstream/clickstream-enwiki-2020-03.tsv.gz,K.G.F:_Chapter_2,30025,133996,168,164189,63720
hdfs://spark-nn.eemcs.utwente.nl/user/s1934538/clickstream/clickstream-enwiki-2020-03.tsv.gz,Christopher_Scarver,69392,24038,10,93440,29825
hdfs://spark-nn.eemcs.utwente.nl/user/s1934538/clickstream/clickstream-enwiki-2020-03.tsv.gz,Donald_Glover,67132,379123,4263,450518,220639
hdfs://spark-nn.eemcs.utwente.nl/user/s1934538/clickstream/clickstream-enwiki-2020-03.tsv.gz,Fyre_Festival,11793,110050,488,122331,55996
hdfs://spark-nn.eemcs.utwente.nl/user/s1934538/clickstream/clickstream-enwiki-2020-03.tsv.gz,Tunnel,2909,10717,118,13744,3273
hdfs://spark-nn.eemcs.utwente.nl/user/s1934538/clickstream/clickstream-enwiki-2020-03.tsv.gz,Mortal_Kombat_(2021_film),31090,48520,160,79770,126008
hdfs://spark-nn.eemcs.utwente.nl/user/s1934538/clickstream/clickstream-enwiki-2020-03.tsv.gz,Crazy_Rich_Asians_(film),32574,99888,948,133410,115578
hdfs://spark-nn.eemcs.utwente.nl/user/s1934538/clickstream/clickstream-enwiki-2020-03.tsv.gz,List_of_James_Bond_films,89875,629862,1126,720863,416759
hdfs://spark-nn.eemcs.utwente.nl/user/s1934538/clickstream/clickstream-enwiki-2020-03.tsv.gz,United_States_Electoral_College,41993,209777,245,252015,34808
hdfs://spark-nn.eemcs.utwente.nl/user/s1934538/clickstream/clickstream-enwiki-2020-03.tsv.gz,Vladimir_Putin,99392,461396,5218,566006,308512
hdfs://spark-nn.eemcs.utwente.nl/user/s1934538/clickstream/clickstream-enwiki-2020-03.tsv.gz,George_VI,443135,227775,880,671790,470244
hdfs://spark-nn.eemcs.utwente.nl/user/s1934538/clickstream/clickstream-enwiki-2020-03.tsv.gz,Juice_Wrld,40889,511209,5565,557663,175460
hdfs://spark-nn.eemcs.utwente.nl/user/s1934538/clickstream/clickstream-enwiki-2020-03.tsv.gz,"Diana,_Princess_of_Wales",211982,414759,2778,629519,381518
hdfs://spark-nn.eemcs.utwente.nl/user/s1934538/clickstream/clickstream-enwiki-2020-03.tsv.gz,Godzilla_vs._Kong,92459,85670,1623,179752,108927
hdfs://spark-nn.eemcs.utwente.nl/user/s1934538/clickstream/clickstream-enwiki-2020-03.tsv.gz,John_McCain,53674,116548,6244,176466,85849
hdfs://spark-nn.eemcs.utwente.nl/user/s1934538/clickstream/clickstream-enwiki-2020-03.tsv.gz,Atal_Bihari_Vajpayee,23741,47269,55,71065,20624
hdfs://spark-nn.eemcs.utwente.nl/user/s1934538/clickstream/clickstream-enwiki-2020-03.tsv.gz,Everything_Everywhere_All_at_Once,6782,1159,201,8142,2527
hdfs://spark-nn.eemcs.utwente.nl/user/s1934538/clickstream/clickstream-enwiki-2020-03.tsv.gz,Kim_Jong-un,102264,339673,1480,443417,247920
hdfs://spark-nn.eemcs.utwente.nl/user/s1934538/clickstream/clickstream-enwiki-2020-03.tsv.gz,Cameron_Boyce,39569,212074,872,252515,67959
hdfs://spark-nn.eemcs.utwente.nl/user/s1934538/clickstream/clickstream-enwiki-2020-03.tsv.gz,Sushma_Swaraj,7261,22980,19,30260,6876
hdfs://spark-nn.eemcs.utwente.nl/user/s1934538/clickstream/clickstream-enwiki-2020-03.tsv.gz,Aquaman_(film),40165,109798,1608,151571,87856
hdfs://spark-nn.eemcs.utwente.nl/user/s1934538/clickstream/clickstream-enwiki-2020-03.tsv.gz,2020_coronavirus_pandemic_in_Italy,1836698,4764798,22636,6624132,611076
hdfs://spark-nn.eemcs.utwente.nl/user/s1934538/clickstream/clickstream-enwiki-2020-03.tsv.gz,Avicii,18196,173073,1458,192727,53588
hdfs://spark-nn.eemcs.utwente.nl/user/s1934538/clickstream/clickstream-enwiki-2020-03.tsv.gz,2019–20_coronavirus_pandemic_by_country_and_territory,1033225,7051617,3919,8088761,2914116
hdfs://spark-nn.eemcs.utwente.nl/user/s1934538/clickstream/clickstream-enwiki-2020-03.tsv.gz,Deadpool_2,51622,83709,1294,136625,88986
hdfs://spark-nn.eemcs.utwente.nl/user/s1934538/clickstream/clickstream-enwiki-2020-03.tsv.gz,Game_of_Thrones_(season_8),15555,59036,945,75536,26921
hdfs://spark-nn.eemcs.utwente.nl/user/s1934538/clickstream/clickstream-enwiki-2020-03.tsv.gz,DMX_(rapper),15116,57560,487,73163,34321
hdfs://spark-nn.eemcs.utwente.nl/user/s1934538/clickstream/clickstream-enwiki-2020-03.tsv.gz,Antifa_(United_States),6478,50693,100,57271,10048
hdfs://spark-nn.eemcs.utwente.nl/user/s1934538/clickstream/clickstream-enwiki-2020-03.tsv.gz,Amber_Heard,105700,259048,3027,367775,176693
hdfs://spark-nn.eemcs.utwente.nl/user/s1934538/clickstream/clickstream-enwiki-2020-03.tsv.gz,Elizabeth_II,625224,1052233,4862,1682319,1281422
hdfs://spark-nn.eemcs.utwente.nl/user/s1934538/clickstream/clickstream-enwiki-2020-03.tsv.gz,Aaron_Hernandez,13707,430774,1757,446238,127064
hdfs://spark-nn.eemcs.utwente.nl/user/s1934538/clickstream/clickstream-enwiki-2020-03.tsv.gz,Puneeth_Rajkumar,11360,45180,158,56698,21681
hdfs://spark-nn.eemcs.utwente.nl/user/s1934538/clickstream/clickstream-enwiki-2020-03.tsv.gz,Hamas,13999,22544,119,36662,13602
hdfs://spark-nn.eemcs.utwente.nl/user/s1934538/clickstream/clickstream-enwiki-2020-03.tsv.gz,Kobe_Bryant,84857,728843,9380,823080,219656
hdfs://spark-nn.eemcs.utwente.nl/user/s1934538/clickstream/clickstream-enwiki-2020-03.tsv.gz,Tonya_Harding,32745,179448,617,212810,49312
hdfs://spark-nn.eemcs.utwente.nl/user/s1934538/clickstream/clickstream-enwiki-2020-03.tsv.gz,Sushant_Singh_Rajput,21448,64731,180,86359,44536
hdfs://spark-nn.eemcs.utwente.nl/user/s1934538/clickstream/clickstream-enwiki-2020-03.tsv.gz,Irrfan_Khan,35070,95738,187,130995,51310
hdfs://spark-nn.eemcs.utwente.nl/user/s1934538/clickstream/clickstream-enwiki-2020-03.tsv.gz,Manti_Te'o,3873,32821,127,36821,3995
hdfs://spark-nn.eemcs.utwente.nl/user/s1934538/clickstream/clickstream-enwiki-2020-03.tsv.gz,WrestleMania_34,75633,35557,799,111989,82143
hdfs://spark-nn.eemcs.utwente.nl/user/s1934538/clickstream/clickstream-enwiki-2020-03.tsv.gz,William_Murdoch,560,1901,13,2474,324
hdfs://spark-nn.eemcs.utwente.nl/user/s1934538/clickstream/clickstream-enwiki-2020-03.tsv.gz,Ray_Liotta,53697,70028,489,124214,43771
hdfs://spark-nn.eemcs.utwente.nl/user/s1934538/clickstream/clickstream-enwiki-2020-03.tsv.gz,Saaho,26557,95526,334,122417,35264
hdfs://spark-nn.eemcs.utwente.nl/user/s1934538/clickstream/clickstream-enwiki-2020-03.tsv.gz,Watts_family_murders,2602,122089,167,124858,30184
hdfs://spark-nn.eemcs.utwente.nl/user/s1934538/clickstream/clickstream-enwiki-2020-03.tsv.gz,Alexander_Hamilton,59122,194076,1481,254679,115345
hdfs://spark-nn.eemcs.utwente.nl/user/s1934538/clickstream/clickstream-enwiki-2020-03.tsv.gz,A_Star_Is_Born_(2018_film),36224,180387,755,217366,92311
hdfs://spark-nn.eemcs.utwente.nl/user/s1934538/clickstream/clickstream-enwiki-2020-03.tsv.gz,"Citizenship_(Amendment)_Act,_2019",13540,237040,9358,259938,31113
hdfs://spark-nn.eemcs.utwente.nl/user/s1934538/clickstream/clickstream-enwiki-2020-03.tsv.gz,Top_Gun:_Maverick,62663,75062,1894,139619,100893
hdfs://spark-nn.eemcs.utwente.nl/user/s1934538/clickstream/clickstream-enwiki-2020-03.tsv.gz,Ruth_Bader_Ginsburg,37159,244977,1362,283498,96508
hdfs://spark-nn.eemcs.utwente.nl/user/s1934538/clickstream/clickstream-enwiki-2020-03.tsv.gz,Stan_Lee,40393,125541,1044,166978,49014
hdfs://spark-nn.eemcs.utwente.nl/user/s1934538/clickstream/clickstream-enwiki-2020-03.tsv.gz,List_of_Marvel_Cinematic_Universe_films,116483,1020390,2097,1138970,424809
hdfs://spark-nn.eemcs.utwente.nl/user/s1934538/clickstream/clickstream-enwiki-2020-03.tsv.gz,Ghislaine_Maxwell,18920,46138,442,65500,29013
hdfs://spark-nn.eemcs.utwente.nl/user/s1934538/clickstream/clickstream-enwiki-2020-03.tsv.gz,2020_United_States_presidential_election,254658,829034,11532,1095224,551974
hdfs://spark-nn.eemcs.utwente.nl/user/s1934538/clickstream/clickstream-enwiki-2020-03.tsv.gz,Captain_Marvel_(film),50899,173291,2046,226236,125507
hdfs://spark-nn.eemcs.utwente.nl/user/s1934538/clickstream/clickstream-enwiki-2020-03.tsv.gz,Tom_Brady,92816,885730,14566,993112,317326
hdfs://spark-nn.eemcs.utwente.nl/user/s1934538/clickstream/clickstream-enwiki-2020-03.tsv.gz,Wikipedia,36352,694435,975,731762,266350
hdfs://spark-nn.eemcs.utwente.nl/user/s1934538/clickstream/clickstream-enwiki-2020-03.tsv.gz,Darth_Vader,43937,350714,1581,396232,88948
hdfs://spark-nn.eemcs.utwente.nl/user/s1934538/clickstream/clickstream-enwiki-2020-03.tsv.gz,Aretha_Franklin,22986,107812,1939,132737,49861
hdfs://spark-nn.eemcs.utwente.nl/user/s1934538/clickstream/clickstream-enwiki-2020-03.tsv.gz,George_H._W._Bush,180889,146053,907,327849,193877
hdfs://spark-nn.eemcs.utwente.nl/user/s1934538/clickstream/clickstream-enwiki-2020-03.tsv.gz,The_Witcher_(TV_series),53275,498257,7338,558870,358615
hdfs://spark-nn.eemcs.utwente.nl/user/s1934538/clickstream/clickstream-enwiki-2020-03.tsv.gz,Black_Panther_(film),58355,176106,2925,237386,152799
hdfs://spark-nn.eemcs.utwente.nl/user/s1934538/clickstream/clickstream-enwiki-2020-03.tsv.gz,Pelé,27967,154659,1445,184071,56328
hdfs://spark-nn.eemcs.utwente.nl/user/s1934538/clickstream/clickstream-enwiki-2020-03.tsv.gz,Rishi_Sunak,63827,806836,3705,874368,391553
hdfs://spark-nn.eemcs.utwente.nl/user/s1934538/clickstream/clickstream-enwiki-2020-03.tsv.gz,Croatia,41139,131985,1829,174953,58752
hdfs://spark-nn.eemcs.utwente.nl/user/s1934538/clickstream/clickstream-enwiki-2020-03.tsv.gz,2020_Summer_Olympics,148879,474370,5089,628338,377983
hdfs://spark-nn.eemcs.utwente.nl/user/s1934538/clickstream/clickstream-enwiki-2020-03.tsv.gz,Cook's_Country,273,2609,16,2898,592
hdfs://spark-nn.eemcs.utwente.nl/user/s1934538/clickstream/clickstream-enwiki-2020-03.tsv.gz,United_States_Senate,89501,132662455,1468,132753424,80573
hdfs://spark-nn.eemcs.utwente.nl/user/s1934538/clickstream/clickstream-enwiki-2020-03.tsv.gz,Eddie_Van_Halen,31009,41528,487,73024,33484
hdfs://spark-nn.eemcs.utwente.nl/user/s1934538/clickstream/clickstream-enwiki-2020-03.tsv.gz,Sinéad_O'Connor,11688,96302,1201,109191,29821
hdfs://spark-nn.eemcs.utwente.nl/user/s1934538/clickstream/clickstream-enwiki-2020-03.tsv.gz,Chernobyl_(miniseries),25556,186290,3005,214851,178436
hdfs://spark-nn.eemcs.utwente.nl/user/s1934538/clickstream/clickstream-enwiki-2020-03.tsv.gz,The_Haunting_of_Bly_Manor,42443,22784,49,65276,46583
hdfs://spark-nn.eemcs.utwente.nl/user/s1934538/clickstream/clickstream-enwiki-2020-03.tsv.gz,UEFA_Euro_2020,65492,316761,9092,391345,140926
hdfs://spark-nn.eemcs.utwente.nl/user/s1934538/clickstream/clickstream-enwiki-2020-03.tsv.gz,FIFA_World_Cup,34452,140007,1794,176253,127491
hdfs://spark-nn.eemcs.utwente.nl/user/s1934538/clickstream/clickstream-enwiki-2020-03.tsv.gz,Qasem_Soleimani,15600,49697,332,65629,26254
hdfs://spark-nn.eemcs.utwente.nl/user/s1934538/clickstream/clickstream-enwiki-2020-03.tsv.gz,Lists_of_deaths_by_year,7253,333208,562,341023,326554
hdfs://spark-nn.eemcs.utwente.nl/user/s1934538/clickstream/clickstream-enwiki-2020-03.tsv.gz,Sidharth_Shukla,20551,99780,525,120856,28491
hdfs://spark-nn.eemcs.utwente.nl/user/s1934538/clickstream/clickstream-enwiki-2020-03.tsv.gz,The_Mandalorian,84252,531122,14069,629443,413593
hdfs://spark-nn.eemcs.utwente.nl/user/s1934538/clickstream/clickstream-enwiki-2020-03.tsv.gz,"Princess_Margaret,_Countess_of_Snowdon",169510,587685,3657,760852,446311
hdfs://spark-nn.eemcs.utwente.nl/user/s1934538/clickstream/clickstream-enwiki-2020-03.tsv.gz,List_of_highest-grossing_films,137916,333694,1853,473463,213302
hdfs://spark-nn.eemcs.utwente.nl/user/s1934538/clickstream/clickstream-enwiki-2020-03.tsv.gz,2020_coronavirus_pandemic_in_India,581514,6607929,3329,7192772,862422
hdfs://spark-nn.eemcs.utwente.nl/user/s1934538/clickstream/clickstream-enwiki-2020-03.tsv.gz,Area_51,12884,191580,1740,206204,35164
hdfs://spark-nn.eemcs.utwente.nl/user/s1934538/clickstream/clickstream-enwiki-2020-03.tsv.gz,Khabib_Nurmagomedov,115607,343904,3195,462706,247586
hdfs://spark-nn.eemcs.utwente.nl/user/s1934538/clickstream/clickstream-enwiki-2020-03.tsv.gz,The_Suicide_Squad_(film),133763,73082,1137,207982,179591
hdfs://spark-nn.eemcs.utwente.nl/user/s1934538/clickstream/clickstream-enwiki-2020-05.tsv.gz,Ukraine,54761,143648,3221,201630,98108
hdfs://spark-nn.eemcs.utwente.nl/user/s1934538/clickstream/clickstream-enwiki-2020-05.tsv.gz,List_of_highest-grossing_films,170273,491981,1780,664034,285055
hdfs://spark-nn.eemcs.utwente.nl/user/s1934538/clickstream/clickstream-enwiki-2020-05.tsv.gz,Rami_Malek,79470,174571,906,254947,101957
hdfs://spark-nn.eemcs.utwente.nl/user/s1934538/clickstream/clickstream-enwiki-2020-05.tsv.gz,Hamilton_(musical),38759,225970,1788,266517,148598
hdfs://spark-nn.eemcs.utwente.nl/user/s1934538/clickstream/clickstream-enwiki-2020-05.tsv.gz,Deion_Sanders,13876,121176,754,135806,36715
hdfs://spark-nn.eemcs.utwente.nl/user/s1934538/clickstream/clickstream-enwiki-2020-05.tsv.gz,Death_of_Elisa_Lam,9444,98218,793,108455,29416
hdfs://spark-nn.eemcs.utwente.nl/user/s1934538/clickstream/clickstream-enwiki-2020-05.tsv.gz,Sushant_Singh_Rajput,25982,78526,843,105351,58120
hdfs://spark-nn.eemcs.utwente.nl/user/s1934538/clickstream/clickstream-enwiki-2020-05.tsv.gz,Mulan_(2020_film),48606,231407,3675,283688,123792
hdfs://spark-nn.eemcs.utwente.nl/user/s1934538/clickstream/clickstream-enwiki-2020-05.tsv.gz,Salman_Rushdie,43675,74587,442,118704,50215
hdfs://spark-nn.eemcs.utwente.nl/user/s1934538/clickstream/clickstream-enwiki-2020-05.tsv.gz,Manti_Te'o,4651,27712,234,32597,4340
hdfs://spark-nn.eemcs.utwente.nl/user/s1934538/clickstream/clickstream-enwiki-2020-05.tsv.gz,Gaza_Strip,28238,86569,347,115154,41477
hdfs://spark-nn.eemcs.utwente.nl/user/s1934538/clickstream/clickstream-enwiki-2020-05.tsv.gz,The_Haunting_of_Bly_Manor,35374,26293,85,61752,45554
hdfs://spark-nn.eemcs.utwente.nl/user/s1934538/clickstream/clickstream-enwiki-2020-05.tsv.gz,Puneeth_Rajkumar,21011,46198,40,67249,31778
hdfs://spark-nn.eemcs.utwente.nl/user/s1934538/clickstream/clickstream-enwiki-2020-05.tsv.gz,NATO,58314,137887,1863,198064,72435
hdfs://spark-nn.eemcs.utwente.nl/user/s1934538/clickstream/clickstream-enwiki-2020-05.tsv.gz,The_Suicide_Squad_(film),132038,59575,781,192394,168827
hdfs://spark-nn.eemcs.utwente.nl/user/s1934538/clickstream/clickstream-enwiki-2020-05.tsv.gz,The_Queen's_Gambit_(miniseries),2415,854,44,3313,648
hdfs://spark-nn.eemcs.utwente.nl/user/s1934538/clickstream/clickstream-enwiki-2020-05.tsv.gz,COVID-19_pandemic_by_country_and_territory,372138,1949103,825,2322066,1131866
hdfs://spark-nn.eemcs.utwente.nl/user/s1934538/clickstream/clickstream-enwiki-2020-05.tsv.gz,Bonnie_and_Clyde,40293,366140,13282,419715,104709
hdfs://spark-nn.eemcs.utwente.nl/user/s1934538/clickstream/clickstream-enwiki-2020-05.tsv.gz,Chernobyl_(miniseries),24978,173851,2796,201625,174541
hdfs://spark-nn.eemcs.utwente.nl/user/s1934538/clickstream/clickstream-enwiki-2020-05.tsv.gz,Cristiano_Ronaldo,100779,634409,4140,739328,179345
hdfs://spark-nn.eemcs.utwente.nl/user/s1934538/clickstream/clickstream-enwiki-2020-05.tsv.gz,2023_Cricket_World_Cup,8667,12742,35,21444,7133
hdfs://spark-nn.eemcs.utwente.nl/user/s1934538/clickstream/clickstream-enwiki-2020-05.tsv.gz,Cook's_Country,437,3352,33,3822,794
hdfs://spark-nn.eemcs.utwente.nl/user/s1934538/clickstream/clickstream-enwiki-2020-05.tsv.gz,Vladimir_Putin,93951,258582,2984,355517,213561
hdfs://spark-nn.eemcs.utwente.nl/user/s1934538/clickstream/clickstream-enwiki-2020-05.tsv.gz,List_of_most_popular_websites,17660,325968,125,343753,49432
hdfs://spark-nn.eemcs.utwente.nl/user/s1934538/clickstream/clickstream-enwiki-2020-05.tsv.gz,The_Irishman,74795,233004,3224,311023,250160
hdfs://spark-nn.eemcs.utwente.nl/user/s1934538/clickstream/clickstream-enwiki-2020-05.tsv.gz,Joe_Biden,155455,704565,12058,872078,311758
hdfs://spark-nn.eemcs.utwente.nl/user/s1934538/clickstream/clickstream-enwiki-2020-05.tsv.gz,Meat_Loaf,27351,84905,732,112988,39806
hdfs://spark-nn.eemcs.utwente.nl/user/s1934538/clickstream/clickstream-enwiki-2020-05.tsv.gz,Cricket_World_Cup,8155,59374,282,67811,35426
hdfs://spark-nn.eemcs.utwente.nl/user/s1934538/clickstream/clickstream-enwiki-2020-05.tsv.gz,Stranger_Things_(season_4),32398,156060,731,189189,108516
hdfs://spark-nn.eemcs.utwente.nl/user/s1934538/clickstream/clickstream-enwiki-2020-05.tsv.gz,Deaths_in_2020,1602515,2507506,14163,4124184,2498820
hdfs://spark-nn.eemcs.utwente.nl/user/s1934538/clickstream/clickstream-enwiki-2020-05.tsv.gz,2022_FIFA_World_Cup,50579,75026,1040,126645,69320
hdfs://spark-nn.eemcs.utwente.nl/user/s1934538/clickstream/clickstream-enwiki-2020-05.tsv.gz,Mortal_Kombat_(2021_film),37502,62462,177,100141,162996
hdfs://spark-nn.eemcs.utwente.nl/user/s1934538/clickstream/clickstream-enwiki-2020-05.tsv.gz,Atal_Bihari_Vajpayee,32897,60344,475,93716,31261
hdfs://spark-nn.eemcs.utwente.nl/user/s1934538/clickstream/clickstream-enwiki-2020-05.tsv.gz,Cleopatra,65274,409949,2834,478057,154274
hdfs://spark-nn.eemcs.utwente.nl/user/s1934538/clickstream/clickstream-enwiki-2020-05.tsv.gz,Donald_Trump,379574,1242181,16347,1638102,1181188
hdfs://spark-nn.eemcs.utwente.nl/user/s1934538/clickstream/clickstream-enwiki-2020-05.tsv.gz,Main_Page,33780,367129353,4979662,372142795,36621598
hdfs://spark-nn.eemcs.utwente.nl/user/s1934538/clickstream/clickstream-enwiki-2020-05.tsv.gz,Once_Upon_a_Time_in_Hollywood,166318,678066,8643,853027,932998
hdfs://spark-nn.eemcs.utwente.nl/user/s1934538/clickstream/clickstream-enwiki-2020-05.tsv.gz,Henry_V_of_England,110253,152203,695,263151,189072
hdfs://spark-nn.eemcs.utwente.nl/user/s1934538/clickstream/clickstream-enwiki-2020-05.tsv.gz,John_McCain,46515,106060,1073,153648,73998
hdfs://spark-nn.eemcs.utwente.nl/user/s1934538/clickstream/clickstream-enwiki-2020-05.tsv.gz,Black_Panther_(film),68983,191601,2793,263377,156398
hdfs://spark-nn.eemcs.utwente.nl/user/s1934538/clickstream/clickstream-enwiki-2020-05.tsv.gz,Google_logo,1498,39195,13,40706,1422
hdfs://spark-nn.eemcs.utwente.nl/user/s1934538/clickstream/clickstream-enwiki-2020-05.tsv.gz,Croatia,47814,127413,1790,177017,71338
hdfs://spark-nn.eemcs.utwente.nl/user/s1934538/clickstream/clickstream-enwiki-2020-05.tsv.gz,R._Kelly,46037,259294,2720,308051,126267
hdfs://spark-nn.eemcs.utwente.nl/user/s1934538/clickstream/clickstream-enwiki-2020-05.tsv.gz,Kim_Jong-un,147686,895999,8768,1052453,442971
hdfs://spark-nn.eemcs.utwente.nl/user/s1934538/clickstream/clickstream-enwiki-2020-05.tsv.gz,United_States_Senate,74151,125591,779,200521,69139
hdfs://spark-nn.eemcs.utwente.nl/user/s1934538/clickstream/clickstream-enwiki-2020-05.tsv.gz,Michael_Jordan,754342,6556576,45955,7356873,3124807
hdfs://spark-nn.eemcs.utwente.nl/user/s1934538/clickstream/clickstream-enwiki-2020-05.tsv.gz,Grimes_(musician),1104329,2268947,7535,3380811,976175
hdfs://spark-nn.eemcs.utwente.nl/user/s1934538/clickstream/clickstream-enwiki-2020-05.tsv.gz,Joaquin_Phoenix,197197,445976,1898,645071,418980
hdfs://spark-nn.eemcs.utwente.nl/user/s1934538/clickstream/clickstream-enwiki-2020-05.tsv.gz,Lists_of_deaths_by_year,6016,293408,247,299671,265573
hdfs://spark-nn.eemcs.utwente.nl/user/s1934538/clickstream/clickstream-enwiki-2020-05.tsv.gz,Jenna_Ortega,17339,25927,2081,45347,8341
hdfs://spark-nn.eemcs.utwente.nl/user/s1934538/clickstream/clickstream-enwiki-2020-05.tsv.gz,K.G.F:_Chapter_2,31961,91700,82,123743,54330
hdfs://spark-nn.eemcs.utwente.nl/user/s1934538/clickstream/clickstream-enwiki-2020-05.tsv.gz,Dark_Phoenix_(film),69882,168488,1374,239744,125967
hdfs://spark-nn.eemcs.utwente.nl/user/s1934538/clickstream/clickstream-enwiki-2020-05.tsv.gz,21_Savage,18671,76785,1347,96803,34002
hdfs://spark-nn.eemcs.utwente.nl/user/s1934538/clickstream/clickstream-enwiki-2020-05.tsv.gz,Qasem_Soleimani,15753,36320,237,52310,25996
hdfs://spark-nn.eemcs.utwente.nl/user/s1934538/clickstream/clickstream-enwiki-2020-05.tsv.gz,Elizabeth_II,547727,835770,4592,1388089,1030040
hdfs://spark-nn.eemcs.utwente.nl/user/s1934538/clickstream/clickstream-enwiki-2020-05.tsv.gz,UEFA_Euro_2020,35979,109648,1947,147574,70527
hdfs://spark-nn.eemcs.utwente.nl/user/s1934538/clickstream/clickstream-enwiki-2020-05.tsv.gz,Mötley_Crüe,35827,121208,1572,158607,188684
hdfs://spark-nn.eemcs.utwente.nl/user/s1934538/clickstream/clickstream-enwiki-2020-05.tsv.gz,Johnny_Depp,172147,473904,3110,649161,480737
hdfs://spark-nn.eemcs.utwente.nl/user/s1934538/clickstream/clickstream-enwiki-2020-05.tsv.gz,Indian_Premier_League,12817,60584,93,73494,47716
hdfs://spark-nn.eemcs.utwente.nl/user/s1934538/clickstream/clickstream-enwiki-2020-05.tsv.gz,Juice_Wrld,37628,360571,4838,403037,143428
hdfs://spark-nn.eemcs.utwente.nl/user/s1934538/clickstream/clickstream-enwiki-2020-05.tsv.gz,William_Murdoch,754,1964,27,2745,459
hdfs://spark-nn.eemcs.utwente.nl/user/s1934538/clickstream/clickstream-enwiki-2020-05.tsv.gz,Article_370_of_the_Constitution_of_India,5018,60177,55,65250,5850
hdfs://spark-nn.eemcs.utwente.nl/user/s1934538/clickstream/clickstream-enwiki-2020-05.tsv.gz,Game_of_Thrones_(season_8),25637,100732,1324,127693,47123
hdfs://spark-nn.eemcs.utwente.nl/user/s1934538/clickstream/clickstream-enwiki-2020-05.tsv.gz,Keanu_Reeves,119679,563903,3321,686903,400067
hdfs://spark-nn.eemcs.utwente.nl/user/s1934538/clickstream/clickstream-enwiki-2020-05.tsv.gz,Khabib_Nurmagomedov,118577,331307,3195,453079,245372
hdfs://spark-nn.eemcs.utwente.nl/user/s1934538/clickstream/clickstream-enwiki-2020-05.tsv.gz,Kelly_Preston,91355,56210,202,147767,42010
hdfs://spark-nn.eemcs.utwente.nl/user/s1934538/clickstream/clickstream-enwiki-2020-05.tsv.gz,Greta_Thunberg,14314,251004,1809,267127,61440
hdfs://spark-nn.eemcs.utwente.nl/user/s1934538/clickstream/clickstream-enwiki-2020-05.tsv.gz,Jason_Momoa,118871,371394,1754,492019,232175
hdfs://spark-nn.eemcs.utwente.nl/user/s1934538/clickstream/clickstream-enwiki-2020-05.tsv.gz,XXX:_Return_of_Xander_Cage,39892,159034,886,199812,55926
hdfs://spark-nn.eemcs.utwente.nl/user/s1934538/clickstream/clickstream-enwiki-2020-05.tsv.gz,Elon_Musk,650707,6105929,41989,6798625,4607823
hdfs://spark-nn.eemcs.utwente.nl/user/s1934538/clickstream/clickstream-enwiki-2020-05.tsv.gz,Richard_Ramirez,18993,147212,996,167201,55416
hdfs://spark-nn.eemcs.utwente.nl/user/s1934538/clickstream/clickstream-enwiki-2020-05.tsv.gz,Irrfan_Khan,152212,1007546,7399,1167157,479327
hdfs://spark-nn.eemcs.utwente.nl/user/s1934538/clickstream/clickstream-enwiki-2020-05.tsv.gz,Luke_Perry,80862,371981,1026,453869,123856
hdfs://spark-nn.eemcs.utwente.nl/user/s1934538/clickstream/clickstream-enwiki-2020-05.tsv.gz,Media,137,4086,300,4523,1939
hdfs://spark-nn.eemcs.utwente.nl/user/s1934538/clickstream/clickstream-enwiki-2020-05.tsv.gz,Priyanka_Chopra,181545,389359,32542,603446,128125
hdfs://spark-nn.eemcs.utwente.nl/user/s1934538/clickstream/clickstream-enwiki-2020-05.tsv.gz,Jeffrey_Epstein,99364,2021374,8852,2129590,781700
hdfs://spark-nn.eemcs.utwente.nl/user/s1934538/clickstream/clickstream-enwiki-2020-05.tsv.gz,Rishi_Sunak,24501,191151,1193,216845,96417
hdfs://spark-nn.eemcs.utwente.nl/user/s1934538/clickstream/clickstream-enwiki-2020-05.tsv.gz,Venom_(2018_film),32381,181169,1837,215387,100038
hdfs://spark-nn.eemcs.utwente.nl/user/s1934538/clickstream/clickstream-enwiki-2020-05.tsv.gz,Tasuku_Honjo,4195,4245190,591,4249976,130011
hdfs://spark-nn.eemcs.utwente.nl/user/s1934538/clickstream/clickstream-enwiki-2020-05.tsv.gz,Aaron_Carter,22324,66074,424,88822,30590
hdfs://spark-nn.eemcs.utwente.nl/user/s1934538/clickstream/clickstream-enwiki-2020-05.tsv.gz,List_of_FIFA_World_Cup_finals,4474,97216,187,101877,45996
hdfs://spark-nn.eemcs.utwente.nl/user/s1934538/clickstream/clickstream-enwiki-2020-05.tsv.gz,Spanish_flu,107829,1865549,18226,1991604,368314
hdfs://spark-nn.eemcs.utwente.nl/user/s1934538/clickstream/clickstream-enwiki-2020-05.tsv.gz,Amy_Coney_Barrett,1687,5790,30,7507,1682
hdfs://spark-nn.eemcs.utwente.nl/user/s1934538/clickstream/clickstream-enwiki-2020-05.tsv.gz,Valentine's_Day,4880,29232,243,34355,3292
hdfs://spark-nn.eemcs.utwente.nl/user/s1934538/clickstream/clickstream-enwiki-2020-05.tsv.gz,List_of_Marvel_Cinematic_Universe_films,117046,1505793,2868,1625707,558840
hdfs://spark-nn.eemcs.utwente.nl/user/s1934538/clickstream/clickstream-enwiki-2020-05.tsv.gz,Anna_Sorokin,14335,35162,928,50425,11504
hdfs://spark-nn.eemcs.utwente.nl/user/s1934538/clickstream/clickstream-enwiki-2020-05.tsv.gz,Shakira,25905,233973,5310,265188,123185
hdfs://spark-nn.eemcs.utwente.nl/user/s1934538/clickstream/clickstream-enwiki-2020-05.tsv.gz,J._Robert_Oppenheimer,25387,104101,324,129812,41926
hdfs://spark-nn.eemcs.utwente.nl/user/s1934538/clickstream/clickstream-enwiki-2020-05.tsv.gz,1917_(2019_film),55548,474755,5908,536211,250731
hdfs://spark-nn.eemcs.utwente.nl/user/s1934538/clickstream/clickstream-enwiki-2020-05.tsv.gz,Eddie_Van_Halen,40012,55328,530,95870,43020
hdfs://spark-nn.eemcs.utwente.nl/user/s1934538/clickstream/clickstream-enwiki-2020-05.tsv.gz,Israel,106614,362364,5904,474882,227720
hdfs://spark-nn.eemcs.utwente.nl/user/s1934538/clickstream/clickstream-enwiki-2020-05.tsv.gz,Simone_Biles,14376,75766,348,90490,26032
hdfs://spark-nn.eemcs.utwente.nl/user/s1934538/clickstream/clickstream-enwiki-2020-05.tsv.gz,Watts_family_murders,3293,161557,413,165263,50161
hdfs://spark-nn.eemcs.utwente.nl/user/s1934538/clickstream/clickstream-enwiki-2020-05.tsv.gz,Sylvester_Stallone,97670,376313,2833,476816,343991
hdfs://spark-nn.eemcs.utwente.nl/user/s1934538/clickstream/clickstream-enwiki-2020-05.tsv.gz,Kate_Spade,63549,67730,340,131619,45836
hdfs://spark-nn.eemcs.utwente.nl/user/s1934538/clickstream/clickstream-enwiki-2020-05.tsv.gz,Parasite_(2019_film),83049,756056,5828,844933,318874
hdfs://spark-nn.eemcs.utwente.nl/user/s1934538/clickstream/clickstream-enwiki-2020-05.tsv.gz,George_VI,466688,287388,1151,755227,525050
hdfs://spark-nn.eemcs.utwente.nl/user/s1934538/clickstream/clickstream-enwiki-2020-05.tsv.gz,Nipsey_Hussle,38541,177415,1176,217132,67504
hdfs://spark-nn.eemcs.utwente.nl/user/s1934538/clickstream/clickstream-enwiki-2020-05.tsv.gz,Rihanna,85001,311082,4646,400729,195519
hdfs://spark-nn.eemcs.utwente.nl/user/s1934538/clickstream/clickstream-enwiki-2020-05.tsv.gz,Tom_Brady,74883,305959,2980,383822,136120
hdfs://spark-nn.eemcs.utwente.nl/user/s1934538/clickstream/clickstream-enwiki-2020-05.tsv.gz,Michael_Bloomberg,48596,70795,457,119848,51665
hdfs://spark-nn.eemcs.utwente.nl/user/s1934538/clickstream/clickstream-enwiki-2020-05.tsv.gz,Betty_White,95135,408066,5796,508997,134406
hdfs://spark-nn.eemcs.utwente.nl/user/s1934538/clickstream/clickstream-enwiki-2020-05.tsv.gz,Microsoft_Office,9966,3242140,728,3252834,24766
hdfs://spark-nn.eemcs.utwente.nl/user/s1934538/clickstream/clickstream-enwiki-2020-05.tsv.gz,The_Weeknd,96423,330952,4308,431683,183141
hdfs://spark-nn.eemcs.utwente.nl/user/s1934538/clickstream/clickstream-enwiki-2020-05.tsv.gz,Sidharth_Shukla,13047,49844,332,63223,14980
hdfs://spark-nn.eemcs.utwente.nl/user/s1934538/clickstream/clickstream-enwiki-2020-05.tsv.gz,Donald_Glover,122808,508342,5309,636459,256873
hdfs://spark-nn.eemcs.utwente.nl/user/s1934538/clickstream/clickstream-enwiki-2020-05.tsv.gz,Amber_Heard,253859,315006,3934,572799,237629
hdfs://spark-nn.eemcs.utwente.nl/user/s1934538/clickstream/clickstream-enwiki-2020-05.tsv.gz,Chadwick_Boseman,44172,79963,811,124946,41442
hdfs://spark-nn.eemcs.utwente.nl/user/s1934538/clickstream/clickstream-enwiki-2020-05.tsv.gz,Top_Gun:_Maverick,79380,109110,1782,190272,125780
hdfs://spark-nn.eemcs.utwente.nl/user/s1934538/clickstream/clickstream-enwiki-2020-05.tsv.gz,Tenet_(film),153428,577070,8128,738626,469102
hdfs://spark-nn.eemcs.utwente.nl/user/s1934538/clickstream/clickstream-enwiki-2020-06.tsv.gz,Juice_Wrld,32017,311305,3595,346917,119551
hdfs://spark-nn.eemcs.utwente.nl/user/s1934538/clickstream/clickstream-enwiki-2020-06.tsv.gz,Dark_Phoenix_(film),61505,139018,1044,201567,104942
hdfs://spark-nn.eemcs.utwente.nl/user/s1934538/clickstream/clickstream-enwiki-2020-06.tsv.gz,2.0_(film),23122,47697,70,70889,19912
hdfs://spark-nn.eemcs.utwente.nl/user/s1934538/clickstream/clickstream-enwiki-2020-06.tsv.gz,Avicii,21922,225159,1655,248736,69226
hdfs://spark-nn.eemcs.utwente.nl/user/s1934538/clickstream/clickstream-enwiki-2020-06.tsv.gz,Sushant_Singh_Rajput,563273,12203918,49653,12816844,4907337
hdfs://spark-nn.eemcs.utwente.nl/user/s1934538/clickstream/clickstream-enwiki-2020-06.tsv.gz,Stan_Lee,50491,127784,1051,179326,55672
hdfs://spark-nn.eemcs.utwente.nl/user/s1934538/clickstream/clickstream-enwiki-2020-06.tsv.gz,Bird_Box_(film),20797,85536,780,107113,33101
hdfs://spark-nn.eemcs.utwente.nl/user/s1934538/clickstream/clickstream-enwiki-2020-06.tsv.gz,Mac_Miller,37862,188631,1609,228102,75168
hdfs://spark-nn.eemcs.utwente.nl/user/s1934538/clickstream/clickstream-enwiki-2020-06.tsv.gz,Elon_Musk,177959,1845730,11824,2035513,1253236
hdfs://spark-nn.eemcs.utwente.nl/user/s1934538/clickstream/clickstream-enwiki-2020-06.tsv.gz,Shang-Chi_and_the_Legend_of_the_Ten_Rings,76398,23763,103,100264,65976
hdfs://spark-nn.eemcs.utwente.nl/user/s1934538/clickstream/clickstream-enwiki-2020-06.tsv.gz,2016_United_States_presidential_election,259187,535989,6379,801555,593485
hdfs://spark-nn.eemcs.utwente.nl/user/s1934538/clickstream/clickstream-enwiki-2020-06.tsv.gz,United_States_Senate,94267,89645,1379,185291,85255
hdfs://spark-nn.eemcs.utwente.nl/user/s1934538/clickstream/clickstream-enwiki-2020-06.tsv.gz,Betty_White,76670,238226,2769,317665,91054
hdfs://spark-nn.eemcs.utwente.nl/user/s1934538/clickstream/clickstream-enwiki-2020-06.tsv.gz,Simone_Biles,30837,121673,597,153107,46113
hdfs://spark-nn.eemcs.utwente.nl/user/s1934538/clickstream/clickstream-enwiki-2020-06.tsv.gz,2018_FIFA_World_Cup,95632,193050,2436,291118,158167
hdfs://spark-nn.eemcs.utwente.nl/user/s1934538/clickstream/clickstream-enwiki-2020-06.tsv.gz,Manti_Te'o,2609,14983,126,17718,2153
hdfs://spark-nn.eemcs.utwente.nl/user/s1934538/clickstream/clickstream-enwiki-2020-06.tsv.gz,Joe_Biden,216257,943797,13133,1173187,435695
hdfs://spark-nn.eemcs.utwente.nl/user/s1934538/clickstream/clickstream-enwiki-2020-06.tsv.gz,WrestleMania_34,24728,13642,169,38539,25988
hdfs://spark-nn.eemcs.utwente.nl/user/s1934538/clickstream/clickstream-enwiki-2020-06.tsv.gz,2023_Cricket_World_Cup,7997,12150,46,20193,6672
hdfs://spark-nn.eemcs.utwente.nl/user/s1934538/clickstream/clickstream-enwiki-2020-06.tsv.gz,Once_Upon_a_Time_in_Hollywood,119033,344204,5041,468278,502411
hdfs://spark-nn.eemcs.utwente.nl/user/s1934538/clickstream/clickstream-enwiki-2020-06.tsv.gz,Donald_Trump,533577,1869577,25570,2428724,1713572
hdfs://spark-nn.eemcs.utwente.nl/user/s1934538/clickstream/clickstream-enwiki-2020-06.tsv.gz,Hamas,20837,29385,636,50858,21111
hdfs://spark-nn.eemcs.utwente.nl/user/s1934538/clickstream/clickstream-enwiki-2020-06.tsv.gz,Cristiano_Ronaldo,106187,663523,4571,774281,185009
hdfs://spark-nn.eemcs.utwente.nl/user/s1934538/clickstream/clickstream-enwiki-2020-06.tsv.gz,Luke_Perry,51228,198165,719,250112,74150
hdfs://spark-nn.eemcs.utwente.nl/user/s1934538/clickstream/clickstream-enwiki-2020-06.tsv.gz,Deadpool_2,44403,71476,937,116816,70202
hdfs://spark-nn.eemcs.utwente.nl/user/s1934538/clickstream/clickstream-enwiki-2020-06.tsv.gz,Ruth_Bader_Ginsburg,61899,168149,973,231021,81871
hdfs://spark-nn.eemcs.utwente.nl/user/s1934538/clickstream/clickstream-enwiki-2020-06.tsv.gz,Roe_v._Wade,20749,100108,646,121503,42830
hdfs://spark-nn.eemcs.utwente.nl/user/s1934538/clickstream/clickstream-enwiki-2020-06.tsv.gz,The_Lion_King_(2019_film),48441,141834,910,191185,89130
hdfs://spark-nn.eemcs.utwente.nl/user/s1934538/clickstream/clickstream-enwiki-2020-06.tsv.gz,Donald_Glover,86801,380053,2727,469581,194651
hdfs://spark-nn.eemcs.utwente.nl/user/s1934538/clickstream/clickstream-enwiki-2020-06.tsv.gz,Joaquin_Phoenix,158968,315447,1021,475436,246531
hdfs://spark-nn.eemcs.utwente.nl/user/s1934538/clickstream/clickstream-enwiki-2020-06.tsv.gz,Sinéad_O'Connor,12833,75809,534,89176,23945
hdfs://spark-nn.eemcs.utwente.nl/user/s1934538/clickstream/clickstream-enwiki-2020-06.tsv.gz,Fantastic_Beasts:_The_Crimes_of_Grindelwald,68569,97141,1108,166818,88626
hdfs://spark-nn.eemcs.utwente.nl/user/s1934538/clickstream/clickstream-enwiki-2020-06.tsv.gz,The_Umbrella_Academy_(TV_series),33206,198695,3502,235403,141731
hdfs://spark-nn.eemcs.utwente.nl/user/s1934538/clickstream/clickstream-enwiki-2020-06.tsv.gz,COVID-19_pandemic_by_country_and_territory,239816,1032567,940,1273323,737545
hdfs://spark-nn.eemcs.utwente.nl/user/s1934538/clickstream/clickstream-enwiki-2020-06.tsv.gz,RRR_(film),44456,44144,176,88776,46625
hdfs://spark-nn.eemcs.utwente.nl/user/s1934538/clickstream/clickstream-enwiki-2020-06.tsv.gz,List_of_most_popular_websites,15321,80574,79,95974,38474
hdfs://spark-nn.eemcs.utwente.nl/user/s1934538/clickstream/clickstream-enwiki-2020-06.tsv.gz,Charles_Sobhraj,3654,17858,46,21558,5027
hdfs://spark-nn.eemcs.utwente.nl/user/s1934538/clickstream/clickstream-enwiki-2020-06.tsv.gz,Watts_family_murders,3285,136569,157,140011,39714
hdfs://spark-nn.eemcs.utwente.nl/user/s1934538/clickstream/clickstream-enwiki-2020-06.tsv.gz,Lists_of_deaths_by_year,4673,209320,367,214360,203996
hdfs://spark-nn.eemcs.utwente.nl/user/s1934538/clickstream/clickstream-enwiki-2020-06.tsv.gz,Queen_(band),66432,259811,2992,329235,314605
hdfs://spark-nn.eemcs.utwente.nl/user/s1934538/clickstream/clickstream-enwiki-2020-06.tsv.gz,When_They_See_Us,52934,302246,2096,357276,245160
hdfs://spark-nn.eemcs.utwente.nl/user/s1934538/clickstream/clickstream-enwiki-2020-06.tsv.gz,Adele,25649,256704,2734,285087,82726
hdfs://spark-nn.eemcs.utwente.nl/user/s1934538/clickstream/clickstream-enwiki-2020-06.tsv.gz,Valentine's_Day,3829,24901,184,28914,3158
hdfs://spark-nn.eemcs.utwente.nl/user/s1934538/clickstream/clickstream-enwiki-2020-06.tsv.gz,Croatia,40522,108879,1519,150920,58056
hdfs://spark-nn.eemcs.utwente.nl/user/s1934538/clickstream/clickstream-enwiki-2020-06.tsv.gz,Critical_race_theory,8607,73858,343,82808,25908
hdfs://spark-nn.eemcs.utwente.nl/user/s1934538/clickstream/clickstream-enwiki-2020-06.tsv.gz,Wonder_Woman_1984,70812,126637,4611,202060,107106
hdfs://spark-nn.eemcs.utwente.nl/user/s1934538/clickstream/clickstream-enwiki-2020-06.tsv.gz,Aaron_Hernandez,7952,127444,576,135972,42308
hdfs://spark-nn.eemcs.utwente.nl/user/s1934538/clickstream/clickstream-enwiki-2020-06.tsv.gz,Hamilton_(musical),50838,395953,3583,450374,254783
hdfs://spark-nn.eemcs.utwente.nl/user/s1934538/clickstream/clickstream-enwiki-2020-06.tsv.gz,Bob_Saget,26071,48164,387,74622,14805
hdfs://spark-nn.eemcs.utwente.nl/user/s1934538/clickstream/clickstream-enwiki-2020-06.tsv.gz,Priyanka_Chopra,119446,286608,1062,407116,159785
hdfs://spark-nn.eemcs.utwente.nl/user/s1934538/clickstream/clickstream-enwiki-2020-06.tsv.gz,Meat_Loaf,24325,102743,1034,128102,42770
hdfs://spark-nn.eemcs.utwente.nl/user/s1934538/clickstream/clickstream-enwiki-2020-06.tsv.gz,Salman_Rushdie,81096,83130,565,164791,52175
hdfs://spark-nn.eemcs.utwente.nl/user/s1934538/clickstream/clickstream-enwiki-2020-06.tsv.gz,"Citizenship_(Amendment)_Act,_2019",6158,48033,37,54228,7214
hdfs://spark-nn.eemcs.utwente.nl/user/s1934538/clickstream/clickstream-enwiki-2020-06.tsv.gz,2018_Asian_Games,4498,7229,43,11770,12314
hdfs://spark-nn.eemcs.utwente.nl/user/s1934538/clickstream/clickstream-enwiki-2020-06.tsv.gz,Matthew_Perry,72184,210746,868,283798,165894
hdfs://spark-nn.eemcs.utwente.nl/user/s1934538/clickstream/clickstream-enwiki-2020-06.tsv.gz,2018_Winter_Olympics,15738,13729,203,29670,22384
hdfs://spark-nn.eemcs.utwente.nl/user/s1934538/clickstream/clickstream-enwiki-2020-06.tsv.gz,WandaVision,42006,36551,418,78975,43392
hdfs://spark-nn.eemcs.utwente.nl/user/s1934538/clickstream/clickstream-enwiki-2020-06.tsv.gz,XXXTentacion,84036,477553,4662,566251,113582
hdfs://spark-nn.eemcs.utwente.nl/user/s1934538/clickstream/clickstream-enwiki-2020-06.tsv.gz,Tonya_Harding,24118,126064,466,150648,37823
hdfs://spark-nn.eemcs.utwente.nl/user/s1934538/clickstream/clickstream-enwiki-2020-06.tsv.gz,Spider-Man:_Far_From_Home,87580,170341,1701,259622,121168
hdfs://spark-nn.eemcs.utwente.nl/user/s1934538/clickstream/clickstream-enwiki-2020-06.tsv.gz,Grover,1648,6214,74,7936,1848
hdfs://spark-nn.eemcs.utwente.nl/user/s1934538/clickstream/clickstream-enwiki-2020-06.tsv.gz,The_Shape_of_Water,27888,56622,562,85072,36142
hdfs://spark-nn.eemcs.utwente.nl/user/s1934538/clickstream/clickstream-enwiki-2020-06.tsv.gz,Ray_Liotta,40821,50746,329,91896,32390
hdfs://spark-nn.eemcs.utwente.nl/user/s1934538/clickstream/clickstream-enwiki-2020-06.tsv.gz,Ghislaine_Maxwell,557686,1277503,5181,1840370,612047
hdfs://spark-nn.eemcs.utwente.nl/user/s1934538/clickstream/clickstream-enwiki-2020-06.tsv.gz,Atal_Bihari_Vajpayee,29009,48662,57,77728,25713
hdfs://spark-nn.eemcs.utwente.nl/user/s1934538/clickstream/clickstream-enwiki-2020-06.tsv.gz,Aaron_Carter,15602,39508,272,55382,21782
hdfs://spark-nn.eemcs.utwente.nl/user/s1934538/clickstream/clickstream-enwiki-2020-06.tsv.gz,Brett_Kavanaugh,64063,100224,641,164928,56547
hdfs://spark-nn.eemcs.utwente.nl/user/s1934538/clickstream/clickstream-enwiki-2020-06.tsv.gz,Afghanistan,48202,127668,2257,178127,93719
hdfs://spark-nn.eemcs.utwente.nl/user/s1934538/clickstream/clickstream-enwiki-2020-06.tsv.gz,Israel,84958,242756,4110,331824,165963
hdfs://spark-nn.eemcs.utwente.nl/user/s1934538/clickstream/clickstream-enwiki-2020-06.tsv.gz,State_of_Palestine,43516,118449,137,162102,72883
hdfs://spark-nn.eemcs.utwente.nl/user/s1934538/clickstream/clickstream-enwiki-2020-06.tsv.gz,Tina_Turner,21660,169739,1561,192960,61808
hdfs://spark-nn.eemcs.utwente.nl/user/s1934538/clickstream/clickstream-enwiki-2020-06.tsv.gz,Kim_Jong-un,62418,257084,2549,322051,129574
hdfs://spark-nn.eemcs.utwente.nl/user/s1934538/clickstream/clickstream-enwiki-2020-06.tsv.gz,Mötley_Crüe,32836,111401,1326,145563,181388
hdfs://spark-nn.eemcs.utwente.nl/user/s1934538/clickstream/clickstream-enwiki-2020-06.tsv.gz,Pelé,32021,138353,1126,171500,56728
hdfs://spark-nn.eemcs.utwente.nl/user/s1934538/clickstream/clickstream-enwiki-2020-06.tsv.gz,Zack_Snyder's_Justice_League,129993,87687,1112,218792,100689
hdfs://spark-nn.eemcs.utwente.nl/user/s1934538/clickstream/clickstream-enwiki-2020-06.tsv.gz,Key_frame,723,7376,13,8112,504
hdfs://spark-nn.eemcs.utwente.nl/user/s1934538/clickstream/clickstream-enwiki-2020-06.tsv.gz,George_VI,355495,145274,708,501477,357143
hdfs://spark-nn.eemcs.utwente.nl/user/s1934538/clickstream/clickstream-enwiki-2020-06.tsv.gz,It_Chapter_Two,41571,130200,2144,173915,120998
hdfs://spark-nn.eemcs.utwente.nl/user/s1934538/clickstream/clickstream-enwiki-2020-06.tsv.gz,Bipin_Rawat,24108,35553,50,59711,33086
hdfs://spark-nn.eemcs.utwente.nl/user/s1934538/clickstream/clickstream-enwiki-2020-06.tsv.gz,Bonnie_and_Clyde,27213,255392,1584,284189,65211
hdfs://spark-nn.eemcs.utwente.nl/user/s1934538/clickstream/clickstream-enwiki-2020-06.tsv.gz,1917_(2019_film),41278,266281,3936,311495,156707
hdfs://spark-nn.eemcs.utwente.nl/user/s1934538/clickstream/clickstream-enwiki-2020-06.tsv.gz,Darth_Vader,30874,82492,718,114084,76601
hdfs://spark-nn.eemcs.utwente.nl/user/s1934538/clickstream/clickstream-enwiki-2020-06.tsv.gz,Puneeth_Rajkumar,15104,24937,30,40071,21834
hdfs://spark-nn.eemcs.utwente.nl/user/s1934538/clickstream/clickstream-enwiki-2020-06.tsv.gz,R._Kelly,34436,187070,1542,223048,89355
hdfs://spark-nn.eemcs.utwente.nl/user/s1934538/clickstream/clickstream-enwiki-2020-06.tsv.gz,"Prince_Philip,_Duke_of_Edinburgh",263561,449522,8099,721182,466641
hdfs://spark-nn.eemcs.utwente.nl/user/s1934538/clickstream/clickstream-enwiki-2020-06.tsv.gz,Stranger_Things_(season_4),32387,185418,579,218384,114006
hdfs://spark-nn.eemcs.utwente.nl/user/s1934538/clickstream/clickstream-enwiki-2020-06.tsv.gz,XXX:_Return_of_Xander_Cage,32694,98661,548,131903,32566
hdfs://spark-nn.eemcs.utwente.nl/user/s1934538/clickstream/clickstream-enwiki-2020-06.tsv.gz,List_of_awards_and_nominations_received_by_Meryl_Streep,19441,16019,321,35781,12940
hdfs://spark-nn.eemcs.utwente.nl/user/s1934538/clickstream/clickstream-enwiki-2020-06.tsv.gz,Top_Gun:_Maverick,60871,106638,1579,169088,100542
hdfs://spark-nn.eemcs.utwente.nl/user/s1934538/clickstream/clickstream-enwiki-2020-06.tsv.gz,Death_of_Elisa_Lam,6885,64684,1055,72624,19618
hdfs://spark-nn.eemcs.utwente.nl/user/s1934538/clickstream/clickstream-enwiki-2020-06.tsv.gz,Cricket_World_Cup,7006,49356,174,56536,30819
hdfs://spark-nn.eemcs.utwente.nl/user/s1934538/clickstream/clickstream-enwiki-2020-06.tsv.gz,XHamster,14509,86976,2816,104301,18463
hdfs://spark-nn.eemcs.utwente.nl/user/s1934538/clickstream/clickstream-enwiki-2020-06.tsv.gz,Crazy_Rich_Asians_(film),34652,134670,1299,170621,168734
hdfs://spark-nn.eemcs.utwente.nl/user/s1934538/clickstream/clickstream-enwiki-2020-06.tsv.gz,Area_51,15927,172364,1176,189467,39635
hdfs://spark-nn.eemcs.utwente.nl/user/s1934538/clickstream/clickstream-enwiki-2020-06.tsv.gz,Richard_Jewell,19152,127139,650,146941,50861
hdfs://spark-nn.eemcs.utwente.nl/user/s1934538/clickstream/clickstream-enwiki-2020-06.tsv.gz,Lance_Reddick,40187,50791,218,91196,19111
hdfs://spark-nn.eemcs.utwente.nl/user/s1934538/clickstream/clickstream-enwiki-2020-06.tsv.gz,Royal_Rumble_(2018),10075,6477,129,16681,12021
hdfs://spark-nn.eemcs.utwente.nl/user/s1934538/clickstream/clickstream-enwiki-2020-06.tsv.gz,Exo_(band),26595,124534,397,151526,159631
hdfs://spark-nn.eemcs.utwente.nl/user/s1934538/clickstream/clickstream-enwiki-2020-06.tsv.gz,Article_370_of_the_Constitution_of_India,3816,49340,72,53228,4559
hdfs://spark-nn.eemcs.utwente.nl/user/s1934538/clickstream/clickstream-enwiki-2020-06.tsv.gz,Juneteenth,37177,6665062,48369,6750608,636431
hdfs://spark-nn.eemcs.utwente.nl/user/s1934538/clickstream/clickstream-enwiki-2020-06.tsv.gz,Stranger_Things,65290,323388,5813,394491,297622
hdfs://spark-nn.eemcs.utwente.nl/user/s1934538/clickstream/clickstream-enwiki-2020-06.tsv.gz,John_McCain,59626,125098,1307,186031,93070
hdfs://spark-nn.eemcs.utwente.nl/user/s1934538/clickstream/clickstream-enwiki-2020-06.tsv.gz,"Diana,_Princess_of_Wales",139505,374767,2858,517130,326655
hdfs://spark-nn.eemcs.utwente.nl/user/s1934538/clickstream/clickstream-enwiki-2020-06.tsv.gz,Henry_V_of_England,79747,111196,547,191490,134827
hdfs://spark-nn.eemcs.utwente.nl/user/s1934538/clickstream/clickstream-enwiki-2020-06.tsv.gz,Jimmy_Buffett,11814,69826,799,82439,34010
hdfs://spark-nn.eemcs.utwente.nl/user/s1934538/clickstream/clickstream-enwiki-2020-06.tsv.gz,FIFA_World_Cup,43400,164362,2398,210160,165094
hdfs://spark-nn.eemcs.utwente.nl/user/s1934538/clickstream/clickstream-enwiki-2020-06.tsv.gz,Anne_Heche,30636,67788,297,98721,30072
hdfs://spark-nn.eemcs.utwente.nl/user/s1934538/clickstream/clickstream-enwiki-2020-06.tsv.gz,Sidharth_Shukla,12409,36064,135,48608,12182
hdfs://spark-nn.eemcs.utwente.nl/user/s1934538/clickstream/clickstream-enwiki-2020-06.tsv.gz,September_11_attacks,85218,249937,2033,337188,158571
hdfs://spark-nn.eemcs.utwente.nl/user/s1934538/clickstream/clickstream-enwiki-2020-06.tsv.gz,Stephen_Hawking,37661,376673,2158,416492,181514
hdfs://spark-nn.eemcs.utwente.nl/user/s1934538/clickstream/clickstream-enwiki-2021-03.tsv.gz,United_States_Electoral_College,14817,47635,120,62572,9132
hdfs://spark-nn.eemcs.utwente.nl/user/s1934538/clickstream/clickstream-enwiki-2021-03.tsv.gz,Darth_Vader,34823,78353,777,113953,68277
hdfs://spark-nn.eemcs.utwente.nl/user/s1934538/clickstream/clickstream-enwiki-2021-03.tsv.gz,Ant-Man_and_the_Wasp:_Quantumania,133101,39496,1198,173795,137184
hdfs://spark-nn.eemcs.utwente.nl/user/s1934538/clickstream/clickstream-enwiki-2021-03.tsv.gz,Google_logo,1215,3659777,25,3661017,2842
hdfs://spark-nn.eemcs.utwente.nl/user/s1934538/clickstream/clickstream-enwiki-2021-03.tsv.gz,Lists_of_deaths_by_year,7891,287648,945,296484,330022
hdfs://spark-nn.eemcs.utwente.nl/user/s1934538/clickstream/clickstream-enwiki-2021-03.tsv.gz,Cristiano_Ronaldo,137695,858893,6967,1003555,245220
hdfs://spark-nn.eemcs.utwente.nl/user/s1934538/clickstream/clickstream-enwiki-2021-03.tsv.gz,K.G.F:_Chapter_2,25375,97003,320,122698,47754
hdfs://spark-nn.eemcs.utwente.nl/user/s1934538/clickstream/clickstream-enwiki-2021-03.tsv.gz,The_Queen's_Gambit_(miniseries),94956,630983,7094,733033,389227
hdfs://spark-nn.eemcs.utwente.nl/user/s1934538/clickstream/clickstream-enwiki-2021-03.tsv.gz,2020_United_States_presidential_election,262725,458486,13799,735010,712701
hdfs://spark-nn.eemcs.utwente.nl/user/s1934538/clickstream/clickstream-enwiki-2021-03.tsv.gz,Henry_V_of_England,105173,110995,574,216742,158579
hdfs://spark-nn.eemcs.utwente.nl/user/s1934538/clickstream/clickstream-enwiki-2021-03.tsv.gz,Carlos_Alcaraz,1320,5708,227,7255,1277
hdfs://spark-nn.eemcs.utwente.nl/user/s1934538/clickstream/clickstream-enwiki-2021-03.tsv.gz,Us_(2019_film),37087,224803,997,262887,89397
hdfs://spark-nn.eemcs.utwente.nl/user/s1934538/clickstream/clickstream-enwiki-2021-03.tsv.gz,Sylvester_Stallone,144260,367382,3084,514726,374233
hdfs://spark-nn.eemcs.utwente.nl/user/s1934538/clickstream/clickstream-enwiki-2021-03.tsv.gz,List_of_FIFA_World_Cup_finals,4608,75561,73,80242,24617
hdfs://spark-nn.eemcs.utwente.nl/user/s1934538/clickstream/clickstream-enwiki-2021-03.tsv.gz,Mortal_Kombat_(2021_film),80686,300171,8241,389098,354268
hdfs://spark-nn.eemcs.utwente.nl/user/s1934538/clickstream/clickstream-enwiki-2021-03.tsv.gz,Mötley_Crüe,38799,121362,1593,161754,182293
hdfs://spark-nn.eemcs.utwente.nl/user/s1934538/clickstream/clickstream-enwiki-2021-03.tsv.gz,Ray_Liotta,38689,56108,404,95201,34641
hdfs://spark-nn.eemcs.utwente.nl/user/s1934538/clickstream/clickstream-enwiki-2021-03.tsv.gz,Vladimir_Putin,104974,303125,4695,412794,237886
hdfs://spark-nn.eemcs.utwente.nl/user/s1934538/clickstream/clickstream-enwiki-2021-03.tsv.gz,Avengers:_Endgame,258865,437832,8867,705564,434560
hdfs://spark-nn.eemcs.utwente.nl/user/s1934538/clickstream/clickstream-enwiki-2021-03.tsv.gz,Kobe_Bryant_sexual_assault_case,7677,42778,61,50516,4050
hdfs://spark-nn.eemcs.utwente.nl/user/s1934538/clickstream/clickstream-enwiki-2021-03.tsv.gz,Sidharth_Shukla,13881,38438,175,52494,16253
hdfs://spark-nn.eemcs.utwente.nl/user/s1934538/clickstream/clickstream-enwiki-2021-03.tsv.gz,Puneeth_Rajkumar,16506,53441,539,70486,47728
hdfs://spark-nn.eemcs.utwente.nl/user/s1934538/clickstream/clickstream-enwiki-2021-03.tsv.gz,Bible,20196,3792799,3243,3816238,44121
hdfs://spark-nn.eemcs.utwente.nl/user/s1934538/clickstream/clickstream-enwiki-2021-03.tsv.gz,Eddie_Van_Halen,45291,111870,1403,158564,59477
hdfs://spark-nn.eemcs.utwente.nl/user/s1934538/clickstream/clickstream-enwiki-2021-03.tsv.gz,Valentine's_Day,6385,51067,388,57840,5724
hdfs://spark-nn.eemcs.utwente.nl/user/s1934538/clickstream/clickstream-enwiki-2021-03.tsv.gz,Joaquin_Phoenix,136499,208714,1292,346505,212564
hdfs://spark-nn.eemcs.utwente.nl/user/s1934538/clickstream/clickstream-enwiki-2021-03.tsv.gz,Anne_Heche,31433,50927,266,82626,26997
hdfs://spark-nn.eemcs.utwente.nl/user/s1934538/clickstream/clickstream-enwiki-2021-03.tsv.gz,List_of_highest-grossing_Indian_films,55145,155946,1094,212185,120049
hdfs://spark-nn.eemcs.utwente.nl/user/s1934538/clickstream/clickstream-enwiki-2021-03.tsv.gz,It_Chapter_Two,35616,58501,750,94867,62140
hdfs://spark-nn.eemcs.utwente.nl/user/s1934538/clickstream/clickstream-enwiki-2021-03.tsv.gz,List_of_Queen_of_the_South_episodes,17074,11262,301,28637,1018
hdfs://spark-nn.eemcs.utwente.nl/user/s1934538/clickstream/clickstream-enwiki-2021-03.tsv.gz,The_Umbrella_Academy_(TV_series),44329,176528,3299,224156,127549
hdfs://spark-nn.eemcs.utwente.nl/user/s1934538/clickstream/clickstream-enwiki-2021-03.tsv.gz,Sinéad_O'Connor,30870,121393,1105,153368,46245
hdfs://spark-nn.eemcs.utwente.nl/user/s1934538/clickstream/clickstream-enwiki-2021-03.tsv.gz,Juice_Wrld,42173,308241,6191,356605,118655
hdfs://spark-nn.eemcs.utwente.nl/user/s1934538/clickstream/clickstream-enwiki-2021-03.tsv.gz,Jimmy_Buffett,9721,52056,810,62587,25044
hdfs://spark-nn.eemcs.utwente.nl/user/s1934538/clickstream/clickstream-enwiki-2021-03.tsv.gz,Luke_Perry,42172,198436,798,241406,80229
hdfs://spark-nn.eemcs.utwente.nl/user/s1934538/clickstream/clickstream-enwiki-2021-03.tsv.gz,Stranger_Things_(season_4),38300,159076,1179,198555,116211
hdfs://spark-nn.eemcs.utwente.nl/user/s1934538/clickstream/clickstream-enwiki-2021-03.tsv.gz,The_Haunting_of_Bly_Manor,25695,94922,820,121437,57493
hdfs://spark-nn.eemcs.utwente.nl/user/s1934538/clickstream/clickstream-enwiki-2021-03.tsv.gz,2018_FIFA_World_Cup,107042,130465,1816,239323,146479
hdfs://spark-nn.eemcs.utwente.nl/user/s1934538/clickstream/clickstream-enwiki-2021-03.tsv.gz,Microsoft_Office,10452,2375626,990,2387068,24715
hdfs://spark-nn.eemcs.utwente.nl/user/s1934538/clickstream/clickstream-enwiki-2021-03.tsv.gz,Death_of_Elisa_Lam,74176,475244,1506,550926,118887
hdfs://spark-nn.eemcs.utwente.nl/user/s1934538/clickstream/clickstream-enwiki-2021-03.tsv.gz,Jason_Momoa,147285,383007,2221,532513,249959
hdfs://spark-nn.eemcs.utwente.nl/user/s1934538/clickstream/clickstream-enwiki-2021-03.tsv.gz,Chernobyl_disaster,100319,506311,5720,612350,264710
hdfs://spark-nn.eemcs.utwente.nl/user/s1934538/clickstream/clickstream-enwiki-2021-03.tsv.gz,Spider-Man:_No_Way_Home,332036,270084,9712,611832,348242
hdfs://spark-nn.eemcs.utwente.nl/user/s1934538/clickstream/clickstream-enwiki-2021-03.tsv.gz,The_Mandalorian,91100,341460,6583,439143,319720
hdfs://spark-nn.eemcs.utwente.nl/user/s1934538/clickstream/clickstream-enwiki-2021-03.tsv.gz,Black_Widow_(2021_film),206009,246881,6343,459233,230717
hdfs://spark-nn.eemcs.utwente.nl/user/s1934538/clickstream/clickstream-enwiki-2021-03.tsv.gz,Fyre_Festival,16475,124414,983,141872,78693
hdfs://spark-nn.eemcs.utwente.nl/user/s1934538/clickstream/clickstream-enwiki-2021-03.tsv.gz,Top_Gun:_Maverick,62866,73001,2275,138142,87307
hdfs://spark-nn.eemcs.utwente.nl/user/s1934538/clickstream/clickstream-enwiki-2021-03.tsv.gz,Notre-Dame_de_Paris,13863,94325,986,109174,26378
hdfs://spark-nn.eemcs.utwente.nl/user/s1934538/clickstream/clickstream-enwiki-2021-03.tsv.gz,Donald_Glover,56215,189581,1358,247154,103634
hdfs://spark-nn.eemcs.utwente.nl/user/s1934538/clickstream/clickstream-enwiki-2021-03.tsv.gz,Michael_Jordan,114635,558789,6002,679426,241457
hdfs://spark-nn.eemcs.utwente.nl/user/s1934538/clickstream/clickstream-enwiki-2021-03.tsv.gz,The_Batman_(film),174885,183093,3170,361148,284316
hdfs://spark-nn.eemcs.utwente.nl/user/s1934538/clickstream/clickstream-enwiki-2021-03.tsv.gz,Captain_Marvel_(film),137543,265470,3635,406648,234916
hdfs://spark-nn.eemcs.utwente.nl/user/s1934538/clickstream/clickstream-enwiki-2021-03.tsv.gz,Kim_Jong-un,81250,198570,2428,282248,158520
hdfs://spark-nn.eemcs.utwente.nl/user/s1934538/clickstream/clickstream-enwiki-2021-03.tsv.gz,2022_FIFA_World_Cup,112177,239811,8307,360295,237286
hdfs://spark-nn.eemcs.utwente.nl/user/s1934538/clickstream/clickstream-enwiki-2021-03.tsv.gz,Army_of_the_Dead,175459,56689,848,232996,110666
hdfs://spark-nn.eemcs.utwente.nl/user/s1934538/clickstream/clickstream-enwiki-2021-03.tsv.gz,"Prince_Philip,_Duke_of_Edinburgh",990552,1732644,15044,2738240,1776592
hdfs://spark-nn.eemcs.utwente.nl/user/s1934538/clickstream/clickstream-enwiki-2021-03.tsv.gz,Elliot_Page,123191,775265,7897,906353,363046
hdfs://spark-nn.eemcs.utwente.nl/user/s1934538/clickstream/clickstream-enwiki-2021-03.tsv.gz,List_of_most_popular_websites,10921,42436,113,53470,19138
hdfs://spark-nn.eemcs.utwente.nl/user/s1934538/clickstream/clickstream-enwiki-2021-03.tsv.gz,Greta_Thunberg,11869,232616,2178,246663,53122
hdfs://spark-nn.eemcs.utwente.nl/user/s1934538/clickstream/clickstream-enwiki-2021-03.tsv.gz,Brett_Kavanaugh,24984,48443,338,73765,21099
hdfs://spark-nn.eemcs.utwente.nl/user/s1934538/clickstream/clickstream-enwiki-2021-03.tsv.gz,Kenosha_unrest_shooting,7895,52262,336,60493,9706
hdfs://spark-nn.eemcs.utwente.nl/user/s1934538/clickstream/clickstream-enwiki-2021-03.tsv.gz,Kelly_Preston,106216,160535,975,267726,78417
hdfs://spark-nn.eemcs.utwente.nl/user/s1934538/clickstream/clickstream-enwiki-2021-03.tsv.gz,WrestleMania_34,40108,18872,273,59253,42336
hdfs://spark-nn.eemcs.utwente.nl/user/s1934538/clickstream/clickstream-enwiki-2021-03.tsv.gz,Mac_Miller,36449,226185,1835,264469,79982
hdfs://spark-nn.eemcs.utwente.nl/user/s1934538/clickstream/clickstream-enwiki-2021-03.tsv.gz,COVID-19_pandemic,504983,719111,3929,1228023,611291
hdfs://spark-nn.eemcs.utwente.nl/user/s1934538/clickstream/clickstream-enwiki-2021-03.tsv.gz,Coronavirus,20281,285185,5799,311265,75817
hdfs://spark-nn.eemcs.utwente.nl/user/s1934538/clickstream/clickstream-enwiki-2021-03.tsv.gz,George_H._W._Bush,161543,132330,1036,294909,174918
hdfs://spark-nn.eemcs.utwente.nl/user/s1934538/clickstream/clickstream-enwiki-2021-03.tsv.gz,IPv4,13259,47240,161,60660,11102
hdfs://spark-nn.eemcs.utwente.nl/user/s1934538/clickstream/clickstream-enwiki-2021-03.tsv.gz,Once_Upon_a_Time_in_Hollywood,111335,191246,3897,306478,273858
hdfs://spark-nn.eemcs.utwente.nl/user/s1934538/clickstream/clickstream-enwiki-2021-03.tsv.gz,Antifa_(United_States),16524,161081,908,178513,33879
hdfs://spark-nn.eemcs.utwente.nl/user/s1934538/clickstream/clickstream-enwiki-2021-03.tsv.gz,Matthew_Perry,71598,143007,811,215416,115723
hdfs://spark-nn.eemcs.utwente.nl/user/s1934538/clickstream/clickstream-enwiki-2021-03.tsv.gz,Adele,28661,164005,2755,195421,67505
hdfs://spark-nn.eemcs.utwente.nl/user/s1934538/clickstream/clickstream-enwiki-2021-03.tsv.gz,Anthony_Bourdain,21689,236549,1950,260188,87156
hdfs://spark-nn.eemcs.utwente.nl/user/s1934538/clickstream/clickstream-enwiki-2021-03.tsv.gz,Loki_(TV_series),106859,157051,2129,266039,129283
hdfs://spark-nn.eemcs.utwente.nl/user/s1934538/clickstream/clickstream-enwiki-2021-03.tsv.gz,1917_(2019_film),32239,122924,2476,157639,85319
hdfs://spark-nn.eemcs.utwente.nl/user/s1934538/clickstream/clickstream-enwiki-2021-03.tsv.gz,Eternals_(film),299776,195796,1401,496973,452305
hdfs://spark-nn.eemcs.utwente.nl/user/s1934538/clickstream/clickstream-enwiki-2021-03.tsv.gz,Shinzo_Abe,38602,36523,490,75615,46987
hdfs://spark-nn.eemcs.utwente.nl/user/s1934538/clickstream/clickstream-enwiki-2021-03.tsv.gz,Naomi_Osaka,29421,144846,46913,221180,72576
hdfs://spark-nn.eemcs.utwente.nl/user/s1934538/clickstream/clickstream-enwiki-2021-03.tsv.gz,Ruth_Bader_Ginsburg,30999,234867,1565,267431,79478
hdfs://spark-nn.eemcs.utwente.nl/user/s1934538/clickstream/clickstream-enwiki-2021-03.tsv.gz,War_(2019_film),17962,63363,165,81490,23839
hdfs://spark-nn.eemcs.utwente.nl/user/s1934538/clickstream/clickstream-enwiki-2021-03.tsv.gz,Simple_Mail_Transfer_Protocol,4602,41508,155,46265,4885
hdfs://spark-nn.eemcs.utwente.nl/user/s1934538/clickstream/clickstream-enwiki-2021-03.tsv.gz,Michael_Bloomberg,36650,40043,348,77041,34958
hdfs://spark-nn.eemcs.utwente.nl/user/s1934538/clickstream/clickstream-enwiki-2021-03.tsv.gz,Aretha_Franklin,124747,1285437,8895,1419079,724508
hdfs://spark-nn.eemcs.utwente.nl/user/s1934538/clickstream/clickstream-enwiki-2021-03.tsv.gz,Rishi_Sunak,24255,225881,1675,251811,121231
hdfs://spark-nn.eemcs.utwente.nl/user/s1934538/clickstream/clickstream-enwiki-2021-03.tsv.gz,Rami_Malek,92988,295794,1484,390266,171068
hdfs://spark-nn.eemcs.utwente.nl/user/s1934538/clickstream/clickstream-enwiki-2021-03.tsv.gz,YouTube,157533,1494056,13283,1664872,138572
hdfs://spark-nn.eemcs.utwente.nl/user/s1934538/clickstream/clickstream-enwiki-2021-03.tsv.gz,QAnon,71880,747800,6502,826182,169513
hdfs://spark-nn.eemcs.utwente.nl/user/s1934538/clickstream/clickstream-enwiki-2021-03.tsv.gz,Stranger_Things,77632,261187,6042,344861,262935
hdfs://spark-nn.eemcs.utwente.nl/user/s1934538/clickstream/clickstream-enwiki-2021-03.tsv.gz,Rihanna,81435,277970,4604,364009,175859
hdfs://spark-nn.eemcs.utwente.nl/user/s1934538/clickstream/clickstream-enwiki-2021-03.tsv.gz,Asia_Cup,2427,68325,365,71117,33124
hdfs://spark-nn.eemcs.utwente.nl/user/s1934538/clickstream/clickstream-enwiki-2021-03.tsv.gz,Brie_Larson,89681,214944,1861,306486,121870
hdfs://spark-nn.eemcs.utwente.nl/user/s1934538/clickstream/clickstream-enwiki-2021-03.tsv.gz,Deaths_in_2021,1705402,2443075,20909,4169386,2389712
hdfs://spark-nn.eemcs.utwente.nl/user/s1934538/clickstream/clickstream-enwiki-2021-03.tsv.gz,Game_of_Thrones,97600,323104,8713,429417,284013
hdfs://spark-nn.eemcs.utwente.nl/user/s1934538/clickstream/clickstream-enwiki-2021-03.tsv.gz,Shooting_of_Breonna_Taylor,9927,266108,729,276764,22678
hdfs://spark-nn.eemcs.utwente.nl/user/s1934538/clickstream/clickstream-enwiki-2021-03.tsv.gz,Grover,1813,6607,65,8485,1991
hdfs://spark-nn.eemcs.utwente.nl/user/s1934538/clickstream/clickstream-enwiki-2021-03.tsv.gz,Russo-Ukrainian_War,31898,45242,182,77322,46672
hdfs://spark-nn.eemcs.utwente.nl/user/s1934538/clickstream/clickstream-enwiki-2021-03.tsv.gz,Black_Panther_(film),132404,189827,3937,326168,195407
hdfs://spark-nn.eemcs.utwente.nl/user/s1934538/clickstream/clickstream-enwiki-2021-03.tsv.gz,Juneteenth,4372,87979,312,92663,6667
hdfs://spark-nn.eemcs.utwente.nl/user/s1934538/clickstream/clickstream-enwiki-2021-03.tsv.gz,DMX_(rapper),16674,73887,636,91197,37290
hdfs://spark-nn.eemcs.utwente.nl/user/s1934538/clickstream/clickstream-enwiki-2021-03.tsv.gz,Joker_(2019_film),75109,221097,2914,299120,139163
hdfs://spark-nn.eemcs.utwente.nl/user/s1934538/clickstream/clickstream-enwiki-2021-03.tsv.gz,2016_United_States_presidential_election,161808,111342,1424,274574,248700
hdfs://spark-nn.eemcs.utwente.nl/user/s1934538/clickstream/clickstream-enwiki-2021-03.tsv.gz,Salman_Rushdie,35343,68582,428,104353,42869
hdfs://spark-nn.eemcs.utwente.nl/user/s1934538/clickstream/clickstream-enwiki-2021-03.tsv.gz,Vivek_Ramaswamy,1010,5923,72,7005,1365
hdfs://spark-nn.eemcs.utwente.nl/user/s1934538/clickstream/clickstream-enwiki-2021-03.tsv.gz,Betty_White,69299,292536,4095,365930,115078
hdfs://spark-nn.eemcs.utwente.nl/user/s1934538/clickstream/clickstream-enwiki-2021-03.tsv.gz,Christopher_Scarver,84611,21342,28,105981,39211
hdfs://spark-nn.eemcs.utwente.nl/user/s1934538/clickstream/clickstream-enwiki-2021-03.tsv.gz,Kate_Spade,28474,62461,355,91290,32666
hdfs://spark-nn.eemcs.utwente.nl/user/s1934538/clickstream/clickstream-enwiki-2021-03.tsv.gz,Tunnel,3926,11379,226,15531,4745
hdfs://spark-nn.eemcs.utwente.nl/user/s1934538/clickstream/clickstream-enwiki-2021-03.tsv.gz,Irrfan_Khan,37676,80913,177,118766,44501
hdfs://spark-nn.eemcs.utwente.nl/user/s1934538/clickstream/clickstream-enwiki-2021-03.tsv.gz,Sushant_Singh_Rajput,37743,139568,1040,178351,77479
hdfs://spark-nn.eemcs.utwente.nl/user/s1934538/clickstream/clickstream-enwiki-2021-03.tsv.gz,Richard_Jewell,27056,169961,801,197818,72480
hdfs://spark-nn.eemcs.utwente.nl/user/s1934538/clickstream/clickstream-enwiki-2021-03.tsv.gz,List_of_James_Bond_films,62442,389585,818,452845,270327
hdfs://spark-nn.eemcs.utwente.nl/user/s1934538/clickstream/clickstream-enwiki-2021-03.tsv.gz,"Citizenship_(Amendment)_Act,_2019",4658,43295,14,47967,5272
hdfs://spark-nn.eemcs.utwente.nl/user/s1934538/clickstream/clickstream-enwiki-2021-03.tsv.gz,Tenet_(film),106868,381732,5589,494189,247962
hdfs://spark-nn.eemcs.utwente.nl/user/s1934538/clickstream/clickstream-enwiki-2021-03.tsv.gz,The_Irishman,56627,115206,2564,174397,141760
hdfs://spark-nn.eemcs.utwente.nl/user/s1934538/clickstream/clickstream-enwiki-2021-03.tsv.gz,Wikipedia,246389,1460904,1400,1708693,674207
hdfs://spark-nn.eemcs.utwente.nl/user/s1934538/clickstream/clickstream-enwiki-2021-03.tsv.gz,Avicii,25789,234044,2157,261990,118587
hdfs://spark-nn.eemcs.utwente.nl/user/s1934538/clickstream/clickstream-enwiki-2021-03.tsv.gz,Thor:_Love_and_Thunder,266609,155351,2916,424876,372288
hdfs://spark-nn.eemcs.utwente.nl/user/s1934538/clickstream/clickstream-enwiki-2021-03.tsv.gz,Naya_Rivera,83390,147818,768,231976,89803
hdfs://spark-nn.eemcs.utwente.nl/user/s1934538/clickstream/clickstream-enwiki-2021-03.tsv.gz,Ghislaine_Maxwell,74755,150411,920,226086,95766
hdfs://spark-nn.eemcs.utwente.nl/user/s1934538/clickstream/clickstream-enwiki-2021-03.tsv.gz,A_Quiet_Place_(film),28377,94923,972,124272,41693
hdfs://spark-nn.eemcs.utwente.nl/user/s1934538/clickstream/clickstream-enwiki-2023-03.tsv.gz,Tonya_Harding,19616,95533,381,115530,30168
hdfs://spark-nn.eemcs.utwente.nl/user/s1934538/clickstream/clickstream-enwiki-2023-03.tsv.gz,Laal_Singh_Chaddha,22656,59189,121,81966,27303
hdfs://spark-nn.eemcs.utwente.nl/user/s1934538/clickstream/clickstream-enwiki-2023-03.tsv.gz,Elizabeth_II,360758,553352,4486,918596,613457
hdfs://spark-nn.eemcs.utwente.nl/user/s1934538/clickstream/clickstream-enwiki-2023-03.tsv.gz,Black_Panther:_Wakanda_Forever,134727,412768,7806,555301,383354
hdfs://spark-nn.eemcs.utwente.nl/user/s1934538/clickstream/clickstream-enwiki-2023-03.tsv.gz,Black_Panther_(film),57496,156570,1427,215493,99986
hdfs://spark-nn.eemcs.utwente.nl/user/s1934538/clickstream/clickstream-enwiki-2023-03.tsv.gz,Tiger_3,66030,17740,494,84264,24554
hdfs://spark-nn.eemcs.utwente.nl/user/s1934538/clickstream/clickstream-enwiki-2023-03.tsv.gz,Darth_Vader,31084,65135,526,96745,59239
hdfs://spark-nn.eemcs.utwente.nl/user/s1934538/clickstream/clickstream-enwiki-2023-03.tsv.gz,Oppenheimer_(film),149453,177309,4088,330850,272982
hdfs://spark-nn.eemcs.utwente.nl/user/s1934538/clickstream/clickstream-enwiki-2023-03.tsv.gz,Lisa_Marie_Presley,560014,451270,1858,1013142,512010
hdfs://spark-nn.eemcs.utwente.nl/user/s1934538/clickstream/clickstream-enwiki-2023-03.tsv.gz,Zack_Snyder's_Justice_League,52695,89091,1003,142789,60974
hdfs://spark-nn.eemcs.utwente.nl/user/s1934538/clickstream/clickstream-enwiki-2023-03.tsv.gz,Brett_Kavanaugh,16637,22992,113,39742,14387
hdfs://spark-nn.eemcs.utwente.nl/user/s1934538/clickstream/clickstream-enwiki-2023-03.tsv.gz,Mötley_Crüe,34329,102170,1601,138100,158668
hdfs://spark-nn.eemcs.utwente.nl/user/s1934538/clickstream/clickstream-enwiki-2023-03.tsv.gz,The_Weeknd,91243,345365,3419,440027,189366
hdfs://spark-nn.eemcs.utwente.nl/user/s1934538/clickstream/clickstream-enwiki-2023-03.tsv.gz,Queen_(band),51227,186731,3000,240958,220835
hdfs://spark-nn.eemcs.utwente.nl/user/s1934538/clickstream/clickstream-enwiki-2023-03.tsv.gz,Juneteenth,4838,95874,237,100949,5638
hdfs://spark-nn.eemcs.utwente.nl/user/s1934538/clickstream/clickstream-enwiki-2023-03.tsv.gz,List_of_highest-grossing_Indian_films,194831,586198,1131,782160,342581
hdfs://spark-nn.eemcs.utwente.nl/user/s1934538/clickstream/clickstream-enwiki-2023-03.tsv.gz,Google_logo,1797,17521,15,19333,1523
hdfs://spark-nn.eemcs.utwente.nl/user/s1934538/clickstream/clickstream-enwiki-2023-03.tsv.gz,Squid_Game,17717,142842,2239,162798,67589
hdfs://spark-nn.eemcs.utwente.nl/user/s1934538/clickstream/clickstream-enwiki-2023-03.tsv.gz,Chernobyl_(miniseries),31259,89324,1933,122516,129609
hdfs://spark-nn.eemcs.utwente.nl/user/s1934538/clickstream/clickstream-enwiki-2023-03.tsv.gz,2023_Indian_Premier_League,45881,1022106,1042,1069029,177659
hdfs://spark-nn.eemcs.utwente.nl/user/s1934538/clickstream/clickstream-enwiki-2023-03.tsv.gz,Michael_Bloomberg,27554,31570,203,59327,28831
hdfs://spark-nn.eemcs.utwente.nl/user/s1934538/clickstream/clickstream-enwiki-2023-03.tsv.gz,Captain_Marvel_(film),27599,58075,780,86454,39892
hdfs://spark-nn.eemcs.utwente.nl/user/s1934538/clickstream/clickstream-enwiki-2023-03.tsv.gz,Grover,1521,5627,63,7211,1483
hdfs://spark-nn.eemcs.utwente.nl/user/s1934538/clickstream/clickstream-enwiki-2023-03.tsv.gz,YouTube,144180,7489975,10461,7644616,191057
hdfs://spark-nn.eemcs.utwente.nl/user/s1934538/clickstream/clickstream-enwiki-2023-03.tsv.gz,Critical_race_theory,19826,178020,998,198844,21126
hdfs://spark-nn.eemcs.utwente.nl/user/s1934538/clickstream/clickstream-enwiki-2023-03.tsv.gz,Stan_Lee,33544,109731,792,144067,38071
hdfs://spark-nn.eemcs.utwente.nl/user/s1934538/clickstream/clickstream-enwiki-2023-03.tsv.gz,Loki_(TV_series),56681,70180,1544,128405,78989
hdfs://spark-nn.eemcs.utwente.nl/user/s1934538/clickstream/clickstream-enwiki-2023-03.tsv.gz,Atal_Bihari_Vajpayee,35534,46079,49,81662,31744
hdfs://spark-nn.eemcs.utwente.nl/user/s1934538/clickstream/clickstream-enwiki-2023-03.tsv.gz,Cristiano_Ronaldo,192388,1630772,9234,1832394,436522
hdfs://spark-nn.eemcs.utwente.nl/user/s1934538/clickstream/clickstream-enwiki-2023-03.tsv.gz,Guardians_of_the_Galaxy_Vol._3,116854,129743,3071,249668,127000
hdfs://spark-nn.eemcs.utwente.nl/user/s1934538/clickstream/clickstream-enwiki-2023-03.tsv.gz,Kamala_Harris,74095,204821,1582,280498,118240
hdfs://spark-nn.eemcs.utwente.nl/user/s1934538/clickstream/clickstream-enwiki-2023-03.tsv.gz,Sinéad_O'Connor,18949,184558,1584,205091,79429
hdfs://spark-nn.eemcs.utwente.nl/user/s1934538/clickstream/clickstream-enwiki-2023-03.tsv.gz,Ponniyin_Selvan:_I,59581,227551,2456,289588,152570
hdfs://spark-nn.eemcs.utwente.nl/user/s1934538/clickstream/clickstream-enwiki-2023-03.tsv.gz,The_Falcon_and_the_Winter_Soldier,21396,31781,447,53624,29533
hdfs://spark-nn.eemcs.utwente.nl/user/s1934538/clickstream/clickstream-enwiki-2023-03.tsv.gz,"Prince_Philip,_Duke_of_Edinburgh",135039,135193,1099,271331,171209
hdfs://spark-nn.eemcs.utwente.nl/user/s1934538/clickstream/clickstream-enwiki-2023-03.tsv.gz,Aretha_Franklin,28815,205439,1365,235619,99991
hdfs://spark-nn.eemcs.utwente.nl/user/s1934538/clickstream/clickstream-enwiki-2023-03.tsv.gz,Richard_Jewell,8871,44738,243,53852,21575
hdfs://spark-nn.eemcs.utwente.nl/user/s1934538/clickstream/clickstream-enwiki-2023-03.tsv.gz,Ukraine,101710,387935,9696,499341,232275
hdfs://spark-nn.eemcs.utwente.nl/user/s1934538/clickstream/clickstream-enwiki-2023-03.tsv.gz,COVID-19_pandemic,98966,227052,6020,332038,107597
hdfs://spark-nn.eemcs.utwente.nl/user/s1934538/clickstream/clickstream-enwiki-2023-03.tsv.gz,Burt_Reynolds,61154,160291,1305,222750,104319
hdfs://spark-nn.eemcs.utwente.nl/user/s1934538/clickstream/clickstream-enwiki-2023-03.tsv.gz,Hyphen-minus,1045,4950335,19627,4971007,854
hdfs://spark-nn.eemcs.utwente.nl/user/s1934538/clickstream/clickstream-enwiki-2023-03.tsv.gz,Ghislaine_Maxwell,50095,92803,416,143314,59172
hdfs://spark-nn.eemcs.utwente.nl/user/s1934538/clickstream/clickstream-enwiki-2023-03.tsv.gz,Eternals_(film),64812,107873,1466,174151,118487
hdfs://spark-nn.eemcs.utwente.nl/user/s1934538/clickstream/clickstream-enwiki-2023-03.tsv.gz,Deaths_in_2023,1632012,2542922,17230,4192164,2553504
hdfs://spark-nn.eemcs.utwente.nl/user/s1934538/clickstream/clickstream-enwiki-2023-03.tsv.gz,Parasite_(2019_film),48125,186695,1751,236571,94340
hdfs://spark-nn.eemcs.utwente.nl/user/s1934538/clickstream/clickstream-enwiki-2023-03.tsv.gz,Bipin_Rawat,8089,26357,13,34459,13611
hdfs://spark-nn.eemcs.utwente.nl/user/s1934538/clickstream/clickstream-enwiki-2023-03.tsv.gz,Royal_Rumble_(2018),7522,5054,157,12733,9580
hdfs://spark-nn.eemcs.utwente.nl/user/s1934538/clickstream/clickstream-enwiki-2023-03.tsv.gz,Luke_Perry,46402,156123,697,203222,82795
hdfs://spark-nn.eemcs.utwente.nl/user/s1934538/clickstream/clickstream-enwiki-2023-03.tsv.gz,Stranger_Things_(season_4),31614,96189,1181,128984,72580
hdfs://spark-nn.eemcs.utwente.nl/user/s1934538/clickstream/clickstream-enwiki-2023-03.tsv.gz,List_of_James_Bond_films,61409,330965,1694,394068,254306
hdfs://spark-nn.eemcs.utwente.nl/user/s1934538/clickstream/clickstream-enwiki-2023-03.tsv.gz,Wonder_Woman_1984,51734,60198,1120,113052,51073
hdfs://spark-nn.eemcs.utwente.nl/user/s1934538/clickstream/clickstream-enwiki-2023-03.tsv.gz,Saltburn_(film),19511,7014,226,26751,12133
hdfs://spark-nn.eemcs.utwente.nl/user/s1934538/clickstream/clickstream-enwiki-2023-03.tsv.gz,Main_Page,54523,135584951,5129661,140769135,33313355
hdfs://spark-nn.eemcs.utwente.nl/user/s1934538/clickstream/clickstream-enwiki-2023-03.tsv.gz,Aaron_Carter,19145,180382,1286,200813,82578
hdfs://spark-nn.eemcs.utwente.nl/user/s1934538/clickstream/clickstream-enwiki-2023-03.tsv.gz,The_Umbrella_Academy_(TV_series),21787,86818,1646,110251,65529
hdfs://spark-nn.eemcs.utwente.nl/user/s1934538/clickstream/clickstream-enwiki-2023-03.tsv.gz,Vladimir_Putin,140684,505323,42051,688058,404644
hdfs://spark-nn.eemcs.utwente.nl/user/s1934538/clickstream/clickstream-enwiki-2023-03.tsv.gz,ChatGPT,76307,6805557,14576,6896440,538461
hdfs://spark-nn.eemcs.utwente.nl/user/s1934538/clickstream/clickstream-enwiki-2023-03.tsv.gz,Pornhub,55897,474026,14662,544585,118275
hdfs://spark-nn.eemcs.utwente.nl/user/s1934538/clickstream/clickstream-enwiki-2023-03.tsv.gz,Sushant_Singh_Rajput,18046,97740,142,115928,49891
hdfs://spark-nn.eemcs.utwente.nl/user/s1934538/clickstream/clickstream-enwiki-2023-03.tsv.gz,List_of_FIFA_World_Cup_finals,3881,63994,55,67930,19165
hdfs://spark-nn.eemcs.utwente.nl/user/s1934538/clickstream/clickstream-enwiki-2023-03.tsv.gz,Mortal_Kombat_(2021_film),25814,81571,1058,108443,102723
hdfs://spark-nn.eemcs.utwente.nl/user/s1934538/clickstream/clickstream-enwiki-2023-03.tsv.gz,David_Beckham,48671,215721,1007,265399,98144
hdfs://spark-nn.eemcs.utwente.nl/user/s1934538/clickstream/clickstream-enwiki-2023-03.tsv.gz,Israel,104996,330253,6975,442224,236984
hdfs://spark-nn.eemcs.utwente.nl/user/s1934538/clickstream/clickstream-enwiki-2023-03.tsv.gz,Joe_Biden,205370,530683,8278,744331,358155
hdfs://spark-nn.eemcs.utwente.nl/user/s1934538/clickstream/clickstream-enwiki-2023-03.tsv.gz,Simple_Mail_Transfer_Protocol,2745,28858,113,31716,2776
hdfs://spark-nn.eemcs.utwente.nl/user/s1934538/clickstream/clickstream-enwiki-2023-03.tsv.gz,Dennis_Nilsen,7615,53629,342,61586,13440
hdfs://spark-nn.eemcs.utwente.nl/user/s1934538/clickstream/clickstream-enwiki-2023-03.tsv.gz,JSON_Web_Token,759,26161,56,26976,2227
hdfs://spark-nn.eemcs.utwente.nl/user/s1934538/clickstream/clickstream-enwiki-2023-03.tsv.gz,House_of_the_Dragon,44081,238302,5131,287514,171753
hdfs://spark-nn.eemcs.utwente.nl/user/s1934538/clickstream/clickstream-enwiki-2023-03.tsv.gz,The_Last_of_Us_(TV_series),432931,4250719,80314,4763964,1895358
hdfs://spark-nn.eemcs.utwente.nl/user/s1934538/clickstream/clickstream-enwiki-2023-03.tsv.gz,George_H._W._Bush,162462,104106,858,267426,166897
hdfs://spark-nn.eemcs.utwente.nl/user/s1934538/clickstream/clickstream-enwiki-2023-03.tsv.gz,Shang-Chi_and_the_Legend_of_the_Ten_Rings,74151,96603,1142,171896,88442
hdfs://spark-nn.eemcs.utwente.nl/user/s1934538/clickstream/clickstream-enwiki-2023-03.tsv.gz,George_VI,291922,114755,609,407286,297673
hdfs://spark-nn.eemcs.utwente.nl/user/s1934538/clickstream/clickstream-enwiki-2023-03.tsv.gz,Joaquin_Phoenix,153960,192747,902,347609,216747
hdfs://spark-nn.eemcs.utwente.nl/user/s1934538/clickstream/clickstream-enwiki-2023-03.tsv.gz,Fyre_Festival,8790,46046,346,55182,30794
hdfs://spark-nn.eemcs.utwente.nl/user/s1934538/clickstream/clickstream-enwiki-2023-03.tsv.gz,Sidharth_Shukla,9671,56999,287,66957,13560
hdfs://spark-nn.eemcs.utwente.nl/user/s1934538/clickstream/clickstream-enwiki-2023-03.tsv.gz,The_Kashmir_Files,11795,41664,180,53639,21415
hdfs://spark-nn.eemcs.utwente.nl/user/s1934538/clickstream/clickstream-enwiki-2023-03.tsv.gz,2018_FIFA_World_Cup,78571,78733,581,157885,100111
hdfs://spark-nn.eemcs.utwente.nl/user/s1934538/clickstream/clickstream-enwiki-2023-03.tsv.gz,State_of_Palestine,63096,138453,135,201684,90397
hdfs://spark-nn.eemcs.utwente.nl/user/s1934538/clickstream/clickstream-enwiki-2023-03.tsv.gz,Barbie_(film),68628,62009,1502,132139,82518
hdfs://spark-nn.eemcs.utwente.nl/user/s1934538/clickstream/clickstream-enwiki-2023-03.tsv.gz,John_McCain,30134,52091,588,82813,41791
hdfs://spark-nn.eemcs.utwente.nl/user/s1934538/clickstream/clickstream-enwiki-2023-03.tsv.gz,Lance_Reddick,291116,3528324,64430,3883870,909519
hdfs://spark-nn.eemcs.utwente.nl/user/s1934538/clickstream/clickstream-enwiki-2023-03.tsv.gz,Qasem_Soleimani,13521,27454,196,41171,24712
hdfs://spark-nn.eemcs.utwente.nl/user/s1934538/clickstream/clickstream-enwiki-2023-03.tsv.gz,Kenosha_unrest_shooting,8356,25645,49,34050,7811
hdfs://spark-nn.eemcs.utwente.nl/user/s1934538/clickstream/clickstream-enwiki-2023-03.tsv.gz,Pathaan_(film),170780,1886846,13132,2070758,767032
hdfs://spark-nn.eemcs.utwente.nl/user/s1934538/clickstream/clickstream-enwiki-2023-03.tsv.gz,Cardi_B,32886,207830,1774,242490,71987
hdfs://spark-nn.eemcs.utwente.nl/user/s1934538/clickstream/clickstream-enwiki-2023-03.tsv.gz,Tenet_(film),53337,123417,1163,177917,88370
hdfs://spark-nn.eemcs.utwente.nl/user/s1934538/clickstream/clickstream-enwiki-2023-03.tsv.gz,Gaza_Strip,21734,41862,291,63887,26491
hdfs://spark-nn.eemcs.utwente.nl/user/s1934538/clickstream/clickstream-enwiki-2023-03.tsv.gz,The_Witcher_(TV_series),31772,126642,2644,161058,82147
hdfs://spark-nn.eemcs.utwente.nl/user/s1934538/clickstream/clickstream-enwiki-2023-03.tsv.gz,RRR_(film),173674,1211859,10830,1396363,813353
hdfs://spark-nn.eemcs.utwente.nl/user/s1934538/clickstream/clickstream-enwiki-2023-03.tsv.gz,1234,54,2673,16,2743,277
hdfs://spark-nn.eemcs.utwente.nl/user/s1934538/clickstream/clickstream-enwiki-2023-03.tsv.gz,Avengers:_Endgame,185654,156756,1847,344257,134243
hdfs://spark-nn.eemcs.utwente.nl/user/s1934538/clickstream/clickstream-enwiki-2023-03.tsv.gz,The_Lion_King_(2019_film),62358,85174,558,148090,54193
hdfs://spark-nn.eemcs.utwente.nl/user/s1934538/clickstream/clickstream-enwiki-2023-03.tsv.gz,Everything_Everywhere_All_at_Once,952299,3902789,173703,5028791,2767382
hdfs://spark-nn.eemcs.utwente.nl/user/s1934538/clickstream/clickstream-enwiki-2023-03.tsv.gz,2020_Summer_Olympics,43874,40934,1386,86194,75414
hdfs://spark-nn.eemcs.utwente.nl/user/s1934538/clickstream/clickstream-enwiki-2023-03.tsv.gz,Rami_Malek,55785,151859,727,208371,91656
hdfs://spark-nn.eemcs.utwente.nl/user/s1934538/clickstream/clickstream-enwiki-2023-03.tsv.gz,Army_of_the_Dead,56113,50756,519,107388,51453
hdfs://spark-nn.eemcs.utwente.nl/user/s1934538/clickstream/clickstream-enwiki-2023-03.tsv.gz,Tom_Brady,69552,272150,2159,343861,118200
hdfs://spark-nn.eemcs.utwente.nl/user/s1934538/clickstream/clickstream-enwiki-2023-03.tsv.gz,Indian_Premier_League,34654,1171940,1188,1207782,190700
hdfs://spark-nn.eemcs.utwente.nl/user/s1934538/clickstream/clickstream-enwiki-2023-03.tsv.gz,Cecil_Hotel_(Los_Angeles),6559,60116,140,66815,17340
hdfs://spark-nn.eemcs.utwente.nl/user/s1934538/clickstream/clickstream-enwiki-2023-03.tsv.gz,Anne_Heche,62508,213585,2052,278145,97802
hdfs://spark-nn.eemcs.utwente.nl/user/s1934538/clickstream/clickstream-enwiki-2023-03.tsv.gz,Antifa_(United_States),8559,100941,380,109880,17539
hdfs://spark-nn.eemcs.utwente.nl/user/s1934538/clickstream/clickstream-enwiki-2023-03.tsv.gz,Henry_V_of_England,79598,89604,311,169513,118211
hdfs://spark-nn.eemcs.utwente.nl/user/s1934538/clickstream/clickstream-enwiki-2023-03.tsv.gz,Louis_Tomlinson,55088,106213,351,161652,45399
hdfs://spark-nn.eemcs.utwente.nl/user/s1934538/clickstream/clickstream-enwiki-2023-03.tsv.gz,Jason_Momoa,70259,326427,1250,397936,148580
hdfs://spark-nn.eemcs.utwente.nl/user/s1934538/clickstream/clickstream-enwiki-2023-03.tsv.gz,Kim_Jong-un,87879,234667,1858,324404,193671
hdfs://spark-nn.eemcs.utwente.nl/user/s1934538/clickstream/clickstream-enwiki-2023-03.tsv.gz,Rihanna,87104,573813,4056,664973,360849
hdfs://spark-nn.eemcs.utwente.nl/user/s1934538/clickstream/clickstream-enwiki-2023-03.tsv.gz,Meat_Loaf,23749,105196,1199,130144,46338
hdfs://spark-nn.eemcs.utwente.nl/user/s1934538/clickstream/clickstream-enwiki-2023-03.tsv.gz,List_of_Queen_of_the_South_episodes,4219,3614,49,7882,191
hdfs://spark-nn.eemcs.utwente.nl/user/s1934538/clickstream/clickstream-enwiki-2023-03.tsv.gz,2.0_(film),28516,50501,100,79117,18990
hdfs://spark-nn.eemcs.utwente.nl/user/s1934538/clickstream/clickstream-enwiki-2023-03.tsv.gz,List_of_highest-grossing_films,235285,465418,3105,703808,299001
hdfs://spark-nn.eemcs.utwente.nl/user/s1934538/clickstream/clickstream-enwiki-2023-03.tsv.gz,Game_of_Thrones_(season_8),13428,32288,425,46141,18654
hdfs://spark-nn.eemcs.utwente.nl/user/s1934538/clickstream/clickstream-enwiki-2023-03.tsv.gz,Aquaman_(film),24668,71303,889,96860,43147
hdfs://spark-nn.eemcs.utwente.nl/user/s1934538/clickstream/clickstream-enwiki-2023-03.tsv.gz,William_Murdoch,687,1559,33,2279,424
hdfs://spark-nn.eemcs.utwente.nl/user/s1934538/clickstream/clickstream-enwiki-2023-03.tsv.gz,John_Wick:_Chapter_4,563703,3222622,63624,3849949,2392010
hdfs://spark-nn.eemcs.utwente.nl/user/s1934538/clickstream/clickstream-enwiki-2023-03.tsv.gz,2023_Asia_Cup,19098,118742,344,138184,39416
hdfs://spark-nn.eemcs.utwente.nl/user/s1934538/clickstream/clickstream-enwiki-2023-03.tsv.gz,Us_(2019_film),28433,76867,422,105722,31384
hdfs://spark-nn.eemcs.utwente.nl/user/s1934538/clickstream/clickstream-enwiki-2023-03.tsv.gz,Richard_Ramirez,14721,150791,1165,166677,48522
hdfs://spark-nn.eemcs.utwente.nl/user/s1934538/clickstream/clickstream-enwiki-2023-03.tsv.gz,Sridevi,41510,109600,219,151329,73984
hdfs://spark-nn.eemcs.utwente.nl/user/s1934538/clickstream/clickstream-enwiki-2023-03.tsv.gz,Lionel_Messi,143284,1252458,8725,1404467,292954
hdfs://spark-nn.eemcs.utwente.nl/user/s1934538/clickstream/clickstream-enwiki-2023-03.tsv.gz,Amy_Coney_Barrett,19881,22704,102,42687,14034
hdfs://spark-nn.eemcs.utwente.nl/user/s1934538/clickstream/clickstream-enwiki-2023-03.tsv.gz,When_They_See_Us,16432,21410,124,37966,16285
hdfs://spark-nn.eemcs.utwente.nl/user/s1934538/clickstream/clickstream-enwiki-2023-03.tsv.gz,Brie_Larson,67266,205687,1550,274503,124046
hdfs://spark-nn.eemcs.utwente.nl/user/s1934538/clickstream/clickstream-enwiki-2023-03.tsv.gz,Black_Widow_(2021_film),40598,77754,907,119259,50081
hdfs://spark-nn.eemcs.utwente.nl/user/s1934538/clickstream/clickstream-enwiki-2023-03.tsv.gz,The_Shape_of_Water,42869,91540,843,135252,56828
hdfs://spark-nn.eemcs.utwente.nl/user/s1934538/clickstream/clickstream-enwiki-2023-03.tsv.gz,Kantara_(film),16721,251920,580,269221,78460
hdfs://spark-nn.eemcs.utwente.nl/user/s1934538/clickstream/clickstream-enwiki-2023-03.tsv.gz,Death_of_Elisa_Lam,12038,62088,231,74357,25668
hdfs://spark-nn.eemcs.utwente.nl/user/s1934538/clickstream/clickstream-enwiki-2023-03.tsv.gz,The_Super_Mario_Bros._Movie,112509,424512,14874,551895,315678
hdfs://spark-nn.eemcs.utwente.nl/user/s1934538/clickstream/clickstream-enwiki-2023-03.tsv.gz,2018_Winter_Olympics,10500,8496,79,19075,12766
hdfs://spark-nn.eemcs.utwente.nl/user/s1934538/clickstream/clickstream-enwiki-2023-03.tsv.gz,Fantastic_Beasts:_The_Crimes_of_Grindelwald,36582,39580,510,76672,38438
hdfs://spark-nn.eemcs.utwente.nl/user/s1934538/clickstream/clickstream-enwiki-2023-03.tsv.gz,Central_Park_jogger_case,10345,56036,296,66677,10010
hdfs://spark-nn.eemcs.utwente.nl/user/s1934538/clickstream/clickstream-enwiki-2023-03.tsv.gz,Adele,29743,242508,2152,274403,99700
hdfs://spark-nn.eemcs.utwente.nl/user/s1934538/clickstream/clickstream-enwiki-2023-03.tsv.gz,War_(2019_film),83819,95822,883,180524,46825
hdfs://spark-nn.eemcs.utwente.nl/user/s1934538/clickstream/clickstream-enwiki-2023-03.tsv.gz,Carlos_Alcaraz,30245,237061,909,268215,63596
hdfs://spark-nn.eemcs.utwente.nl/user/s1934538/clickstream/clickstream-enwiki-2023-03.tsv.gz,Avengers:_Infinity_War,39440,72179,738,112357,48336
hdfs://spark-nn.eemcs.utwente.nl/user/s1934538/clickstream/clickstream-enwiki-2023-04.tsv.gz,Fantastic_Beasts:_The_Crimes_of_Grindelwald,33764,31103,277,65144,35705
hdfs://spark-nn.eemcs.utwente.nl/user/s1934538/clickstream/clickstream-enwiki-2023-04.tsv.gz,List_of_Marvel_Cinematic_Universe_films,175224,476514,1854,653592,449530
hdfs://spark-nn.eemcs.utwente.nl/user/s1934538/clickstream/clickstream-enwiki-2023-04.tsv.gz,Israel,103494,314886,5641,424021,229548
hdfs://spark-nn.eemcs.utwente.nl/user/s1934538/clickstream/clickstream-enwiki-2023-04.tsv.gz,Jeffrey_Dahmer,30733,485184,4202,520119,205317
hdfs://spark-nn.eemcs.utwente.nl/user/s1934538/clickstream/clickstream-enwiki-2023-04.tsv.gz,Tina_Turner,25649,302410,1797,329856,96156
hdfs://spark-nn.eemcs.utwente.nl/user/s1934538/clickstream/clickstream-enwiki-2023-04.tsv.gz,Henry_V_of_England,87071,80416,325,167812,120905
hdfs://spark-nn.eemcs.utwente.nl/user/s1934538/clickstream/clickstream-enwiki-2023-04.tsv.gz,The_Kerala_Story,6857,220256,203,227316,82939
hdfs://spark-nn.eemcs.utwente.nl/user/s1934538/clickstream/clickstream-enwiki-2023-04.tsv.gz,"Prince_Philip,_Duke_of_Edinburgh",129978,126136,1207,257321,160126
hdfs://spark-nn.eemcs.utwente.nl/user/s1934538/clickstream/clickstream-enwiki-2023-04.tsv.gz,The_Idol_(TV_series),48714,123434,1099,173247,121229
hdfs://spark-nn.eemcs.utwente.nl/user/s1934538/clickstream/clickstream-enwiki-2023-04.tsv.gz,Microsoft_Office,5945,139174,600,145719,16240
hdfs://spark-nn.eemcs.utwente.nl/user/s1934538/clickstream/clickstream-enwiki-2023-04.tsv.gz,Wonder_Woman_1984,34377,40403,739,75519,34730
hdfs://spark-nn.eemcs.utwente.nl/user/s1934538/clickstream/clickstream-enwiki-2023-04.tsv.gz,2023_Asia_Cup,20460,111280,333,132073,39597
hdfs://spark-nn.eemcs.utwente.nl/user/s1934538/clickstream/clickstream-enwiki-2023-04.tsv.gz,Sylvester_Stallone,121061,456246,2501,579808,428617
hdfs://spark-nn.eemcs.utwente.nl/user/s1934538/clickstream/clickstream-enwiki-2023-04.tsv.gz,Mötley_Crüe,49055,131670,2659,183384,238948
hdfs://spark-nn.eemcs.utwente.nl/user/s1934538/clickstream/clickstream-enwiki-2023-04.tsv.gz,Spider-Man:_Across_the_Spider-Verse,103089,219797,6177,329063,273649
hdfs://spark-nn.eemcs.utwente.nl/user/s1934538/clickstream/clickstream-enwiki-2023-04.tsv.gz,Chernobyl_(miniseries),20237,59909,1380,81526,92663
hdfs://spark-nn.eemcs.utwente.nl/user/s1934538/clickstream/clickstream-enwiki-2023-04.tsv.gz,The_Batman_(film),86887,184630,3011,274528,153117
hdfs://spark-nn.eemcs.utwente.nl/user/s1934538/clickstream/clickstream-enwiki-2023-04.tsv.gz,When_They_See_Us,13839,19484,124,33447,16407
hdfs://spark-nn.eemcs.utwente.nl/user/s1934538/clickstream/clickstream-enwiki-2023-04.tsv.gz,Tonya_Harding,19535,74540,324,94399,26420
hdfs://spark-nn.eemcs.utwente.nl/user/s1934538/clickstream/clickstream-enwiki-2023-04.tsv.gz,UEFA_Euro_2020,35208,34166,486,69860,45346
hdfs://spark-nn.eemcs.utwente.nl/user/s1934538/clickstream/clickstream-enwiki-2023-04.tsv.gz,Glass_(2019_film),40517,44911,331,85759,29232
hdfs://spark-nn.eemcs.utwente.nl/user/s1934538/clickstream/clickstream-enwiki-2023-04.tsv.gz,Game_of_Thrones_(season_8),12387,29746,367,42500,17948
hdfs://spark-nn.eemcs.utwente.nl/user/s1934538/clickstream/clickstream-enwiki-2023-04.tsv.gz,Aquaman_(film),23794,64650,816,89260,40056
hdfs://spark-nn.eemcs.utwente.nl/user/s1934538/clickstream/clickstream-enwiki-2023-04.tsv.gz,RRR_(film),54793,333362,3244,391399,213760
hdfs://spark-nn.eemcs.utwente.nl/user/s1934538/clickstream/clickstream-enwiki-2023-04.tsv.gz,Amber_Heard,72963,171173,1168,245304,104736
hdfs://spark-nn.eemcs.utwente.nl/user/s1934538/clickstream/clickstream-enwiki-2023-04.tsv.gz,COVID-19_pandemic,82650,187079,5743,275472,88457
hdfs://spark-nn.eemcs.utwente.nl/user/s1934538/clickstream/clickstream-enwiki-2023-04.tsv.gz,2022_FIFA_World_Cup,119494,212300,2558,334352,207376
hdfs://spark-nn.eemcs.utwente.nl/user/s1934538/clickstream/clickstream-enwiki-2023-04.tsv.gz,Anne_Heche,47382,161078,943,209403,71705
hdfs://spark-nn.eemcs.utwente.nl/user/s1934538/clickstream/clickstream-enwiki-2023-04.tsv.gz,The_Flash_(film),106622,300190,8976,415788,286242
hdfs://spark-nn.eemcs.utwente.nl/user/s1934538/clickstream/clickstream-enwiki-2023-04.tsv.gz,Russo-Ukrainian_War,111362,313675,2250,427287,282751
hdfs://spark-nn.eemcs.utwente.nl/user/s1934538/clickstream/clickstream-enwiki-2023-04.tsv.gz,House_of_the_Dragon,45738,193497,5897,245132,151399
hdfs://spark-nn.eemcs.utwente.nl/user/s1934538/clickstream/clickstream-enwiki-2023-04.tsv.gz,The_Sandman_(TV_series),34567,71774,1177,107518,72388
hdfs://spark-nn.eemcs.utwente.nl/user/s1934538/clickstream/clickstream-enwiki-2023-04.tsv.gz,Puneeth_Rajkumar,17306,65536,33,82875,31899
hdfs://spark-nn.eemcs.utwente.nl/user/s1934538/clickstream/clickstream-enwiki-2023-04.tsv.gz,It_Chapter_Two,35404,52979,520,88903,56473
hdfs://spark-nn.eemcs.utwente.nl/user/s1934538/clickstream/clickstream-enwiki-2023-04.tsv.gz,Central_Park_jogger_case,11611,86620,634,98865,14902
hdfs://spark-nn.eemcs.utwente.nl/user/s1934538/clickstream/clickstream-enwiki-2023-04.tsv.gz,Sidharth_Shukla,13191,56117,428,69736,12918
hdfs://spark-nn.eemcs.utwente.nl/user/s1934538/clickstream/clickstream-enwiki-2023-04.tsv.gz,Donald_Trump,276306,1018033,42618,1336957,812170
hdfs://spark-nn.eemcs.utwente.nl/user/s1934538/clickstream/clickstream-enwiki-2023-04.tsv.gz,Joe_Exotic,28998,62266,362,91626,44500
hdfs://spark-nn.eemcs.utwente.nl/user/s1934538/clickstream/clickstream-enwiki-2023-04.tsv.gz,2016_United_States_presidential_election,118852,78751,1045,198648,174194
hdfs://spark-nn.eemcs.utwente.nl/user/s1934538/clickstream/clickstream-enwiki-2023-04.tsv.gz,WrestleMania_34,44643,24584,138,69365,48092
hdfs://spark-nn.eemcs.utwente.nl/user/s1934538/clickstream/clickstream-enwiki-2023-04.tsv.gz,Pathaan_(film),112215,644520,4781,761516,271249
hdfs://spark-nn.eemcs.utwente.nl/user/s1934538/clickstream/clickstream-enwiki-2023-04.tsv.gz,Bridgerton,35280,126575,1981,163836,128738
hdfs://spark-nn.eemcs.utwente.nl/user/s1934538/clickstream/clickstream-enwiki-2023-04.tsv.gz,Atal_Bihari_Vajpayee,33190,44899,41,78130,31082
hdfs://spark-nn.eemcs.utwente.nl/user/s1934538/clickstream/clickstream-enwiki-2023-04.tsv.gz,Cricket_World_Cup,23526,87913,396,111835,73250
hdfs://spark-nn.eemcs.utwente.nl/user/s1934538/clickstream/clickstream-enwiki-2023-04.tsv.gz,XXXTentacion,59085,1027961,5449,1092495,120859
hdfs://spark-nn.eemcs.utwente.nl/user/s1934538/clickstream/clickstream-enwiki-2023-04.tsv.gz,Qasem_Soleimani,12660,25310,146,38116,21964
hdfs://spark-nn.eemcs.utwente.nl/user/s1934538/clickstream/clickstream-enwiki-2023-04.tsv.gz,Zack_Snyder's_Justice_League,45249,68296,483,114028,50076
hdfs://spark-nn.eemcs.utwente.nl/user/s1934538/clickstream/clickstream-enwiki-2023-04.tsv.gz,Cristiano_Ronaldo,145900,1136598,5650,1288148,306216
hdfs://spark-nn.eemcs.utwente.nl/user/s1934538/clickstream/clickstream-enwiki-2023-04.tsv.gz,Volodymyr_Zelenskyy,69268,126336,1300,196904,105603
hdfs://spark-nn.eemcs.utwente.nl/user/s1934538/clickstream/clickstream-enwiki-2023-04.tsv.gz,Asia_Cup,5690,35760,125,41575,22380
hdfs://spark-nn.eemcs.utwente.nl/user/s1934538/clickstream/clickstream-enwiki-2023-04.tsv.gz,Aaron_Carter,32210,242657,2414,277281,144580
hdfs://spark-nn.eemcs.utwente.nl/user/s1934538/clickstream/clickstream-enwiki-2023-04.tsv.gz,Brett_Kavanaugh,22151,24481,182,46814,18129
hdfs://spark-nn.eemcs.utwente.nl/user/s1934538/clickstream/clickstream-enwiki-2023-04.tsv.gz,Laal_Singh_Chaddha,21303,67412,168,88883,30683
hdfs://spark-nn.eemcs.utwente.nl/user/s1934538/clickstream/clickstream-enwiki-2023-04.tsv.gz,Mulan_(2020_film),21839,47979,665,70483,37081
hdfs://spark-nn.eemcs.utwente.nl/user/s1934538/clickstream/clickstream-enwiki-2023-04.tsv.gz,Bob_Saget,27631,91257,657,119545,23007
hdfs://spark-nn.eemcs.utwente.nl/user/s1934538/clickstream/clickstream-enwiki-2023-04.tsv.gz,War_(2019_film),49004,71518,111,120633,42515
hdfs://spark-nn.eemcs.utwente.nl/user/s1934538/clickstream/clickstream-enwiki-2023-04.tsv.gz,Taliban,41304,69723,729,111756,85272
hdfs://spark-nn.eemcs.utwente.nl/user/s1934538/clickstream/clickstream-enwiki-2023-04.tsv.gz,Notre-Dame_de_Paris,15909,113575,4364,133848,33020
hdfs://spark-nn.eemcs.utwente.nl/user/s1934538/clickstream/clickstream-enwiki-2023-04.tsv.gz,Game_of_Thrones,72008,242022,4579,318609,191160
hdfs://spark-nn.eemcs.utwente.nl/user/s1934538/clickstream/clickstream-enwiki-2023-04.tsv.gz,Leave_the_World_Behind_(film),13743,3851,12,17606,5609
hdfs://spark-nn.eemcs.utwente.nl/user/s1934538/clickstream/clickstream-enwiki-2023-04.tsv.gz,Kantara_(film),12782,110169,386,123337,49605
hdfs://spark-nn.eemcs.utwente.nl/user/s1934538/clickstream/clickstream-enwiki-2023-04.tsv.gz,List_of_FIFA_World_Cup_finals,2983,48398,56,51437,14719
hdfs://spark-nn.eemcs.utwente.nl/user/s1934538/clickstream/clickstream-enwiki-2023-04.tsv.gz,Wikipedia,224889,740856,1329,967074,323751
hdfs://spark-nn.eemcs.utwente.nl/user/s1934538/clickstream/clickstream-enwiki-2023-04.tsv.gz,Deion_Sanders,16334,166643,894,183871,52211
hdfs://spark-nn.eemcs.utwente.nl/user/s1934538/clickstream/clickstream-enwiki-2023-04.tsv.gz,Burt_Reynolds,75398,191739,1230,268367,143004
hdfs://spark-nn.eemcs.utwente.nl/user/s1934538/clickstream/clickstream-enwiki-2023-04.tsv.gz,Everything_Everywhere_All_at_Once,110121,520833,7700,638654,332669
hdfs://spark-nn.eemcs.utwente.nl/user/s1934538/clickstream/clickstream-enwiki-2023-04.tsv.gz,Main_Page,58299,129540695,4472613,134071607,31374286
hdfs://spark-nn.eemcs.utwente.nl/user/s1934538/clickstream/clickstream-enwiki-2023-04.tsv.gz,ICC_Men's_T20_World_Cup,14424,68147,400,82971,39404
hdfs://spark-nn.eemcs.utwente.nl/user/s1934538/clickstream/clickstream-enwiki-2023-04.tsv.gz,Jeffrey_Epstein,55974,210185,1384,267543,131570
hdfs://spark-nn.eemcs.utwente.nl/user/s1934538/clickstream/clickstream-enwiki-2023-04.tsv.gz,The_Kashmir_Files,10426,31751,54,42231,17344
hdfs://spark-nn.eemcs.utwente.nl/user/s1934538/clickstream/clickstream-enwiki-2023-04.tsv.gz,Avengers:_Infinity_War,37882,59729,1555,99166,48759
hdfs://spark-nn.eemcs.utwente.nl/user/s1934538/clickstream/clickstream-enwiki-2023-04.tsv.gz,2018_FIFA_World_Cup,61656,55653,442,117751,79227
hdfs://spark-nn.eemcs.utwente.nl/user/s1934538/clickstream/clickstream-enwiki-2023-04.tsv.gz,Mac_Miller,26509,154581,954,182044,55802
hdfs://spark-nn.eemcs.utwente.nl/user/s1934538/clickstream/clickstream-enwiki-2023-04.tsv.gz,Article_370_of_the_Constitution_of_India,4814,58448,228,63490,3269
hdfs://spark-nn.eemcs.utwente.nl/user/s1934538/clickstream/clickstream-enwiki-2023-04.tsv.gz,2018_Asian_Games,6781,4684,51,11516,12382
hdfs://spark-nn.eemcs.utwente.nl/user/s1934538/clickstream/clickstream-enwiki-2023-04.tsv.gz,Spanish_flu,15303,42963,446,58712,16526
hdfs://spark-nn.eemcs.utwente.nl/user/s1934538/clickstream/clickstream-enwiki-2023-04.tsv.gz,Roe_v._Wade,18510,112098,780,131388,45285
hdfs://spark-nn.eemcs.utwente.nl/user/s1934538/clickstream/clickstream-enwiki-2023-04.tsv.gz,Emma_Raducanu,3862,60200,775,64837,11260
hdfs://spark-nn.eemcs.utwente.nl/user/s1934538/clickstream/clickstream-enwiki-2023-04.tsv.gz,Shang-Chi_and_the_Legend_of_the_Ten_Rings,45788,67050,714,113552,63503
hdfs://spark-nn.eemcs.utwente.nl/user/s1934538/clickstream/clickstream-enwiki-2023-04.tsv.gz,The_Haunting_of_Bly_Manor,16405,32994,207,49606,25690
hdfs://spark-nn.eemcs.utwente.nl/user/s1934538/clickstream/clickstream-enwiki-2023-04.tsv.gz,Croatia,52140,142289,2295,196724,71547
hdfs://spark-nn.eemcs.utwente.nl/user/s1934538/clickstream/clickstream-enwiki-2023-04.tsv.gz,FIFA_World_Cup,52433,178905,2212,233550,158989
hdfs://spark-nn.eemcs.utwente.nl/user/s1934538/clickstream/clickstream-enwiki-2023-04.tsv.gz,Parasite_(2019_film),29305,120322,1102,150729,62610
hdfs://spark-nn.eemcs.utwente.nl/user/s1934538/clickstream/clickstream-enwiki-2023-04.tsv.gz,ChatGPT,59035,7906522,12239,7977796,527631
hdfs://spark-nn.eemcs.utwente.nl/user/s1934538/clickstream/clickstream-enwiki-2023-04.tsv.gz,"Princess_Margaret,_Countess_of_Snowdon",69010,154221,1021,224252,129838
hdfs://spark-nn.eemcs.utwente.nl/user/s1934538/clickstream/clickstream-enwiki-2023-04.tsv.gz,Cook's_Country,365,1976,35,2376,429
hdfs://spark-nn.eemcs.utwente.nl/user/s1934538/clickstream/clickstream-enwiki-2023-04.tsv.gz,Cecil_Hotel_(Los_Angeles),6423,43419,126,49968,13207
hdfs://spark-nn.eemcs.utwente.nl/user/s1934538/clickstream/clickstream-enwiki-2023-04.tsv.gz,Black_Panther_(film),32161,84817,942,117920,59367
hdfs://spark-nn.eemcs.utwente.nl/user/s1934538/clickstream/clickstream-enwiki-2023-04.tsv.gz,Dennis_Nilsen,7657,49821,274,57752,13536
hdfs://spark-nn.eemcs.utwente.nl/user/s1934538/clickstream/clickstream-enwiki-2023-04.tsv.gz,YouTube,125748,3327598,9826,3463172,119174
hdfs://spark-nn.eemcs.utwente.nl/user/s1934538/clickstream/clickstream-enwiki-2023-04.tsv.gz,Shinzo_Abe,55129,121551,1483,178163,127360
hdfs://spark-nn.eemcs.utwente.nl/user/s1934538/clickstream/clickstream-enwiki-2023-04.tsv.gz,"Meghan,_Duchess_of_Sussex",82505,254312,1402,338219,184045
hdfs://spark-nn.eemcs.utwente.nl/user/s1934538/clickstream/clickstream-enwiki-2023-04.tsv.gz,The_Super_Mario_Bros._Movie,588867,3528663,98760,4216290,2360082
hdfs://spark-nn.eemcs.utwente.nl/user/s1934538/clickstream/clickstream-enwiki-2023-04.tsv.gz,Stan_Lee,33001,92487,686,126174,37351
hdfs://spark-nn.eemcs.utwente.nl/user/s1934538/clickstream/clickstream-enwiki-2023-04.tsv.gz,List_of_James_Bond_films,57410,318790,1425,377625,244960
hdfs://spark-nn.eemcs.utwente.nl/user/s1934538/clickstream/clickstream-enwiki-2023-04.tsv.gz,Ukraine,87837,279657,7817,375311,184575
hdfs://spark-nn.eemcs.utwente.nl/user/s1934538/clickstream/clickstream-enwiki-2023-04.tsv.gz,Valentine's_Day,3904,39975,217,44096,3675
hdfs://spark-nn.eemcs.utwente.nl/user/s1934538/clickstream/clickstream-enwiki-2023-04.tsv.gz,JSON_Web_Token,685,21977,36,22698,1781
hdfs://spark-nn.eemcs.utwente.nl/user/s1934538/clickstream/clickstream-enwiki-2023-04.tsv.gz,Mortal_Kombat_(2021_film),27308,78085,1260,106653,97892
hdfs://spark-nn.eemcs.utwente.nl/user/s1934538/clickstream/clickstream-enwiki-2023-04.tsv.gz,John_McCain,34015,64507,636,99158,51570
hdfs://spark-nn.eemcs.utwente.nl/user/s1934538/clickstream/clickstream-enwiki-2023-04.tsv.gz,Barbie_(film),163388,598787,13594,775769,987559
hdfs://spark-nn.eemcs.utwente.nl/user/s1934538/clickstream/clickstream-enwiki-2023-04.tsv.gz,XHamster,8058,181943,5275,195276,20834
hdfs://spark-nn.eemcs.utwente.nl/user/s1934538/clickstream/clickstream-enwiki-2023-04.tsv.gz,Simone_Biles,20671,113635,734,135040,48992
hdfs://spark-nn.eemcs.utwente.nl/user/s1934538/clickstream/clickstream-enwiki-2023-04.tsv.gz,Indian_Premier_League,67927,8438011,2666,8508604,398211
hdfs://spark-nn.eemcs.utwente.nl/user/s1934538/clickstream/clickstream-enwiki-2023-04.tsv.gz,Kenosha_unrest_shooting,8334,21291,46,29671,7309
hdfs://spark-nn.eemcs.utwente.nl/user/s1934538/clickstream/clickstream-enwiki-2023-04.tsv.gz,Sridevi,33014,80361,205,113580,58474
hdfs://spark-nn.eemcs.utwente.nl/user/s1934538/clickstream/clickstream-enwiki-2023-04.tsv.gz,David_Beckham,45364,200740,819,246923,93625
hdfs://spark-nn.eemcs.utwente.nl/user/s1934538/clickstream/clickstream-enwiki-2023-04.tsv.gz,Sushant_Singh_Rajput,17424,84904,172,102500,48479
hdfs://spark-nn.eemcs.utwente.nl/user/s1934538/clickstream/clickstream-enwiki-2023-04.tsv.gz,Brahmāstra:_Part_One_–_Shiva,34607,115633,386,150626,41272
hdfs://spark-nn.eemcs.utwente.nl/user/s1934538/clickstream/clickstream-enwiki-2023-04.tsv.gz,Spider-Man:_Far_From_Home,36328,39610,333,76271,33712
hdfs://spark-nn.eemcs.utwente.nl/user/s1934538/clickstream/clickstream-enwiki-2023-04.tsv.gz,2.0_(film),20758,25636,44,46438,11692
hdfs://spark-nn.eemcs.utwente.nl/user/s1934538/clickstream/clickstream-enwiki-2023-04.tsv.gz,Irrfan_Khan,29254,76517,107,105878,40985
hdfs://spark-nn.eemcs.utwente.nl/user/s1934538/clickstream/clickstream-enwiki-2023-04.tsv.gz,Adipurush,44797,146718,3072,194587,122048
hdfs://spark-nn.eemcs.utwente.nl/user/s1934538/clickstream/clickstream-enwiki-2023-04.tsv.gz,Stranger_Things_(season_3),10906,18040,171,29117,16235
hdfs://spark-nn.eemcs.utwente.nl/user/s1934538/clickstream/clickstream-enwiki-2023-04.tsv.gz,Jason_Momoa,63873,282658,1241,347772,152889
hdfs://spark-nn.eemcs.utwente.nl/user/s1934538/clickstream/clickstream-enwiki-2023-04.tsv.gz,Nipsey_Hussle,29460,91445,480,121385,39598
hdfs://spark-nn.eemcs.utwente.nl/user/s1934538/clickstream/clickstream-enwiki-2023-04.tsv.gz,"Diana,_Princess_of_Wales",132265,255767,2142,390174,223722
hdfs://spark-nn.eemcs.utwente.nl/user/s1934538/clickstream/clickstream-enwiki-2023-04.tsv.gz,Sinéad_O'Connor,16291,126874,910,144075,56203
hdfs://spark-nn.eemcs.utwente.nl/user/s1934538/clickstream/clickstream-enwiki-2023-04.tsv.gz,Kobe_Bryant_sexual_assault_case,7447,29347,30,36824,3565
hdfs://spark-nn.eemcs.utwente.nl/user/s1934538/clickstream/clickstream-enwiki-2023-04.tsv.gz,Fyre_Festival,11633,88080,906,100619,57667
hdfs://spark-nn.eemcs.utwente.nl/user/s1934538/clickstream/clickstream-enwiki-2023-04.tsv.gz,Alexander_Hamilton,70309,214234,1390,285933,179516
hdfs://spark-nn.eemcs.utwente.nl/user/s1934538/clickstream/clickstream-enwiki-2023-04.tsv.gz,List_of_highest-grossing_films,170283,468145,6038,644466,297419
hdfs://spark-nn.eemcs.utwente.nl/user/s1934538/clickstream/clickstream-enwiki-2023-04.tsv.gz,QAnon,40566,109971,1127,151664,49911
hdfs://spark-nn.eemcs.utwente.nl/user/s1934538/clickstream/clickstream-enwiki-2023-04.tsv.gz,Doctor_Strange_in_the_Multiverse_of_Madness,63871,85857,1563,151291,75460
hdfs://spark-nn.eemcs.utwente.nl/user/s1934538/clickstream/clickstream-enwiki-2023-04.tsv.gz,The_Queen's_Gambit_(miniseries),23136,87178,744,111058,54137
hdfs://spark-nn.eemcs.utwente.nl/user/s1934538/clickstream/clickstream-enwiki-2023-04.tsv.gz,Greta_Thunberg,13739,142223,880,156842,37899
hdfs://spark-nn.eemcs.utwente.nl/user/s1934538/clickstream/clickstream-enwiki-2023-04.tsv.gz,Jenna_Ortega,113472,557646,13221,684339,190395
hdfs://spark-nn.eemcs.utwente.nl/user/s1934538/clickstream/clickstream-enwiki-2023-04.tsv.gz,A_Star_Is_Born_(2018_film),23021,68766,445,92232,45535
hdfs://spark-nn.eemcs.utwente.nl/user/s1934538/clickstream/clickstream-enwiki-2023-04.tsv.gz,Kobe_Bryant,66881,375465,2594,444940,132222
hdfs://spark-nn.eemcs.utwente.nl/user/s1934538/clickstream/clickstream-enwiki-2023-04.tsv.gz,Avatar:_The_Way_of_Water,152362,862149,17380,1031891,512697
hdfs://spark-nn.eemcs.utwente.nl/user/s1934538/clickstream/clickstream-enwiki-2023-04.tsv.gz,Johnny_Depp,109856,286190,2392,398438,268887
hdfs://spark-nn.eemcs.utwente.nl/user/s1934538/clickstream/clickstream-enwiki-2023-04.tsv.gz,Anthony_Bourdain,20812,249131,1755,271698,108337
hdfs://spark-nn.eemcs.utwente.nl/user/s1934538/clickstream/clickstream-enwiki-2023-04.tsv.gz,2020_Summer_Olympics,42668,36243,1159,80070,72021
hdfs://spark-nn.eemcs.utwente.nl/user/s1934538/clickstream/clickstream-enwiki-2023-04.tsv.gz,Once_Upon_a_Time_in_Hollywood,90820,128327,2039,221186,240288
hdfs://spark-nn.eemcs.utwente.nl/user/s1934538/clickstream/clickstream-enwiki-2023-05.tsv.gz,Darth_Vader,47618,132035,988,180641,109082
hdfs://spark-nn.eemcs.utwente.nl/user/s1934538/clickstream/clickstream-enwiki-2023-05.tsv.gz,Charles_III,1280540,1838577,107217,3226334,2191247
hdfs://spark-nn.eemcs.utwente.nl/user/s1934538/clickstream/clickstream-enwiki-2023-05.tsv.gz,Death_of_Elisa_Lam,10720,84564,562,95846,26358
hdfs://spark-nn.eemcs.utwente.nl/user/s1934538/clickstream/clickstream-enwiki-2023-05.tsv.gz,John_McCain,30562,60252,694,91508,45907
hdfs://spark-nn.eemcs.utwente.nl/user/s1934538/clickstream/clickstream-enwiki-2023-05.tsv.gz,Cricket_World_Cup,44002,143319,532,187853,71215
hdfs://spark-nn.eemcs.utwente.nl/user/s1934538/clickstream/clickstream-enwiki-2023-05.tsv.gz,Jason_Momoa,126862,530517,2300,659679,301748
hdfs://spark-nn.eemcs.utwente.nl/user/s1934538/clickstream/clickstream-enwiki-2023-05.tsv.gz,Ray_Liotta,69394,385832,3564,458790,153772
hdfs://spark-nn.eemcs.utwente.nl/user/s1934538/clickstream/clickstream-enwiki-2023-05.tsv.gz,HTTP_cookie,2258,273595,119,275972,16598
hdfs://spark-nn.eemcs.utwente.nl/user/s1934538/clickstream/clickstream-enwiki-2023-05.tsv.gz,Stranger_Things_(season_3),10766,19881,191,30838,16935
hdfs://spark-nn.eemcs.utwente.nl/user/s1934538/clickstream/clickstream-enwiki-2023-05.tsv.gz,Ghislaine_Maxwell,96359,121189,437,217985,93216
hdfs://spark-nn.eemcs.utwente.nl/user/s1934538/clickstream/clickstream-enwiki-2023-05.tsv.gz,George_H._W._Bush,151767,109637,775,262179,159398
hdfs://spark-nn.eemcs.utwente.nl/user/s1934538/clickstream/clickstream-enwiki-2023-05.tsv.gz,Adele,33567,254604,2446,290617,104070
hdfs://spark-nn.eemcs.utwente.nl/user/s1934538/clickstream/clickstream-enwiki-2023-05.tsv.gz,"Diana,_Princess_of_Wales",461440,792608,5286,1259334,765702
hdfs://spark-nn.eemcs.utwente.nl/user/s1934538/clickstream/clickstream-enwiki-2023-05.tsv.gz,Salman_Rushdie,63845,122550,1038,187433,101811
hdfs://spark-nn.eemcs.utwente.nl/user/s1934538/clickstream/clickstream-enwiki-2023-05.tsv.gz,Freddie_Mercury,74862,405454,3132,483448,193316
hdfs://spark-nn.eemcs.utwente.nl/user/s1934538/clickstream/clickstream-enwiki-2023-05.tsv.gz,Thor:_Love_and_Thunder,95469,142385,2194,240048,112089
hdfs://spark-nn.eemcs.utwente.nl/user/s1934538/clickstream/clickstream-enwiki-2023-05.tsv.gz,Oppenheimer_(film),168801,754830,18154,941785,903445
hdfs://spark-nn.eemcs.utwente.nl/user/s1934538/clickstream/clickstream-enwiki-2023-05.tsv.gz,Mulan_(2020_film),27075,57358,697,85130,43282
hdfs://spark-nn.eemcs.utwente.nl/user/s1934538/clickstream/clickstream-enwiki-2023-05.tsv.gz,Top_Gun:_Maverick,113543,235843,4415,353801,255333
hdfs://spark-nn.eemcs.utwente.nl/user/s1934538/clickstream/clickstream-enwiki-2023-05.tsv.gz,Zack_Snyder's_Justice_League,48666,74155,528,123349,49580
hdfs://spark-nn.eemcs.utwente.nl/user/s1934538/clickstream/clickstream-enwiki-2023-05.tsv.gz,Ted_Bundy,25921,299578,3719,329218,76325
hdfs://spark-nn.eemcs.utwente.nl/user/s1934538/clickstream/clickstream-enwiki-2023-05.tsv.gz,Cristiano_Ronaldo,130156,1186860,5945,1322961,282463
hdfs://spark-nn.eemcs.utwente.nl/user/s1934538/clickstream/clickstream-enwiki-2023-05.tsv.gz,The_Falcon_and_the_Winter_Soldier,19872,28377,381,48630,26088
hdfs://spark-nn.eemcs.utwente.nl/user/s1934538/clickstream/clickstream-enwiki-2023-05.tsv.gz,Meat_Loaf,23176,89377,953,113506,42233
hdfs://spark-nn.eemcs.utwente.nl/user/s1934538/clickstream/clickstream-enwiki-2023-05.tsv.gz,The_Weeknd,77800,399740,3916,481456,184120
hdfs://spark-nn.eemcs.utwente.nl/user/s1934538/clickstream/clickstream-enwiki-2023-05.tsv.gz,Once_Upon_a_Time_in_Hollywood,95213,134832,2370,232415,235269
hdfs://spark-nn.eemcs.utwente.nl/user/s1934538/clickstream/clickstream-enwiki-2023-05.tsv.gz,Lists_of_deaths_by_year,18450,226021,1255,245726,275511
hdfs://spark-nn.eemcs.utwente.nl/user/s1934538/clickstream/clickstream-enwiki-2023-05.tsv.gz,Brett_Kavanaugh,15190,22843,156,38189,13367
hdfs://spark-nn.eemcs.utwente.nl/user/s1934538/clickstream/clickstream-enwiki-2023-05.tsv.gz,Shakira,23132,346360,3558,373050,138050
hdfs://spark-nn.eemcs.utwente.nl/user/s1934538/clickstream/clickstream-enwiki-2023-05.tsv.gz,Us_(2019_film),22116,53449,285,75850,22319
hdfs://spark-nn.eemcs.utwente.nl/user/s1934538/clickstream/clickstream-enwiki-2023-05.tsv.gz,Sylvester_Stallone,152729,814166,4775,971670,764188
hdfs://spark-nn.eemcs.utwente.nl/user/s1934538/clickstream/clickstream-enwiki-2023-05.tsv.gz,House_of_the_Dragon,44602,180022,5102,229726,139220
hdfs://spark-nn.eemcs.utwente.nl/user/s1934538/clickstream/clickstream-enwiki-2023-05.tsv.gz,Jimmy_Buffett,10709,116662,1204,128575,41002
hdfs://spark-nn.eemcs.utwente.nl/user/s1934538/clickstream/clickstream-enwiki-2023-05.tsv.gz,Chernobyl_(miniseries),20089,60136,1349,81574,89602
hdfs://spark-nn.eemcs.utwente.nl/user/s1934538/clickstream/clickstream-enwiki-2023-05.tsv.gz,R._Kelly,36274,139057,1429,176760,99939
hdfs://spark-nn.eemcs.utwente.nl/user/s1934538/clickstream/clickstream-enwiki-2023-05.tsv.gz,Tom_Brady,52420,250228,2117,304765,116696
hdfs://spark-nn.eemcs.utwente.nl/user/s1934538/clickstream/clickstream-enwiki-2023-05.tsv.gz,Aquaman_(film),30097,109681,919,140697,49147
hdfs://spark-nn.eemcs.utwente.nl/user/s1934538/clickstream/clickstream-enwiki-2023-05.tsv.gz,YouTube,138456,5711963,10384,5860803,123059
hdfs://spark-nn.eemcs.utwente.nl/user/s1934538/clickstream/clickstream-enwiki-2023-05.tsv.gz,Volodymyr_Zelenskyy,93344,217125,2240,312709,166424
hdfs://spark-nn.eemcs.utwente.nl/user/s1934538/clickstream/clickstream-enwiki-2023-05.tsv.gz,September_11_attacks,116365,326420,4816,447601,291139
hdfs://spark-nn.eemcs.utwente.nl/user/s1934538/clickstream/clickstream-enwiki-2023-05.tsv.gz,Betty_White,45205,119706,1152,166063,44443
hdfs://spark-nn.eemcs.utwente.nl/user/s1934538/clickstream/clickstream-enwiki-2023-05.tsv.gz,Army_of_the_Dead,53887,42640,4136,100663,48938
hdfs://spark-nn.eemcs.utwente.nl/user/s1934538/clickstream/clickstream-enwiki-2023-05.tsv.gz,2023_Asia_Cup,51317,375002,570,426889,71965
hdfs://spark-nn.eemcs.utwente.nl/user/s1934538/clickstream/clickstream-enwiki-2023-05.tsv.gz,Mac_Miller,24089,164497,1028,189614,58879
hdfs://spark-nn.eemcs.utwente.nl/user/s1934538/clickstream/clickstream-enwiki-2023-05.tsv.gz,Anthony_Bourdain,21399,195902,1413,218714,92443
hdfs://spark-nn.eemcs.utwente.nl/user/s1934538/clickstream/clickstream-enwiki-2023-05.tsv.gz,Ponniyin_Selvan:_I,103948,632287,1609,737844,381812
hdfs://spark-nn.eemcs.utwente.nl/user/s1934538/clickstream/clickstream-enwiki-2023-05.tsv.gz,Sushma_Swaraj,18346,32349,23,50718,12164
hdfs://spark-nn.eemcs.utwente.nl/user/s1934538/clickstream/clickstream-enwiki-2023-05.tsv.gz,Henry_V_of_England,122020,92431,501,214952,159640
hdfs://spark-nn.eemcs.utwente.nl/user/s1934538/clickstream/clickstream-enwiki-2023-05.tsv.gz,Avengers:_Infinity_War,57572,87463,1139,146174,68969
hdfs://spark-nn.eemcs.utwente.nl/user/s1934538/clickstream/clickstream-enwiki-2023-05.tsv.gz,Jawan_(film),84932,242120,9490,336542,201058
hdfs://spark-nn.eemcs.utwente.nl/user/s1934538/clickstream/clickstream-enwiki-2023-05.tsv.gz,Matthew_Perry,43503,118712,668,162883,76209
hdfs://spark-nn.eemcs.utwente.nl/user/s1934538/clickstream/clickstream-enwiki-2023-05.tsv.gz,Pornhub,85665,328810,14232,428707,80042
hdfs://spark-nn.eemcs.utwente.nl/user/s1934538/clickstream/clickstream-enwiki-2023-05.tsv.gz,Joe_Biden,201094,562931,8023,772048,346026
hdfs://spark-nn.eemcs.utwente.nl/user/s1934538/clickstream/clickstream-enwiki-2023-05.tsv.gz,Louis_Tomlinson,28379,50093,243,78715,22664
hdfs://spark-nn.eemcs.utwente.nl/user/s1934538/clickstream/clickstream-enwiki-2023-05.tsv.gz,No_Time_to_Die,93447,131372,1899,226718,117694
hdfs://spark-nn.eemcs.utwente.nl/user/s1934538/clickstream/clickstream-enwiki-2023-05.tsv.gz,Vikram_(2022_film),36443,123780,326,160549,55241
hdfs://spark-nn.eemcs.utwente.nl/user/s1934538/clickstream/clickstream-enwiki-2023-05.tsv.gz,Eternals_(film),69780,120495,1524,191799,128799
hdfs://spark-nn.eemcs.utwente.nl/user/s1934538/clickstream/clickstream-enwiki-2023-05.tsv.gz,Area_51,16732,113094,964,130790,41968
hdfs://spark-nn.eemcs.utwente.nl/user/s1934538/clickstream/clickstream-enwiki-2023-05.tsv.gz,Coronavirus,5275,28097,575,33947,10993
hdfs://spark-nn.eemcs.utwente.nl/user/s1934538/clickstream/clickstream-enwiki-2023-05.tsv.gz,Spider-Man:_Across_the_Spider-Verse,183498,665851,17469,866818,493152
hdfs://spark-nn.eemcs.utwente.nl/user/s1934538/clickstream/clickstream-enwiki-2023-05.tsv.gz,Squid_Game,16420,123161,2306,141887,56883
hdfs://spark-nn.eemcs.utwente.nl/user/s1934538/clickstream/clickstream-enwiki-2023-05.tsv.gz,The_Suicide_Squad_(film),116968,127261,1677,245906,146792
hdfs://spark-nn.eemcs.utwente.nl/user/s1934538/clickstream/clickstream-enwiki-2023-05.tsv.gz,UEFA_Euro_2020,35293,33627,448,69368,44834
hdfs://spark-nn.eemcs.utwente.nl/user/s1934538/clickstream/clickstream-enwiki-2023-05.tsv.gz,Kobe_Bryant_sexual_assault_case,10097,41843,66,52006,5187
hdfs://spark-nn.eemcs.utwente.nl/user/s1934538/clickstream/clickstream-enwiki-2023-05.tsv.gz,Black_Panther_(film),31585,130386,816,162787,53015
hdfs://spark-nn.eemcs.utwente.nl/user/s1934538/clickstream/clickstream-enwiki-2023-05.tsv.gz,Anne_Heche,42799,155636,1171,199606,70575
hdfs://spark-nn.eemcs.utwente.nl/user/s1934538/clickstream/clickstream-enwiki-2023-05.tsv.gz,2020_Summer_Olympics,52803,49064,945,102812,95685
hdfs://spark-nn.eemcs.utwente.nl/user/s1934538/clickstream/clickstream-enwiki-2023-05.tsv.gz,Carlos_Alcaraz,36901,238758,1301,276960,67452
hdfs://spark-nn.eemcs.utwente.nl/user/s1934538/clickstream/clickstream-enwiki-2023-05.tsv.gz,When_They_See_Us,15146,17740,80,32966,13308
hdfs://spark-nn.eemcs.utwente.nl/user/s1934538/clickstream/clickstream-enwiki-2023-05.tsv.gz,List_of_highest-grossing_Indian_films,76585,233827,4908,315320,188999
hdfs://spark-nn.eemcs.utwente.nl/user/s1934538/clickstream/clickstream-enwiki-2023-05.tsv.gz,The_Kashmir_Files,46001,149021,395,195417,67309
hdfs://spark-nn.eemcs.utwente.nl/user/s1934538/clickstream/clickstream-enwiki-2023-05.tsv.gz,K.G.F:_Chapter_2,25843,141083,430,167356,36040
hdfs://spark-nn.eemcs.utwente.nl/user/s1934538/clickstream/clickstream-enwiki-2023-05.tsv.gz,Cardi_B,35891,169560,1657,207108,62432
hdfs://spark-nn.eemcs.utwente.nl/user/s1934538/clickstream/clickstream-enwiki-2023-05.tsv.gz,2018_Winter_Olympics,9741,7872,72,17685,11580
hdfs://spark-nn.eemcs.utwente.nl/user/s1934538/clickstream/clickstream-enwiki-2023-05.tsv.gz,Aretha_Franklin,27193,143516,1620,172329,72673
hdfs://spark-nn.eemcs.utwente.nl/user/s1934538/clickstream/clickstream-enwiki-2023-05.tsv.gz,FIFA_World_Cup,61365,199866,2752,263983,130202
hdfs://spark-nn.eemcs.utwente.nl/user/s1934538/clickstream/clickstream-enwiki-2023-05.tsv.gz,Line_shaft,339,852,24,1215,84
hdfs://spark-nn.eemcs.utwente.nl/user/s1934538/clickstream/clickstream-enwiki-2023-05.tsv.gz,United_States_Electoral_College,13214,29648,257,43119,8022
hdfs://spark-nn.eemcs.utwente.nl/user/s1934538/clickstream/clickstream-enwiki-2023-05.tsv.gz,The_Kerala_Story,111324,4931872,11186,5054382,1539429
hdfs://spark-nn.eemcs.utwente.nl/user/s1934538/clickstream/clickstream-enwiki-2023-05.tsv.gz,Charles_Sobhraj,8536,47041,318,55895,10156
hdfs://spark-nn.eemcs.utwente.nl/user/s1934538/clickstream/clickstream-enwiki-2023-05.tsv.gz,Kantara_(film),9952,93699,272,103923,38758
hdfs://spark-nn.eemcs.utwente.nl/user/s1934538/clickstream/clickstream-enwiki-2023-05.tsv.gz,XHamster,7045,220409,5975,233429,23007
hdfs://spark-nn.eemcs.utwente.nl/user/s1934538/clickstream/clickstream-enwiki-2023-05.tsv.gz,Elon_Musk,115252,1185899,10056,1311207,645902
hdfs://spark-nn.eemcs.utwente.nl/user/s1934538/clickstream/clickstream-enwiki-2023-05.tsv.gz,Mötley_Crüe,31502,96272,1821,129595,155605
hdfs://spark-nn.eemcs.utwente.nl/user/s1934538/clickstream/clickstream-enwiki-2023-05.tsv.gz,Game_of_Thrones_(season_8),12553,41155,471,54179,16855
hdfs://spark-nn.eemcs.utwente.nl/user/s1934538/clickstream/clickstream-enwiki-2023-05.tsv.gz,Pelé,33373,187207,1588,222168,70660
hdfs://spark-nn.eemcs.utwente.nl/user/s1934538/clickstream/clickstream-enwiki-2023-05.tsv.gz,Spider-Man:_No_Way_Home,111872,177653,449,289974,121771
hdfs://spark-nn.eemcs.utwente.nl/user/s1934538/clickstream/clickstream-enwiki-2023-05.tsv.gz,Tiger_3,31289,25444,154,56887,28081
hdfs://spark-nn.eemcs.utwente.nl/user/s1934538/clickstream/clickstream-enwiki-2023-05.tsv.gz,Black_Adam_(film),59836,165457,2081,227374,90458
hdfs://spark-nn.eemcs.utwente.nl/user/s1934538/clickstream/clickstream-enwiki-2023-05.tsv.gz,Richard_Jewell,13663,132428,405,146496,60893
hdfs://spark-nn.eemcs.utwente.nl/user/s1934538/clickstream/clickstream-enwiki-2023-05.tsv.gz,Main_Page,64662,136386857,4806800,141258319,33433580
hdfs://spark-nn.eemcs.utwente.nl/user/s1934538/clickstream/clickstream-enwiki-2023-05.tsv.gz,JSON_Web_Token,743,24530,52,25325,1866
hdfs://spark-nn.eemcs.utwente.nl/user/s1934538/clickstream/clickstream-enwiki-2023-05.tsv.gz,2020_United_States_presidential_election,143939,167085,4295,315319,317731
hdfs://spark-nn.eemcs.utwente.nl/user/s1934538/clickstream/clickstream-enwiki-2023-05.tsv.gz,2023_Cricket_World_Cup,75858,1167020,571,1243449,232912
hdfs://spark-nn.eemcs.utwente.nl/user/s1934538/clickstream/clickstream-enwiki-2023-05.tsv.gz,Stephen_Hawking,25222,309945,2199,337366,124333
hdfs://spark-nn.eemcs.utwente.nl/user/s1934538/clickstream/clickstream-enwiki-2023-05.tsv.gz,Guardians_of_the_Galaxy_Vol._3,660871,4808785,127350,5597006,3735144
hdfs://spark-nn.eemcs.utwente.nl/user/s1934538/clickstream/clickstream-enwiki-2023-05.tsv.gz,Qasem_Soleimani,12935,19600,107,32642,19560
hdfs://spark-nn.eemcs.utwente.nl/user/s1934538/clickstream/clickstream-enwiki-2023-05.tsv.gz,COVID-19_pandemic_by_country_and_territory,9512,24251,625,34388,13879
hdfs://spark-nn.eemcs.utwente.nl/user/s1934538/clickstream/clickstream-enwiki-2023-05.tsv.gz,Game_of_Thrones,77111,245634,5173,327918,187163
hdfs://spark-nn.eemcs.utwente.nl/user/s1934538/clickstream/clickstream-enwiki-2023-05.tsv.gz,Stranger_Things,56837,234129,5533,296499,230072
hdfs://spark-nn.eemcs.utwente.nl/user/s1934538/clickstream/clickstream-enwiki-2023-05.tsv.gz,Afghanistan,119978,220125,3782,343885,251063
hdfs://spark-nn.eemcs.utwente.nl/user/s1934538/clickstream/clickstream-enwiki-2023-05.tsv.gz,21_Savage,14326,67914,606,82846,26903
hdfs://spark-nn.eemcs.utwente.nl/user/s1934538/clickstream/clickstream-enwiki-2023-05.tsv.gz,Chernobyl_disaster,43947,269458,2787,316192,145097
hdfs://spark-nn.eemcs.utwente.nl/user/s1934538/clickstream/clickstream-enwiki-2023-05.tsv.gz,Vivek_Ramaswamy,26029,359716,1960,387705,82889
hdfs://spark-nn.eemcs.utwente.nl/user/s1934538/clickstream/clickstream-enwiki-2023-05.tsv.gz,Cameron_Boyce,25117,232720,733,258570,68154
hdfs://spark-nn.eemcs.utwente.nl/user/s1934538/clickstream/clickstream-enwiki-2023-05.tsv.gz,Everything_Everywhere_All_at_Once,78792,300634,4416,383842,169527
hdfs://spark-nn.eemcs.utwente.nl/user/s1934538/clickstream/clickstream-enwiki-2023-05.tsv.gz,Luke_Perry,36128,109032,531,145691,57222
hdfs://spark-nn.eemcs.utwente.nl/user/s1934538/clickstream/clickstream-enwiki-2023-05.tsv.gz,Keanu_Reeves,125980,739454,3867,869301,551051
hdfs://spark-nn.eemcs.utwente.nl/user/s1934538/clickstream/clickstream-enwiki-2023-05.tsv.gz,Star_Wars:_The_Rise_of_Skywalker,101863,70738,1411,174012,92932
hdfs://spark-nn.eemcs.utwente.nl/user/s1934538/clickstream/clickstream-enwiki-2023-05.tsv.gz,Kenosha_unrest_shooting,7493,20000,34,27527,6296
hdfs://spark-nn.eemcs.utwente.nl/user/s1934538/clickstream/clickstream-enwiki-2023-05.tsv.gz,XXXTentacion,56812,1874423,5793,1937028,130815
hdfs://spark-nn.eemcs.utwente.nl/user/s1934538/clickstream/clickstream-enwiki-2023-05.tsv.gz,The_Matrix_Resurrections,58467,66592,828,125887,57670
hdfs://spark-nn.eemcs.utwente.nl/user/s1934538/clickstream/clickstream-enwiki-2023-05.tsv.gz,Rishi_Sunak,232287,510753,3494,746534,329093
hdfs://spark-nn.eemcs.utwente.nl/user/s1934538/clickstream/clickstream-enwiki-2023-05.tsv.gz,Queen_(band),51563,173025,2884,227472,206740
hdfs://spark-nn.eemcs.utwente.nl/user/s1934538/clickstream/clickstream-enwiki-2023-05.tsv.gz,1234,48,2064,24,2136,220
hdfs://spark-nn.eemcs.utwente.nl/user/s1934538/clickstream/clickstream-enwiki-2023-05.tsv.gz,Black_Widow_(2021_film),40371,84662,879,125912,48880
hdfs://spark-nn.eemcs.utwente.nl/user/s1934538/clickstream/clickstream-enwiki-2023-05.tsv.gz,Dark_Phoenix_(film),37006,37889,464,75359,41394
hdfs://spark-nn.eemcs.utwente.nl/user/s1934538/clickstream/clickstream-enwiki-2023-05.tsv.gz,Croatia,57599,190058,2513,250170,80260
hdfs://spark-nn.eemcs.utwente.nl/user/s1934538/clickstream/clickstream-enwiki-2023-05.tsv.gz,NATO,74587,224457,5588,304632,139371
hdfs://spark-nn.eemcs.utwente.nl/user/s1934538/clickstream/clickstream-enwiki-2023-05.tsv.gz,Naya_Rivera,48135,67299,202,115636,48918
hdfs://spark-nn.eemcs.utwente.nl/user/s1934538/clickstream/clickstream-enwiki-2023-05.tsv.gz,The_Queen's_Gambit_(miniseries),17974,110009,890,128873,64537
hdfs://spark-nn.eemcs.utwente.nl/user/s1934538/clickstream/clickstream-enwiki-2023-05.tsv.gz,Shang-Chi_and_the_Legend_of_the_Ten_Rings,56672,128879,1643,187194,102883
hdfs://spark-nn.eemcs.utwente.nl/user/s1934538/clickstream/clickstream-enwiki-2023-05.tsv.gz,The_Sandman_(TV_series),42786,77743,1144,121673,72840
hdfs://spark-nn.eemcs.utwente.nl/user/s1934538/clickstream/clickstream-enwiki-2023-05.tsv.gz,Glass_(2019_film),41467,51336,323,93126,30474
hdfs://spark-nn.eemcs.utwente.nl/user/s1934538/clickstream/clickstream-enwiki-2023-05.tsv.gz,Tina_Turner,445805,6866162,12278,7324245,2443995
hdfs://spark-nn.eemcs.utwente.nl/user/s1934538/clickstream/clickstream-enwiki-2023-05.tsv.gz,Aaron_Carter,30898,230776,4282,265956,175172
hdfs://spark-nn.eemcs.utwente.nl/user/s1934538/clickstream/clickstream-enwiki-2023-05.tsv.gz,Notre-Dame_de_Paris,13549,86307,888,100744,20968
hdfs://spark-nn.eemcs.utwente.nl/user/s1934538/clickstream/clickstream-enwiki-2023-05.tsv.gz,WandaVision,22914,45910,661,69485,32575
hdfs://spark-nn.eemcs.utwente.nl/user/s1934538/clickstream/clickstream-enwiki-2023-05.tsv.gz,2018_Asian_Games,23776,16941,101,40818,50486
hdfs://spark-nn.eemcs.utwente.nl/user/s1934538/clickstream/clickstream-enwiki-2023-05.tsv.gz,"Prince_Philip,_Duke_of_Edinburgh",379881,318905,2197,700983,426442
hdfs://spark-nn.eemcs.utwente.nl/user/s1934538/clickstream/clickstream-enwiki-2023-05.tsv.gz,The_Nun_(2018_film),18291,55188,219,73698,35804
hdfs://spark-nn.eemcs.utwente.nl/user/s1934538/clickstream/clickstream-enwiki-2023-05.tsv.gz,Watts_family_murders,5574,141875,312,147761,39717
hdfs://spark-nn.eemcs.utwente.nl/user/s1934538/clickstream/clickstream-enwiki-2023-05.tsv.gz,It_Chapter_Two,32921,50007,407,83335,47537
hdfs://spark-nn.eemcs.utwente.nl/user/s1934538/clickstream/clickstream-enwiki-2023-05.tsv.gz,Ukraine,102663,384046,9204,495913,220984
hdfs://spark-nn.eemcs.utwente.nl/user/s1934538/clickstream/clickstream-enwiki-2023-05.tsv.gz,Fyre_Festival,8306,50077,488,58871,33223
hdfs://spark-nn.eemcs.utwente.nl/user/s1934538/clickstream/clickstream-enwiki-2023-05.tsv.gz,The_Idol_(TV_series),70903,282454,5499,358856,228576
hdfs://spark-nn.eemcs.utwente.nl/user/s1934538/clickstream/clickstream-enwiki-2023-06.tsv.gz,Media,25,1819,221,2065,941
hdfs://spark-nn.eemcs.utwente.nl/user/s1934538/clickstream/clickstream-enwiki-2023-06.tsv.gz,Animal_(2023_film),50951,100044,218,151213,105509
hdfs://spark-nn.eemcs.utwente.nl/user/s1934538/clickstream/clickstream-enwiki-2023-06.tsv.gz,Doctor_Strange_in_the_Multiverse_of_Madness,63597,116061,1629,181287,79898
hdfs://spark-nn.eemcs.utwente.nl/user/s1934538/clickstream/clickstream-enwiki-2023-06.tsv.gz,Lionel_Messi,177546,2327495,24943,2529984,464411
hdfs://spark-nn.eemcs.utwente.nl/user/s1934538/clickstream/clickstream-enwiki-2023-06.tsv.gz,Shakira,21860,324777,4377,351014,130639
hdfs://spark-nn.eemcs.utwente.nl/user/s1934538/clickstream/clickstream-enwiki-2023-06.tsv.gz,Eddie_Van_Halen,48185,88795,805,137785,58576
hdfs://spark-nn.eemcs.utwente.nl/user/s1934538/clickstream/clickstream-enwiki-2023-06.tsv.gz,2023_Cricket_World_Cup,122875,1506204,1657,1630736,345575
hdfs://spark-nn.eemcs.utwente.nl/user/s1934538/clickstream/clickstream-enwiki-2023-06.tsv.gz,Bob_Saget,24937,78461,613,104011,20197
hdfs://spark-nn.eemcs.utwente.nl/user/s1934538/clickstream/clickstream-enwiki-2023-06.tsv.gz,"Prince_Philip,_Duke_of_Edinburgh",112242,110462,1126,223830,140177
hdfs://spark-nn.eemcs.utwente.nl/user/s1934538/clickstream/clickstream-enwiki-2023-06.tsv.gz,UEFA_Euro_2020,69718,65237,899,135854,84046
hdfs://spark-nn.eemcs.utwente.nl/user/s1934538/clickstream/clickstream-enwiki-2023-06.tsv.gz,Ruth_Bader_Ginsburg,20960,67808,414,89182,36556
hdfs://spark-nn.eemcs.utwente.nl/user/s1934538/clickstream/clickstream-enwiki-2023-06.tsv.gz,Line_shaft,302,1023,33,1358,111
hdfs://spark-nn.eemcs.utwente.nl/user/s1934538/clickstream/clickstream-enwiki-2023-06.tsv.gz,RRR_(film),60020,255643,2132,317795,132421
hdfs://spark-nn.eemcs.utwente.nl/user/s1934538/clickstream/clickstream-enwiki-2023-06.tsv.gz,Simone_Biles,14399,70682,463,85544,31981
hdfs://spark-nn.eemcs.utwente.nl/user/s1934538/clickstream/clickstream-enwiki-2023-06.tsv.gz,Shinzo_Abe,51474,69300,1533,122307,83392
hdfs://spark-nn.eemcs.utwente.nl/user/s1934538/clickstream/clickstream-enwiki-2023-06.tsv.gz,Tiger_3,52395,57314,278,109987,68419
hdfs://spark-nn.eemcs.utwente.nl/user/s1934538/clickstream/clickstream-enwiki-2023-06.tsv.gz,The_Queen's_Gambit_(miniseries),13916,72101,520,86537,39972
hdfs://spark-nn.eemcs.utwente.nl/user/s1934538/clickstream/clickstream-enwiki-2023-06.tsv.gz,Kantara_(film),11921,87402,267,99590,37775
hdfs://spark-nn.eemcs.utwente.nl/user/s1934538/clickstream/clickstream-enwiki-2023-06.tsv.gz,Cook's_Country,317,1539,25,1881,421
hdfs://spark-nn.eemcs.utwente.nl/user/s1934538/clickstream/clickstream-enwiki-2023-06.tsv.gz,Brett_Kavanaugh,27337,29877,222,57436,22514
hdfs://spark-nn.eemcs.utwente.nl/user/s1934538/clickstream/clickstream-enwiki-2023-06.tsv.gz,Loki_(TV_series),34480,58281,1260,94021,54399
hdfs://spark-nn.eemcs.utwente.nl/user/s1934538/clickstream/clickstream-enwiki-2023-06.tsv.gz,Darth_Vader,25902,60871,727,87500,56039
hdfs://spark-nn.eemcs.utwente.nl/user/s1934538/clickstream/clickstream-enwiki-2023-06.tsv.gz,Jenna_Ortega,81040,442567,4543,528150,148200
hdfs://spark-nn.eemcs.utwente.nl/user/s1934538/clickstream/clickstream-enwiki-2023-06.tsv.gz,Star_Wars:_The_Rise_of_Skywalker,66843,42147,916,109906,56467
hdfs://spark-nn.eemcs.utwente.nl/user/s1934538/clickstream/clickstream-enwiki-2023-06.tsv.gz,Dark_Phoenix_(film),45111,39050,681,84842,44670
hdfs://spark-nn.eemcs.utwente.nl/user/s1934538/clickstream/clickstream-enwiki-2023-06.tsv.gz,Charles_Sobhraj,7289,38536,65,45890,8434
hdfs://spark-nn.eemcs.utwente.nl/user/s1934538/clickstream/clickstream-enwiki-2023-06.tsv.gz,Naya_Rivera,48093,70497,347,118937,52023
hdfs://spark-nn.eemcs.utwente.nl/user/s1934538/clickstream/clickstream-enwiki-2023-06.tsv.gz,Zack_Snyder's_Justice_League,74123,96878,795,171796,75332
hdfs://spark-nn.eemcs.utwente.nl/user/s1934538/clickstream/clickstream-enwiki-2023-06.tsv.gz,2018_Asian_Games,12194,8019,41,20254,21993
hdfs://spark-nn.eemcs.utwente.nl/user/s1934538/clickstream/clickstream-enwiki-2023-06.tsv.gz,Avengers:_Endgame,98995,152171,2363,253529,122802
hdfs://spark-nn.eemcs.utwente.nl/user/s1934538/clickstream/clickstream-enwiki-2023-06.tsv.gz,Fyre_Festival,7037,41006,337,48380,26774
hdfs://spark-nn.eemcs.utwente.nl/user/s1934538/clickstream/clickstream-enwiki-2023-06.tsv.gz,Elizabeth_II,321179,421792,8959,751930,488344
hdfs://spark-nn.eemcs.utwente.nl/user/s1934538/clickstream/clickstream-enwiki-2023-06.tsv.gz,Manti_Te'o,2430,32088,108,34626,4659
hdfs://spark-nn.eemcs.utwente.nl/user/s1934538/clickstream/clickstream-enwiki-2023-06.tsv.gz,Kamala_Harris,80093,227470,1288,308851,151114
hdfs://spark-nn.eemcs.utwente.nl/user/s1934538/clickstream/clickstream-enwiki-2023-06.tsv.gz,1234,48,1828,19,1895,193
hdfs://spark-nn.eemcs.utwente.nl/user/s1934538/clickstream/clickstream-enwiki-2023-06.tsv.gz,Once_Upon_a_Time_in_Hollywood,94107,134194,2263,230564,234454
hdfs://spark-nn.eemcs.utwente.nl/user/s1934538/clickstream/clickstream-enwiki-2023-06.tsv.gz,WandaVision,19192,41743,572,61507,29637
hdfs://spark-nn.eemcs.utwente.nl/user/s1934538/clickstream/clickstream-enwiki-2023-06.tsv.gz,List_of_FIFA_World_Cup_finals,4592,67330,79,72001,22135
hdfs://spark-nn.eemcs.utwente.nl/user/s1934538/clickstream/clickstream-enwiki-2023-06.tsv.gz,Coronavirus,4180,27017,366,31563,8878
hdfs://spark-nn.eemcs.utwente.nl/user/s1934538/clickstream/clickstream-enwiki-2023-06.tsv.gz,Watts_family_murders,6017,224687,358,231062,59722
hdfs://spark-nn.eemcs.utwente.nl/user/s1934538/clickstream/clickstream-enwiki-2023-06.tsv.gz,Donald_Trump,224605,859469,24433,1108507,554557
hdfs://spark-nn.eemcs.utwente.nl/user/s1934538/clickstream/clickstream-enwiki-2023-06.tsv.gz,Greta_Thunberg,13914,187422,1479,202815,51253
hdfs://spark-nn.eemcs.utwente.nl/user/s1934538/clickstream/clickstream-enwiki-2023-06.tsv.gz,Valentine's_Day,3997,49752,165,53914,3682
hdfs://spark-nn.eemcs.utwente.nl/user/s1934538/clickstream/clickstream-enwiki-2023-06.tsv.gz,Aretha_Franklin,23548,132731,1068,157347,66162
hdfs://spark-nn.eemcs.utwente.nl/user/s1934538/clickstream/clickstream-enwiki-2023-06.tsv.gz,Laal_Singh_Chaddha,21727,47410,83,69220,23793
hdfs://spark-nn.eemcs.utwente.nl/user/s1934538/clickstream/clickstream-enwiki-2023-06.tsv.gz,Hyphen-minus,753,5909758,21631,5932142,910
hdfs://spark-nn.eemcs.utwente.nl/user/s1934538/clickstream/clickstream-enwiki-2023-06.tsv.gz,Jeffrey_Dahmer,31388,459920,4195,495503,193166
hdfs://spark-nn.eemcs.utwente.nl/user/s1934538/clickstream/clickstream-enwiki-2023-06.tsv.gz,ICC_Men's_T20_World_Cup,27076,130165,1307,158548,58050
hdfs://spark-nn.eemcs.utwente.nl/user/s1934538/clickstream/clickstream-enwiki-2023-06.tsv.gz,Stranger_Things_(season_3),10946,20537,189,31672,16865
hdfs://spark-nn.eemcs.utwente.nl/user/s1934538/clickstream/clickstream-enwiki-2023-06.tsv.gz,The_Batman_(film),186564,234377,4668,425609,176070
hdfs://spark-nn.eemcs.utwente.nl/user/s1934538/clickstream/clickstream-enwiki-2023-06.tsv.gz,2016_United_States_presidential_election,114067,71499,1203,186769,169136
hdfs://spark-nn.eemcs.utwente.nl/user/s1934538/clickstream/clickstream-enwiki-2023-06.tsv.gz,Microsoft_Office,5729,335684,571,341984,16642
hdfs://spark-nn.eemcs.utwente.nl/user/s1934538/clickstream/clickstream-enwiki-2023-06.tsv.gz,Rami_Malek,52645,113335,579,166559,68093
hdfs://spark-nn.eemcs.utwente.nl/user/s1934538/clickstream/clickstream-enwiki-2023-06.tsv.gz,Barbie_(film),137969,477253,14152,629374,535729
hdfs://spark-nn.eemcs.utwente.nl/user/s1934538/clickstream/clickstream-enwiki-2023-06.tsv.gz,Irrfan_Khan,28397,72853,67,101317,35117
hdfs://spark-nn.eemcs.utwente.nl/user/s1934538/clickstream/clickstream-enwiki-2023-06.tsv.gz,Amy_Coney_Barrett,31096,36445,296,67837,23027
hdfs://spark-nn.eemcs.utwente.nl/user/s1934538/clickstream/clickstream-enwiki-2023-06.tsv.gz,Asia_Cup,30992,172993,6488,210473,63260
hdfs://spark-nn.eemcs.utwente.nl/user/s1934538/clickstream/clickstream-enwiki-2023-06.tsv.gz,Johnny_Depp,205497,418568,3692,627757,386934
hdfs://spark-nn.eemcs.utwente.nl/user/s1934538/clickstream/clickstream-enwiki-2023-06.tsv.gz,Spider-Man:_Far_From_Home,57502,68811,1539,127852,52172
hdfs://spark-nn.eemcs.utwente.nl/user/s1934538/clickstream/clickstream-enwiki-2023-06.tsv.gz,Stan_Lee,63651,212273,1884,277808,115209
hdfs://spark-nn.eemcs.utwente.nl/user/s1934538/clickstream/clickstream-enwiki-2023-06.tsv.gz,Cristiano_Ronaldo,182975,1331361,8434,1522770,392487
hdfs://spark-nn.eemcs.utwente.nl/user/s1934538/clickstream/clickstream-enwiki-2023-06.tsv.gz,Black_Adam_(film),63662,184690,2519,250871,88816
hdfs://spark-nn.eemcs.utwente.nl/user/s1934538/clickstream/clickstream-enwiki-2023-06.tsv.gz,Sylvester_Stallone,147845,662356,4011,814212,640704
hdfs://spark-nn.eemcs.utwente.nl/user/s1934538/clickstream/clickstream-enwiki-2023-06.tsv.gz,The_Idol_(TV_series),194813,14044141,28103,14267057,1731236
hdfs://spark-nn.eemcs.utwente.nl/user/s1934538/clickstream/clickstream-enwiki-2023-06.tsv.gz,Cameron_Boyce,26215,194853,695,221763,60029
hdfs://spark-nn.eemcs.utwente.nl/user/s1934538/clickstream/clickstream-enwiki-2023-06.tsv.gz,Eternals_(film),56183,99546,1310,157039,102688
hdfs://spark-nn.eemcs.utwente.nl/user/s1934538/clickstream/clickstream-enwiki-2023-06.tsv.gz,Donald_Glover,60096,200817,1460,262373,114789
hdfs://spark-nn.eemcs.utwente.nl/user/s1934538/clickstream/clickstream-enwiki-2023-06.tsv.gz,Atal_Bihari_Vajpayee,37377,69105,69,106551,39745
hdfs://spark-nn.eemcs.utwente.nl/user/s1934538/clickstream/clickstream-enwiki-2023-06.tsv.gz,The_Lion_King_(2019_film),85411,98943,745,185099,60083
hdfs://spark-nn.eemcs.utwente.nl/user/s1934538/clickstream/clickstream-enwiki-2023-06.tsv.gz,Avatar:_The_Way_of_Water,236553,1193972,20430,1450955,887996
hdfs://spark-nn.eemcs.utwente.nl/user/s1934538/clickstream/clickstream-enwiki-2023-06.tsv.gz,Roe_v._Wade,14280,95621,726,110627,40606
hdfs://spark-nn.eemcs.utwente.nl/user/s1934538/clickstream/clickstream-enwiki-2023-06.tsv.gz,Murder_of_Dee_Dee_Blanchard,18743,62751,264,81758,19562
hdfs://spark-nn.eemcs.utwente.nl/user/s1934538/clickstream/clickstream-enwiki-2023-06.tsv.gz,Deadpool_2,45181,53928,1095,100204,69785
hdfs://spark-nn.eemcs.utwente.nl/user/s1934538/clickstream/clickstream-enwiki-2023-06.tsv.gz,It_Chapter_Two,40372,50916,439,91727,50775
hdfs://spark-nn.eemcs.utwente.nl/user/s1934538/clickstream/clickstream-enwiki-2023-06.tsv.gz,Juneteenth,28873,3205317,23557,3257747,279555
hdfs://spark-nn.eemcs.utwente.nl/user/s1934538/clickstream/clickstream-enwiki-2023-06.tsv.gz,September_11_attacks,111847,286407,4683,402937,289216
hdfs://spark-nn.eemcs.utwente.nl/user/s1934538/clickstream/clickstream-enwiki-2023-06.tsv.gz,WrestleMania_34,12427,6955,57,19439,12826
hdfs://spark-nn.eemcs.utwente.nl/user/s1934538/clickstream/clickstream-enwiki-2023-06.tsv.gz,Kelly_Preston,94449,111358,973,206780,65449
hdfs://spark-nn.eemcs.utwente.nl/user/s1934538/clickstream/clickstream-enwiki-2023-06.tsv.gz,Kobe_Bryant,80264,414020,3144,497428,158957
hdfs://spark-nn.eemcs.utwente.nl/user/s1934538/clickstream/clickstream-enwiki-2023-06.tsv.gz,Chadwick_Boseman,33052,129990,697,163739,44261
hdfs://spark-nn.eemcs.utwente.nl/user/s1934538/clickstream/clickstream-enwiki-2023-06.tsv.gz,FIFA_World_Cup,77827,290109,3453,371389,190323
hdfs://spark-nn.eemcs.utwente.nl/user/s1934538/clickstream/clickstream-enwiki-2023-06.tsv.gz,The_Last_of_Us_(TV_series),52310,312454,4578,369342,149235
hdfs://spark-nn.eemcs.utwente.nl/user/s1934538/clickstream/clickstream-enwiki-2023-06.tsv.gz,Lisa_Marie_Presley,210124,171359,866,382349,201240
hdfs://spark-nn.eemcs.utwente.nl/user/s1934538/clickstream/clickstream-enwiki-2023-06.tsv.gz,Tina_Turner,58594,755117,28362,842073,316309
hdfs://spark-nn.eemcs.utwente.nl/user/s1934538/clickstream/clickstream-enwiki-2023-06.tsv.gz,Thor:_Love_and_Thunder,74944,111000,2056,188000,84904
hdfs://spark-nn.eemcs.utwente.nl/user/s1934538/clickstream/clickstream-enwiki-2023-06.tsv.gz,Naomi_Osaka,32147,94344,525,127016,39251
hdfs://spark-nn.eemcs.utwente.nl/user/s1934538/clickstream/clickstream-enwiki-2023-06.tsv.gz,Volodymyr_Zelenskyy,91575,177075,1985,270635,152045
hdfs://spark-nn.eemcs.utwente.nl/user/s1934538/clickstream/clickstream-enwiki-2023-06.tsv.gz,Main_Page,76176,131075841,4552006,135704023,32552678
hdfs://spark-nn.eemcs.utwente.nl/user/s1934538/clickstream/clickstream-enwiki-2023-06.tsv.gz,Central_Park_jogger_case,10774,65620,422,76816,18207
hdfs://spark-nn.eemcs.utwente.nl/user/s1934538/clickstream/clickstream-enwiki-2023-06.tsv.gz,William_Murdoch,588,2102,64,2754,558
hdfs://spark-nn.eemcs.utwente.nl/user/s1934538/clickstream/clickstream-enwiki-2023-06.tsv.gz,Anthony_Bourdain,24807,255029,1680,281516,122171
hdfs://spark-nn.eemcs.utwente.nl/user/s1934538/clickstream/clickstream-enwiki-2023-06.tsv.gz,Ant-Man_and_the_Wasp:_Quantumania,130414,312240,7051,449705,292075
hdfs://spark-nn.eemcs.utwente.nl/user/s1934538/clickstream/clickstream-enwiki-2023-06.tsv.gz,Game_of_Thrones,66843,278333,5021,350197,189474
hdfs://spark-nn.eemcs.utwente.nl/user/s1934538/clickstream/clickstream-enwiki-2023-06.tsv.gz,Charles_III,378852,339344,8140,726336,422106
hdfs://spark-nn.eemcs.utwente.nl/user/s1934538/clickstream/clickstream-enwiki-2023-06.tsv.gz,Black_Panther:_Wakanda_Forever,65933,138785,3197,207915,133856
hdfs://spark-nn.eemcs.utwente.nl/user/s1934538/clickstream/clickstream-enwiki-2023-06.tsv.gz,Mulan_(2020_film),22828,53795,609,77232,37135
hdfs://spark-nn.eemcs.utwente.nl/user/s1934538/clickstream/clickstream-enwiki-2023-06.tsv.gz,2023_Asia_Cup,53936,495554,2353,551843,79186
hdfs://spark-nn.eemcs.utwente.nl/user/s1934538/clickstream/clickstream-enwiki-2023-06.tsv.gz,Henry_V_of_England,73825,78490,435,152750,107966
hdfs://spark-nn.eemcs.utwente.nl/user/s1934538/clickstream/clickstream-enwiki-2023-06.tsv.gz,Meat_Loaf,22381,89399,988,112768,41863
hdfs://spark-nn.eemcs.utwente.nl/user/s1934538/clickstream/clickstream-enwiki-2023-06.tsv.gz,The_Kerala_Story,44526,646977,2362,693865,134022
hdfs://spark-nn.eemcs.utwente.nl/user/s1934538/clickstream/clickstream-enwiki-2023-06.tsv.gz,The_Matrix_Resurrections,49587,56631,738,106956,50654
hdfs://spark-nn.eemcs.utwente.nl/user/s1934538/clickstream/clickstream-enwiki-2023-06.tsv.gz,Squid_Game,25139,174436,3805,203380,105973
hdfs://spark-nn.eemcs.utwente.nl/user/s1934538/clickstream/clickstream-enwiki-2023-06.tsv.gz,The_Irishman,51524,79349,1164,132037,111539
hdfs://spark-nn.eemcs.utwente.nl/user/s1934538/clickstream/clickstream-enwiki-2023-06.tsv.gz,Ponniyin_Selvan:_I,48056,246972,4764,299792,162194
hdfs://spark-nn.eemcs.utwente.nl/user/s1934538/clickstream/clickstream-enwiki-2023-06.tsv.gz,Ted_Bundy,27985,312491,3697,344173,81754
hdfs://spark-nn.eemcs.utwente.nl/user/s1934538/clickstream/clickstream-enwiki-2023-06.tsv.gz,Vladimir_Putin,180790,558694,7575,747059,422537
hdfs://spark-nn.eemcs.utwente.nl/user/s1934538/clickstream/clickstream-enwiki-2023-06.tsv.gz,Wikipedia,275304,1095556,720,1371580,524361
hdfs://spark-nn.eemcs.utwente.nl/user/s1934538/clickstream/clickstream-enwiki-2023-06.tsv.gz,XHamster,6535,165076,5836,177447,18738
hdfs://spark-nn.eemcs.utwente.nl/user/s1934538/clickstream/clickstream-enwiki-2023-06.tsv.gz,Jawan_(film),70536,114457,718,185711,108757
hdfs://spark-nn.eemcs.utwente.nl/user/s1934538/clickstream/clickstream-enwiki-2023-06.tsv.gz,Game_of_Thrones_(season_8),12496,31274,410,44180,16326
hdfs://spark-nn.eemcs.utwente.nl/user/s1934538/clickstream/clickstream-enwiki-2023-06.tsv.gz,Betty_White,45735,111427,894,158056,41673
hdfs://spark-nn.eemcs.utwente.nl/user/s1934538/clickstream/clickstream-enwiki-2023-06.tsv.gz,Kenosha_unrest_shooting,7234,17037,88,24359,6662
hdfs://spark-nn.eemcs.utwente.nl/user/s1934538/clickstream/clickstream-enwiki-2023-06.tsv.gz,Kate_Spade,56338,74594,318,131250,49279
hdfs://spark-nn.eemcs.utwente.nl/user/s1934538/clickstream/clickstream-enwiki-2023-06.tsv.gz,List_of_awards_and_nominations_received_by_Meryl_Streep,6086,7156,10,13252,5858
hdfs://spark-nn.eemcs.utwente.nl/user/s1934538/clickstream/clickstream-enwiki-2023-06.tsv.gz,"Meghan,_Duchess_of_Sussex",100442,381822,1481,483745,247845
hdfs://spark-nn.eemcs.utwente.nl/user/s1934538/clickstream/clickstream-enwiki-2023-06.tsv.gz,Jason_Momoa,101780,452028,1982,555790,249348
hdfs://spark-nn.eemcs.utwente.nl/user/s1934538/clickstream/clickstream-enwiki-2023-06.tsv.gz,Black_Panther_(film),32777,96209,863,129849,53402
hdfs://spark-nn.eemcs.utwente.nl/user/s1934538/clickstream/clickstream-enwiki-2023-06.tsv.gz,Anne_Heche,103183,149867,966,254016,79738
hdfs://spark-nn.eemcs.utwente.nl/user/s1934538/clickstream/clickstream-enwiki-2023-06.tsv.gz,JSON_Web_Token,721,21702,33,22456,1708
hdfs://spark-nn.eemcs.utwente.nl/user/s1934538/clickstream/clickstream-enwiki-2023-06.tsv.gz,The_Nun_(2018_film),18212,56556,344,75112,37311
hdfs://spark-nn.eemcs.utwente.nl/user/s1934538/clickstream/clickstream-enwiki-2023-06.tsv.gz,Aquaman_(film),37705,120264,1234,159203,62348
hdfs://spark-nn.eemcs.utwente.nl/user/s1934538/clickstream/clickstream-enwiki-2023-06.tsv.gz,Russo-Ukrainian_War,136158,499555,2550,638263,438401
hdfs://spark-nn.eemcs.utwente.nl/user/s1934538/clickstream/clickstream-enwiki-2023-06.tsv.gz,Joe_Biden,232049,761381,8959,1002389,463261
hdfs://spark-nn.eemcs.utwente.nl/user/s1934538/clickstream/clickstream-enwiki-2023-06.tsv.gz,Elliot_Page,121951,992789,6168,1120908,542674
hdfs://spark-nn.eemcs.utwente.nl/user/s1934538/clickstream/clickstream-enwiki-2023-06.tsv.gz,XNXX,11851,747302,9281,768434,49080
hdfs://spark-nn.eemcs.utwente.nl/user/s1934538/clickstream/clickstream-enwiki-2023-06.tsv.gz,Sridevi,34652,87830,124,122606,58869
hdfs://spark-nn.eemcs.utwente.nl/user/s1934538/clickstream/clickstream-enwiki-2023-06.tsv.gz,Priyanka_Chopra,105537,383604,937,490078,169249
hdfs://spark-nn.eemcs.utwente.nl/user/s1934538/clickstream/clickstream-enwiki-2023-06.tsv.gz,Mötley_Crüe,32192,104404,1901,138497,164785
hdfs://spark-nn.eemcs.utwente.nl/user/s1934538/clickstream/clickstream-enwiki-2023-06.tsv.gz,Mac_Miller,21992,156710,921,179623,55633
hdfs://spark-nn.eemcs.utwente.nl/user/s1934538/clickstream/clickstream-enwiki-2023-06.tsv.gz,The_Haunting_of_Bly_Manor,14400,33699,242,48341,24799
hdfs://spark-nn.eemcs.utwente.nl/user/s1934538/clickstream/clickstream-enwiki-2023-06.tsv.gz,Godzilla_vs._Kong,38510,68594,954,108058,56183
hdfs://spark-nn.eemcs.utwente.nl/user/s1934538/clickstream/clickstream-enwiki-2023-06.tsv.gz,Queen_(band),50241,173350,3292,226883,211243
hdfs://spark-nn.eemcs.utwente.nl/user/s1934538/clickstream/clickstream-enwiki-2023-06.tsv.gz,Burt_Reynolds,54342,114170,869,169381,84421
hdfs://spark-nn.eemcs.utwente.nl/user/s1934538/clickstream/clickstream-enwiki-2023-06.tsv.gz,The_Kashmir_Files,12479,47135,186,59800,20192
hdfs://spark-nn.eemcs.utwente.nl/user/s1934538/clickstream/clickstream-enwiki-2023-06.tsv.gz,John_Wick:_Chapter_4,173796,734552,17442,925790,568343
hdfs://spark-nn.eemcs.utwente.nl/user/s1934538/clickstream/clickstream-enwiki-2023-06.tsv.gz,Spanish_flu,16436,37214,456,54106,15542
hdfs://spark-nn.eemcs.utwente.nl/user/s1934538/clickstream/clickstream-enwiki-2023-06.tsv.gz,Stranger_Things_(season_4),23400,79447,969,103816,55419
hdfs://spark-nn.eemcs.utwente.nl/user/s1934538/clickstream/clickstream-enwiki-2023-06.tsv.gz,Amber_Heard,87804,205913,1595,295312,124035
hdfs://spark-nn.eemcs.utwente.nl/user/s1934538/clickstream/clickstream-enwiki-2023-06.tsv.gz,Pathaan_(film),65987,351143,2730,419860,107249
hdfs://spark-nn.eemcs.utwente.nl/user/s1934538/clickstream/clickstream-enwiki-2023-06.tsv.gz,Bridgerton,45697,197131,3012,245840,183823
hdfs://spark-nn.eemcs.utwente.nl/user/s1934538/clickstream/clickstream-enwiki-2023-06.tsv.gz,Dennis_Nilsen,8805,41169,226,50200,12889
hdfs://spark-nn.eemcs.utwente.nl/user/s1934538/clickstream/clickstream-enwiki-2023-07.tsv.gz,YouTube,136592,4412974,12843,4562409,118266
hdfs://spark-nn.eemcs.utwente.nl/user/s1934538/clickstream/clickstream-enwiki-2023-07.tsv.gz,Sushant_Singh_Rajput,19411,104507,114,124032,53815
hdfs://spark-nn.eemcs.utwente.nl/user/s1934538/clickstream/clickstream-enwiki-2023-07.tsv.gz,Salman_Rushdie,33209,88178,707,122094,72226
hdfs://spark-nn.eemcs.utwente.nl/user/s1934538/clickstream/clickstream-enwiki-2023-07.tsv.gz,The_Flash_(film),215233,1704651,44516,1964400,1007800
hdfs://spark-nn.eemcs.utwente.nl/user/s1934538/clickstream/clickstream-enwiki-2023-07.tsv.gz,Saltburn_(film),23627,14034,485,38146,18709
hdfs://spark-nn.eemcs.utwente.nl/user/s1934538/clickstream/clickstream-enwiki-2023-07.tsv.gz,Louis_Tomlinson,35507,58028,239,93774,26540
hdfs://spark-nn.eemcs.utwente.nl/user/s1934538/clickstream/clickstream-enwiki-2023-07.tsv.gz,Puneeth_Rajkumar,17368,62959,45,80372,28392
hdfs://spark-nn.eemcs.utwente.nl/user/s1934538/clickstream/clickstream-enwiki-2023-07.tsv.gz,September_11_attacks,115081,295331,4380,414792,309094
hdfs://spark-nn.eemcs.utwente.nl/user/s1934538/clickstream/clickstream-enwiki-2023-07.tsv.gz,NATO,93699,410664,13984,518347,267275
hdfs://spark-nn.eemcs.utwente.nl/user/s1934538/clickstream/clickstream-enwiki-2023-07.tsv.gz,List_of_Marvel_Cinematic_Universe_films,249028,549370,2130,800528,558907
hdfs://spark-nn.eemcs.utwente.nl/user/s1934538/clickstream/clickstream-enwiki-2023-07.tsv.gz,The_Shape_of_Water,22841,43382,413,66636,28348
hdfs://spark-nn.eemcs.utwente.nl/user/s1934538/clickstream/clickstream-enwiki-2023-07.tsv.gz,2023_Asia_Cup,33279,463301,1999,498579,78526
hdfs://spark-nn.eemcs.utwente.nl/user/s1934538/clickstream/clickstream-enwiki-2023-07.tsv.gz,George_VI,276785,88085,609,365479,262636
hdfs://spark-nn.eemcs.utwente.nl/user/s1934538/clickstream/clickstream-enwiki-2023-07.tsv.gz,Deaths_in_2023,1521675,2594618,17114,4133407,2461402
hdfs://spark-nn.eemcs.utwente.nl/user/s1934538/clickstream/clickstream-enwiki-2023-07.tsv.gz,Spider-Man:_Across_the_Spider-Verse,323816,1032228,28798,1384842,761102
hdfs://spark-nn.eemcs.utwente.nl/user/s1934538/clickstream/clickstream-enwiki-2023-07.tsv.gz,Bipin_Rawat,7311,18538,33,25882,10719
hdfs://spark-nn.eemcs.utwente.nl/user/s1934538/clickstream/clickstream-enwiki-2023-07.tsv.gz,Aaron_Hernandez,9197,167152,904,177253,69567
hdfs://spark-nn.eemcs.utwente.nl/user/s1934538/clickstream/clickstream-enwiki-2023-07.tsv.gz,Ghislaine_Maxwell,68934,120377,590,189901,83114
hdfs://spark-nn.eemcs.utwente.nl/user/s1934538/clickstream/clickstream-enwiki-2023-07.tsv.gz,Atal_Bihari_Vajpayee,42756,72527,60,115343,44051
hdfs://spark-nn.eemcs.utwente.nl/user/s1934538/clickstream/clickstream-enwiki-2023-07.tsv.gz,Fantastic_Beasts:_The_Crimes_of_Grindelwald,33596,33158,340,67094,37001
hdfs://spark-nn.eemcs.utwente.nl/user/s1934538/clickstream/clickstream-enwiki-2023-07.tsv.gz,Manti_Te'o,3391,40527,102,44020,5422
hdfs://spark-nn.eemcs.utwente.nl/user/s1934538/clickstream/clickstream-enwiki-2023-07.tsv.gz,Lionel_Messi,185490,1779085,14576,1979151,526416
hdfs://spark-nn.eemcs.utwente.nl/user/s1934538/clickstream/clickstream-enwiki-2023-07.tsv.gz,2018_Asian_Games,22998,11434,101,34533,37017
hdfs://spark-nn.eemcs.utwente.nl/user/s1934538/clickstream/clickstream-enwiki-2023-07.tsv.gz,Notre-Dame_de_Paris,18763,77459,732,96954,22030
hdfs://spark-nn.eemcs.utwente.nl/user/s1934538/clickstream/clickstream-enwiki-2023-07.tsv.gz,Croatia,62304,230741,2622,295667,90519
hdfs://spark-nn.eemcs.utwente.nl/user/s1934538/clickstream/clickstream-enwiki-2023-07.tsv.gz,XXX:_Return_of_Xander_Cage,58350,996368,1051,1055769,51912
hdfs://spark-nn.eemcs.utwente.nl/user/s1934538/clickstream/clickstream-enwiki-2023-07.tsv.gz,Mac_Miller,36506,194503,1432,232441,62574
hdfs://spark-nn.eemcs.utwente.nl/user/s1934538/clickstream/clickstream-enwiki-2023-07.tsv.gz,Emma_Raducanu,21662,190746,2083,214491,45929
hdfs://spark-nn.eemcs.utwente.nl/user/s1934538/clickstream/clickstream-enwiki-2023-07.tsv.gz,Rami_Malek,222659,242128,1310,466097,165063
hdfs://spark-nn.eemcs.utwente.nl/user/s1934538/clickstream/clickstream-enwiki-2023-07.tsv.gz,List_of_awards_and_nominations_received_by_Meryl_Streep,6698,6696,16,13410,6266
hdfs://spark-nn.eemcs.utwente.nl/user/s1934538/clickstream/clickstream-enwiki-2023-07.tsv.gz,Avengers:_Endgame,106723,149756,2509,258988,121883
hdfs://spark-nn.eemcs.utwente.nl/user/s1934538/clickstream/clickstream-enwiki-2023-07.tsv.gz,HTTP_cookie,2468,253266,100,255834,17754
hdfs://spark-nn.eemcs.utwente.nl/user/s1934538/clickstream/clickstream-enwiki-2023-07.tsv.gz,Indian_Premier_League,18544,161668,235,180447,42150
hdfs://spark-nn.eemcs.utwente.nl/user/s1934538/clickstream/clickstream-enwiki-2023-07.tsv.gz,Afghanistan,112968,210015,3912,326895,248111
hdfs://spark-nn.eemcs.utwente.nl/user/s1934538/clickstream/clickstream-enwiki-2023-07.tsv.gz,Alexander_Hamilton,74462,216228,1668,292358,183131
hdfs://spark-nn.eemcs.utwente.nl/user/s1934538/clickstream/clickstream-enwiki-2023-07.tsv.gz,Avicii,23014,210720,1417,235151,68510
hdfs://spark-nn.eemcs.utwente.nl/user/s1934538/clickstream/clickstream-enwiki-2023-07.tsv.gz,Naya_Rivera,68516,120738,395,189649,90629
hdfs://spark-nn.eemcs.utwente.nl/user/s1934538/clickstream/clickstream-enwiki-2023-07.tsv.gz,Vivek_Ramaswamy,27457,772015,3559,803031,174991
hdfs://spark-nn.eemcs.utwente.nl/user/s1934538/clickstream/clickstream-enwiki-2023-07.tsv.gz,Stranger_Things,60753,247980,5598,314331,248111
hdfs://spark-nn.eemcs.utwente.nl/user/s1934538/clickstream/clickstream-enwiki-2023-07.tsv.gz,Critical_race_theory,13745,71500,1489,86734,11285
hdfs://spark-nn.eemcs.utwente.nl/user/s1934538/clickstream/clickstream-enwiki-2023-07.tsv.gz,"Princess_Margaret,_Countess_of_Snowdon",68313,122932,738,191983,109430
hdfs://spark-nn.eemcs.utwente.nl/user/s1934538/clickstream/clickstream-enwiki-2023-07.tsv.gz,Royal_Rumble_(2018),6886,4449,48,11383,8762
hdfs://spark-nn.eemcs.utwente.nl/user/s1934538/clickstream/clickstream-enwiki-2023-07.tsv.gz,Lisa_Marie_Presley,200168,339809,3221,543198,303693
hdfs://spark-nn.eemcs.utwente.nl/user/s1934538/clickstream/clickstream-enwiki-2023-07.tsv.gz,Bible,21425,102903,1620,125948,38063
hdfs://spark-nn.eemcs.utwente.nl/user/s1934538/clickstream/clickstream-enwiki-2023-07.tsv.gz,Guardians_of_the_Galaxy_Vol._3,244277,1513107,22772,1780156,719958
hdfs://spark-nn.eemcs.utwente.nl/user/s1934538/clickstream/clickstream-enwiki-2023-07.tsv.gz,Russo-Ukrainian_War,103988,400970,2344,507302,332346
hdfs://spark-nn.eemcs.utwente.nl/user/s1934538/clickstream/clickstream-enwiki-2023-07.tsv.gz,Jurassic_World_Dominion,72127,122736,1322,196185,105680
hdfs://spark-nn.eemcs.utwente.nl/user/s1934538/clickstream/clickstream-enwiki-2023-07.tsv.gz,2016_United_States_presidential_election,113809,71058,1133,186000,175415
hdfs://spark-nn.eemcs.utwente.nl/user/s1934538/clickstream/clickstream-enwiki-2023-07.tsv.gz,William_Murdoch,642,1996,80,2718,640
hdfs://spark-nn.eemcs.utwente.nl/user/s1934538/clickstream/clickstream-enwiki-2023-07.tsv.gz,WrestleMania_34,16014,7875,51,23940,16749
hdfs://spark-nn.eemcs.utwente.nl/user/s1934538/clickstream/clickstream-enwiki-2023-07.tsv.gz,Barbie_(film),1399916,6747828,162931,8310675,7571316
hdfs://spark-nn.eemcs.utwente.nl/user/s1934538/clickstream/clickstream-enwiki-2023-07.tsv.gz,List_of_highest-grossing_Indian_films,79838,219510,4060,303408,221968
hdfs://spark-nn.eemcs.utwente.nl/user/s1934538/clickstream/clickstream-enwiki-2023-07.tsv.gz,Keanu_Reeves,95405,522772,3156,621333,377747
hdfs://spark-nn.eemcs.utwente.nl/user/s1934538/clickstream/clickstream-enwiki-2023-07.tsv.gz,Pornhub,53188,355709,13351,422248,80083
hdfs://spark-nn.eemcs.utwente.nl/user/s1934538/clickstream/clickstream-enwiki-2023-07.tsv.gz,Gaza_Strip,24305,38514,260,63079,28620
hdfs://spark-nn.eemcs.utwente.nl/user/s1934538/clickstream/clickstream-enwiki-2023-07.tsv.gz,List_of_James_Bond_films,79419,478836,1878,560133,369441
hdfs://spark-nn.eemcs.utwente.nl/user/s1934538/clickstream/clickstream-enwiki-2023-07.tsv.gz,Priyanka_Chopra,94207,319461,641,414309,140535
hdfs://spark-nn.eemcs.utwente.nl/user/s1934538/clickstream/clickstream-enwiki-2023-07.tsv.gz,Jeffrey_Dahmer,33694,461091,4436,499221,201916
hdfs://spark-nn.eemcs.utwente.nl/user/s1934538/clickstream/clickstream-enwiki-2023-07.tsv.gz,Ruth_Bader_Ginsburg,22238,76432,571,99241,40416
hdfs://spark-nn.eemcs.utwente.nl/user/s1934538/clickstream/clickstream-enwiki-2023-07.tsv.gz,Vladimir_Putin,117461,398812,4679,520952,289284
hdfs://spark-nn.eemcs.utwente.nl/user/s1934538/clickstream/clickstream-enwiki-2023-07.tsv.gz,Ted_Bundy,30118,313119,3745,346982,88766
hdfs://spark-nn.eemcs.utwente.nl/user/s1934538/clickstream/clickstream-enwiki-2023-07.tsv.gz,Black_Panther:_Wakanda_Forever,69516,117432,2328,189276,114719
hdfs://spark-nn.eemcs.utwente.nl/user/s1934538/clickstream/clickstream-enwiki-2023-07.tsv.gz,Eddie_Van_Halen,48070,85687,987,134744,59943
hdfs://spark-nn.eemcs.utwente.nl/user/s1934538/clickstream/clickstream-enwiki-2023-07.tsv.gz,Henry_V_of_England,78169,81308,466,159943,113455
hdfs://spark-nn.eemcs.utwente.nl/user/s1934538/clickstream/clickstream-enwiki-2023-07.tsv.gz,Tina_Turner,28859,300760,2827,332446,111585
hdfs://spark-nn.eemcs.utwente.nl/user/s1934538/clickstream/clickstream-enwiki-2023-07.tsv.gz,When_They_See_Us,15661,22845,129,38635,18296
hdfs://spark-nn.eemcs.utwente.nl/user/s1934538/clickstream/clickstream-enwiki-2023-07.tsv.gz,Aaron_Carter,27496,76406,644,104546,68078
hdfs://spark-nn.eemcs.utwente.nl/user/s1934538/clickstream/clickstream-enwiki-2023-07.tsv.gz,Darth_Vader,25351,60482,527,86360,52447
hdfs://spark-nn.eemcs.utwente.nl/user/s1934538/clickstream/clickstream-enwiki-2023-07.tsv.gz,Loki_(TV_series),38435,65804,1682,105921,66414
hdfs://spark-nn.eemcs.utwente.nl/user/s1934538/clickstream/clickstream-enwiki-2023-07.tsv.gz,The_Falcon_and_the_Winter_Soldier,20568,30132,499,51199,28929
hdfs://spark-nn.eemcs.utwente.nl/user/s1934538/clickstream/clickstream-enwiki-2023-07.tsv.gz,Donald_Trump,208889,487105,8401,704395,414224
hdfs://spark-nn.eemcs.utwente.nl/user/s1934538/clickstream/clickstream-enwiki-2023-07.tsv.gz,Tenet_(film),381881,332389,3484,717754,285782
hdfs://spark-nn.eemcs.utwente.nl/user/s1934538/clickstream/clickstream-enwiki-2023-07.tsv.gz,Roe_v._Wade,13671,71870,1495,87036,34565
hdfs://spark-nn.eemcs.utwente.nl/user/s1934538/clickstream/clickstream-enwiki-2023-07.tsv.gz,Ray_Liotta,60330,204631,1768,266729,101699
hdfs://spark-nn.eemcs.utwente.nl/user/s1934538/clickstream/clickstream-enwiki-2023-07.tsv.gz,Mortal_Kombat_(2021_film),33955,74570,2105,110630,99180
hdfs://spark-nn.eemcs.utwente.nl/user/s1934538/clickstream/clickstream-enwiki-2023-07.tsv.gz,Thor:_Love_and_Thunder,72288,93967,1598,167853,72401
hdfs://spark-nn.eemcs.utwente.nl/user/s1934538/clickstream/clickstream-enwiki-2023-07.tsv.gz,Fyre_Festival,8830,44523,334,53687,29792
hdfs://spark-nn.eemcs.utwente.nl/user/s1934538/clickstream/clickstream-enwiki-2023-07.tsv.gz,Kate_Spade,34188,62126,316,96630,33155
hdfs://spark-nn.eemcs.utwente.nl/user/s1934538/clickstream/clickstream-enwiki-2023-07.tsv.gz,Joe_Exotic,27344,56642,241,84227,35739
hdfs://spark-nn.eemcs.utwente.nl/user/s1934538/clickstream/clickstream-enwiki-2023-07.tsv.gz,John_McCain,34068,58391,645,93104,51631
hdfs://spark-nn.eemcs.utwente.nl/user/s1934538/clickstream/clickstream-enwiki-2023-07.tsv.gz,Bridgerton,33998,118546,1957,154501,114494
hdfs://spark-nn.eemcs.utwente.nl/user/s1934538/clickstream/clickstream-enwiki-2023-07.tsv.gz,The_Weeknd,109712,389205,3464,502381,216901
hdfs://spark-nn.eemcs.utwente.nl/user/s1934538/clickstream/clickstream-enwiki-2023-07.tsv.gz,Queen_(band),58790,191022,3239,253051,263397
hdfs://spark-nn.eemcs.utwente.nl/user/s1934538/clickstream/clickstream-enwiki-2023-07.tsv.gz,List_of_Queen_of_the_South_episodes,4975,5449,33,10457,178
hdfs://spark-nn.eemcs.utwente.nl/user/s1934538/clickstream/clickstream-enwiki-2023-07.tsv.gz,Leave_the_World_Behind_(film),15237,4810,39,20086,6099
hdfs://spark-nn.eemcs.utwente.nl/user/s1934538/clickstream/clickstream-enwiki-2023-07.tsv.gz,Bird_Box_(film),52744,370237,3276,426257,188922
hdfs://spark-nn.eemcs.utwente.nl/user/s1934538/clickstream/clickstream-enwiki-2023-07.tsv.gz,Richard_Ramirez,16244,144720,1095,162059,46013
hdfs://spark-nn.eemcs.utwente.nl/user/s1934538/clickstream/clickstream-enwiki-2023-07.tsv.gz,Shinzo_Abe,48005,90405,4003,142413,98876
hdfs://spark-nn.eemcs.utwente.nl/user/s1934538/clickstream/clickstream-enwiki-2023-07.tsv.gz,K.G.F:_Chapter_2,43428,164680,572,208680,51972
hdfs://spark-nn.eemcs.utwente.nl/user/s1934538/clickstream/clickstream-enwiki-2023-07.tsv.gz,Mission:_Impossible_–_Dead_Reckoning_Part_One,896574,3382837,102334,4381745,2780037
hdfs://spark-nn.eemcs.utwente.nl/user/s1934538/clickstream/clickstream-enwiki-2023-07.tsv.gz,The_Irishman,58808,92553,1596,152957,127246
hdfs://spark-nn.eemcs.utwente.nl/user/s1934538/clickstream/clickstream-enwiki-2023-07.tsv.gz,Main_Page,83634,142771393,4651063,147506090,33471133
hdfs://spark-nn.eemcs.utwente.nl/user/s1934538/clickstream/clickstream-enwiki-2023-07.tsv.gz,Wonder_Woman_1984,43641,48715,868,93224,37704
hdfs://spark-nn.eemcs.utwente.nl/user/s1934538/clickstream/clickstream-enwiki-2023-07.tsv.gz,Aquaman_(film),36489,94781,1005,132275,51323
hdfs://spark-nn.eemcs.utwente.nl/user/s1934538/clickstream/clickstream-enwiki-2023-07.tsv.gz,Jimmy_Hoffa,40001,140499,1150,181650,73389
hdfs://spark-nn.eemcs.utwente.nl/user/s1934538/clickstream/clickstream-enwiki-2023-07.tsv.gz,Jeffrey_Epstein,58931,273569,1795,334295,158931
hdfs://spark-nn.eemcs.utwente.nl/user/s1934538/clickstream/clickstream-enwiki-2023-07.tsv.gz,Sidharth_Shukla,10055,50956,219,61230,13881
hdfs://spark-nn.eemcs.utwente.nl/user/s1934538/clickstream/clickstream-enwiki-2023-07.tsv.gz,Kantara_(film),16184,86279,246,102709,41305
hdfs://spark-nn.eemcs.utwente.nl/user/s1934538/clickstream/clickstream-enwiki-2023-07.tsv.gz,Luke_Perry,46202,126800,514,173516,69616
hdfs://spark-nn.eemcs.utwente.nl/user/s1934538/clickstream/clickstream-enwiki-2023-07.tsv.gz,Antifa_(United_States),8197,91355,389,99941,15855
hdfs://spark-nn.eemcs.utwente.nl/user/s1934538/clickstream/clickstream-enwiki-2023-07.tsv.gz,Joe_Biden,250742,664075,10044,924861,472339
hdfs://spark-nn.eemcs.utwente.nl/user/s1934538/clickstream/clickstream-enwiki-2023-07.tsv.gz,George_H._W._Bush,179100,116808,954,296862,192850
hdfs://spark-nn.eemcs.utwente.nl/user/s1934538/clickstream/clickstream-enwiki-2023-07.tsv.gz,Captain_Marvel_(film),44970,103755,1252,149977,72896
hdfs://spark-nn.eemcs.utwente.nl/user/s1934538/clickstream/clickstream-enwiki-2023-07.tsv.gz,Dennis_Nilsen,8489,39089,261,47839,12210
hdfs://spark-nn.eemcs.utwente.nl/user/s1934538/clickstream/clickstream-enwiki-2023-07.tsv.gz,Matthew_Perry,44935,133295,767,178997,85175
hdfs://spark-nn.eemcs.utwente.nl/user/s1934538/clickstream/clickstream-enwiki-2023-07.tsv.gz,Kylian_Mbappé,65964,927985,7056,1001005,170769
hdfs://spark-nn.eemcs.utwente.nl/user/s1934538/clickstream/clickstream-enwiki-2023-07.tsv.gz,"Prince_Philip,_Duke_of_Edinburgh",107649,96124,922,204695,129405
hdfs://spark-nn.eemcs.utwente.nl/user/s1934538/clickstream/clickstream-enwiki-2023-07.tsv.gz,Glass_(2019_film),43482,52164,350,95996,32095
hdfs://spark-nn.eemcs.utwente.nl/user/s1934538/clickstream/clickstream-enwiki-2023-07.tsv.gz,COVID-19_pandemic,90742,196739,5300,292781,98628
hdfs://spark-nn.eemcs.utwente.nl/user/s1934538/clickstream/clickstream-enwiki-2023-07.tsv.gz,Bob_Saget,28640,95520,688,124848,25160
hdfs://spark-nn.eemcs.utwente.nl/user/s1934538/clickstream/clickstream-enwiki-2023-07.tsv.gz,Squid_Game,27784,147095,2217,177096,90494
hdfs://spark-nn.eemcs.utwente.nl/user/s1934538/clickstream/clickstream-enwiki-2023-07.tsv.gz,The_Matrix_Resurrections,53332,56559,779,110670,51811
hdfs://spark-nn.eemcs.utwente.nl/user/s1934538/clickstream/clickstream-enwiki-2023-07.tsv.gz,Cleopatra,78639,6041390,891,6120920,564831
hdfs://spark-nn.eemcs.utwente.nl/user/s1934538/clickstream/clickstream-enwiki-2023-07.tsv.gz,List_of_FIFA_World_Cup_finals,4579,64755,69,69403,21570
hdfs://spark-nn.eemcs.utwente.nl/user/s1934538/clickstream/clickstream-enwiki-2023-07.tsv.gz,Israel,104294,319258,6687,430239,229282
hdfs://spark-nn.eemcs.utwente.nl/user/s1934538/clickstream/clickstream-enwiki-2023-07.tsv.gz,Laal_Singh_Chaddha,20710,48394,67,69171,25174
hdfs://spark-nn.eemcs.utwente.nl/user/s1934538/clickstream/clickstream-enwiki-2023-07.tsv.gz,United_States_Electoral_College,12994,24748,102,37844,8027
hdfs://spark-nn.eemcs.utwente.nl/user/s1934538/clickstream/clickstream-enwiki-2023-07.tsv.gz,Black_Adam_(film),66571,194888,2647,264106,125473
hdfs://spark-nn.eemcs.utwente.nl/user/s1934538/clickstream/clickstream-enwiki-2023-07.tsv.gz,2022_FIFA_World_Cup,171722,214626,3520,389868,257311
hdfs://spark-nn.eemcs.utwente.nl/user/s1934538/clickstream/clickstream-enwiki-2023-07.tsv.gz,Aretha_Franklin,26971,183447,1756,212174,91667
hdfs://spark-nn.eemcs.utwente.nl/user/s1934538/clickstream/clickstream-enwiki-2023-07.tsv.gz,UEFA_Euro_2020,44689,40359,797,85845,58702
hdfs://spark-nn.eemcs.utwente.nl/user/s1934538/clickstream/clickstream-enwiki-2023-07.tsv.gz,Carlos_Alcaraz,273207,3938534,14717,4226458,1007977
hdfs://spark-nn.eemcs.utwente.nl/user/s1934538/clickstream/clickstream-enwiki-2023-07.tsv.gz,Crazy_Rich_Asians_(film),34046,96367,1436,131849,112139
hdfs://spark-nn.eemcs.utwente.nl/user/s1934538/clickstream/clickstream-enwiki-2023-07.tsv.gz,Anne_Heche,46528,173125,1163,220816,77905
hdfs://spark-nn.eemcs.utwente.nl/user/s1934538/clickstream/clickstream-enwiki-2023-07.tsv.gz,Stranger_Things_(season_4),23542,77255,866,101663,57847
hdfs://spark-nn.eemcs.utwente.nl/user/s1934538/clickstream/clickstream-enwiki-2023-07.tsv.gz,Sushma_Swaraj,10566,21406,44,32016,9627
hdfs://spark-nn.eemcs.utwente.nl/user/s1934538/clickstream/clickstream-enwiki-2023-07.tsv.gz,The_Batman_(film),152137,264816,4150,421103,203869
hdfs://spark-nn.eemcs.utwente.nl/user/s1934538/clickstream/clickstream-enwiki-2023-07.tsv.gz,RRR_(film),55284,226004,1869,283157,125737
hdfs://spark-nn.eemcs.utwente.nl/user/s1934538/clickstream/clickstream-enwiki-2023-07.tsv.gz,Jason_Momoa,74640,481365,2226,558231,238231
hdfs://spark-nn.eemcs.utwente.nl/user/s1934538/clickstream/clickstream-enwiki-2023-07.tsv.gz,Jimmy_Buffett,16360,100321,1239,117920,51157
hdfs://spark-nn.eemcs.utwente.nl/user/s1934538/clickstream/clickstream-enwiki-2023-07.tsv.gz,Amber_Heard,81990,168590,1079,251659,107734
hdfs://spark-nn.eemcs.utwente.nl/user/s1934538/clickstream/clickstream-enwiki-2018-05.tsv.gz,Aquaman_(film),104266,93096,1366,198728,114010
hdfs://spark-nn.eemcs.utwente.nl/user/s1934538/clickstream/clickstream-enwiki-2018-05.tsv.gz,Ray_Liotta,24800,57530,286,82616,22986
hdfs://spark-nn.eemcs.utwente.nl/user/s1934538/clickstream/clickstream-enwiki-2018-05.tsv.gz,Lists_of_deaths_by_year,7646,152782,171,160599,135015
hdfs://spark-nn.eemcs.utwente.nl/user/s1934538/clickstream/clickstream-enwiki-2018-05.tsv.gz,Shakira,13463,236940,2016,252419,92979
hdfs://spark-nn.eemcs.utwente.nl/user/s1934538/clickstream/clickstream-enwiki-2018-05.tsv.gz,Sushma_Swaraj,4870,27739,54,32663,7227
hdfs://spark-nn.eemcs.utwente.nl/user/s1934538/clickstream/clickstream-enwiki-2018-05.tsv.gz,Donald_Trump,221344,932667,12879,1166890,583809
hdfs://spark-nn.eemcs.utwente.nl/user/s1934538/clickstream/clickstream-enwiki-2018-05.tsv.gz,Darth_Vader,25786,2391721,835,2418342,53090
hdfs://spark-nn.eemcs.utwente.nl/user/s1934538/clickstream/clickstream-enwiki-2018-05.tsv.gz,Tunnel,3216,14106,139,17461,3790
hdfs://spark-nn.eemcs.utwente.nl/user/s1934538/clickstream/clickstream-enwiki-2018-05.tsv.gz,John_McCain,48172,686609,8921,743702,240454
hdfs://spark-nn.eemcs.utwente.nl/user/s1934538/clickstream/clickstream-enwiki-2018-05.tsv.gz,XXXTentacion,34966,247300,4769,287035,75306
hdfs://spark-nn.eemcs.utwente.nl/user/s1934538/clickstream/clickstream-enwiki-2018-05.tsv.gz,YouTube,94286,627432,7906,729624,118689
hdfs://spark-nn.eemcs.utwente.nl/user/s1934538/clickstream/clickstream-enwiki-2018-05.tsv.gz,Henry_V_of_England,54711,38194,174,93079,58568
hdfs://spark-nn.eemcs.utwente.nl/user/s1934538/clickstream/clickstream-enwiki-2018-05.tsv.gz,The_Umbrella_Academy_(TV_series),6234,9375,25,15634,6774
hdfs://spark-nn.eemcs.utwente.nl/user/s1934538/clickstream/clickstream-enwiki-2018-05.tsv.gz,George_VI,1073111,703668,1522,1778301,1050741
hdfs://spark-nn.eemcs.utwente.nl/user/s1934538/clickstream/clickstream-enwiki-2018-05.tsv.gz,Game_of_Thrones_(season_8),50713,367165,1108,418986,117374
hdfs://spark-nn.eemcs.utwente.nl/user/s1934538/clickstream/clickstream-enwiki-2018-05.tsv.gz,Ukraine,43932,165891,3221,213044,81158
hdfs://spark-nn.eemcs.utwente.nl/user/s1934538/clickstream/clickstream-enwiki-2018-05.tsv.gz,Black_Panther_(film),363409,1765615,33529,2162553,1485816
hdfs://spark-nn.eemcs.utwente.nl/user/s1934538/clickstream/clickstream-enwiki-2018-05.tsv.gz,WrestleMania_34,57160,92471,1285,150916,97303
hdfs://spark-nn.eemcs.utwente.nl/user/s1934538/clickstream/clickstream-enwiki-2018-05.tsv.gz,Indian_Premier_League,58688,549997,1150,609835,231449
hdfs://spark-nn.eemcs.utwente.nl/user/s1934538/clickstream/clickstream-enwiki-2018-05.tsv.gz,Kate_Spade,13915,29299,71,43285,13146
hdfs://spark-nn.eemcs.utwente.nl/user/s1934538/clickstream/clickstream-enwiki-2018-05.tsv.gz,Charles_III,254,625,119,998,593
hdfs://spark-nn.eemcs.utwente.nl/user/s1934538/clickstream/clickstream-enwiki-2018-05.tsv.gz,Grover,1161,6417,52,7630,1234
hdfs://spark-nn.eemcs.utwente.nl/user/s1934538/clickstream/clickstream-enwiki-2018-05.tsv.gz,Rami_Malek,140978,319825,2435,463238,152708
hdfs://spark-nn.eemcs.utwente.nl/user/s1934538/clickstream/clickstream-enwiki-2018-05.tsv.gz,Olivia_Newton-John,35173,426576,2342,464091,164950
hdfs://spark-nn.eemcs.utwente.nl/user/s1934538/clickstream/clickstream-enwiki-2018-05.tsv.gz,"Prince_Philip,_Duke_of_Edinburgh",973004,1344758,10975,2328737,1224761
hdfs://spark-nn.eemcs.utwente.nl/user/s1934538/clickstream/clickstream-enwiki-2018-05.tsv.gz,"Princess_Margaret,_Countess_of_Snowdon",415050,1023067,4991,1443108,710773
hdfs://spark-nn.eemcs.utwente.nl/user/s1934538/clickstream/clickstream-enwiki-2018-05.tsv.gz,JSON_Web_Token,1032,20536,30,21598,1782
hdfs://spark-nn.eemcs.utwente.nl/user/s1934538/clickstream/clickstream-enwiki-2018-05.tsv.gz,Kim_Jong-un,56078,409616,14368,480062,190084
hdfs://spark-nn.eemcs.utwente.nl/user/s1934538/clickstream/clickstream-enwiki-2018-05.tsv.gz,Luke_Perry,23988,45090,219,69297,10482
hdfs://spark-nn.eemcs.utwente.nl/user/s1934538/clickstream/clickstream-enwiki-2018-05.tsv.gz,Line_shaft,573,1285,105,1963,187
hdfs://spark-nn.eemcs.utwente.nl/user/s1934538/clickstream/clickstream-enwiki-2018-05.tsv.gz,Roe_v._Wade,11073,116562,833,128468,23518
hdfs://spark-nn.eemcs.utwente.nl/user/s1934538/clickstream/clickstream-enwiki-2018-05.tsv.gz,The_Witcher_(TV_series),5691,42105,256,48052,11229
hdfs://spark-nn.eemcs.utwente.nl/user/s1934538/clickstream/clickstream-enwiki-2018-05.tsv.gz,The_Lion_King_(2019_film),122007,106164,764,228935,201657
hdfs://spark-nn.eemcs.utwente.nl/user/s1934538/clickstream/clickstream-enwiki-2018-05.tsv.gz,Adele,19789,226782,4575,251146,58814
hdfs://spark-nn.eemcs.utwente.nl/user/s1934538/clickstream/clickstream-enwiki-2018-05.tsv.gz,Royal_Rumble_(2018),19515,54870,295,74680,30286
hdfs://spark-nn.eemcs.utwente.nl/user/s1934538/clickstream/clickstream-enwiki-2018-05.tsv.gz,Avengers:_Infinity_War,1247663,8858212,200515,10306390,6232676
hdfs://spark-nn.eemcs.utwente.nl/user/s1934538/clickstream/clickstream-enwiki-2018-05.tsv.gz,DMX_(rapper),11559,76804,394,88757,30907
hdfs://spark-nn.eemcs.utwente.nl/user/s1934538/clickstream/clickstream-enwiki-2018-05.tsv.gz,Top_Gun:_Maverick,965,1036,162,2163,960
hdfs://spark-nn.eemcs.utwente.nl/user/s1934538/clickstream/clickstream-enwiki-2018-05.tsv.gz,Mac_Miller,64264,133967,683,198914,43760
hdfs://spark-nn.eemcs.utwente.nl/user/s1934538/clickstream/clickstream-enwiki-2018-05.tsv.gz,List_of_FIFA_World_Cup_finals,3911,263976,241,268128,60015
hdfs://spark-nn.eemcs.utwente.nl/user/s1934538/clickstream/clickstream-enwiki-2018-05.tsv.gz,List_of_highest-grossing_Indian_films,63122,441181,1339,505642,225602
hdfs://spark-nn.eemcs.utwente.nl/user/s1934538/clickstream/clickstream-enwiki-2018-05.tsv.gz,Deaths_in_2018,1225769,2081354,7991,3315114,1639330
hdfs://spark-nn.eemcs.utwente.nl/user/s1934538/clickstream/clickstream-enwiki-2018-05.tsv.gz,Stan_Lee,176327,537018,3691,717036,231779
hdfs://spark-nn.eemcs.utwente.nl/user/s1934538/clickstream/clickstream-enwiki-2018-05.tsv.gz,List_of_highest-grossing_films,724484,2367030,11060,3102574,900254
hdfs://spark-nn.eemcs.utwente.nl/user/s1934538/clickstream/clickstream-enwiki-2018-05.tsv.gz,Taliban,18289,79698,461,98448,42300
hdfs://spark-nn.eemcs.utwente.nl/user/s1934538/clickstream/clickstream-enwiki-2018-05.tsv.gz,Key_frame,719,7038,38,7795,643
hdfs://spark-nn.eemcs.utwente.nl/user/s1934538/clickstream/clickstream-enwiki-2018-05.tsv.gz,Stephen_Hawking,28733,573969,4634,607336,180203
hdfs://spark-nn.eemcs.utwente.nl/user/s1934538/clickstream/clickstream-enwiki-2018-05.tsv.gz,UEFA_Euro_2020,27589,79478,1266,108333,42022
hdfs://spark-nn.eemcs.utwente.nl/user/s1934538/clickstream/clickstream-enwiki-2018-05.tsv.gz,Queen_(band),84571,330622,3800,418993,352730
hdfs://spark-nn.eemcs.utwente.nl/user/s1934538/clickstream/clickstream-enwiki-2018-05.tsv.gz,Anne_Heche,26495,45665,217,72377,18542
hdfs://spark-nn.eemcs.utwente.nl/user/s1934538/clickstream/clickstream-enwiki-2018-05.tsv.gz,Gaza_Strip,42567,238687,12966,294220,108393
hdfs://spark-nn.eemcs.utwente.nl/user/s1934538/clickstream/clickstream-enwiki-2018-05.tsv.gz,Salman_Rushdie,22484,72519,1753,96756,38784
hdfs://spark-nn.eemcs.utwente.nl/user/s1934538/clickstream/clickstream-enwiki-2018-05.tsv.gz,David_Beckham,61321,660088,4223,725632,186075
hdfs://spark-nn.eemcs.utwente.nl/user/s1934538/clickstream/clickstream-enwiki-2018-05.tsv.gz,United_States_Senate,39001,67408,528,106937,33337
hdfs://spark-nn.eemcs.utwente.nl/user/s1934538/clickstream/clickstream-enwiki-2018-05.tsv.gz,Cook's_Country,110,2942,18,3070,32
hdfs://spark-nn.eemcs.utwente.nl/user/s1934538/clickstream/clickstream-enwiki-2018-05.tsv.gz,The_Irishman_(2019_film),49291,57227,296,106814,77237
hdfs://spark-nn.eemcs.utwente.nl/user/s1934538/clickstream/clickstream-enwiki-2018-05.tsv.gz,Donald_Glover,263297,4187417,38270,4488984,1089361
hdfs://spark-nn.eemcs.utwente.nl/user/s1934538/clickstream/clickstream-enwiki-2018-05.tsv.gz,Glass_(2019_film),63372,44125,115,107612,51972
hdfs://spark-nn.eemcs.utwente.nl/user/s1934538/clickstream/clickstream-enwiki-2018-05.tsv.gz,Joaquin_Phoenix,68547,115071,649,184267,103002
hdfs://spark-nn.eemcs.utwente.nl/user/s1934538/clickstream/clickstream-enwiki-2018-05.tsv.gz,Captain_Marvel_(film),463833,612324,7357,1083514,714391
hdfs://spark-nn.eemcs.utwente.nl/user/s1934538/clickstream/clickstream-enwiki-2018-05.tsv.gz,Murder_of_Dee_Dee_Blanchard,3441,48428,70,51939,8191
hdfs://spark-nn.eemcs.utwente.nl/user/s1934538/clickstream/clickstream-enwiki-2018-05.tsv.gz,Lance_Reddick,17956,25799,128,43883,8618
hdfs://spark-nn.eemcs.utwente.nl/user/s1934538/clickstream/clickstream-enwiki-2018-05.tsv.gz,XHamster,7253,7766076,7235,7780564,35488
hdfs://spark-nn.eemcs.utwente.nl/user/s1934538/clickstream/clickstream-enwiki-2018-05.tsv.gz,1234,54,2483,14,2551,164
hdfs://spark-nn.eemcs.utwente.nl/user/s1934538/clickstream/clickstream-enwiki-2018-05.tsv.gz,Critical_race_theory,1644,15365,52,17061,3043
hdfs://spark-nn.eemcs.utwente.nl/user/s1934538/clickstream/clickstream-enwiki-2018-05.tsv.gz,FIFA_World_Cup,86941,463946,8940,559827,395360
hdfs://spark-nn.eemcs.utwente.nl/user/s1934538/clickstream/clickstream-enwiki-2018-05.tsv.gz,Notre-Dame_de_Paris,8546,89192,397,98135,13956
hdfs://spark-nn.eemcs.utwente.nl/user/s1934538/clickstream/clickstream-enwiki-2018-05.tsv.gz,Antifa_(United_States),7124,67805,94,75023,14177
hdfs://spark-nn.eemcs.utwente.nl/user/s1934538/clickstream/clickstream-enwiki-2018-05.tsv.gz,Meghan_Markle,732175,17739233,176067,18647475,1588107
hdfs://spark-nn.eemcs.utwente.nl/user/s1934538/clickstream/clickstream-enwiki-2018-05.tsv.gz,Chernobyl_disaster,27581,264486,1412,293479,71478
hdfs://spark-nn.eemcs.utwente.nl/user/s1934538/clickstream/clickstream-enwiki-2018-05.tsv.gz,Area_51,12512,202006,1299,215817,48238
hdfs://spark-nn.eemcs.utwente.nl/user/s1934538/clickstream/clickstream-enwiki-2018-05.tsv.gz,Media,57,17867,422,18346,3365
hdfs://spark-nn.eemcs.utwente.nl/user/s1934538/clickstream/clickstream-enwiki-2018-05.tsv.gz,Grimes_(musician),73660,691625,2896,768181,157194
hdfs://spark-nn.eemcs.utwente.nl/user/s1934538/clickstream/clickstream-enwiki-2018-05.tsv.gz,Freddie_Mercury,179521,1005412,7854,1192787,406748
hdfs://spark-nn.eemcs.utwente.nl/user/s1934538/clickstream/clickstream-enwiki-2018-05.tsv.gz,Tonya_Harding,55725,873659,4069,933453,138501
hdfs://spark-nn.eemcs.utwente.nl/user/s1934538/clickstream/clickstream-enwiki-2018-05.tsv.gz,Valentine's_Day,2688,35561,201,38450,497
hdfs://spark-nn.eemcs.utwente.nl/user/s1934538/clickstream/clickstream-enwiki-2018-05.tsv.gz,The_Weeknd,46543,202605,1863,251011,87405
hdfs://spark-nn.eemcs.utwente.nl/user/s1934538/clickstream/clickstream-enwiki-2018-05.tsv.gz,Louis_Tomlinson,27278,56298,344,83920,10615
hdfs://spark-nn.eemcs.utwente.nl/user/s1934538/clickstream/clickstream-enwiki-2018-05.tsv.gz,2018_Asian_Games,9693,70992,383,81068,28074
hdfs://spark-nn.eemcs.utwente.nl/user/s1934538/clickstream/clickstream-enwiki-2018-05.tsv.gz,The_Irishman,66,477,29,572,481
hdfs://spark-nn.eemcs.utwente.nl/user/s1934538/clickstream/clickstream-enwiki-2018-05.tsv.gz,NATO,39972,171581,2026,213579,58961
hdfs://spark-nn.eemcs.utwente.nl/user/s1934538/clickstream/clickstream-enwiki-2018-05.tsv.gz,R._Kelly,24800,256057,2567,283424,105938
hdfs://spark-nn.eemcs.utwente.nl/user/s1934538/clickstream/clickstream-enwiki-2018-05.tsv.gz,Jimmy_Hoffa,19517,69294,682,89493,26466
hdfs://spark-nn.eemcs.utwente.nl/user/s1934538/clickstream/clickstream-enwiki-2018-05.tsv.gz,Dennis_Nilsen,22388,173396,1771,197555,45186
hdfs://spark-nn.eemcs.utwente.nl/user/s1934538/clickstream/clickstream-enwiki-2018-05.tsv.gz,Hamas,35345,152325,1751,189421,55881
hdfs://spark-nn.eemcs.utwente.nl/user/s1934538/clickstream/clickstream-enwiki-2018-05.tsv.gz,Aretha_Franklin,13850,79514,671,94035,23763
hdfs://spark-nn.eemcs.utwente.nl/user/s1934538/clickstream/clickstream-enwiki-2018-05.tsv.gz,2.0_(film),41787,190883,431,233101,49245
hdfs://spark-nn.eemcs.utwente.nl/user/s1934538/clickstream/clickstream-enwiki-2018-05.tsv.gz,Deion_Sanders,7306,52804,349,60459,12183
hdfs://spark-nn.eemcs.utwente.nl/user/s1934538/clickstream/clickstream-enwiki-2018-05.tsv.gz,Fyre_Festival,2421,46321,169,48911,17352
hdfs://spark-nn.eemcs.utwente.nl/user/s1934538/clickstream/clickstream-enwiki-2018-05.tsv.gz,Ghislaine_Maxwell,1005,1645,195,2845,706
hdfs://spark-nn.eemcs.utwente.nl/user/s1934538/clickstream/clickstream-enwiki-2018-05.tsv.gz,2022_FIFA_World_Cup,105334,92065,807,198206,104365
hdfs://spark-nn.eemcs.utwente.nl/user/s1934538/clickstream/clickstream-enwiki-2018-05.tsv.gz,Coronavirus,868,9965,18,10851,1362
hdfs://spark-nn.eemcs.utwente.nl/user/s1934538/clickstream/clickstream-enwiki-2018-05.tsv.gz,Brie_Larson,369877,485443,3347,858667,313351
hdfs://spark-nn.eemcs.utwente.nl/user/s1934538/clickstream/clickstream-enwiki-2018-05.tsv.gz,Johnny_Depp,82264,309293,2563,394120,225384
hdfs://spark-nn.eemcs.utwente.nl/user/s1934538/clickstream/clickstream-enwiki-2018-05.tsv.gz,The_Nun_(2018_film),51082,94897,513,146492,53532
hdfs://spark-nn.eemcs.utwente.nl/user/s1934538/clickstream/clickstream-enwiki-2018-05.tsv.gz,Jimmy_Buffett,8336,70831,588,79755,20318
hdfs://spark-nn.eemcs.utwente.nl/user/s1934538/clickstream/clickstream-enwiki-2018-05.tsv.gz,Elon_Musk,175238,1175566,8944,1359748,671013
hdfs://spark-nn.eemcs.utwente.nl/user/s1934538/clickstream/clickstream-enwiki-2018-05.tsv.gz,Fantastic_Beasts:_The_Crimes_of_Grindelwald,63177,65039,593,128809,73611
hdfs://spark-nn.eemcs.utwente.nl/user/s1934538/clickstream/clickstream-enwiki-2018-05.tsv.gz,A_Star_Is_Born_(2018_film),27200,23321,164,50685,18858
hdfs://spark-nn.eemcs.utwente.nl/user/s1934538/clickstream/clickstream-enwiki-2018-08.tsv.gz,Royal_Rumble_(2018),16627,26104,266,42997,24474
hdfs://spark-nn.eemcs.utwente.nl/user/s1934538/clickstream/clickstream-enwiki-2018-08.tsv.gz,Area_51,15010,191639,1357,208006,54428
hdfs://spark-nn.eemcs.utwente.nl/user/s1934538/clickstream/clickstream-enwiki-2018-08.tsv.gz,HTTP_cookie,9694,693142,225,703061,37069
hdfs://spark-nn.eemcs.utwente.nl/user/s1934538/clickstream/clickstream-enwiki-2018-08.tsv.gz,IPv4,10783,43600,143,54526,9873
hdfs://spark-nn.eemcs.utwente.nl/user/s1934538/clickstream/clickstream-enwiki-2018-08.tsv.gz,Tunnel,3643,12471,145,16259,3628
hdfs://spark-nn.eemcs.utwente.nl/user/s1934538/clickstream/clickstream-enwiki-2018-08.tsv.gz,Simone_Biles,14784,121112,776,136672,38815
hdfs://spark-nn.eemcs.utwente.nl/user/s1934538/clickstream/clickstream-enwiki-2018-08.tsv.gz,Jimmy_Buffett,8404,68174,659,77237,23462
hdfs://spark-nn.eemcs.utwente.nl/user/s1934538/clickstream/clickstream-enwiki-2018-08.tsv.gz,Richard_Jewell,2232,6600,45,8877,2426
hdfs://spark-nn.eemcs.utwente.nl/user/s1934538/clickstream/clickstream-enwiki-2018-08.tsv.gz,Avengers:_Infinity_War,361007,1535917,41725,1938649,1501538
hdfs://spark-nn.eemcs.utwente.nl/user/s1934538/clickstream/clickstream-enwiki-2018-08.tsv.gz,2018_Asian_Games,403101,2668102,6172,3077375,2504116
hdfs://spark-nn.eemcs.utwente.nl/user/s1934538/clickstream/clickstream-enwiki-2018-08.tsv.gz,WrestleMania_34,41172,47563,658,89393,57112
hdfs://spark-nn.eemcs.utwente.nl/user/s1934538/clickstream/clickstream-enwiki-2018-08.tsv.gz,Rami_Malek,75902,165663,1020,242585,82643
hdfs://spark-nn.eemcs.utwente.nl/user/s1934538/clickstream/clickstream-enwiki-2018-08.tsv.gz,Media,90,11394,319,11803,2697
hdfs://spark-nn.eemcs.utwente.nl/user/s1934538/clickstream/clickstream-enwiki-2018-08.tsv.gz,Bob_Saget,17946,35127,182,53255,9529
hdfs://spark-nn.eemcs.utwente.nl/user/s1934538/clickstream/clickstream-enwiki-2018-08.tsv.gz,Rishi_Sunak,5382,1970,10,7362,948
hdfs://spark-nn.eemcs.utwente.nl/user/s1934538/clickstream/clickstream-enwiki-2018-08.tsv.gz,Amy_Coney_Barrett,1043,3639,16,4698,815
hdfs://spark-nn.eemcs.utwente.nl/user/s1934538/clickstream/clickstream-enwiki-2018-08.tsv.gz,Hamas,13478,39319,307,53104,18380
hdfs://spark-nn.eemcs.utwente.nl/user/s1934538/clickstream/clickstream-enwiki-2018-08.tsv.gz,A_Star_Is_Born_(2018_film),39879,212646,2301,254826,101982
hdfs://spark-nn.eemcs.utwente.nl/user/s1934538/clickstream/clickstream-enwiki-2018-08.tsv.gz,"Meghan,_Duchess_of_Sussex",113707,479988,3563,597258,260450
hdfs://spark-nn.eemcs.utwente.nl/user/s1934538/clickstream/clickstream-enwiki-2018-08.tsv.gz,Critical_race_theory,1479,10536,23,12038,2553
hdfs://spark-nn.eemcs.utwente.nl/user/s1934538/clickstream/clickstream-enwiki-2018-08.tsv.gz,Cleopatra,56631,228065,2295,286991,122112
hdfs://spark-nn.eemcs.utwente.nl/user/s1934538/clickstream/clickstream-enwiki-2018-08.tsv.gz,2022_FIFA_World_Cup,57654,100948,1012,159614,71568
hdfs://spark-nn.eemcs.utwente.nl/user/s1934538/clickstream/clickstream-enwiki-2018-08.tsv.gz,The_Shape_of_Water,34891,122848,2077,159816,78029
hdfs://spark-nn.eemcs.utwente.nl/user/s1934538/clickstream/clickstream-enwiki-2018-08.tsv.gz,Priyanka_Chopra,415128,1466116,4993,1886237,657973
hdfs://spark-nn.eemcs.utwente.nl/user/s1934538/clickstream/clickstream-enwiki-2018-08.tsv.gz,Wonder_Woman_1984,106625,76660,816,184101,104698
hdfs://spark-nn.eemcs.utwente.nl/user/s1934538/clickstream/clickstream-enwiki-2018-08.tsv.gz,Grimes_(musician),77520,173064,1409,251993,52810
hdfs://spark-nn.eemcs.utwente.nl/user/s1934538/clickstream/clickstream-enwiki-2018-08.tsv.gz,List_of_FIFA_World_Cup_finals,1884,89741,87,91712,18589
hdfs://spark-nn.eemcs.utwente.nl/user/s1934538/clickstream/clickstream-enwiki-2018-08.tsv.gz,No_Time_to_Die,128,539,13,680,487
hdfs://spark-nn.eemcs.utwente.nl/user/s1934538/clickstream/clickstream-enwiki-2018-08.tsv.gz,Bird_Box_(film),13962,5825,50,19837,8415
hdfs://spark-nn.eemcs.utwente.nl/user/s1934538/clickstream/clickstream-enwiki-2018-08.tsv.gz,Chernobyl_disaster,27362,247980,1227,276569,69369
hdfs://spark-nn.eemcs.utwente.nl/user/s1934538/clickstream/clickstream-enwiki-2018-08.tsv.gz,Elizabeth_II,407046,673337,2727,1083110,817148
hdfs://spark-nn.eemcs.utwente.nl/user/s1934538/clickstream/clickstream-enwiki-2018-08.tsv.gz,DMX_(rapper),13387,83441,462,97290,34395
hdfs://spark-nn.eemcs.utwente.nl/user/s1934538/clickstream/clickstream-enwiki-2018-08.tsv.gz,George_VI,344508,260691,831,606030,397721
hdfs://spark-nn.eemcs.utwente.nl/user/s1934538/clickstream/clickstream-enwiki-2018-08.tsv.gz,Donald_Glover,63217,319400,7500,390117,109502
hdfs://spark-nn.eemcs.utwente.nl/user/s1934538/clickstream/clickstream-enwiki-2018-08.tsv.gz,Notre-Dame_de_Paris,8282,72925,424,81631,13787
hdfs://spark-nn.eemcs.utwente.nl/user/s1934538/clickstream/clickstream-enwiki-2018-08.tsv.gz,Stephen_Hawking,24771,389114,2872,416757,133147
hdfs://spark-nn.eemcs.utwente.nl/user/s1934538/clickstream/clickstream-enwiki-2018-08.tsv.gz,Anthony_Bourdain,59682,436913,4613,501208,133136
hdfs://spark-nn.eemcs.utwente.nl/user/s1934538/clickstream/clickstream-enwiki-2018-08.tsv.gz,Venom_(2018_film),90963,513743,10101,614807,372097
hdfs://spark-nn.eemcs.utwente.nl/user/s1934538/clickstream/clickstream-enwiki-2018-08.tsv.gz,Cricket_World_Cup,7555,72522,376,80453,42230
hdfs://spark-nn.eemcs.utwente.nl/user/s1934538/clickstream/clickstream-enwiki-2018-08.tsv.gz,Henry_V_of_England,39229,25753,127,65109,41214
hdfs://spark-nn.eemcs.utwente.nl/user/s1934538/clickstream/clickstream-enwiki-2018-08.tsv.gz,Microsoft_Office,9341,88107,657,98105,22179
hdfs://spark-nn.eemcs.utwente.nl/user/s1934538/clickstream/clickstream-enwiki-2018-08.tsv.gz,Sridevi,31321,187135,776,219232,61734
hdfs://spark-nn.eemcs.utwente.nl/user/s1934538/clickstream/clickstream-enwiki-2018-08.tsv.gz,Tom_Brady,42153,239091,2316,283560,88636
hdfs://spark-nn.eemcs.utwente.nl/user/s1934538/clickstream/clickstream-enwiki-2018-08.tsv.gz,Juice_Wrld,23901,201691,2911,228503,49983
hdfs://spark-nn.eemcs.utwente.nl/user/s1934538/clickstream/clickstream-enwiki-2018-08.tsv.gz,Cameron_Boyce,13983,34708,172,48863,9256
hdfs://spark-nn.eemcs.utwente.nl/user/s1934538/clickstream/clickstream-enwiki-2018-08.tsv.gz,Qasem_Soleimani,2248,8296,21,10565,4814
hdfs://spark-nn.eemcs.utwente.nl/user/s1934538/clickstream/clickstream-enwiki-2018-08.tsv.gz,Lisa_Marie_Presley,148191,139215,467,287873,139564
hdfs://spark-nn.eemcs.utwente.nl/user/s1934538/clickstream/clickstream-enwiki-2018-08.tsv.gz,Naya_Rivera,19971,39364,77,59412,11179
hdfs://spark-nn.eemcs.utwente.nl/user/s1934538/clickstream/clickstream-enwiki-2018-08.tsv.gz,Christopher_Scarver,87434,27247,14,114695,34345
hdfs://spark-nn.eemcs.utwente.nl/user/s1934538/clickstream/clickstream-enwiki-2018-08.tsv.gz,Dennis_Nilsen,5678,26530,159,32367,6272
hdfs://spark-nn.eemcs.utwente.nl/user/s1934538/clickstream/clickstream-enwiki-2018-08.tsv.gz,Kamala_Harris,16647,122631,948,140226,42808
hdfs://spark-nn.eemcs.utwente.nl/user/s1934538/clickstream/clickstream-enwiki-2018-08.tsv.gz,Betty_White,61335,459440,3767,524542,106066
hdfs://spark-nn.eemcs.utwente.nl/user/s1934538/clickstream/clickstream-enwiki-2018-08.tsv.gz,Bipin_Rawat,6002,19689,21,25712,7164
hdfs://spark-nn.eemcs.utwente.nl/user/s1934538/clickstream/clickstream-enwiki-2018-08.tsv.gz,The_Weeknd,49717,138700,1590,190007,74944
hdfs://spark-nn.eemcs.utwente.nl/user/s1934538/clickstream/clickstream-enwiki-2018-08.tsv.gz,Kobe_Bryant,26043,260761,1933,288737,65507
hdfs://spark-nn.eemcs.utwente.nl/user/s1934538/clickstream/clickstream-enwiki-2018-08.tsv.gz,List_of_highest-grossing_films,217904,567330,2697,787931,314575
hdfs://spark-nn.eemcs.utwente.nl/user/s1934538/clickstream/clickstream-enwiki-2018-08.tsv.gz,Deaths_in_2018,1280565,2126366,8746,3415677,1836506
hdfs://spark-nn.eemcs.utwente.nl/user/s1934538/clickstream/clickstream-enwiki-2018-08.tsv.gz,Cristiano_Ronaldo,105263,886044,5774,997081,226421
hdfs://spark-nn.eemcs.utwente.nl/user/s1934538/clickstream/clickstream-enwiki-2018-08.tsv.gz,Wikipedia,39736,439812,897,480445,185555
hdfs://spark-nn.eemcs.utwente.nl/user/s1934538/clickstream/clickstream-enwiki-2018-08.tsv.gz,R._Kelly,30539,88895,735,120169,54040
hdfs://spark-nn.eemcs.utwente.nl/user/s1934538/clickstream/clickstream-enwiki-2018-08.tsv.gz,"Prince_Philip,_Duke_of_Edinburgh",193341,312359,7764,513464,287828
hdfs://spark-nn.eemcs.utwente.nl/user/s1934538/clickstream/clickstream-enwiki-2018-08.tsv.gz,XXXTentacion,91011,586264,10640,687915,199333
hdfs://spark-nn.eemcs.utwente.nl/user/s1934538/clickstream/clickstream-enwiki-2018-08.tsv.gz,Jenna_Ortega,8213,23194,197,31604,4498
hdfs://spark-nn.eemcs.utwente.nl/user/s1934538/clickstream/clickstream-enwiki-2018-08.tsv.gz,David_Beckham,33227,191083,1255,225565,62954
hdfs://spark-nn.eemcs.utwente.nl/user/s1934538/clickstream/clickstream-enwiki-2018-08.tsv.gz,Top_Gun:_Maverick,104860,73329,3901,182090,146534
hdfs://spark-nn.eemcs.utwente.nl/user/s1934538/clickstream/clickstream-enwiki-2018-08.tsv.gz,2.0_(film),54420,109563,539,164522,64003
hdfs://spark-nn.eemcs.utwente.nl/user/s1934538/clickstream/clickstream-enwiki-2018-08.tsv.gz,Article_370_of_the_Constitution_of_India,24280,58609,38,82927,7278
hdfs://spark-nn.eemcs.utwente.nl/user/s1934538/clickstream/clickstream-enwiki-2018-08.tsv.gz,Fyre_Festival,2163,27927,114,30204,13973
hdfs://spark-nn.eemcs.utwente.nl/user/s1934538/clickstream/clickstream-enwiki-2018-08.tsv.gz,Richard_Ramirez,10987,158848,1578,171413,37979
hdfs://spark-nn.eemcs.utwente.nl/user/s1934538/clickstream/clickstream-enwiki-2018-08.tsv.gz,1234,58,1926,14,1998,91
hdfs://spark-nn.eemcs.utwente.nl/user/s1934538/clickstream/clickstream-enwiki-2018-08.tsv.gz,Joe_Biden,49551,207216,2926,259693,96080
hdfs://spark-nn.eemcs.utwente.nl/user/s1934538/clickstream/clickstream-enwiki-2018-08.tsv.gz,Us_(2019_film),23867,7231,18,31116,19138
hdfs://spark-nn.eemcs.utwente.nl/user/s1934538/clickstream/clickstream-enwiki-2018-08.tsv.gz,Pornhub,35526,379297,9432,424255,67837
hdfs://spark-nn.eemcs.utwente.nl/user/s1934538/clickstream/clickstream-enwiki-2018-08.tsv.gz,John_McCain,317984,5183297,131185,5632466,2530605
hdfs://spark-nn.eemcs.utwente.nl/user/s1934538/clickstream/clickstream-enwiki-2018-08.tsv.gz,Dark_Phoenix_(film),147680,85304,2805,235789,148908
hdfs://spark-nn.eemcs.utwente.nl/user/s1934538/clickstream/clickstream-enwiki-2018-08.tsv.gz,Lance_Reddick,19016,20974,3915,43905,8888
hdfs://spark-nn.eemcs.utwente.nl/user/s1934538/clickstream/clickstream-enwiki-2018-08.tsv.gz,Michael_Bloomberg,27636,47259,332,75227,32004
hdfs://spark-nn.eemcs.utwente.nl/user/s1934538/clickstream/clickstream-enwiki-2018-08.tsv.gz,List_of_highest-grossing_Indian_films,81982,424746,931,507659,207099
hdfs://spark-nn.eemcs.utwente.nl/user/s1934538/clickstream/clickstream-enwiki-2018-08.tsv.gz,Darth_Vader,20420,2519158,739,2540317,52559
hdfs://spark-nn.eemcs.utwente.nl/user/s1934538/clickstream/clickstream-enwiki-2018-08.tsv.gz,The_Umbrella_Academy_(TV_series),5739,6617,92,12448,5394
hdfs://spark-nn.eemcs.utwente.nl/user/s1934538/clickstream/clickstream-enwiki-2018-08.tsv.gz,Main_Page,23072,423846121,3347042,427216235,33306658
hdfs://spark-nn.eemcs.utwente.nl/user/s1934538/clickstream/clickstream-enwiki-2018-08.tsv.gz,Manti_Te'o,4909,23306,74,28289,1255
hdfs://spark-nn.eemcs.utwente.nl/user/s1934538/clickstream/clickstream-enwiki-2018-08.tsv.gz,Meat_Loaf,20006,101969,911,122886,40917
hdfs://spark-nn.eemcs.utwente.nl/user/s1934538/clickstream/clickstream-enwiki-2018-08.tsv.gz,Aquaman_(film),84779,111218,2341,198338,118900
hdfs://spark-nn.eemcs.utwente.nl/user/s1934538/clickstream/clickstream-enwiki-2018-08.tsv.gz,Donald_Trump,249297,966549,14645,1230491,707384
hdfs://spark-nn.eemcs.utwente.nl/user/s1934538/clickstream/clickstream-enwiki-2018-08.tsv.gz,Ted_Bundy,42710,387327,4187,434224,95927
hdfs://spark-nn.eemcs.utwente.nl/user/s1934538/clickstream/clickstream-enwiki-2018-08.tsv.gz,The_Irishman,68,460,49,577,538
hdfs://spark-nn.eemcs.utwente.nl/user/s1934538/clickstream/clickstream-enwiki-2018-08.tsv.gz,"Diana,_Princess_of_Wales",104034,286664,2772,393470,199828
hdfs://spark-nn.eemcs.utwente.nl/user/s1934538/clickstream/clickstream-enwiki-2018-08.tsv.gz,Mac_Miller,47841,143467,2691,193999,95008
hdfs://spark-nn.eemcs.utwente.nl/user/s1934538/clickstream/clickstream-enwiki-2018-08.tsv.gz,Stan_Lee,71067,214568,2239,287874,92052
hdfs://spark-nn.eemcs.utwente.nl/user/s1934538/clickstream/clickstream-enwiki-2018-08.tsv.gz,Rihanna,53826,293410,3727,350963,144771
hdfs://spark-nn.eemcs.utwente.nl/user/s1934538/clickstream/clickstream-enwiki-2018-08.tsv.gz,2020_Summer_Olympics,57338,158245,2275,217858,140344
hdfs://spark-nn.eemcs.utwente.nl/user/s1934538/clickstream/clickstream-enwiki-2018-08.tsv.gz,Murder_of_Dee_Dee_Blanchard,9985,136513,338,146836,27450
hdfs://spark-nn.eemcs.utwente.nl/user/s1934538/clickstream/clickstream-enwiki-2018-09.tsv.gz,Aaron_Hernandez,13158,126950,641,140749,37197
hdfs://spark-nn.eemcs.utwente.nl/user/s1934538/clickstream/clickstream-enwiki-2018-09.tsv.gz,Joe_Biden,46422,199721,2739,248882,81600
hdfs://spark-nn.eemcs.utwente.nl/user/s1934538/clickstream/clickstream-enwiki-2018-09.tsv.gz,Ruth_Bader_Ginsburg,128596,763363,4978,896937,293242
hdfs://spark-nn.eemcs.utwente.nl/user/s1934538/clickstream/clickstream-enwiki-2018-09.tsv.gz,Bipin_Rawat,6308,32042,43,38393,12240
hdfs://spark-nn.eemcs.utwente.nl/user/s1934538/clickstream/clickstream-enwiki-2018-09.tsv.gz,Avicii,18713,298526,3893,321132,61214
hdfs://spark-nn.eemcs.utwente.nl/user/s1934538/clickstream/clickstream-enwiki-2018-09.tsv.gz,Elon_Musk,130191,2214435,19156,2363782,1204477
hdfs://spark-nn.eemcs.utwente.nl/user/s1934538/clickstream/clickstream-enwiki-2018-09.tsv.gz,Matthew_Perry,57310,202547,868,260725,135486
hdfs://spark-nn.eemcs.utwente.nl/user/s1934538/clickstream/clickstream-enwiki-2018-09.tsv.gz,Bonnie_and_Clyde,12863,139899,1092,153854,30809
hdfs://spark-nn.eemcs.utwente.nl/user/s1934538/clickstream/clickstream-enwiki-2018-09.tsv.gz,Amber_Heard,102899,109228,437,212564,94543
hdfs://spark-nn.eemcs.utwente.nl/user/s1934538/clickstream/clickstream-enwiki-2018-09.tsv.gz,"Prince_Philip,_Duke_of_Edinburgh",163586,241469,5972,411027,228657
hdfs://spark-nn.eemcs.utwente.nl/user/s1934538/clickstream/clickstream-enwiki-2018-09.tsv.gz,Manti_Te'o,7169,46578,157,53904,2413
hdfs://spark-nn.eemcs.utwente.nl/user/s1934538/clickstream/clickstream-enwiki-2018-09.tsv.gz,Jenna_Ortega,5873,13923,120,19916,2844
hdfs://spark-nn.eemcs.utwente.nl/user/s1934538/clickstream/clickstream-enwiki-2018-09.tsv.gz,Jason_Momoa,109023,396332,1563,506918,176347
hdfs://spark-nn.eemcs.utwente.nl/user/s1934538/clickstream/clickstream-enwiki-2018-09.tsv.gz,Gaza_Strip,11199,32143,262,43604,15142
hdfs://spark-nn.eemcs.utwente.nl/user/s1934538/clickstream/clickstream-enwiki-2018-09.tsv.gz,Pornhub,34562,406293,9736,450591,79215
hdfs://spark-nn.eemcs.utwente.nl/user/s1934538/clickstream/clickstream-enwiki-2018-09.tsv.gz,John_McCain,180429,2185769,28421,2394619,1044119
hdfs://spark-nn.eemcs.utwente.nl/user/s1934538/clickstream/clickstream-enwiki-2018-09.tsv.gz,IPv4,11216,47955,266,59437,10184
hdfs://spark-nn.eemcs.utwente.nl/user/s1934538/clickstream/clickstream-enwiki-2018-09.tsv.gz,"Meghan,_Duchess_of_Sussex",86199,335236,2227,423662,189337
hdfs://spark-nn.eemcs.utwente.nl/user/s1934538/clickstream/clickstream-enwiki-2018-09.tsv.gz,Main_Page,21611,439646816,3780001,443448428,32710022
hdfs://spark-nn.eemcs.utwente.nl/user/s1934538/clickstream/clickstream-enwiki-2018-09.tsv.gz,Royal_Rumble_(2018),12740,21326,220,34286,19492
hdfs://spark-nn.eemcs.utwente.nl/user/s1934538/clickstream/clickstream-enwiki-2018-09.tsv.gz,Sylvester_Stallone,76555,385669,2384,464608,268884
hdfs://spark-nn.eemcs.utwente.nl/user/s1934538/clickstream/clickstream-enwiki-2018-09.tsv.gz,Roe_v._Wade,27779,401099,2228,431106,90896
hdfs://spark-nn.eemcs.utwente.nl/user/s1934538/clickstream/clickstream-enwiki-2018-09.tsv.gz,Kamala_Harris,59647,732904,5213,797764,255443
hdfs://spark-nn.eemcs.utwente.nl/user/s1934538/clickstream/clickstream-enwiki-2018-09.tsv.gz,Alexander_Hamilton,64981,337455,2928,405364,148658
hdfs://spark-nn.eemcs.utwente.nl/user/s1934538/clickstream/clickstream-enwiki-2018-09.tsv.gz,Wikipedia,39552,402939,1008,443499,192838
hdfs://spark-nn.eemcs.utwente.nl/user/s1934538/clickstream/clickstream-enwiki-2018-09.tsv.gz,Joaquin_Phoenix,124373,445129,4830,574332,468482
hdfs://spark-nn.eemcs.utwente.nl/user/s1934538/clickstream/clickstream-enwiki-2018-09.tsv.gz,A_Quiet_Place_(film),55578,357589,3772,416939,115895
hdfs://spark-nn.eemcs.utwente.nl/user/s1934538/clickstream/clickstream-enwiki-2018-09.tsv.gz,Donald_Glover,92644,507091,5846,605581,169287
hdfs://spark-nn.eemcs.utwente.nl/user/s1934538/clickstream/clickstream-enwiki-2018-09.tsv.gz,2022_FIFA_World_Cup,46922,80480,1049,128451,61089
hdfs://spark-nn.eemcs.utwente.nl/user/s1934538/clickstream/clickstream-enwiki-2018-09.tsv.gz,Joker_(2019_film),186225,125442,2099,313766,268851
hdfs://spark-nn.eemcs.utwente.nl/user/s1934538/clickstream/clickstream-enwiki-2018-09.tsv.gz,Mulan_(2020_film),27577,16342,314,44233,49737
hdfs://spark-nn.eemcs.utwente.nl/user/s1934538/clickstream/clickstream-enwiki-2018-09.tsv.gz,Taliban,20319,119109,417,139845,43806
hdfs://spark-nn.eemcs.utwente.nl/user/s1934538/clickstream/clickstream-enwiki-2018-09.tsv.gz,Area_51,11751,179828,1356,192935,47210
hdfs://spark-nn.eemcs.utwente.nl/user/s1934538/clickstream/clickstream-enwiki-2018-09.tsv.gz,Fyre_Festival,2060,27249,146,29455,12598
hdfs://spark-nn.eemcs.utwente.nl/user/s1934538/clickstream/clickstream-enwiki-2018-09.tsv.gz,Grimes_(musician),107789,93944,517,202250,32128
hdfs://spark-nn.eemcs.utwente.nl/user/s1934538/clickstream/clickstream-enwiki-2018-09.tsv.gz,Cricket_World_Cup,9139,94496,536,104171,54173
hdfs://spark-nn.eemcs.utwente.nl/user/s1934538/clickstream/clickstream-enwiki-2018-09.tsv.gz,Antifa_(United_States),8165,87563,230,95958,14065
hdfs://spark-nn.eemcs.utwente.nl/user/s1934538/clickstream/clickstream-enwiki-2018-09.tsv.gz,Tunnel,3382,2481689,158,2485229,3665
hdfs://spark-nn.eemcs.utwente.nl/user/s1934538/clickstream/clickstream-enwiki-2018-09.tsv.gz,FIFA_World_Cup,30233,144493,1721,176447,102329
hdfs://spark-nn.eemcs.utwente.nl/user/s1934538/clickstream/clickstream-enwiki-2018-09.tsv.gz,Charles_III,76,306,60,442,341
hdfs://spark-nn.eemcs.utwente.nl/user/s1934538/clickstream/clickstream-enwiki-2018-09.tsv.gz,Lisa_Marie_Presley,113242,75992,204,189438,91159
hdfs://spark-nn.eemcs.utwente.nl/user/s1934538/clickstream/clickstream-enwiki-2018-09.tsv.gz,Captain_Marvel_(film),211452,756935,13394,981781,736426
hdfs://spark-nn.eemcs.utwente.nl/user/s1934538/clickstream/clickstream-enwiki-2018-09.tsv.gz,Anthony_Bourdain,24891,438196,4073,467160,120759
hdfs://spark-nn.eemcs.utwente.nl/user/s1934538/clickstream/clickstream-enwiki-2018-09.tsv.gz,2020_Summer_Olympics,44061,125631,2458,172150,130796
hdfs://spark-nn.eemcs.utwente.nl/user/s1934538/clickstream/clickstream-enwiki-2018-09.tsv.gz,Elizabeth_II,350719,562064,4034,916817,673089
hdfs://spark-nn.eemcs.utwente.nl/user/s1934538/clickstream/clickstream-enwiki-2018-09.tsv.gz,Central_Park_jogger_case,4387,43699,185,48271,4875
hdfs://spark-nn.eemcs.utwente.nl/user/s1934538/clickstream/clickstream-enwiki-2018-09.tsv.gz,2018_FIFA_World_Cup,73105,1179090,3135,1255330,175794
hdfs://spark-nn.eemcs.utwente.nl/user/s1934538/clickstream/clickstream-enwiki-2018-09.tsv.gz,YouTube,102653,817554,7481,927688,135157
hdfs://spark-nn.eemcs.utwente.nl/user/s1934538/clickstream/clickstream-enwiki-2018-09.tsv.gz,Top_Gun:_Maverick,71466,44095,393,115954,96513
hdfs://spark-nn.eemcs.utwente.nl/user/s1934538/clickstream/clickstream-enwiki-2018-09.tsv.gz,Saaho,55864,49306,808,105978,70113
hdfs://spark-nn.eemcs.utwente.nl/user/s1934538/clickstream/clickstream-enwiki-2018-09.tsv.gz,Kim_Jong-un,32541,133062,1580,167183,73158
hdfs://spark-nn.eemcs.utwente.nl/user/s1934538/clickstream/clickstream-enwiki-2018-09.tsv.gz,Queen_(band),63569,238177,3424,305170,275784
hdfs://spark-nn.eemcs.utwente.nl/user/s1934538/clickstream/clickstream-enwiki-2018-09.tsv.gz,Stan_Lee,69773,194251,1753,265777,87989
hdfs://spark-nn.eemcs.utwente.nl/user/s1934538/clickstream/clickstream-enwiki-2018-09.tsv.gz,A_Star_Is_Born_(2018_film),120410,1266865,12822,1400097,578954
hdfs://spark-nn.eemcs.utwente.nl/user/s1934538/clickstream/clickstream-enwiki-2018-09.tsv.gz,William_Murdoch,515,1409,14,1938,211
hdfs://spark-nn.eemcs.utwente.nl/user/s1934538/clickstream/clickstream-enwiki-2018-09.tsv.gz,Spider-Man:_Far_From_Home,193501,143920,2683,340104,201772
hdfs://spark-nn.eemcs.utwente.nl/user/s1934538/clickstream/clickstream-enwiki-2018-09.tsv.gz,Valentine's_Day,2279,30048,199,32526,370
hdfs://spark-nn.eemcs.utwente.nl/user/s1934538/clickstream/clickstream-enwiki-2018-09.tsv.gz,Cardi_B,62210,1177827,19565,1259602,336641
hdfs://spark-nn.eemcs.utwente.nl/user/s1934538/clickstream/clickstream-enwiki-2018-09.tsv.gz,State_of_Palestine,35299,71657,136,107092,43676
hdfs://spark-nn.eemcs.utwente.nl/user/s1934538/clickstream/clickstream-enwiki-2018-09.tsv.gz,Rami_Malek,77811,217575,1387,296773,93394
hdfs://spark-nn.eemcs.utwente.nl/user/s1934538/clickstream/clickstream-enwiki-2018-09.tsv.gz,XXXTentacion,123787,600000,11751,735538,217310
hdfs://spark-nn.eemcs.utwente.nl/user/s1934538/clickstream/clickstream-enwiki-2018-09.tsv.gz,Michael_Bloomberg,28119,113861,827,142807,49064
hdfs://spark-nn.eemcs.utwente.nl/user/s1934538/clickstream/clickstream-enwiki-2018-09.tsv.gz,The_Umbrella_Academy_(TV_series),5349,6665,81,12095,5274
hdfs://spark-nn.eemcs.utwente.nl/user/s1934538/clickstream/clickstream-enwiki-2018-09.tsv.gz,Anne_Heche,23016,58588,341,81945,20963
hdfs://spark-nn.eemcs.utwente.nl/user/s1934538/clickstream/clickstream-enwiki-2018-09.tsv.gz,Dark_Phoenix_(film),169820,257776,7143,434739,302846
hdfs://spark-nn.eemcs.utwente.nl/user/s1934538/clickstream/clickstream-enwiki-2018-09.tsv.gz,Betty_White,49834,461360,3523,514717,93843
hdfs://spark-nn.eemcs.utwente.nl/user/s1934538/clickstream/clickstream-enwiki-2018-09.tsv.gz,Grover,1392,9264,38,10694,1746
hdfs://spark-nn.eemcs.utwente.nl/user/s1934538/clickstream/clickstream-enwiki-2018-09.tsv.gz,Richard_Ramirez,9830,122230,1451,133511,28421
hdfs://spark-nn.eemcs.utwente.nl/user/s1934538/clickstream/clickstream-enwiki-2018-09.tsv.gz,Johnny_Depp,81427,290298,2145,373870,217781
hdfs://spark-nn.eemcs.utwente.nl/user/s1934538/clickstream/clickstream-enwiki-2018-09.tsv.gz,Bird_Box_(film),24265,6952,73,31290,10440
hdfs://spark-nn.eemcs.utwente.nl/user/s1934538/clickstream/clickstream-enwiki-2018-09.tsv.gz,Deion_Sanders,12070,93672,476,106218,26083
hdfs://spark-nn.eemcs.utwente.nl/user/s1934538/clickstream/clickstream-enwiki-2018-09.tsv.gz,Cameron_Boyce,11094,25653,161,36908,7451
hdfs://spark-nn.eemcs.utwente.nl/user/s1934538/clickstream/clickstream-enwiki-2018-09.tsv.gz,David_Beckham,32626,191967,1537,226130,66491
hdfs://spark-nn.eemcs.utwente.nl/user/s1934538/clickstream/clickstream-enwiki-2018-09.tsv.gz,Once_Upon_a_Time_in_Hollywood,138503,87222,16763,242488,237186
hdfs://spark-nn.eemcs.utwente.nl/user/s1934538/clickstream/clickstream-enwiki-2018-09.tsv.gz,Israel,61759,279446,4776,345981,152305
hdfs://spark-nn.eemcs.utwente.nl/user/s1934538/clickstream/clickstream-enwiki-2018-09.tsv.gz,Ray_Liotta,28340,225223,1071,254634,54222
hdfs://spark-nn.eemcs.utwente.nl/user/s1934538/clickstream/clickstream-enwiki-2018-09.tsv.gz,Michael_Jordan,43345,346855,2940,393140,113025
hdfs://spark-nn.eemcs.utwente.nl/user/s1934538/clickstream/clickstream-enwiki-2018-09.tsv.gz,Deaths_in_2018,1186739,2004486,8112,3199337,1699045
hdfs://spark-nn.eemcs.utwente.nl/user/s1934538/clickstream/clickstream-enwiki-2018-09.tsv.gz,Notre-Dame_de_Paris,9424,75388,321,85133,14077
hdfs://spark-nn.eemcs.utwente.nl/user/s1934538/clickstream/clickstream-enwiki-2018-09.tsv.gz,Venom_(2018_film),123878,860031,24465,1008374,429563
hdfs://spark-nn.eemcs.utwente.nl/user/s1934538/clickstream/clickstream-enwiki-2018-09.tsv.gz,Kate_Spade,33480,76772,801,111053,31751
hdfs://spark-nn.eemcs.utwente.nl/user/s1934538/clickstream/clickstream-enwiki-2018-09.tsv.gz,Chadwick_Boseman,66818,161274,1263,229355,57309
hdfs://spark-nn.eemcs.utwente.nl/user/s1934538/clickstream/clickstream-enwiki-2018-09.tsv.gz,Richard_Jewell,2099,9742,83,11924,2998
hdfs://spark-nn.eemcs.utwente.nl/user/s1934538/clickstream/clickstream-enwiki-2018-09.tsv.gz,Hamilton_(musical),31327,276091,1868,309286,159600
hdfs://spark-nn.eemcs.utwente.nl/user/s1934538/clickstream/clickstream-enwiki-2018-09.tsv.gz,List_of_most_popular_websites,18331,94261,172,112764,46050
hdfs://spark-nn.eemcs.utwente.nl/user/s1934538/clickstream/clickstream-enwiki-2018-09.tsv.gz,Bob_Saget,15924,35482,208,51614,9355
hdfs://spark-nn.eemcs.utwente.nl/user/s1934538/clickstream/clickstream-enwiki-2018-09.tsv.gz,HTTP_cookie,13154,490840,244,504238,59272
hdfs://spark-nn.eemcs.utwente.nl/user/s1934538/clickstream/clickstream-enwiki-2018-09.tsv.gz,The_Weeknd,38905,132806,1125,172836,65882
hdfs://spark-nn.eemcs.utwente.nl/user/s1934538/clickstream/clickstream-enwiki-2018-09.tsv.gz,Priyanka_Chopra,158977,507587,1819,668383,257224
hdfs://spark-nn.eemcs.utwente.nl/user/s1934538/clickstream/clickstream-enwiki-2019-01.tsv.gz,Vladimir_Putin,67821,259321,3762,330904,162479
hdfs://spark-nn.eemcs.utwente.nl/user/s1934538/clickstream/clickstream-enwiki-2019-01.tsv.gz,2018_Winter_Olympics,34626,61686,686,96998,52220
hdfs://spark-nn.eemcs.utwente.nl/user/s1934538/clickstream/clickstream-enwiki-2019-01.tsv.gz,List_of_Marvel_Cinematic_Universe_films,124574,1100814,2697,1228085,392818
hdfs://spark-nn.eemcs.utwente.nl/user/s1934538/clickstream/clickstream-enwiki-2019-01.tsv.gz,1234,67,1589,17,1673,163
hdfs://spark-nn.eemcs.utwente.nl/user/s1934538/clickstream/clickstream-enwiki-2019-01.tsv.gz,Valentine's_Day,6923,195833,1107,203863,4821
hdfs://spark-nn.eemcs.utwente.nl/user/s1934538/clickstream/clickstream-enwiki-2019-01.tsv.gz,Tom_Brady,195632,1868910,16006,2080548,707387
hdfs://spark-nn.eemcs.utwente.nl/user/s1934538/clickstream/clickstream-enwiki-2019-01.tsv.gz,Jimmy_Buffett,9649,114415,1600,125664,28252
hdfs://spark-nn.eemcs.utwente.nl/user/s1934538/clickstream/clickstream-enwiki-2019-01.tsv.gz,Ray_Liotta,34257,219670,1051,254978,55017
hdfs://spark-nn.eemcs.utwente.nl/user/s1934538/clickstream/clickstream-enwiki-2019-01.tsv.gz,Simple_Mail_Transfer_Protocol,5292,39608,169,45069,5200
hdfs://spark-nn.eemcs.utwente.nl/user/s1934538/clickstream/clickstream-enwiki-2019-01.tsv.gz,"Prince_Philip,_Duke_of_Edinburgh",251552,499962,9873,761387,454714
hdfs://spark-nn.eemcs.utwente.nl/user/s1934538/clickstream/clickstream-enwiki-2019-01.tsv.gz,Henry_V_of_England,55441,28660,1539,85640,60369
hdfs://spark-nn.eemcs.utwente.nl/user/s1934538/clickstream/clickstream-enwiki-2019-01.tsv.gz,Article_370_of_the_Constitution_of_India,4134,24768,27,28929,2348
hdfs://spark-nn.eemcs.utwente.nl/user/s1934538/clickstream/clickstream-enwiki-2019-01.tsv.gz,Christopher_Scarver,137523,36947,20,174490,60966
hdfs://spark-nn.eemcs.utwente.nl/user/s1934538/clickstream/clickstream-enwiki-2019-01.tsv.gz,Lists_of_deaths_by_year,52846,590815,2789,646450,601090
hdfs://spark-nn.eemcs.utwente.nl/user/s1934538/clickstream/clickstream-enwiki-2019-01.tsv.gz,Louis_Tomlinson,31676,70955,303,102934,14784
hdfs://spark-nn.eemcs.utwente.nl/user/s1934538/clickstream/clickstream-enwiki-2019-01.tsv.gz,Taliban,25523,113616,858,139997,68884
hdfs://spark-nn.eemcs.utwente.nl/user/s1934538/clickstream/clickstream-enwiki-2019-01.tsv.gz,Grimes_(musician),116953,106467,730,224150,55824
hdfs://spark-nn.eemcs.utwente.nl/user/s1934538/clickstream/clickstream-enwiki-2019-01.tsv.gz,Key_frame,689,5983,17,6689,630
hdfs://spark-nn.eemcs.utwente.nl/user/s1934538/clickstream/clickstream-enwiki-2019-01.tsv.gz,William_Murdoch,590,1931,15,2536,339
hdfs://spark-nn.eemcs.utwente.nl/user/s1934538/clickstream/clickstream-enwiki-2019-01.tsv.gz,Sushma_Swaraj,5514,30153,60,35727,8371
hdfs://spark-nn.eemcs.utwente.nl/user/s1934538/clickstream/clickstream-enwiki-2019-01.tsv.gz,Notre-Dame_de_Paris,9970,66466,368,76804,12610
hdfs://spark-nn.eemcs.utwente.nl/user/s1934538/clickstream/clickstream-enwiki-2019-01.tsv.gz,Us_(2019_film),67085,154252,858,222195,125599
hdfs://spark-nn.eemcs.utwente.nl/user/s1934538/clickstream/clickstream-enwiki-2019-01.tsv.gz,Rihanna,78410,331238,24690,434338,210340
hdfs://spark-nn.eemcs.utwente.nl/user/s1934538/clickstream/clickstream-enwiki-2019-01.tsv.gz,Shakira,15943,177451,1672,195066,78740
hdfs://spark-nn.eemcs.utwente.nl/user/s1934538/clickstream/clickstream-enwiki-2019-01.tsv.gz,A_Quiet_Place_(film),70493,663029,8884,742406,206189
hdfs://spark-nn.eemcs.utwente.nl/user/s1934538/clickstream/clickstream-enwiki-2019-01.tsv.gz,YouTube,123339,932498,9443,1065280,158963
hdfs://spark-nn.eemcs.utwente.nl/user/s1934538/clickstream/clickstream-enwiki-2019-01.tsv.gz,Mulan_(2020_film),31478,33386,408,65272,76491
hdfs://spark-nn.eemcs.utwente.nl/user/s1934538/clickstream/clickstream-enwiki-2019-01.tsv.gz,Amber_Heard,264584,537319,2523,804426,433451
hdfs://spark-nn.eemcs.utwente.nl/user/s1934538/clickstream/clickstream-enwiki-2019-01.tsv.gz,Donald_Trump,293118,1218130,16568,1527816,935370
hdfs://spark-nn.eemcs.utwente.nl/user/s1934538/clickstream/clickstream-enwiki-2019-01.tsv.gz,Nipsey_Hussle,19986,50154,214,70354,31109
hdfs://spark-nn.eemcs.utwente.nl/user/s1934538/clickstream/clickstream-enwiki-2019-01.tsv.gz,IPv4,14255,52184,124,66563,11553
hdfs://spark-nn.eemcs.utwente.nl/user/s1934538/clickstream/clickstream-enwiki-2019-01.tsv.gz,Bipin_Rawat,8361,30765,466,39592,15081
hdfs://spark-nn.eemcs.utwente.nl/user/s1934538/clickstream/clickstream-enwiki-2019-01.tsv.gz,Puneeth_Rajkumar,13128,29887,62,43077,22376
hdfs://spark-nn.eemcs.utwente.nl/user/s1934538/clickstream/clickstream-enwiki-2019-01.tsv.gz,Kate_Spade,91841,121822,971,214634,68125
hdfs://spark-nn.eemcs.utwente.nl/user/s1934538/clickstream/clickstream-enwiki-2019-01.tsv.gz,JSON_Web_Token,1122,22407,28,23557,2151
hdfs://spark-nn.eemcs.utwente.nl/user/s1934538/clickstream/clickstream-enwiki-2019-01.tsv.gz,Hamas,15282,40777,319,56378,19039
hdfs://spark-nn.eemcs.utwente.nl/user/s1934538/clickstream/clickstream-enwiki-2019-01.tsv.gz,21_Savage,29331,144374,2167,175872,78452
hdfs://spark-nn.eemcs.utwente.nl/user/s1934538/clickstream/clickstream-enwiki-2019-01.tsv.gz,WrestleMania_34,56566,64197,2329,123092,86162
hdfs://spark-nn.eemcs.utwente.nl/user/s1934538/clickstream/clickstream-enwiki-2019-01.tsv.gz,Croatia,39389,138951,2280,180620,64444
hdfs://spark-nn.eemcs.utwente.nl/user/s1934538/clickstream/clickstream-enwiki-2019-01.tsv.gz,Asia_Cup,1334,37737,539,39610,10019
hdfs://spark-nn.eemcs.utwente.nl/user/s1934538/clickstream/clickstream-enwiki-2019-01.tsv.gz,Sridevi,29808,144773,698,175279,68235
hdfs://spark-nn.eemcs.utwente.nl/user/s1934538/clickstream/clickstream-enwiki-2019-01.tsv.gz,Elon_Musk,122755,732875,5477,861107,565526
hdfs://spark-nn.eemcs.utwente.nl/user/s1934538/clickstream/clickstream-enwiki-2019-01.tsv.gz,Jenna_Ortega,6487,28106,293,34886,5294
hdfs://spark-nn.eemcs.utwente.nl/user/s1934538/clickstream/clickstream-enwiki-2019-01.tsv.gz,Exo_(band),40002,186006,3423,229431,271348
hdfs://spark-nn.eemcs.utwente.nl/user/s1934538/clickstream/clickstream-enwiki-2019-01.tsv.gz,Hyphen-minus,6213,33772981,8173265,41952459,1142
hdfs://spark-nn.eemcs.utwente.nl/user/s1934538/clickstream/clickstream-enwiki-2019-01.tsv.gz,Grover,1604,6539,53,8196,1846
hdfs://spark-nn.eemcs.utwente.nl/user/s1934538/clickstream/clickstream-enwiki-2019-01.tsv.gz,United_States_Senate,106184,135982,4225,246391,123293
hdfs://spark-nn.eemcs.utwente.nl/user/s1934538/clickstream/clickstream-enwiki-2019-01.tsv.gz,The_Mandalorian,33968,38085,330,72383,55142
hdfs://spark-nn.eemcs.utwente.nl/user/s1934538/clickstream/clickstream-enwiki-2019-01.tsv.gz,Game_of_Thrones_(season_8),85714,579594,3152,668460,220792
hdfs://spark-nn.eemcs.utwente.nl/user/s1934538/clickstream/clickstream-enwiki-2019-01.tsv.gz,Microsoft_Office,10020,95016,774,105810,26753
hdfs://spark-nn.eemcs.utwente.nl/user/s1934538/clickstream/clickstream-enwiki-2019-01.tsv.gz,Khabib_Nurmagomedov,63958,176820,1931,242709,119777
hdfs://spark-nn.eemcs.utwente.nl/user/s1934538/clickstream/clickstream-enwiki-2019-01.tsv.gz,Glass_(2019_film),527195,2723746,61535,3312476,1307322
hdfs://spark-nn.eemcs.utwente.nl/user/s1934538/clickstream/clickstream-enwiki-2019-01.tsv.gz,Queen_(band),271238,1019238,11120,1301596,1374355
hdfs://spark-nn.eemcs.utwente.nl/user/s1934538/clickstream/clickstream-enwiki-2019-01.tsv.gz,Indian_Premier_League,20268,60810,153,81231,55335
hdfs://spark-nn.eemcs.utwente.nl/user/s1934538/clickstream/clickstream-enwiki-2019-01.tsv.gz,List_of_most_popular_websites,32868,94769,204,127841,54996
hdfs://spark-nn.eemcs.utwente.nl/user/s1934538/clickstream/clickstream-enwiki-2019-01.tsv.gz,Dennis_Nilsen,9968,42905,223,53096,10862
hdfs://spark-nn.eemcs.utwente.nl/user/s1934538/clickstream/clickstream-enwiki-2019-01.tsv.gz,Cameron_Boyce,14774,48387,162,63323,12198
hdfs://spark-nn.eemcs.utwente.nl/user/s1934538/clickstream/clickstream-enwiki-2019-01.tsv.gz,"Diana,_Princess_of_Wales",135922,232522,2291,370735,211999
hdfs://spark-nn.eemcs.utwente.nl/user/s1934538/clickstream/clickstream-enwiki-2019-01.tsv.gz,Royal_Rumble_(2018),90582,123719,2754,217055,163494
hdfs://spark-nn.eemcs.utwente.nl/user/s1934538/clickstream/clickstream-enwiki-2019-01.tsv.gz,Elizabeth_II,548673,984533,9335,1542541,1089825
hdfs://spark-nn.eemcs.utwente.nl/user/s1934538/clickstream/clickstream-enwiki-2019-01.tsv.gz,Keanu_Reeves,101486,835071,5669,942226,417513
hdfs://spark-nn.eemcs.utwente.nl/user/s1934538/clickstream/clickstream-enwiki-2019-01.tsv.gz,Deadpool_2,101144,212685,7679,321508,206181
hdfs://spark-nn.eemcs.utwente.nl/user/s1934538/clickstream/clickstream-enwiki-2019-01.tsv.gz,Captain_Marvel_(film),161749,410233,9713,581695,352478
hdfs://spark-nn.eemcs.utwente.nl/user/s1934538/clickstream/clickstream-enwiki-2019-01.tsv.gz,The_Weeknd,47084,133307,1500,181891,84454
hdfs://spark-nn.eemcs.utwente.nl/user/s1934538/clickstream/clickstream-enwiki-2019-01.tsv.gz,Crazy_Rich_Asians_(film),91767,440206,6152,538125,541127
hdfs://spark-nn.eemcs.utwente.nl/user/s1934538/clickstream/clickstream-enwiki-2019-01.tsv.gz,Antifa_(United_States),7054,95853,325,103232,14799
hdfs://spark-nn.eemcs.utwente.nl/user/s1934538/clickstream/clickstream-enwiki-2019-01.tsv.gz,Anne_Heche,40533,63773,299,104605,29051
hdfs://spark-nn.eemcs.utwente.nl/user/s1934538/clickstream/clickstream-enwiki-2019-01.tsv.gz,George_H._W._Bush,148530,189967,1762,340259,163324
hdfs://spark-nn.eemcs.utwente.nl/user/s1934538/clickstream/clickstream-enwiki-2019-01.tsv.gz,Lisa_Marie_Presley,180685,108628,316,289629,143076
hdfs://spark-nn.eemcs.utwente.nl/user/s1934538/clickstream/clickstream-enwiki-2019-01.tsv.gz,Irrfan_Khan,29733,59568,143,89444,40711
hdfs://spark-nn.eemcs.utwente.nl/user/s1934538/clickstream/clickstream-enwiki-2019-01.tsv.gz,List_of_James_Bond_films,11830,255296,397,267523,102065
hdfs://spark-nn.eemcs.utwente.nl/user/s1934538/clickstream/clickstream-enwiki-2019-01.tsv.gz,Chadwick_Boseman,67238,139111,796,207145,61246
hdfs://spark-nn.eemcs.utwente.nl/user/s1934538/clickstream/clickstream-enwiki-2019-01.tsv.gz,"Meghan,_Duchess_of_Sussex",111668,495110,3360,610138,282115
hdfs://spark-nn.eemcs.utwente.nl/user/s1934538/clickstream/clickstream-enwiki-2019-01.tsv.gz,Qasem_Soleimani,2836,7872,17,10725,5516
hdfs://spark-nn.eemcs.utwente.nl/user/s1934538/clickstream/clickstream-enwiki-2019-01.tsv.gz,Cecil_Hotel_(Los_Angeles),5258,20334,40,25632,9043
hdfs://spark-nn.eemcs.utwente.nl/user/s1934538/clickstream/clickstream-enwiki-2019-01.tsv.gz,Anthony_Bourdain,18409,293521,2611,314541,89754
hdfs://spark-nn.eemcs.utwente.nl/user/s1934538/clickstream/clickstream-enwiki-2019-01.tsv.gz,John_McCain,37813,107607,1126,146546,62376
hdfs://spark-nn.eemcs.utwente.nl/user/s1934538/clickstream/clickstream-enwiki-2019-01.tsv.gz,2018_FIFA_World_Cup,72426,1006271,2657,1081354,142985
hdfs://spark-nn.eemcs.utwente.nl/user/s1934538/clickstream/clickstream-enwiki-2019-01.tsv.gz,List_of_awards_and_nominations_received_by_Meryl_Streep,20895,16282,88,37265,13096
hdfs://spark-nn.eemcs.utwente.nl/user/s1934538/clickstream/clickstream-enwiki-2019-01.tsv.gz,Bob_Saget,23566,47533,257,71356,12318
hdfs://spark-nn.eemcs.utwente.nl/user/s1934538/clickstream/clickstream-enwiki-2019-01.tsv.gz,Saaho,47218,58710,724,106652,77613
hdfs://spark-nn.eemcs.utwente.nl/user/s1934538/clickstream/clickstream-enwiki-2019-01.tsv.gz,Charles_III,94,331,90,515,427
hdfs://spark-nn.eemcs.utwente.nl/user/s1934538/clickstream/clickstream-enwiki-2019-01.tsv.gz,List_of_highest-grossing_films,211101,470568,2647,684316,322914
hdfs://spark-nn.eemcs.utwente.nl/user/s1934538/clickstream/clickstream-enwiki-2019-01.tsv.gz,Dark_Phoenix_(film),148571,100732,6528,255831,171945
hdfs://spark-nn.eemcs.utwente.nl/user/s1934538/clickstream/clickstream-enwiki-2019-01.tsv.gz,Aretha_Franklin,21965,107909,1285,131159,39526
hdfs://spark-nn.eemcs.utwente.nl/user/s1934538/clickstream/clickstream-enwiki-2019-01.tsv.gz,FIFA_World_Cup,33649,108070,1736,143455,112812
hdfs://spark-nn.eemcs.utwente.nl/user/s1934538/clickstream/clickstream-enwiki-2019-01.tsv.gz,UEFA_Euro_2020,22128,110710,1196,134034,40188
hdfs://spark-nn.eemcs.utwente.nl/user/s1934538/clickstream/clickstream-enwiki-2019-01.tsv.gz,Game_of_Thrones,140934,787121,22300,950355,731305
hdfs://spark-nn.eemcs.utwente.nl/user/s1934538/clickstream/clickstream-enwiki-2019-01.tsv.gz,Joe_Biden,61296,192204,3992,257492,89134
hdfs://spark-nn.eemcs.utwente.nl/user/s1934538/clickstream/clickstream-enwiki-2019-01.tsv.gz,Greta_Thunberg,1812,52845,20227,74884,28042
hdfs://spark-nn.eemcs.utwente.nl/user/s1934538/clickstream/clickstream-enwiki-2019-01.tsv.gz,Roe_v._Wade,17590,202363,1062,221015,50484
hdfs://spark-nn.eemcs.utwente.nl/user/s1934538/clickstream/clickstream-enwiki-2019-01.tsv.gz,David_Beckham,42051,221336,1757,265144,81295
hdfs://spark-nn.eemcs.utwente.nl/user/s1934538/clickstream/clickstream-enwiki-2019-01.tsv.gz,Fyre_Festival,77931,3537269,17379,3632579,1713096
hdfs://spark-nn.eemcs.utwente.nl/user/s1934538/clickstream/clickstream-enwiki-2019-01.tsv.gz,Michael_Jordan,72432,488025,4804,565261,181341
hdfs://spark-nn.eemcs.utwente.nl/user/s1934538/clickstream/clickstream-enwiki-2019-01.tsv.gz,The_Shape_of_Water,50005,190067,2850,242922,124915
hdfs://spark-nn.eemcs.utwente.nl/user/s1934538/clickstream/clickstream-enwiki-2019-01.tsv.gz,Tonya_Harding,59568,291760,1301,352629,81645
hdfs://spark-nn.eemcs.utwente.nl/user/s1934538/clickstream/clickstream-enwiki-2019-01.tsv.gz,Ghislaine_Maxwell,2208,1894,117,4219,1095
hdfs://spark-nn.eemcs.utwente.nl/user/s1934538/clickstream/clickstream-enwiki-2019-01.tsv.gz,Michael_Bloomberg,41291,115883,1307,158481,61884
hdfs://spark-nn.eemcs.utwente.nl/user/s1934538/clickstream/clickstream-enwiki-2019-01.tsv.gz,Jason_Momoa,367063,1886439,7155,2260657,1110780
hdfs://spark-nn.eemcs.utwente.nl/user/s1934538/clickstream/clickstream-enwiki-2019-01.tsv.gz,Central_Park_jogger_case,5520,36578,169,42267,4682
hdfs://spark-nn.eemcs.utwente.nl/user/s1934538/clickstream/clickstream-enwiki-2019-01.tsv.gz,Deaths_in_2019,1669272,1707365,7800,3384437,2070973
hdfs://spark-nn.eemcs.utwente.nl/user/s1934538/clickstream/clickstream-enwiki-2019-01.tsv.gz,2022_FIFA_World_Cup,55694,125654,6326,187674,89775
hdfs://spark-nn.eemcs.utwente.nl/user/s1934538/clickstream/clickstream-enwiki-2019-01.tsv.gz,Olivia_Newton-John,29021,249757,2371,281149,113828
hdfs://spark-nn.eemcs.utwente.nl/user/s1934538/clickstream/clickstream-enwiki-2019-01.tsv.gz,XHamster,12702,4024311,2253,4039266,32985
hdfs://spark-nn.eemcs.utwente.nl/user/s1934538/clickstream/clickstream-enwiki-2019-01.tsv.gz,Salman_Rushdie,30631,61468,410,92509,36742
hdfs://spark-nn.eemcs.utwente.nl/user/s1934538/clickstream/clickstream-enwiki-2019-01.tsv.gz,XNXX,3583,853773,7345,864701,89999
hdfs://spark-nn.eemcs.utwente.nl/user/s1934538/clickstream/clickstream-enwiki-2019-11.tsv.gz,List_of_highest-grossing_films,218865,597555,2969,819389,335228
hdfs://spark-nn.eemcs.utwente.nl/user/s1934538/clickstream/clickstream-enwiki-2019-11.tsv.gz,Roe_v._Wade,11726,74703,493,86922,22473
hdfs://spark-nn.eemcs.utwente.nl/user/s1934538/clickstream/clickstream-enwiki-2019-11.tsv.gz,Simple_Mail_Transfer_Protocol,4599,13306474,135,13311208,5407
hdfs://spark-nn.eemcs.utwente.nl/user/s1934538/clickstream/clickstream-enwiki-2019-11.tsv.gz,2.0_(film),31845,81991,379,114215,27173
hdfs://spark-nn.eemcs.utwente.nl/user/s1934538/clickstream/clickstream-enwiki-2019-11.tsv.gz,A_Star_Is_Born_(2018_film),39867,219914,995,260776,110258
hdfs://spark-nn.eemcs.utwente.nl/user/s1934538/clickstream/clickstream-enwiki-2019-11.tsv.gz,Lists_of_deaths_by_year,5626,119666,255,125547,119187
hdfs://spark-nn.eemcs.utwente.nl/user/s1934538/clickstream/clickstream-enwiki-2019-11.tsv.gz,Cook's_Country,415,5375,46,5836,1363
hdfs://spark-nn.eemcs.utwente.nl/user/s1934538/clickstream/clickstream-enwiki-2019-11.tsv.gz,Tunnel,3691,13531,197,17419,3442
hdfs://spark-nn.eemcs.utwente.nl/user/s1934538/clickstream/clickstream-enwiki-2019-11.tsv.gz,Cricket_World_Cup,6706,49163,313,56182,22790
hdfs://spark-nn.eemcs.utwente.nl/user/s1934538/clickstream/clickstream-enwiki-2019-11.tsv.gz,2018_Winter_Olympics,21829,27380,312,49521,27731
hdfs://spark-nn.eemcs.utwente.nl/user/s1934538/clickstream/clickstream-enwiki-2019-11.tsv.gz,Watts_family_murders,4444,260196,414,265054,58329
hdfs://spark-nn.eemcs.utwente.nl/user/s1934538/clickstream/clickstream-enwiki-2019-11.tsv.gz,Anna_Sorokin,6563,59693,193,66449,14764
hdfs://spark-nn.eemcs.utwente.nl/user/s1934538/clickstream/clickstream-enwiki-2019-11.tsv.gz,List_of_most_popular_websites,13730,1429279,198,1443207,43591
hdfs://spark-nn.eemcs.utwente.nl/user/s1934538/clickstream/clickstream-enwiki-2019-11.tsv.gz,Hyphen-minus,5416,51932697,7468835,59406948,754
hdfs://spark-nn.eemcs.utwente.nl/user/s1934538/clickstream/clickstream-enwiki-2019-11.tsv.gz,Tina_Turner,28808,370278,11145,410231,107214
hdfs://spark-nn.eemcs.utwente.nl/user/s1934538/clickstream/clickstream-enwiki-2019-11.tsv.gz,David_Beckham,44722,166397,1350,212469,70714
hdfs://spark-nn.eemcs.utwente.nl/user/s1934538/clickstream/clickstream-enwiki-2019-11.tsv.gz,Tom_Brady,78596,403100,4111,485807,158465
hdfs://spark-nn.eemcs.utwente.nl/user/s1934538/clickstream/clickstream-enwiki-2019-11.tsv.gz,1234,75,1539,52,1666,279
hdfs://spark-nn.eemcs.utwente.nl/user/s1934538/clickstream/clickstream-enwiki-2019-11.tsv.gz,The_Mandalorian,425586,4453172,79157,4957915,2814837
hdfs://spark-nn.eemcs.utwente.nl/user/s1934538/clickstream/clickstream-enwiki-2019-11.tsv.gz,Lance_Reddick,36879,31528,140,68547,13972
hdfs://spark-nn.eemcs.utwente.nl/user/s1934538/clickstream/clickstream-enwiki-2019-11.tsv.gz,Jimmy_Hoffa,421884,2201307,17376,2640567,952398
hdfs://spark-nn.eemcs.utwente.nl/user/s1934538/clickstream/clickstream-enwiki-2019-11.tsv.gz,Microsoft_Office,8470,778925,549,787944,21447
hdfs://spark-nn.eemcs.utwente.nl/user/s1934538/clickstream/clickstream-enwiki-2019-11.tsv.gz,Donald_Trump,271634,803640,12462,1087736,673618
hdfs://spark-nn.eemcs.utwente.nl/user/s1934538/clickstream/clickstream-enwiki-2019-11.tsv.gz,Juneteenth,2766,21192,39,23997,2094
hdfs://spark-nn.eemcs.utwente.nl/user/s1934538/clickstream/clickstream-enwiki-2019-11.tsv.gz,Luke_Perry,59868,207339,2310,269517,61824
hdfs://spark-nn.eemcs.utwente.nl/user/s1934538/clickstream/clickstream-enwiki-2019-11.tsv.gz,Lionel_Messi,83428,547037,6851,637316,133843
hdfs://spark-nn.eemcs.utwente.nl/user/s1934538/clickstream/clickstream-enwiki-2019-11.tsv.gz,"Prince_Philip,_Duke_of_Edinburgh",805825,1066923,31972,1904720,1474891
hdfs://spark-nn.eemcs.utwente.nl/user/s1934538/clickstream/clickstream-enwiki-2019-11.tsv.gz,Adele,22379,158878,2480,183737,60170
hdfs://spark-nn.eemcs.utwente.nl/user/s1934538/clickstream/clickstream-enwiki-2019-11.tsv.gz,Stan_Lee,37860,168303,1582,207745,55614
hdfs://spark-nn.eemcs.utwente.nl/user/s1934538/clickstream/clickstream-enwiki-2019-11.tsv.gz,Google_logo,1526,35633,16,37175,1619
hdfs://spark-nn.eemcs.utwente.nl/user/s1934538/clickstream/clickstream-enwiki-2019-11.tsv.gz,Elizabeth_II,1327772,1897197,8783,3233752,3078341
hdfs://spark-nn.eemcs.utwente.nl/user/s1934538/clickstream/clickstream-enwiki-2019-11.tsv.gz,Crazy_Rich_Asians_(film),46905,128848,1474,177227,163927
hdfs://spark-nn.eemcs.utwente.nl/user/s1934538/clickstream/clickstream-enwiki-2019-11.tsv.gz,1917_(2019_film),47833,206939,5095,259867,140039
hdfs://spark-nn.eemcs.utwente.nl/user/s1934538/clickstream/clickstream-enwiki-2019-11.tsv.gz,Israel,76791,305604,4753,387148,175231
hdfs://spark-nn.eemcs.utwente.nl/user/s1934538/clickstream/clickstream-enwiki-2019-11.tsv.gz,2023_Cricket_World_Cup,8502,20110,119,28731,8114
hdfs://spark-nn.eemcs.utwente.nl/user/s1934538/clickstream/clickstream-enwiki-2019-11.tsv.gz,Brett_Kavanaugh,24954,49159,338,74451,24684
hdfs://spark-nn.eemcs.utwente.nl/user/s1934538/clickstream/clickstream-enwiki-2019-11.tsv.gz,Fyre_Festival,10002,97757,548,108307,52177
hdfs://spark-nn.eemcs.utwente.nl/user/s1934538/clickstream/clickstream-enwiki-2019-11.tsv.gz,Laal_Singh_Chaddha,56915,28643,281,85839,57399
hdfs://spark-nn.eemcs.utwente.nl/user/s1934538/clickstream/clickstream-enwiki-2019-11.tsv.gz,Stephen_Hawking,34832,440534,2568,477934,187191
hdfs://spark-nn.eemcs.utwente.nl/user/s1934538/clickstream/clickstream-enwiki-2019-11.tsv.gz,Notre-Dame_de_Paris,15560,93982,939,110481,23591
hdfs://spark-nn.eemcs.utwente.nl/user/s1934538/clickstream/clickstream-enwiki-2019-11.tsv.gz,Chernobyl_disaster,58575,527298,4205,590078,219792
hdfs://spark-nn.eemcs.utwente.nl/user/s1934538/clickstream/clickstream-enwiki-2019-11.tsv.gz,RRR_(film),55505,92495,104,148104,97249
hdfs://spark-nn.eemcs.utwente.nl/user/s1934538/clickstream/clickstream-enwiki-2019-11.tsv.gz,Stranger_Things_(season_3),21129,80480,1248,102857,64860
hdfs://spark-nn.eemcs.utwente.nl/user/s1934538/clickstream/clickstream-enwiki-2019-11.tsv.gz,Lisa_Marie_Presley,131159,76306,238,207703,112255
hdfs://spark-nn.eemcs.utwente.nl/user/s1934538/clickstream/clickstream-enwiki-2019-11.tsv.gz,NATO,46060,125293,1929,173282,58938
hdfs://spark-nn.eemcs.utwente.nl/user/s1934538/clickstream/clickstream-enwiki-2019-11.tsv.gz,Juice_Wrld,11248,61559,716,73523,21289
hdfs://spark-nn.eemcs.utwente.nl/user/s1934538/clickstream/clickstream-enwiki-2019-11.tsv.gz,Chadwick_Boseman,45778,147187,1481,194446,71407
hdfs://spark-nn.eemcs.utwente.nl/user/s1934538/clickstream/clickstream-enwiki-2019-11.tsv.gz,Freddie_Mercury,106406,841841,9608,957855,332220
hdfs://spark-nn.eemcs.utwente.nl/user/s1934538/clickstream/clickstream-enwiki-2019-11.tsv.gz,Top_Gun:_Maverick,57116,53702,849,111667,78010
hdfs://spark-nn.eemcs.utwente.nl/user/s1934538/clickstream/clickstream-enwiki-2019-11.tsv.gz,Murder_of_Dee_Dee_Blanchard,16294,165250,568,182112,31280
hdfs://spark-nn.eemcs.utwente.nl/user/s1934538/clickstream/clickstream-enwiki-2019-11.tsv.gz,Anne_Heche,25486,53842,266,79594,22960
hdfs://spark-nn.eemcs.utwente.nl/user/s1934538/clickstream/clickstream-enwiki-2019-11.tsv.gz,Brie_Larson,84463,223216,1915,309594,119083
hdfs://spark-nn.eemcs.utwente.nl/user/s1934538/clickstream/clickstream-enwiki-2019-11.tsv.gz,Dennis_Nilsen,4681,145109,930,150720,41925
hdfs://spark-nn.eemcs.utwente.nl/user/s1934538/clickstream/clickstream-enwiki-2019-11.tsv.gz,ICC_Men's_T20_World_Cup,10805,91609,364,102778,30817
hdfs://spark-nn.eemcs.utwente.nl/user/s1934538/clickstream/clickstream-enwiki-2019-11.tsv.gz,Michael_Bloomberg,133393,1479181,13117,1625691,547372
hdfs://spark-nn.eemcs.utwente.nl/user/s1934538/clickstream/clickstream-enwiki-2019-11.tsv.gz,Captain_Marvel_(film),64772,264022,3653,332447,198218
hdfs://spark-nn.eemcs.utwente.nl/user/s1934538/clickstream/clickstream-enwiki-2019-11.tsv.gz,Grimes_(musician),57544,82259,859,140662,59852
hdfs://spark-nn.eemcs.utwente.nl/user/s1934538/clickstream/clickstream-enwiki-2019-11.tsv.gz,Kamala_Harris,33083,241975,2006,277064,90824
hdfs://spark-nn.eemcs.utwente.nl/user/s1934538/clickstream/clickstream-enwiki-2019-11.tsv.gz,Cleopatra,35415,146018,1717,183150,75667
hdfs://spark-nn.eemcs.utwente.nl/user/s1934538/clickstream/clickstream-enwiki-2019-11.tsv.gz,Aretha_Franklin,23085,92640,741,116466,39556
hdfs://spark-nn.eemcs.utwente.nl/user/s1934538/clickstream/clickstream-enwiki-2019-11.tsv.gz,Kate_Spade,25719,65461,369,91549,29228
hdfs://spark-nn.eemcs.utwente.nl/user/s1934538/clickstream/clickstream-enwiki-2019-11.tsv.gz,Joaquin_Phoenix,316389,671315,3429,991133,763779
hdfs://spark-nn.eemcs.utwente.nl/user/s1934538/clickstream/clickstream-enwiki-2019-11.tsv.gz,Johnny_Depp,131038,302734,2150,435922,256899
hdfs://spark-nn.eemcs.utwente.nl/user/s1934538/clickstream/clickstream-enwiki-2019-11.tsv.gz,Kim_Jong-un,38229,95984,881,135094,77146
hdfs://spark-nn.eemcs.utwente.nl/user/s1934538/clickstream/clickstream-enwiki-2019-11.tsv.gz,Qasem_Soleimani,5076,10735,53,15864,7956
hdfs://spark-nn.eemcs.utwente.nl/user/s1934538/clickstream/clickstream-enwiki-2019-11.tsv.gz,Michael_Jordan,72467,364457,3159,440083,134147
hdfs://spark-nn.eemcs.utwente.nl/user/s1934538/clickstream/clickstream-enwiki-2019-11.tsv.gz,21_Savage,19948,83074,891,103913,33154
hdfs://spark-nn.eemcs.utwente.nl/user/s1934538/clickstream/clickstream-enwiki-2019-11.tsv.gz,K.G.F:_Chapter_2,34146,105979,110,140235,52844
hdfs://spark-nn.eemcs.utwente.nl/user/s1934538/clickstream/clickstream-enwiki-2019-11.tsv.gz,Taliban,20619,63813,372,84804,47479
hdfs://spark-nn.eemcs.utwente.nl/user/s1934538/clickstream/clickstream-enwiki-2019-11.tsv.gz,Kobe_Bryant_sexual_assault_case,2662,19887,10,22559,2496
hdfs://spark-nn.eemcs.utwente.nl/user/s1934538/clickstream/clickstream-enwiki-2019-11.tsv.gz,Priyanka_Chopra,110262,258739,827,369828,131047
hdfs://spark-nn.eemcs.utwente.nl/user/s1934538/clickstream/clickstream-enwiki-2019-11.tsv.gz,The_Weeknd,50527,151635,1515,203677,105353
hdfs://spark-nn.eemcs.utwente.nl/user/s1934538/clickstream/clickstream-enwiki-2019-11.tsv.gz,Dark_Phoenix_(film),57203,162812,2617,222632,101693
hdfs://spark-nn.eemcs.utwente.nl/user/s1934538/clickstream/clickstream-enwiki-2019-11.tsv.gz,Wonder_Woman_1984,82621,45447,756,128824,80812
hdfs://spark-nn.eemcs.utwente.nl/user/s1934538/clickstream/clickstream-enwiki-2019-11.tsv.gz,Mötley_Crüe,35181,144211,2054,181446,209404
hdfs://spark-nn.eemcs.utwente.nl/user/s1934538/clickstream/clickstream-enwiki-2019-11.tsv.gz,Pelé,26118,124908,6369,157395,47602
hdfs://spark-nn.eemcs.utwente.nl/user/s1934538/clickstream/clickstream-enwiki-2019-11.tsv.gz,List_of_Marvel_Cinematic_Universe_films,118578,836624,3192,958394,367412
hdfs://spark-nn.eemcs.utwente.nl/user/s1934538/clickstream/clickstream-enwiki-2019-11.tsv.gz,Joker_(2019_film),263554,3203800,57241,3524595,1282919
hdfs://spark-nn.eemcs.utwente.nl/user/s1934538/clickstream/clickstream-enwiki-2019-11.tsv.gz,The_Suicide_Squad_(film),97478,40652,1335,139465,125152
hdfs://spark-nn.eemcs.utwente.nl/user/s1934538/clickstream/clickstream-enwiki-2019-11.tsv.gz,IPv4,14082,55864,206,70152,12390
hdfs://spark-nn.eemcs.utwente.nl/user/s1934538/clickstream/clickstream-enwiki-2019-11.tsv.gz,Joe_Biden,72288,232968,6515,311771,111226
hdfs://spark-nn.eemcs.utwente.nl/user/s1934538/clickstream/clickstream-enwiki-2019-11.tsv.gz,The_Irishman,1179,10378,4955,16512,20179
hdfs://spark-nn.eemcs.utwente.nl/user/s1934538/clickstream/clickstream-enwiki-2019-11.tsv.gz,Croatia,35420,109534,1433,146387,47816
hdfs://spark-nn.eemcs.utwente.nl/user/s1934538/clickstream/clickstream-enwiki-2019-11.tsv.gz,Indian_Premier_League,16734,72280,342,89356,52414
hdfs://spark-nn.eemcs.utwente.nl/user/s1934538/clickstream/clickstream-enwiki-2019-11.tsv.gz,Wikipedia,39246,2880874,881,2921001,214658
hdfs://spark-nn.eemcs.utwente.nl/user/s1934538/clickstream/clickstream-enwiki-2019-11.tsv.gz,Khabib_Nurmagomedov,83106,218673,3986,305765,149461
hdfs://spark-nn.eemcs.utwente.nl/user/s1934538/clickstream/clickstream-enwiki-2019-11.tsv.gz,Donald_Glover,59876,167852,1327,229055,71787
hdfs://spark-nn.eemcs.utwente.nl/user/s1934538/clickstream/clickstream-enwiki-2019-11.tsv.gz,XHamster,8884,58141,2747,69772,12043
hdfs://spark-nn.eemcs.utwente.nl/user/s1934538/clickstream/clickstream-enwiki-2019-11.tsv.gz,WandaVision,43950,19033,169,63152,32585
hdfs://spark-nn.eemcs.utwente.nl/user/s1934538/clickstream/clickstream-enwiki-2019-11.tsv.gz,2018_FIFA_World_Cup,66073,115553,1692,183318,92758
hdfs://spark-nn.eemcs.utwente.nl/user/s1934538/clickstream/clickstream-enwiki-2019-11.tsv.gz,Bipin_Rawat,6282,21754,108,28144,12149
hdfs://spark-nn.eemcs.utwente.nl/user/s1934538/clickstream/clickstream-enwiki-2019-11.tsv.gz,XXX:_Return_of_Xander_Cage,29653,78120,494,108267,34341
hdfs://spark-nn.eemcs.utwente.nl/user/s1934538/clickstream/clickstream-enwiki-2019-11.tsv.gz,War_(2019_film),90588,785287,2779,878654,197143
hdfs://spark-nn.eemcs.utwente.nl/user/s1934538/clickstream/clickstream-enwiki-2019-11.tsv.gz,Charles_III,114,347,78,539,442
hdfs://spark-nn.eemcs.utwente.nl/user/s1934538/clickstream/clickstream-enwiki-2019-11.tsv.gz,Rami_Malek,91312,183636,923,275871,96961
hdfs://spark-nn.eemcs.utwente.nl/user/s1934538/clickstream/clickstream-enwiki-2019-11.tsv.gz,Parasite_(2019_film),69756,941345,11964,1023065,415556
hdfs://spark-nn.eemcs.utwente.nl/user/s1934538/clickstream/clickstream-enwiki-2019-11.tsv.gz,Avengers:_Endgame,204890,450153,10430,665473,427858
hdfs://spark-nn.eemcs.utwente.nl/user/s1934538/clickstream/clickstream-enwiki-2019-11.tsv.gz,Salman_Rushdie,23146,55670,384,79200,35951
hdfs://spark-nn.eemcs.utwente.nl/user/s1934538/clickstream/clickstream-enwiki-2019-11.tsv.gz,United_States_Electoral_College,31618,148632,193,180443,25691
hdfs://spark-nn.eemcs.utwente.nl/user/s1934538/clickstream/clickstream-enwiki-2019-11.tsv.gz,"Princess_Margaret,_Countess_of_Snowdon",550329,2555457,24595,3130381,1991287
hdfs://spark-nn.eemcs.utwente.nl/user/s1934538/clickstream/clickstream-enwiki-2019-11.tsv.gz,Avengers:_Infinity_War,66733,120139,1694,188566,95477
hdfs://spark-nn.eemcs.utwente.nl/user/s1934538/clickstream/clickstream-enwiki-2019-11.tsv.gz,Greta_Thunberg,14805,529935,5402,550142,153309
hdfs://spark-nn.eemcs.utwente.nl/user/s1934538/clickstream/clickstream-enwiki-2019-11.tsv.gz,Hamas,19947,38047,295,58289,21903
hdfs://spark-nn.eemcs.utwente.nl/user/s1934538/clickstream/clickstream-enwiki-2019-11.tsv.gz,Darth_Vader,76566,229599,1106,307271,172739
hdfs://spark-nn.eemcs.utwente.nl/user/s1934538/clickstream/clickstream-enwiki-2019-11.tsv.gz,Bob_Saget,17355,35375,251,52981,10069
hdfs://spark-nn.eemcs.utwente.nl/user/s1934538/clickstream/clickstream-enwiki-2020-02.tsv.gz,Bible,15680,1265033,1393,1282106,32937
hdfs://spark-nn.eemcs.utwente.nl/user/s1934538/clickstream/clickstream-enwiki-2020-02.tsv.gz,2022_FIFA_World_Cup,47959,104582,1483,154024,71800
hdfs://spark-nn.eemcs.utwente.nl/user/s1934538/clickstream/clickstream-enwiki-2020-02.tsv.gz,Amy_Coney_Barrett,1745,5991,27,7763,1630
hdfs://spark-nn.eemcs.utwente.nl/user/s1934538/clickstream/clickstream-enwiki-2020-02.tsv.gz,List_of_Queen_of_the_South_episodes,8925,6012,58,14995,419
hdfs://spark-nn.eemcs.utwente.nl/user/s1934538/clickstream/clickstream-enwiki-2020-02.tsv.gz,Olivia_Newton-John,29300,122556,1176,153032,63749
hdfs://spark-nn.eemcs.utwente.nl/user/s1934538/clickstream/clickstream-enwiki-2020-02.tsv.gz,Meat_Loaf,18940,65500,650,85090,28541
hdfs://spark-nn.eemcs.utwente.nl/user/s1934538/clickstream/clickstream-enwiki-2020-02.tsv.gz,Mötley_Crüe,26172,85680,1182,113034,141810
hdfs://spark-nn.eemcs.utwente.nl/user/s1934538/clickstream/clickstream-enwiki-2020-02.tsv.gz,Antifa_(United_States),8024,86569,210,94803,14966
hdfs://spark-nn.eemcs.utwente.nl/user/s1934538/clickstream/clickstream-enwiki-2020-02.tsv.gz,Joaquin_Phoenix,537533,1837561,14766,2389860,1815047
hdfs://spark-nn.eemcs.utwente.nl/user/s1934538/clickstream/clickstream-enwiki-2020-02.tsv.gz,2019–20_coronavirus_outbreak,2251956,6105194,17979,8375129,1346451
hdfs://spark-nn.eemcs.utwente.nl/user/s1934538/clickstream/clickstream-enwiki-2020-02.tsv.gz,Irrfan_Khan,26793,90922,174,117889,51324
hdfs://spark-nn.eemcs.utwente.nl/user/s1934538/clickstream/clickstream-enwiki-2020-02.tsv.gz,Mortal_Kombat_(2021_film),28321,44138,255,72714,111045
hdfs://spark-nn.eemcs.utwente.nl/user/s1934538/clickstream/clickstream-enwiki-2020-02.tsv.gz,Everything_Everywhere_All_at_Once,8743,1258,423,10424,2836
hdfs://spark-nn.eemcs.utwente.nl/user/s1934538/clickstream/clickstream-enwiki-2020-02.tsv.gz,Jenna_Ortega,33948,42950,1714,78612,11780
hdfs://spark-nn.eemcs.utwente.nl/user/s1934538/clickstream/clickstream-enwiki-2020-02.tsv.gz,Sidharth_Shukla,77676,406942,2512,487130,138737
hdfs://spark-nn.eemcs.utwente.nl/user/s1934538/clickstream/clickstream-enwiki-2020-02.tsv.gz,Game_of_Thrones_(season_8),12550,49140,875,62565,23847
hdfs://spark-nn.eemcs.utwente.nl/user/s1934538/clickstream/clickstream-enwiki-2020-02.tsv.gz,Salman_Rushdie,21895,58545,383,80823,35882
hdfs://spark-nn.eemcs.utwente.nl/user/s1934538/clickstream/clickstream-enwiki-2020-02.tsv.gz,Media,92,3046936,326,3047354,1845
hdfs://spark-nn.eemcs.utwente.nl/user/s1934538/clickstream/clickstream-enwiki-2020-02.tsv.gz,The_Falcon_and_the_Winter_Soldier,67606,92687,1104,161397,96062
hdfs://spark-nn.eemcs.utwente.nl/user/s1934538/clickstream/clickstream-enwiki-2020-02.tsv.gz,Cardi_B,48107,264404,3625,316136,98871
hdfs://spark-nn.eemcs.utwente.nl/user/s1934538/clickstream/clickstream-enwiki-2020-02.tsv.gz,Richard_Ramirez,13499,187276,960,201735,77915
hdfs://spark-nn.eemcs.utwente.nl/user/s1934538/clickstream/clickstream-enwiki-2020-02.tsv.gz,Qasem_Soleimani,13874,74804,592,89270,31775
hdfs://spark-nn.eemcs.utwente.nl/user/s1934538/clickstream/clickstream-enwiki-2020-02.tsv.gz,2023_Cricket_World_Cup,12119,26026,44,38189,11454
hdfs://spark-nn.eemcs.utwente.nl/user/s1934538/clickstream/clickstream-enwiki-2020-02.tsv.gz,Watts_family_murders,3260,228536,284,232080,46949
hdfs://spark-nn.eemcs.utwente.nl/user/s1934538/clickstream/clickstream-enwiki-2020-02.tsv.gz,List_of_highest-grossing_films,147536,328645,2556,478737,226308
hdfs://spark-nn.eemcs.utwente.nl/user/s1934538/clickstream/clickstream-enwiki-2020-02.tsv.gz,The_Mandalorian,69627,368904,12318,450849,291318
hdfs://spark-nn.eemcs.utwente.nl/user/s1934538/clickstream/clickstream-enwiki-2020-02.tsv.gz,Aaron_Carter,17479,43750,231,61460,18011
hdfs://spark-nn.eemcs.utwente.nl/user/s1934538/clickstream/clickstream-enwiki-2020-02.tsv.gz,The_Witcher_(TV_series),72287,686041,11092,769420,514381
hdfs://spark-nn.eemcs.utwente.nl/user/s1934538/clickstream/clickstream-enwiki-2020-02.tsv.gz,Adele,26734,198879,2988,228601,77120
hdfs://spark-nn.eemcs.utwente.nl/user/s1934538/clickstream/clickstream-enwiki-2020-02.tsv.gz,Cristiano_Ronaldo,106321,819368,6121,931810,196486
hdfs://spark-nn.eemcs.utwente.nl/user/s1934538/clickstream/clickstream-enwiki-2020-02.tsv.gz,Simple_Mail_Transfer_Protocol,4463,33798,144,38405,4153
hdfs://spark-nn.eemcs.utwente.nl/user/s1934538/clickstream/clickstream-enwiki-2020-02.tsv.gz,Valentine's_Day,45122,1372441,12386,1429949,133941
hdfs://spark-nn.eemcs.utwente.nl/user/s1934538/clickstream/clickstream-enwiki-2020-02.tsv.gz,Us_(2019_film),50373,228911,1222,280506,85022
hdfs://spark-nn.eemcs.utwente.nl/user/s1934538/clickstream/clickstream-enwiki-2020-02.tsv.gz,A_Quiet_Place_(film),54563,359197,3038,416798,134725
hdfs://spark-nn.eemcs.utwente.nl/user/s1934538/clickstream/clickstream-enwiki-2020-02.tsv.gz,Donald_Trump,478515,3278720,31973,3789208,2072283
hdfs://spark-nn.eemcs.utwente.nl/user/s1934538/clickstream/clickstream-enwiki-2020-02.tsv.gz,FIFA_World_Cup,31162,142380,1507,175049,123744
hdfs://spark-nn.eemcs.utwente.nl/user/s1934538/clickstream/clickstream-enwiki-2020-02.tsv.gz,Michael_Jordan,150069,1144068,19203,1313340,485691
hdfs://spark-nn.eemcs.utwente.nl/user/s1934538/clickstream/clickstream-enwiki-2020-02.tsv.gz,List_of_highest-grossing_Indian_films,69437,261430,1114,331981,185201
hdfs://spark-nn.eemcs.utwente.nl/user/s1934538/clickstream/clickstream-enwiki-2020-02.tsv.gz,Eddie_Van_Halen,29625,41849,345,71819,32386
hdfs://spark-nn.eemcs.utwente.nl/user/s1934538/clickstream/clickstream-enwiki-2020-02.tsv.gz,Jason_Momoa,145685,433920,2833,582438,243719
hdfs://spark-nn.eemcs.utwente.nl/user/s1934538/clickstream/clickstream-enwiki-2020-02.tsv.gz,Priyanka_Chopra,187341,337332,923,525596,169903
hdfs://spark-nn.eemcs.utwente.nl/user/s1934538/clickstream/clickstream-enwiki-2020-02.tsv.gz,The_Lion_King_(2019_film),60368,232290,2119,294777,192331
hdfs://spark-nn.eemcs.utwente.nl/user/s1934538/clickstream/clickstream-enwiki-2020-02.tsv.gz,Stephen_Hawking,30813,417582,2265,450660,159361
hdfs://spark-nn.eemcs.utwente.nl/user/s1934538/clickstream/clickstream-enwiki-2020-02.tsv.gz,The_Queen's_Gambit_(miniseries),3332,856,18,4206,764
hdfs://spark-nn.eemcs.utwente.nl/user/s1934538/clickstream/clickstream-enwiki-2020-02.tsv.gz,John_McCain,45719,106279,1378,153376,72172
hdfs://spark-nn.eemcs.utwente.nl/user/s1934538/clickstream/clickstream-enwiki-2020-02.tsv.gz,Stan_Lee,30927,122146,952,154025,39991
hdfs://spark-nn.eemcs.utwente.nl/user/s1934538/clickstream/clickstream-enwiki-2020-02.tsv.gz,XXX:_Return_of_Xander_Cage,32708,68431,466,101605,31280
hdfs://spark-nn.eemcs.utwente.nl/user/s1934538/clickstream/clickstream-enwiki-2020-02.tsv.gz,Chernobyl_disaster,56180,454749,5054,515983,181650
hdfs://spark-nn.eemcs.utwente.nl/user/s1934538/clickstream/clickstream-enwiki-2020-02.tsv.gz,Tom_Brady,84320,391042,3862,479224,180285
hdfs://spark-nn.eemcs.utwente.nl/user/s1934538/clickstream/clickstream-enwiki-2020-02.tsv.gz,Lists_of_deaths_by_year,6738,319932,570,327240,323709
hdfs://spark-nn.eemcs.utwente.nl/user/s1934538/clickstream/clickstream-enwiki-2020-02.tsv.gz,Bonnie_and_Clyde,20861,223530,1408,245799,54739
hdfs://spark-nn.eemcs.utwente.nl/user/s1934538/clickstream/clickstream-enwiki-2020-02.tsv.gz,Saaho,25379,93810,431,119620,31103
hdfs://spark-nn.eemcs.utwente.nl/user/s1934538/clickstream/clickstream-enwiki-2020-02.tsv.gz,Area_51,12979,152595,943,166517,31916
hdfs://spark-nn.eemcs.utwente.nl/user/s1934538/clickstream/clickstream-enwiki-2020-02.tsv.gz,Richard_Jewell,57527,348498,2582,408607,128343
hdfs://spark-nn.eemcs.utwente.nl/user/s1934538/clickstream/clickstream-enwiki-2020-02.tsv.gz,Godzilla_vs._Kong,79248,74571,984,154803,97024
hdfs://spark-nn.eemcs.utwente.nl/user/s1934538/clickstream/clickstream-enwiki-2020-02.tsv.gz,Cook's_Country,289,2522,44,2855,740
hdfs://spark-nn.eemcs.utwente.nl/user/s1934538/clickstream/clickstream-enwiki-2020-02.tsv.gz,Queen_(band),66745,311557,3101,381403,306279
hdfs://spark-nn.eemcs.utwente.nl/user/s1934538/clickstream/clickstream-enwiki-2020-02.tsv.gz,The_Batman_(film),211722,227673,3575,442970,553314
hdfs://spark-nn.eemcs.utwente.nl/user/s1934538/clickstream/clickstream-enwiki-2020-02.tsv.gz,Anne_Heche,33657,53519,296,87472,25413
hdfs://spark-nn.eemcs.utwente.nl/user/s1934538/clickstream/clickstream-enwiki-2020-02.tsv.gz,Coronavirus_disease_2019,438257,577132,23160,1038549,371045
hdfs://spark-nn.eemcs.utwente.nl/user/s1934538/clickstream/clickstream-enwiki-2020-02.tsv.gz,Shakira,150621,3926203,32890,4109714,1577831
hdfs://spark-nn.eemcs.utwente.nl/user/s1934538/clickstream/clickstream-enwiki-2020-02.tsv.gz,R._Kelly,30416,177652,1770,209838,82387
hdfs://spark-nn.eemcs.utwente.nl/user/s1934538/clickstream/clickstream-enwiki-2020-02.tsv.gz,Stranger_Things_(season_4),21763,13648,405,35816,20408
hdfs://spark-nn.eemcs.utwente.nl/user/s1934538/clickstream/clickstream-enwiki-2020-02.tsv.gz,Kamala_Harris,28788,83987,2363,115138,34488
hdfs://spark-nn.eemcs.utwente.nl/user/s1934538/clickstream/clickstream-enwiki-2020-02.tsv.gz,Wikipedia,36185,14010089,1191,14047465,218808
hdfs://spark-nn.eemcs.utwente.nl/user/s1934538/clickstream/clickstream-enwiki-2020-02.tsv.gz,Tenet_(film),107297,109885,1875,219057,146014
hdfs://spark-nn.eemcs.utwente.nl/user/s1934538/clickstream/clickstream-enwiki-2020-02.tsv.gz,ICC_Men's_T20_World_Cup,16872,138454,479,155805,65893
hdfs://spark-nn.eemcs.utwente.nl/user/s1934538/clickstream/clickstream-enwiki-2020-02.tsv.gz,Amber_Heard,159338,810980,6614,976932,448189
hdfs://spark-nn.eemcs.utwente.nl/user/s1934538/clickstream/clickstream-enwiki-2020-02.tsv.gz,Ghislaine_Maxwell,19733,57745,586,78064,32944
hdfs://spark-nn.eemcs.utwente.nl/user/s1934538/clickstream/clickstream-enwiki-2020-02.tsv.gz,George_VI,397978,229663,1011,628652,440809
hdfs://spark-nn.eemcs.utwente.nl/user/s1934538/clickstream/clickstream-enwiki-2020-02.tsv.gz,Cecil_Hotel_(Los_Angeles),4746,21258,65,26069,9725
hdfs://spark-nn.eemcs.utwente.nl/user/s1934538/clickstream/clickstream-enwiki-2020-02.tsv.gz,Johnny_Depp,191291,633466,4841,829598,597143
hdfs://spark-nn.eemcs.utwente.nl/user/s1934538/clickstream/clickstream-enwiki-2020-02.tsv.gz,"Princess_Margaret,_Countess_of_Snowdon",164475,643213,9292,816980,485717
hdfs://spark-nn.eemcs.utwente.nl/user/s1934538/clickstream/clickstream-enwiki-2020-02.tsv.gz,Sridevi,24487,108336,4476,137299,41521
hdfs://spark-nn.eemcs.utwente.nl/user/s1934538/clickstream/clickstream-enwiki-2020-02.tsv.gz,Greta_Thunberg,21871,382352,3478,407701,97254
hdfs://spark-nn.eemcs.utwente.nl/user/s1934538/clickstream/clickstream-enwiki-2020-02.tsv.gz,1234,33,2172,11,2216,133
hdfs://spark-nn.eemcs.utwente.nl/user/s1934538/clickstream/clickstream-enwiki-2020-02.tsv.gz,List_of_FIFA_World_Cup_finals,2082,39932,73,42087,11857
hdfs://spark-nn.eemcs.utwente.nl/user/s1934538/clickstream/clickstream-enwiki-2020-02.tsv.gz,Sinéad_O'Connor,11741,83781,568,96090,25294
hdfs://spark-nn.eemcs.utwente.nl/user/s1934538/clickstream/clickstream-enwiki-2020-02.tsv.gz,YouTube,119715,819938,7616,947269,125813
hdfs://spark-nn.eemcs.utwente.nl/user/s1934538/clickstream/clickstream-enwiki-2020-02.tsv.gz,List_of_James_Bond_films,82692,395486,651,478829,336268
hdfs://spark-nn.eemcs.utwente.nl/user/s1934538/clickstream/clickstream-enwiki-2020-02.tsv.gz,Deion_Sanders,12781,122572,672,136025,39800
hdfs://spark-nn.eemcs.utwente.nl/user/s1934538/clickstream/clickstream-enwiki-2020-02.tsv.gz,Michael_Bloomberg,323593,3726281,35826,4085700,1454578
hdfs://spark-nn.eemcs.utwente.nl/user/s1934538/clickstream/clickstream-enwiki-2020-02.tsv.gz,Wonder_Woman_1984,87431,76238,2578,166247,113030
hdfs://spark-nn.eemcs.utwente.nl/user/s1934538/clickstream/clickstream-enwiki-2020-02.tsv.gz,Hamilton_(musical),37195,287037,3436,327668,153620
hdfs://spark-nn.eemcs.utwente.nl/user/s1934538/clickstream/clickstream-enwiki-2020-02.tsv.gz,Venom_(2018_film),29775,116832,1545,148152,69547
hdfs://spark-nn.eemcs.utwente.nl/user/s1934538/clickstream/clickstream-enwiki-2020-02.tsv.gz,Elon_Musk,151440,975233,6796,1133469,709374
hdfs://spark-nn.eemcs.utwente.nl/user/s1934538/clickstream/clickstream-enwiki-2020-02.tsv.gz,Coronavirus,108453,5161250,103390,5373093,1676363
hdfs://spark-nn.eemcs.utwente.nl/user/s1934538/clickstream/clickstream-enwiki-2020-02.tsv.gz,WandaVision,62816,193904,2209,258929,130177
hdfs://spark-nn.eemcs.utwente.nl/user/s1934538/clickstream/clickstream-enwiki-2020-02.tsv.gz,Tina_Turner,22827,298680,2196,323703,76804
hdfs://spark-nn.eemcs.utwente.nl/user/s1934538/clickstream/clickstream-enwiki-2020-02.tsv.gz,"Meghan,_Duchess_of_Sussex",103470,315602,2600,421672,237284
hdfs://spark-nn.eemcs.utwente.nl/user/s1934538/clickstream/clickstream-enwiki-2020-02.tsv.gz,It_Chapter_Two,47276,123444,2003,172723,109890
hdfs://spark-nn.eemcs.utwente.nl/user/s1934538/clickstream/clickstream-enwiki-2020-02.tsv.gz,Royal_Rumble_(2018),13608,8706,331,22645,15866
hdfs://spark-nn.eemcs.utwente.nl/user/s1934538/clickstream/clickstream-enwiki-2020-02.tsv.gz,Army_of_the_Dead,29733,7826,39,37598,19048
hdfs://spark-nn.eemcs.utwente.nl/user/s1934538/clickstream/clickstream-enwiki-2020-02.tsv.gz,Charles_III,63,177,46,286,234
hdfs://spark-nn.eemcs.utwente.nl/user/s1934538/clickstream/clickstream-enwiki-2020-02.tsv.gz,Glass_(2019_film),58201,118075,898,177174,59012
hdfs://spark-nn.eemcs.utwente.nl/user/s1934538/clickstream/clickstream-enwiki-2020-02.tsv.gz,Joe_Biden,135246,523671,7083,666000,220740
hdfs://spark-nn.eemcs.utwente.nl/user/s1934538/clickstream/clickstream-enwiki-2020-02.tsv.gz,Mulan_(2020_film),52127,215141,4483,271751,235293
hdfs://spark-nn.eemcs.utwente.nl/user/s1934538/clickstream/clickstream-enwiki-2020-02.tsv.gz,Google_logo,1285,33618,12,34915,1366
hdfs://spark-nn.eemcs.utwente.nl/user/s1934538/clickstream/clickstream-enwiki-2020-02.tsv.gz,Elizabeth_II,492447,782045,6734,1281226,1029690
hdfs://spark-nn.eemcs.utwente.nl/user/s1934538/clickstream/clickstream-enwiki-2020-02.tsv.gz,Carlos_Alcaraz,1360,20262,39,21661,3593
hdfs://spark-nn.eemcs.utwente.nl/user/s1934538/clickstream/clickstream-enwiki-2020-02.tsv.gz,2.0_(film),20362,39867,212,60441,14861
hdfs://spark-nn.eemcs.utwente.nl/user/s1934538/clickstream/clickstream-enwiki-2020-02.tsv.gz,2016_United_States_presidential_election,225737,480871,6103,712711,521453
hdfs://spark-nn.eemcs.utwente.nl/user/s1934538/clickstream/clickstream-enwiki-2020-02.tsv.gz,No_Time_to_Die,211167,441952,10484,663603,512274
hdfs://spark-nn.eemcs.utwente.nl/user/s1934538/clickstream/clickstream-enwiki-2020-02.tsv.gz,RRR_(film),46403,80419,5207,132029,75128
hdfs://spark-nn.eemcs.utwente.nl/user/s1934538/clickstream/clickstream-enwiki-2020-02.tsv.gz,Ted_Bundy,38989,820610,6850,866449,165234
hdfs://spark-nn.eemcs.utwente.nl/user/s1934538/clickstream/clickstream-enwiki-2020-02.tsv.gz,Stranger_Things,54464,359435,7617,421516,317939
hdfs://spark-nn.eemcs.utwente.nl/user/s1934538/clickstream/clickstream-enwiki-2020-02.tsv.gz,Puneeth_Rajkumar,8161,27868,35,36064,12980
hdfs://spark-nn.eemcs.utwente.nl/user/s1934538/clickstream/clickstream-enwiki-2020-02.tsv.gz,2020_Summer_Olympics,86001,416099,9550,511650,362174
hdfs://spark-nn.eemcs.utwente.nl/user/s1934538/clickstream/clickstream-enwiki-2020-02.tsv.gz,War_(2019_film),41295,171283,488,213066,47755
hdfs://spark-nn.eemcs.utwente.nl/user/s1934538/clickstream/clickstream-enwiki-2020-02.tsv.gz,1917_(2019_film),181754,1506730,61856,1750340,1004015
hdfs://spark-nn.eemcs.utwente.nl/user/s1934538/clickstream/clickstream-enwiki-2020-02.tsv.gz,Ray_Liotta,46429,53273,521,100223,31463
hdfs://spark-nn.eemcs.utwente.nl/user/s1934538/clickstream/clickstream-enwiki-2020-02.tsv.gz,Betty_White,59291,294519,3306,357116,99826
hdfs://spark-nn.eemcs.utwente.nl/user/s1934538/clickstream/clickstream-enwiki-2020-02.tsv.gz,Aquaman_(film),58264,134393,2441,195098,106445
hdfs://spark-nn.eemcs.utwente.nl/user/s1934538/clickstream/clickstream-enwiki-2020-02.tsv.gz,George_H._W._Bush,158683,135895,848,295426,169785
hdfs://spark-nn.eemcs.utwente.nl/user/s1934538/clickstream/clickstream-enwiki-2020-02.tsv.gz,Deaths_in_2020,1397783,1789779,9259,3196821,2060998
hdfs://spark-nn.eemcs.utwente.nl/user/s1934538/clickstream/clickstream-enwiki-2020-02.tsv.gz,Kelly_Preston,62788,32160,198,95146,26501
hdfs://spark-nn.eemcs.utwente.nl/user/s1934538/clickstream/clickstream-enwiki-2020-02.tsv.gz,Sushma_Swaraj,12637,34930,46,47613,11467
hdfs://spark-nn.eemcs.utwente.nl/user/s1934538/clickstream/clickstream-enwiki-2020-02.tsv.gz,Naya_Rivera,20653,29671,72,50396,10070
hdfs://spark-nn.eemcs.utwente.nl/user/s1934538/clickstream/clickstream-enwiki-2020-02.tsv.gz,September_11_attacks,83296,320778,8979,413053,169096
hdfs://spark-nn.eemcs.utwente.nl/user/s1934538/clickstream/clickstream-enwiki-2020-02.tsv.gz,21_Savage,16137,62411,1410,79958,27042
hdfs://spark-nn.eemcs.utwente.nl/user/s1934538/clickstream/clickstream-enwiki-2020-02.tsv.gz,Laal_Singh_Chaddha,43120,39360,40,82520,41312
hdfs://spark-nn.eemcs.utwente.nl/user/s1934538/clickstream/clickstream-enwiki-2020-04.tsv.gz,Cameron_Boyce,45781,250032,1323,297136,87260
hdfs://spark-nn.eemcs.utwente.nl/user/s1934538/clickstream/clickstream-enwiki-2020-04.tsv.gz,Aquaman_(film),51030,166270,2086,219386,120887
hdfs://spark-nn.eemcs.utwente.nl/user/s1934538/clickstream/clickstream-enwiki-2020-04.tsv.gz,Rami_Malek,94006,178631,741,273378,106187
hdfs://spark-nn.eemcs.utwente.nl/user/s1934538/clickstream/clickstream-enwiki-2020-04.tsv.gz,ICC_Men's_T20_World_Cup,6155,92146,180,98481,47462
hdfs://spark-nn.eemcs.utwente.nl/user/s1934538/clickstream/clickstream-enwiki-2020-04.tsv.gz,Meat_Loaf,27610,93971,821,122402,40728
hdfs://spark-nn.eemcs.utwente.nl/user/s1934538/clickstream/clickstream-enwiki-2020-04.tsv.gz,Aaron_Carter,28120,69043,427,97590,37177
hdfs://spark-nn.eemcs.utwente.nl/user/s1934538/clickstream/clickstream-enwiki-2020-04.tsv.gz,Sridevi,45961,165016,598,211575,78572
hdfs://spark-nn.eemcs.utwente.nl/user/s1934538/clickstream/clickstream-enwiki-2020-04.tsv.gz,Bird_Box_(film),22509,154313,1347,178169,52976
hdfs://spark-nn.eemcs.utwente.nl/user/s1934538/clickstream/clickstream-enwiki-2020-04.tsv.gz,Murder_of_Dee_Dee_Blanchard,26615,236807,577,263999,48718
hdfs://spark-nn.eemcs.utwente.nl/user/s1934538/clickstream/clickstream-enwiki-2020-04.tsv.gz,Kamala_Harris,27230,193962,2231,223423,70035
hdfs://spark-nn.eemcs.utwente.nl/user/s1934538/clickstream/clickstream-enwiki-2020-04.tsv.gz,Mulan_(2020_film),55309,297414,6151,358874,156956
hdfs://spark-nn.eemcs.utwente.nl/user/s1934538/clickstream/clickstream-enwiki-2020-04.tsv.gz,Charles_III,86,268,67,421,298
hdfs://spark-nn.eemcs.utwente.nl/user/s1934538/clickstream/clickstream-enwiki-2020-04.tsv.gz,Joe_Exotic,929110,5209902,23682,6162694,2043292
hdfs://spark-nn.eemcs.utwente.nl/user/s1934538/clickstream/clickstream-enwiki-2020-04.tsv.gz,Eddie_Van_Halen,46104,65306,515,111925,50322
hdfs://spark-nn.eemcs.utwente.nl/user/s1934538/clickstream/clickstream-enwiki-2020-04.tsv.gz,Ghislaine_Maxwell,21554,41046,1036,63636,28844
hdfs://spark-nn.eemcs.utwente.nl/user/s1934538/clickstream/clickstream-enwiki-2020-04.tsv.gz,1917_(2019_film),62540,696952,8050,767542,376221
hdfs://spark-nn.eemcs.utwente.nl/user/s1934538/clickstream/clickstream-enwiki-2020-04.tsv.gz,Cecil_Hotel_(Los_Angeles),5373,19894,33,25300,9969
hdfs://spark-nn.eemcs.utwente.nl/user/s1934538/clickstream/clickstream-enwiki-2020-04.tsv.gz,Top_Gun:_Maverick,75281,100383,2468,178132,140763
hdfs://spark-nn.eemcs.utwente.nl/user/s1934538/clickstream/clickstream-enwiki-2020-04.tsv.gz,Army_of_the_Dead,43537,14330,35,57902,32746
hdfs://spark-nn.eemcs.utwente.nl/user/s1934538/clickstream/clickstream-enwiki-2020-04.tsv.gz,"Prince_Philip,_Duke_of_Edinburgh",407267,517342,12367,936976,594484
hdfs://spark-nn.eemcs.utwente.nl/user/s1934538/clickstream/clickstream-enwiki-2020-04.tsv.gz,Joaquin_Phoenix,191845,324581,1279,517705,321862
hdfs://spark-nn.eemcs.utwente.nl/user/s1934538/clickstream/clickstream-enwiki-2020-04.tsv.gz,Death_of_Elisa_Lam,7571,99901,1124,108596,25215
hdfs://spark-nn.eemcs.utwente.nl/user/s1934538/clickstream/clickstream-enwiki-2020-04.tsv.gz,Sylvester_Stallone,118165,496052,2955,617172,447262
hdfs://spark-nn.eemcs.utwente.nl/user/s1934538/clickstream/clickstream-enwiki-2020-04.tsv.gz,Jimmy_Buffett,10992,54374,614,65980,27214
hdfs://spark-nn.eemcs.utwente.nl/user/s1934538/clickstream/clickstream-enwiki-2020-04.tsv.gz,Shang-Chi_and_the_Legend_of_the_Ten_Rings,126084,44406,8564,179054,120075
hdfs://spark-nn.eemcs.utwente.nl/user/s1934538/clickstream/clickstream-enwiki-2020-04.tsv.gz,Black_Panther_(film),74726,223091,3425,301242,198447
hdfs://spark-nn.eemcs.utwente.nl/user/s1934538/clickstream/clickstream-enwiki-2020-04.tsv.gz,Joker_(2019_film),96923,664599,5278,766800,267636
hdfs://spark-nn.eemcs.utwente.nl/user/s1934538/clickstream/clickstream-enwiki-2020-04.tsv.gz,Brett_Kavanaugh,32757,69004,575,102336,34048
hdfs://spark-nn.eemcs.utwente.nl/user/s1934538/clickstream/clickstream-enwiki-2020-04.tsv.gz,Game_of_Thrones,96153,402673,11828,510654,363596
hdfs://spark-nn.eemcs.utwente.nl/user/s1934538/clickstream/clickstream-enwiki-2020-04.tsv.gz,The_Shape_of_Water,39350,106354,1136,146840,61037
hdfs://spark-nn.eemcs.utwente.nl/user/s1934538/clickstream/clickstream-enwiki-2020-04.tsv.gz,Brie_Larson,113522,238258,2289,354069,136874
hdfs://spark-nn.eemcs.utwente.nl/user/s1934538/clickstream/clickstream-enwiki-2020-04.tsv.gz,Chadwick_Boseman,47100,126041,678,173819,58878
hdfs://spark-nn.eemcs.utwente.nl/user/s1934538/clickstream/clickstream-enwiki-2020-04.tsv.gz,Aretha_Franklin,28688,100679,1415,130782,51523
hdfs://spark-nn.eemcs.utwente.nl/user/s1934538/clickstream/clickstream-enwiki-2020-04.tsv.gz,Kobe_Bryant,116372,761925,8814,887111,250481
hdfs://spark-nn.eemcs.utwente.nl/user/s1934538/clickstream/clickstream-enwiki-2020-04.tsv.gz,Donald_Trump,447564,1517728,17642,1982934,1552129
hdfs://spark-nn.eemcs.utwente.nl/user/s1934538/clickstream/clickstream-enwiki-2020-04.tsv.gz,Juneteenth,1541,53648,98,55287,5093
hdfs://spark-nn.eemcs.utwente.nl/user/s1934538/clickstream/clickstream-enwiki-2020-04.tsv.gz,Glass_(2019_film),58114,121996,965,181075,60105
hdfs://spark-nn.eemcs.utwente.nl/user/s1934538/clickstream/clickstream-enwiki-2020-04.tsv.gz,Avicii,24815,268701,1998,295514,83850
hdfs://spark-nn.eemcs.utwente.nl/user/s1934538/clickstream/clickstream-enwiki-2020-04.tsv.gz,Stan_Lee,67629,194057,1266,262952,78121
hdfs://spark-nn.eemcs.utwente.nl/user/s1934538/clickstream/clickstream-enwiki-2020-04.tsv.gz,Shinzo_Abe,45384,64282,669,110335,58029
hdfs://spark-nn.eemcs.utwente.nl/user/s1934538/clickstream/clickstream-enwiki-2020-04.tsv.gz,Google_logo,1600,36151,10,37761,1565
hdfs://spark-nn.eemcs.utwente.nl/user/s1934538/clickstream/clickstream-enwiki-2020-04.tsv.gz,J._Robert_Oppenheimer,25969,104032,338,130339,41342
hdfs://spark-nn.eemcs.utwente.nl/user/s1934538/clickstream/clickstream-enwiki-2020-04.tsv.gz,State_of_Palestine,56509,161115,135,217759,91155
hdfs://spark-nn.eemcs.utwente.nl/user/s1934538/clickstream/clickstream-enwiki-2020-04.tsv.gz,Watts_family_murders,2639,114473,189,117301,36431
hdfs://spark-nn.eemcs.utwente.nl/user/s1934538/clickstream/clickstream-enwiki-2020-04.tsv.gz,Luke_Perry,64595,187350,1129,253074,71944
hdfs://spark-nn.eemcs.utwente.nl/user/s1934538/clickstream/clickstream-enwiki-2020-04.tsv.gz,Adele,27413,220756,3052,251221,83503
hdfs://spark-nn.eemcs.utwente.nl/user/s1934538/clickstream/clickstream-enwiki-2020-04.tsv.gz,2018_Asian_Games,6864,9510,58,16432,14589
hdfs://spark-nn.eemcs.utwente.nl/user/s1934538/clickstream/clickstream-enwiki-2020-04.tsv.gz,HTTP_cookie,5046,452588,125,457759,25563
hdfs://spark-nn.eemcs.utwente.nl/user/s1934538/clickstream/clickstream-enwiki-2020-04.tsv.gz,List_of_Queen_of_the_South_episodes,13573,8559,66,22198,629
hdfs://spark-nn.eemcs.utwente.nl/user/s1934538/clickstream/clickstream-enwiki-2020-04.tsv.gz,Hamilton_(musical),49193,284323,2041,335557,223749
hdfs://spark-nn.eemcs.utwente.nl/user/s1934538/clickstream/clickstream-enwiki-2020-04.tsv.gz,2020_United_States_presidential_election,175494,541316,8425,725235,480703
hdfs://spark-nn.eemcs.utwente.nl/user/s1934538/clickstream/clickstream-enwiki-2020-04.tsv.gz,No_Time_to_Die,202925,197671,2827,403423,270480
hdfs://spark-nn.eemcs.utwente.nl/user/s1934538/clickstream/clickstream-enwiki-2020-04.tsv.gz,Greta_Thunberg,12402,199923,1357,213682,46793
hdfs://spark-nn.eemcs.utwente.nl/user/s1934538/clickstream/clickstream-enwiki-2020-04.tsv.gz,Spider-Man:_Far_From_Home,134330,322318,4373,461021,249981
hdfs://spark-nn.eemcs.utwente.nl/user/s1934538/clickstream/clickstream-enwiki-2020-04.tsv.gz,United_States_Electoral_College,34629,163251,172,198052,26758
hdfs://spark-nn.eemcs.utwente.nl/user/s1934538/clickstream/clickstream-enwiki-2020-04.tsv.gz,1234,33,2480,214,2727,349
hdfs://spark-nn.eemcs.utwente.nl/user/s1934538/clickstream/clickstream-enwiki-2020-04.tsv.gz,Burt_Reynolds,71439,173246,1374,246059,101143
hdfs://spark-nn.eemcs.utwente.nl/user/s1934538/clickstream/clickstream-enwiki-2020-04.tsv.gz,R._Kelly,48485,390442,2969,441896,176475
hdfs://spark-nn.eemcs.utwente.nl/user/s1934538/clickstream/clickstream-enwiki-2020-04.tsv.gz,Ted_Bundy,49297,651181,5487,705965,154144
hdfs://spark-nn.eemcs.utwente.nl/user/s1934538/clickstream/clickstream-enwiki-2020-04.tsv.gz,Star_Wars:_The_Rise_of_Skywalker,197481,488242,10786,696509,389691
hdfs://spark-nn.eemcs.utwente.nl/user/s1934538/clickstream/clickstream-enwiki-2020-04.tsv.gz,Israel,122899,407633,7007,537539,263715
hdfs://spark-nn.eemcs.utwente.nl/user/s1934538/clickstream/clickstream-enwiki-2020-04.tsv.gz,Crazy_Rich_Asians_(film),40690,129105,1172,170967,154404
hdfs://spark-nn.eemcs.utwente.nl/user/s1934538/clickstream/clickstream-enwiki-2020-04.tsv.gz,The_Lion_King_(2019_film),67022,263972,1797,332791,173635
hdfs://spark-nn.eemcs.utwente.nl/user/s1934538/clickstream/clickstream-enwiki-2020-04.tsv.gz,Simple_Mail_Transfer_Protocol,4548,35669,146,40363,4065
hdfs://spark-nn.eemcs.utwente.nl/user/s1934538/clickstream/clickstream-enwiki-2020-04.tsv.gz,Bipin_Rawat,7528,18014,24,25566,13231
hdfs://spark-nn.eemcs.utwente.nl/user/s1934538/clickstream/clickstream-enwiki-2020-04.tsv.gz,Royal_Rumble_(2018),15535,9608,175,25318,17599
hdfs://spark-nn.eemcs.utwente.nl/user/s1934538/clickstream/clickstream-enwiki-2020-04.tsv.gz,Jason_Momoa,119373,441089,1812,562274,261347
hdfs://spark-nn.eemcs.utwente.nl/user/s1934538/clickstream/clickstream-enwiki-2020-04.tsv.gz,Olivia_Newton-John,37532,122409,1318,161259,70872
hdfs://spark-nn.eemcs.utwente.nl/user/s1934538/clickstream/clickstream-enwiki-2020-04.tsv.gz,Kate_Spade,42751,56114,233,99098,33719
hdfs://spark-nn.eemcs.utwente.nl/user/s1934538/clickstream/clickstream-enwiki-2020-04.tsv.gz,A_Quiet_Place_(film),47878,258826,1715,308419,97385
hdfs://spark-nn.eemcs.utwente.nl/user/s1934538/clickstream/clickstream-enwiki-2020-04.tsv.gz,Juice_Wrld,38682,390707,4940,434329,160001
hdfs://spark-nn.eemcs.utwente.nl/user/s1934538/clickstream/clickstream-enwiki-2020-04.tsv.gz,List_of_highest-grossing_films,181613,514059,2496,698168,301901
hdfs://spark-nn.eemcs.utwente.nl/user/s1934538/clickstream/clickstream-enwiki-2020-04.tsv.gz,Alexander_Hamilton,73140,266483,1730,341353,146735
hdfs://spark-nn.eemcs.utwente.nl/user/s1934538/clickstream/clickstream-enwiki-2020-04.tsv.gz,"Citizenship_(Amendment)_Act,_2019",7253,80533,50,87836,10364
hdfs://spark-nn.eemcs.utwente.nl/user/s1934538/clickstream/clickstream-enwiki-2020-04.tsv.gz,Loki_(TV_series),40647,22890,131,63668,24744
hdfs://spark-nn.eemcs.utwente.nl/user/s1934538/clickstream/clickstream-enwiki-2020-04.tsv.gz,Cook's_Country,427,4928,20,5375,949
hdfs://spark-nn.eemcs.utwente.nl/user/s1934538/clickstream/clickstream-enwiki-2020-04.tsv.gz,QAnon,75783,1189501,2114,1267398,193793
hdfs://spark-nn.eemcs.utwente.nl/user/s1934538/clickstream/clickstream-enwiki-2020-04.tsv.gz,2023_Cricket_World_Cup,12212,16781,25,29018,9530
hdfs://spark-nn.eemcs.utwente.nl/user/s1934538/clickstream/clickstream-enwiki-2020-04.tsv.gz,Freddie_Mercury,109644,793380,5083,908107,318584
hdfs://spark-nn.eemcs.utwente.nl/user/s1934538/clickstream/clickstream-enwiki-2020-04.tsv.gz,Richard_Ramirez,18522,153412,1007,172941,56245
hdfs://spark-nn.eemcs.utwente.nl/user/s1934538/clickstream/clickstream-enwiki-2020-04.tsv.gz,Sushant_Singh_Rajput,26692,74304,396,101392,58376
hdfs://spark-nn.eemcs.utwente.nl/user/s1934538/clickstream/clickstream-enwiki-2020-04.tsv.gz,Jeffrey_Dahmer,34301,402866,3977,441144,189616
hdfs://spark-nn.eemcs.utwente.nl/user/s1934538/clickstream/clickstream-enwiki-2020-04.tsv.gz,William_Murdoch,675,1972,36,2683,374
hdfs://spark-nn.eemcs.utwente.nl/user/s1934538/clickstream/clickstream-enwiki-2020-04.tsv.gz,Sinéad_O'Connor,15323,107306,751,123380,32871
hdfs://spark-nn.eemcs.utwente.nl/user/s1934538/clickstream/clickstream-enwiki-2020-04.tsv.gz,Wikipedia,39484,548715,1218,589417,295488
hdfs://spark-nn.eemcs.utwente.nl/user/s1934538/clickstream/clickstream-enwiki-2020-04.tsv.gz,FIFA_World_Cup,52948,200674,2793,256415,193676
hdfs://spark-nn.eemcs.utwente.nl/user/s1934538/clickstream/clickstream-enwiki-2020-04.tsv.gz,Valentine's_Day,4706,31986,230,36922,3528
hdfs://spark-nn.eemcs.utwente.nl/user/s1934538/clickstream/clickstream-enwiki-2020-04.tsv.gz,Qasem_Soleimani,18321,46716,228,65265,29125
hdfs://spark-nn.eemcs.utwente.nl/user/s1934538/clickstream/clickstream-enwiki-2020-04.tsv.gz,A_Star_Is_Born_(2018_film),44636,195989,785,241410,104432
hdfs://spark-nn.eemcs.utwente.nl/user/s1934538/clickstream/clickstream-enwiki-2020-04.tsv.gz,Aaron_Hernandez,13284,299663,1402,314349,92324
hdfs://spark-nn.eemcs.utwente.nl/user/s1934538/clickstream/clickstream-enwiki-2020-04.tsv.gz,Key_frame,804,6783,11,7598,535
hdfs://spark-nn.eemcs.utwente.nl/user/s1934538/clickstream/clickstream-enwiki-2020-04.tsv.gz,It_Chapter_Two,63219,253220,2924,319363,231787
hdfs://spark-nn.eemcs.utwente.nl/user/s1934538/clickstream/clickstream-enwiki-2020-04.tsv.gz,The_Irishman,92247,332958,4924,430129,346395
hdfs://spark-nn.eemcs.utwente.nl/user/s1934538/clickstream/clickstream-enwiki-2020-04.tsv.gz,21_Savage,18558,80318,1092,99968,36382
hdfs://spark-nn.eemcs.utwente.nl/user/s1934538/clickstream/clickstream-enwiki-2020-04.tsv.gz,Stranger_Things,77019,413348,7219,497586,396159
hdfs://spark-nn.eemcs.utwente.nl/user/s1934538/clickstream/clickstream-enwiki-2020-04.tsv.gz,Kim_Jong-un,671822,5613396,55448,6340666,2626480
hdfs://spark-nn.eemcs.utwente.nl/user/s1934538/clickstream/clickstream-enwiki-2020-04.tsv.gz,Croatia,46908,128186,2134,177228,72867
hdfs://spark-nn.eemcs.utwente.nl/user/s1934538/clickstream/clickstream-enwiki-2020-04.tsv.gz,Atal_Bihari_Vajpayee,38008,63732,64,101804,31134
hdfs://spark-nn.eemcs.utwente.nl/user/s1934538/clickstream/clickstream-enwiki-2020-04.tsv.gz,Shakira,23262,234509,2337,260108,126032
hdfs://spark-nn.eemcs.utwente.nl/user/s1934538/clickstream/clickstream-enwiki-2020-04.tsv.gz,Pelé,37416,175549,1386,214351,62959
hdfs://spark-nn.eemcs.utwente.nl/user/s1934538/clickstream/clickstream-enwiki-2020-04.tsv.gz,When_They_See_Us,28068,136162,723,164953,83438
hdfs://spark-nn.eemcs.utwente.nl/user/s1934538/clickstream/clickstream-enwiki-2020-04.tsv.gz,The_Nun_(2018_film),24503,93481,646,118630,69254
hdfs://spark-nn.eemcs.utwente.nl/user/s1934538/clickstream/clickstream-enwiki-2020-04.tsv.gz,Bob_Saget,25352,48825,330,74507,13530
hdfs://spark-nn.eemcs.utwente.nl/user/s1934538/clickstream/clickstream-enwiki-2020-04.tsv.gz,2016_United_States_presidential_election,195513,397647,4143,597303,434427
hdfs://spark-nn.eemcs.utwente.nl/user/s1934538/clickstream/clickstream-enwiki-2020-04.tsv.gz,Fyre_Festival,18038,145393,752,164183,84798
hdfs://spark-nn.eemcs.utwente.nl/user/s1934538/clickstream/clickstream-enwiki-2020-04.tsv.gz,WrestleMania_34,72866,56542,368,129776,82057
hdfs://spark-nn.eemcs.utwente.nl/user/s1934538/clickstream/clickstream-enwiki-2020-04.tsv.gz,XHamster,10846,68775,3950,83571,17092
hdfs://spark-nn.eemcs.utwente.nl/user/s1934538/clickstream/clickstream-enwiki-2020-04.tsv.gz,Louis_Tomlinson,50807,91857,546,143210,22745
hdfs://spark-nn.eemcs.utwente.nl/user/s1934538/clickstream/clickstream-enwiki-2020-04.tsv.gz,Manti_Te'o,6210,24491,491,31192,3717
hdfs://spark-nn.eemcs.utwente.nl/user/s1934538/clickstream/clickstream-enwiki-2020-04.tsv.gz,Ruth_Bader_Ginsburg,37701,194245,1011,232957,81299
hdfs://spark-nn.eemcs.utwente.nl/user/s1934538/clickstream/clickstream-enwiki-2020-12.tsv.gz,Grimes_(musician),197030,231137,938,429105,119070
hdfs://spark-nn.eemcs.utwente.nl/user/s1934538/clickstream/clickstream-enwiki-2020-12.tsv.gz,Stranger_Things_(season_3),18121,50122,355,68598,35949
hdfs://spark-nn.eemcs.utwente.nl/user/s1934538/clickstream/clickstream-enwiki-2020-12.tsv.gz,A_Quiet_Place_(film),32369,104147,872,137388,42620
hdfs://spark-nn.eemcs.utwente.nl/user/s1934538/clickstream/clickstream-enwiki-2020-12.tsv.gz,R._Kelly,32615,160278,1539,194432,83633
hdfs://spark-nn.eemcs.utwente.nl/user/s1934538/clickstream/clickstream-enwiki-2020-12.tsv.gz,Black_Widow_(2021_film),100860,112350,2898,216108,107459
hdfs://spark-nn.eemcs.utwente.nl/user/s1934538/clickstream/clickstream-enwiki-2020-12.tsv.gz,Main_Page,14155,175678585,4533171,180225911,33480046
hdfs://spark-nn.eemcs.utwente.nl/user/s1934538/clickstream/clickstream-enwiki-2020-12.tsv.gz,XXX:_Return_of_Xander_Cage,42134,600046,837,643017,81066
hdfs://spark-nn.eemcs.utwente.nl/user/s1934538/clickstream/clickstream-enwiki-2020-12.tsv.gz,Kelly_Preston,169627,515271,6984,691882,179279
hdfs://spark-nn.eemcs.utwente.nl/user/s1934538/clickstream/clickstream-enwiki-2020-12.tsv.gz,Henry_V_of_England,118292,168441,686,287419,199444
hdfs://spark-nn.eemcs.utwente.nl/user/s1934538/clickstream/clickstream-enwiki-2020-12.tsv.gz,Pelé,50665,331368,2589,384622,126716
hdfs://spark-nn.eemcs.utwente.nl/user/s1934538/clickstream/clickstream-enwiki-2020-12.tsv.gz,Darth_Vader,96795,184152,1653,282600,202328
hdfs://spark-nn.eemcs.utwente.nl/user/s1934538/clickstream/clickstream-enwiki-2020-12.tsv.gz,Joe_Exotic,31489,176157,1083,208729,56221
hdfs://spark-nn.eemcs.utwente.nl/user/s1934538/clickstream/clickstream-enwiki-2020-12.tsv.gz,Richard_Ramirez,30854,326388,1550,358792,124059
hdfs://spark-nn.eemcs.utwente.nl/user/s1934538/clickstream/clickstream-enwiki-2020-12.tsv.gz,Wonder_Woman_1984,395551,3215306,75119,3685976,2154971
hdfs://spark-nn.eemcs.utwente.nl/user/s1934538/clickstream/clickstream-enwiki-2020-12.tsv.gz,When_They_See_Us,16938,46507,198,63643,29053
hdfs://spark-nn.eemcs.utwente.nl/user/s1934538/clickstream/clickstream-enwiki-2020-12.tsv.gz,Richard_Jewell,228792,1512421,4204,1745417,565450
hdfs://spark-nn.eemcs.utwente.nl/user/s1934538/clickstream/clickstream-enwiki-2020-12.tsv.gz,Matthew_Perry,75447,177688,844,253979,134706
hdfs://spark-nn.eemcs.utwente.nl/user/s1934538/clickstream/clickstream-enwiki-2020-12.tsv.gz,Bonnie_and_Clyde,28157,301065,1645,330867,75631
hdfs://spark-nn.eemcs.utwente.nl/user/s1934538/clickstream/clickstream-enwiki-2020-12.tsv.gz,Bird_Box_(film),21472,86899,794,109165,34440
hdfs://spark-nn.eemcs.utwente.nl/user/s1934538/clickstream/clickstream-enwiki-2020-12.tsv.gz,Chadwick_Boseman,132365,689738,6430,828533,252100
hdfs://spark-nn.eemcs.utwente.nl/user/s1934538/clickstream/clickstream-enwiki-2020-12.tsv.gz,"Prince_Philip,_Duke_of_Edinburgh",1009581,1475674,9357,2494612,1604162
hdfs://spark-nn.eemcs.utwente.nl/user/s1934538/clickstream/clickstream-enwiki-2020-12.tsv.gz,Lisa_Marie_Presley,145495,88439,298,234232,121671
hdfs://spark-nn.eemcs.utwente.nl/user/s1934538/clickstream/clickstream-enwiki-2020-12.tsv.gz,Us_(2019_film),26567,144905,466,171938,55166
hdfs://spark-nn.eemcs.utwente.nl/user/s1934538/clickstream/clickstream-enwiki-2020-12.tsv.gz,WrestleMania_34,17967,10547,136,28650,19218
hdfs://spark-nn.eemcs.utwente.nl/user/s1934538/clickstream/clickstream-enwiki-2020-12.tsv.gz,Priyanka_Chopra,143526,269929,853,414308,136407
hdfs://spark-nn.eemcs.utwente.nl/user/s1934538/clickstream/clickstream-enwiki-2020-12.tsv.gz,Kamala_Harris,203994,647409,8599,860002,362605
hdfs://spark-nn.eemcs.utwente.nl/user/s1934538/clickstream/clickstream-enwiki-2020-12.tsv.gz,Hyphen-minus,4288,6850958,7067595,13922841,724
hdfs://spark-nn.eemcs.utwente.nl/user/s1934538/clickstream/clickstream-enwiki-2020-12.tsv.gz,Jason_Momoa,85507,309699,1472,396678,163891
hdfs://spark-nn.eemcs.utwente.nl/user/s1934538/clickstream/clickstream-enwiki-2020-12.tsv.gz,Luke_Perry,36023,133497,476,169996,53333
hdfs://spark-nn.eemcs.utwente.nl/user/s1934538/clickstream/clickstream-enwiki-2020-12.tsv.gz,Rishi_Sunak,19119,100429,650,120198,53561
hdfs://spark-nn.eemcs.utwente.nl/user/s1934538/clickstream/clickstream-enwiki-2020-12.tsv.gz,Amy_Coney_Barrett,52227,102362,976,155565,48725
hdfs://spark-nn.eemcs.utwente.nl/user/s1934538/clickstream/clickstream-enwiki-2020-12.tsv.gz,Deaths_in_2021,2274,63711,101,66086,1516
hdfs://spark-nn.eemcs.utwente.nl/user/s1934538/clickstream/clickstream-enwiki-2020-12.tsv.gz,Crazy_Rich_Asians_(film),38139,136655,1526,176320,177086
hdfs://spark-nn.eemcs.utwente.nl/user/s1934538/clickstream/clickstream-enwiki-2020-12.tsv.gz,Doctor_Strange_in_the_Multiverse_of_Madness,120657,80758,522,201937,104511
hdfs://spark-nn.eemcs.utwente.nl/user/s1934538/clickstream/clickstream-enwiki-2020-12.tsv.gz,Rami_Malek,70081,162717,627,233425,91415
hdfs://spark-nn.eemcs.utwente.nl/user/s1934538/clickstream/clickstream-enwiki-2020-12.tsv.gz,Kenosha_unrest_shooting,12989,114151,752,127892,17107
hdfs://spark-nn.eemcs.utwente.nl/user/s1934538/clickstream/clickstream-enwiki-2020-12.tsv.gz,Bipin_Rawat,8120,19070,15,27205,12515
hdfs://spark-nn.eemcs.utwente.nl/user/s1934538/clickstream/clickstream-enwiki-2020-12.tsv.gz,Zack_Snyder's_Justice_League,132732,130240,1115,264087,124290
hdfs://spark-nn.eemcs.utwente.nl/user/s1934538/clickstream/clickstream-enwiki-2020-12.tsv.gz,COVID-19_pandemic_by_country_and_territory,367822,745046,2305,1115173,755279
hdfs://spark-nn.eemcs.utwente.nl/user/s1934538/clickstream/clickstream-enwiki-2020-12.tsv.gz,Betty_White,57526,286233,3600,347359,107495
hdfs://spark-nn.eemcs.utwente.nl/user/s1934538/clickstream/clickstream-enwiki-2020-12.tsv.gz,Tenet_(film),222376,2183637,22636,2428649,1272019
hdfs://spark-nn.eemcs.utwente.nl/user/s1934538/clickstream/clickstream-enwiki-2020-12.tsv.gz,Brett_Kavanaugh,32171,37402,224,69797,22553
hdfs://spark-nn.eemcs.utwente.nl/user/s1934538/clickstream/clickstream-enwiki-2020-12.tsv.gz,Israel,96058,262737,4940,363735,182610
hdfs://spark-nn.eemcs.utwente.nl/user/s1934538/clickstream/clickstream-enwiki-2020-12.tsv.gz,2023_Cricket_World_Cup,13521,26147,63,39731,13448
hdfs://spark-nn.eemcs.utwente.nl/user/s1934538/clickstream/clickstream-enwiki-2020-12.tsv.gz,Simone_Biles,11124,78118,555,89797,27952
hdfs://spark-nn.eemcs.utwente.nl/user/s1934538/clickstream/clickstream-enwiki-2020-12.tsv.gz,Dennis_Nilsen,25122,150663,869,176654,44571
hdfs://spark-nn.eemcs.utwente.nl/user/s1934538/clickstream/clickstream-enwiki-2020-12.tsv.gz,Gaza_Strip,18670,37376,243,56289,22854
hdfs://spark-nn.eemcs.utwente.nl/user/s1934538/clickstream/clickstream-enwiki-2020-12.tsv.gz,Joaquin_Phoenix,138030,216998,990,356018,211173
hdfs://spark-nn.eemcs.utwente.nl/user/s1934538/clickstream/clickstream-enwiki-2020-12.tsv.gz,Top_Gun:_Maverick,52884,85071,1719,139674,90594
hdfs://spark-nn.eemcs.utwente.nl/user/s1934538/clickstream/clickstream-enwiki-2020-12.tsv.gz,FIFA_World_Cup,42056,211141,2875,256072,156488
hdfs://spark-nn.eemcs.utwente.nl/user/s1934538/clickstream/clickstream-enwiki-2020-12.tsv.gz,Tasuku_Honjo,1009,326902,34,327945,10598
hdfs://spark-nn.eemcs.utwente.nl/user/s1934538/clickstream/clickstream-enwiki-2020-12.tsv.gz,Spanish_flu,56329,641582,7574,705485,153675
hdfs://spark-nn.eemcs.utwente.nl/user/s1934538/clickstream/clickstream-enwiki-2020-12.tsv.gz,Deadpool_2,55209,122465,1996,179670,109382
hdfs://spark-nn.eemcs.utwente.nl/user/s1934538/clickstream/clickstream-enwiki-2020-12.tsv.gz,IPv4,10681,44416,137,55234,9241
hdfs://spark-nn.eemcs.utwente.nl/user/s1934538/clickstream/clickstream-enwiki-2020-12.tsv.gz,Jimmy_Hoffa,41502,182972,1451,225925,84418
hdfs://spark-nn.eemcs.utwente.nl/user/s1934538/clickstream/clickstream-enwiki-2020-12.tsv.gz,Charles_III,189,281,76,546,390
hdfs://spark-nn.eemcs.utwente.nl/user/s1934538/clickstream/clickstream-enwiki-2020-12.tsv.gz,Simple_Mail_Transfer_Protocol,3556,36334,124,40014,3796
hdfs://spark-nn.eemcs.utwente.nl/user/s1934538/clickstream/clickstream-enwiki-2020-12.tsv.gz,Russo-Ukrainian_War,18424,25423,177,44024,25592
hdfs://spark-nn.eemcs.utwente.nl/user/s1934538/clickstream/clickstream-enwiki-2020-12.tsv.gz,Eternals_(film),123999,93245,630,217874,237887
hdfs://spark-nn.eemcs.utwente.nl/user/s1934538/clickstream/clickstream-enwiki-2020-12.tsv.gz,List_of_highest-grossing_Indian_films,41610,123422,79,165111,104710
hdfs://spark-nn.eemcs.utwente.nl/user/s1934538/clickstream/clickstream-enwiki-2020-12.tsv.gz,Murder_of_Dee_Dee_Blanchard,22904,170018,446,193368,34570
hdfs://spark-nn.eemcs.utwente.nl/user/s1934538/clickstream/clickstream-enwiki-2020-12.tsv.gz,Avengers:_Infinity_War,58675,90366,1791,150832,85557
hdfs://spark-nn.eemcs.utwente.nl/user/s1934538/clickstream/clickstream-enwiki-2020-12.tsv.gz,Freddie_Mercury,83582,606067,4357,694006,248330
hdfs://spark-nn.eemcs.utwente.nl/user/s1934538/clickstream/clickstream-enwiki-2020-12.tsv.gz,Black_Panther_(film),75839,169178,3538,248555,145277
hdfs://spark-nn.eemcs.utwente.nl/user/s1934538/clickstream/clickstream-enwiki-2020-12.tsv.gz,2020_Summer_Olympics,50277,113397,2362,166036,118046
hdfs://spark-nn.eemcs.utwente.nl/user/s1934538/clickstream/clickstream-enwiki-2020-12.tsv.gz,Afghanistan,52942,131056,1852,185850,105984
hdfs://spark-nn.eemcs.utwente.nl/user/s1934538/clickstream/clickstream-enwiki-2020-12.tsv.gz,Bridgerton,189228,2219935,27738,2436901,2069621
hdfs://spark-nn.eemcs.utwente.nl/user/s1934538/clickstream/clickstream-enwiki-2020-12.tsv.gz,Brie_Larson,68945,229577,1793,300315,106604
hdfs://spark-nn.eemcs.utwente.nl/user/s1934538/clickstream/clickstream-enwiki-2020-12.tsv.gz,Aretha_Franklin,30278,133948,1180,165406,57570
hdfs://spark-nn.eemcs.utwente.nl/user/s1934538/clickstream/clickstream-enwiki-2020-12.tsv.gz,The_Queen's_Gambit_(miniseries),348678,3154336,24677,3527691,1894395
hdfs://spark-nn.eemcs.utwente.nl/user/s1934538/clickstream/clickstream-enwiki-2020-12.tsv.gz,A_Star_Is_Born_(2018_film),40033,314439,1417,355889,162336
hdfs://spark-nn.eemcs.utwente.nl/user/s1934538/clickstream/clickstream-enwiki-2020-12.tsv.gz,Stan_Lee,52192,214497,1200,267889,60114
hdfs://spark-nn.eemcs.utwente.nl/user/s1934538/clickstream/clickstream-enwiki-2020-12.tsv.gz,Article_370_of_the_Constitution_of_India,2995,53996,15,57006,3749
hdfs://spark-nn.eemcs.utwente.nl/user/s1934538/clickstream/clickstream-enwiki-2020-12.tsv.gz,Burt_Reynolds,50593,143935,1429,195957,87528
hdfs://spark-nn.eemcs.utwente.nl/user/s1934538/clickstream/clickstream-enwiki-2020-12.tsv.gz,Spider-Man:_Far_From_Home,97228,150343,3901,251472,157197
hdfs://spark-nn.eemcs.utwente.nl/user/s1934538/clickstream/clickstream-enwiki-2020-12.tsv.gz,George_VI,1137688,694601,4006,1836295,1358311
hdfs://spark-nn.eemcs.utwente.nl/user/s1934538/clickstream/clickstream-enwiki-2020-12.tsv.gz,NATO,47403,109174,2162,158739,60154
hdfs://spark-nn.eemcs.utwente.nl/user/s1934538/clickstream/clickstream-enwiki-2020-12.tsv.gz,Notre-Dame_de_Paris,13768,83661,3044,100473,25923
hdfs://spark-nn.eemcs.utwente.nl/user/s1934538/clickstream/clickstream-enwiki-2020-12.tsv.gz,Area_51,14284,151089,1218,166591,40600
hdfs://spark-nn.eemcs.utwente.nl/user/s1934538/clickstream/clickstream-enwiki-2020-12.tsv.gz,George_H._W._Bush,194659,168009,1494,364162,206374
hdfs://spark-nn.eemcs.utwente.nl/user/s1934538/clickstream/clickstream-enwiki-2020-12.tsv.gz,Coronavirus_disease_2019,234502,534337,6918,775757,270802
hdfs://spark-nn.eemcs.utwente.nl/user/s1934538/clickstream/clickstream-enwiki-2020-12.tsv.gz,Khabib_Nurmagomedov,73661,226838,2189,302688,150619
hdfs://spark-nn.eemcs.utwente.nl/user/s1934538/clickstream/clickstream-enwiki-2020-12.tsv.gz,The_Suicide_Squad_(film),130996,86837,1890,219723,202362
hdfs://spark-nn.eemcs.utwente.nl/user/s1934538/clickstream/clickstream-enwiki-2020-12.tsv.gz,2020_United_States_presidential_election,662764,1461703,59715,2184182,2046682
hdfs://spark-nn.eemcs.utwente.nl/user/s1934538/clickstream/clickstream-enwiki-2020-12.tsv.gz,Indian_Premier_League,14110,76249,84,90443,46171
hdfs://spark-nn.eemcs.utwente.nl/user/s1934538/clickstream/clickstream-enwiki-2020-12.tsv.gz,XXXTentacion,67721,489614,5291,562626,96877
hdfs://spark-nn.eemcs.utwente.nl/user/s1934538/clickstream/clickstream-enwiki-2020-12.tsv.gz,Elon_Musk,174342,1410574,11492,1596408,941945
hdfs://spark-nn.eemcs.utwente.nl/user/s1934538/clickstream/clickstream-enwiki-2020-12.tsv.gz,The_Batman_(film),103875,122818,4679,231372,193529
hdfs://spark-nn.eemcs.utwente.nl/user/s1934538/clickstream/clickstream-enwiki-2020-12.tsv.gz,The_Haunting_of_Bly_Manor,38586,238791,2118,279495,136689
hdfs://spark-nn.eemcs.utwente.nl/user/s1934538/clickstream/clickstream-enwiki-2020-12.tsv.gz,It_Chapter_Two,31075,63596,620,95291,58921
hdfs://spark-nn.eemcs.utwente.nl/user/s1934538/clickstream/clickstream-enwiki-2020-12.tsv.gz,Kobe_Bryant,63421,514597,6045,584063,151773
hdfs://spark-nn.eemcs.utwente.nl/user/s1934538/clickstream/clickstream-enwiki-2020-12.tsv.gz,1234,82,1557,18,1657,225
hdfs://spark-nn.eemcs.utwente.nl/user/s1934538/clickstream/clickstream-enwiki-2020-12.tsv.gz,Antifa_(United_States),19547,200086,1000,220633,39939
hdfs://spark-nn.eemcs.utwente.nl/user/s1934538/clickstream/clickstream-enwiki-2020-12.tsv.gz,"Citizenship_(Amendment)_Act,_2019",5967,50367,170,56504,6014
hdfs://spark-nn.eemcs.utwente.nl/user/s1934538/clickstream/clickstream-enwiki-2020-12.tsv.gz,Star_Wars:_The_Rise_of_Skywalker,178952,213281,4047,396280,217616
hdfs://spark-nn.eemcs.utwente.nl/user/s1934538/clickstream/clickstream-enwiki-2020-12.tsv.gz,Sylvester_Stallone,100731,327670,2064,430465,315869
hdfs://spark-nn.eemcs.utwente.nl/user/s1934538/clickstream/clickstream-enwiki-2020-12.tsv.gz,Hamas,22221,31117,551,53889,22967
hdfs://spark-nn.eemcs.utwente.nl/user/s1934538/clickstream/clickstream-enwiki-2020-12.tsv.gz,Stranger_Things,57873,254646,5300,317819,241431
hdfs://spark-nn.eemcs.utwente.nl/user/s1934538/clickstream/clickstream-enwiki-2020-12.tsv.gz,The_Weeknd,75598,278413,3466,357477,151771
hdfs://spark-nn.eemcs.utwente.nl/user/s1934538/clickstream/clickstream-enwiki-2020-12.tsv.gz,List_of_most_popular_websites,11129,70174,81,81384,30366
hdfs://spark-nn.eemcs.utwente.nl/user/s1934538/clickstream/clickstream-enwiki-2020-12.tsv.gz,Glass_(2019_film),69660,83566,541,153767,48580
hdfs://spark-nn.eemcs.utwente.nl/user/s1934538/clickstream/clickstream-enwiki-2020-12.tsv.gz,Tom_Brady,83535,366347,3454,453336,158387
hdfs://spark-nn.eemcs.utwente.nl/user/s1934538/clickstream/clickstream-enwiki-2020-12.tsv.gz,Juneteenth,3502,46754,177,50433,4054
hdfs://spark-nn.eemcs.utwente.nl/user/s1934538/clickstream/clickstream-enwiki-2020-12.tsv.gz,Bible,17449,3570051,1666,3589166,37539
hdfs://spark-nn.eemcs.utwente.nl/user/s1934538/clickstream/clickstream-enwiki-2020-12.tsv.gz,Loki_(TV_series),75968,157215,3675,236858,127741
hdfs://spark-nn.eemcs.utwente.nl/user/s1934538/clickstream/clickstream-enwiki-2020-12.tsv.gz,Salman_Rushdie,29362,86961,522,116845,50339
hdfs://spark-nn.eemcs.utwente.nl/user/s1934538/clickstream/clickstream-enwiki-2020-12.tsv.gz,Donald_Trump,411368,2593850,16401,3021619,821695
hdfs://spark-nn.eemcs.utwente.nl/user/s1934538/clickstream/clickstream-enwiki-2020-12.tsv.gz,Saaho,17762,59514,119,77395,27114
hdfs://spark-nn.eemcs.utwente.nl/user/s1934538/clickstream/clickstream-enwiki-2020-12.tsv.gz,No_Time_to_Die,151603,152234,2338,306175,201766
hdfs://spark-nn.eemcs.utwente.nl/user/s1934538/clickstream/clickstream-enwiki-2020-12.tsv.gz,1917_(2019_film),37809,294457,4480,336746,181862
hdfs://spark-nn.eemcs.utwente.nl/user/s1934538/clickstream/clickstream-enwiki-2020-12.tsv.gz,The_Nun_(2018_film),16167,59547,338,76052,44182
hdfs://spark-nn.eemcs.utwente.nl/user/s1934538/clickstream/clickstream-enwiki-2021-01.tsv.gz,Rami_Malek,123055,367831,1551,492437,208357
hdfs://spark-nn.eemcs.utwente.nl/user/s1934538/clickstream/clickstream-enwiki-2021-01.tsv.gz,Brett_Kavanaugh,51445,53252,279,104976,31497
hdfs://spark-nn.eemcs.utwente.nl/user/s1934538/clickstream/clickstream-enwiki-2021-01.tsv.gz,Grimes_(musician),493925,379902,2115,875942,204928
hdfs://spark-nn.eemcs.utwente.nl/user/s1934538/clickstream/clickstream-enwiki-2021-01.tsv.gz,Adele,25142,175455,2632,203229,67907
hdfs://spark-nn.eemcs.utwente.nl/user/s1934538/clickstream/clickstream-enwiki-2021-01.tsv.gz,1917_(2019_film),36010,236055,3511,275576,152831
hdfs://spark-nn.eemcs.utwente.nl/user/s1934538/clickstream/clickstream-enwiki-2021-01.tsv.gz,Afghanistan,56990,135374,2259,194623,107770
hdfs://spark-nn.eemcs.utwente.nl/user/s1934538/clickstream/clickstream-enwiki-2021-01.tsv.gz,Chernobyl_(miniseries),22357,138520,2049,162926,157206
hdfs://spark-nn.eemcs.utwente.nl/user/s1934538/clickstream/clickstream-enwiki-2021-01.tsv.gz,Cook's_Country,524,5057,49,5630,1442
hdfs://spark-nn.eemcs.utwente.nl/user/s1934538/clickstream/clickstream-enwiki-2021-01.tsv.gz,Naya_Rivera,70307,197298,1020,268625,103059
hdfs://spark-nn.eemcs.utwente.nl/user/s1934538/clickstream/clickstream-enwiki-2021-01.tsv.gz,War_(2019_film),21856,69576,111,91543,26326
hdfs://spark-nn.eemcs.utwente.nl/user/s1934538/clickstream/clickstream-enwiki-2021-01.tsv.gz,Tonya_Harding,34697,182729,774,218200,56604
hdfs://spark-nn.eemcs.utwente.nl/user/s1934538/clickstream/clickstream-enwiki-2021-01.tsv.gz,List_of_Marvel_Cinematic_Universe_films,123697,743475,1626,868798,401475
hdfs://spark-nn.eemcs.utwente.nl/user/s1934538/clickstream/clickstream-enwiki-2021-01.tsv.gz,"Princess_Margaret,_Countess_of_Snowdon",350894,1517039,8006,1875939,989057
hdfs://spark-nn.eemcs.utwente.nl/user/s1934538/clickstream/clickstream-enwiki-2021-01.tsv.gz,COVID-19_pandemic_by_country_and_territory,229558,722968,120404,1072930,680758
hdfs://spark-nn.eemcs.utwente.nl/user/s1934538/clickstream/clickstream-enwiki-2021-01.tsv.gz,"Diana,_Princess_of_Wales",339303,998211,8740,1346254,780032
hdfs://spark-nn.eemcs.utwente.nl/user/s1934538/clickstream/clickstream-enwiki-2021-01.tsv.gz,Mötley_Crüe,33050,107793,1284,142127,175907
hdfs://spark-nn.eemcs.utwente.nl/user/s1934538/clickstream/clickstream-enwiki-2021-01.tsv.gz,Greta_Thunberg,15224,346898,3157,365279,93815
hdfs://spark-nn.eemcs.utwente.nl/user/s1934538/clickstream/clickstream-enwiki-2021-01.tsv.gz,Lists_of_deaths_by_year,36254,690126,4618,730998,687679
hdfs://spark-nn.eemcs.utwente.nl/user/s1934538/clickstream/clickstream-enwiki-2021-01.tsv.gz,Kenosha_unrest_shooting,22078,158763,2018,182859,25469
hdfs://spark-nn.eemcs.utwente.nl/user/s1934538/clickstream/clickstream-enwiki-2021-01.tsv.gz,Deadpool_2,58114,104903,2430,165447,138893
hdfs://spark-nn.eemcs.utwente.nl/user/s1934538/clickstream/clickstream-enwiki-2021-01.tsv.gz,Jason_Momoa,91759,274125,1318,367202,143703
hdfs://spark-nn.eemcs.utwente.nl/user/s1934538/clickstream/clickstream-enwiki-2021-01.tsv.gz,Donald_Trump,1492828,5422263,144241,7059332,3441632
hdfs://spark-nn.eemcs.utwente.nl/user/s1934538/clickstream/clickstream-enwiki-2021-01.tsv.gz,Ruth_Bader_Ginsburg,53339,231608,2038,286985,110558
hdfs://spark-nn.eemcs.utwente.nl/user/s1934538/clickstream/clickstream-enwiki-2021-01.tsv.gz,Olivia_Newton-John,42937,163888,1428,208253,94717
hdfs://spark-nn.eemcs.utwente.nl/user/s1934538/clickstream/clickstream-enwiki-2021-01.tsv.gz,The_Suicide_Squad_(film),141100,88538,1641,231279,223592
hdfs://spark-nn.eemcs.utwente.nl/user/s1934538/clickstream/clickstream-enwiki-2021-01.tsv.gz,Rishi_Sunak,18813,82051,402,101266,45700
hdfs://spark-nn.eemcs.utwente.nl/user/s1934538/clickstream/clickstream-enwiki-2021-01.tsv.gz,Grover,1748,6738,67,8553,1858
hdfs://spark-nn.eemcs.utwente.nl/user/s1934538/clickstream/clickstream-enwiki-2021-01.tsv.gz,Bob_Saget,29234,47630,306,77170,12868
hdfs://spark-nn.eemcs.utwente.nl/user/s1934538/clickstream/clickstream-enwiki-2021-01.tsv.gz,DMX_(rapper),15698,56505,357,72560,31267
hdfs://spark-nn.eemcs.utwente.nl/user/s1934538/clickstream/clickstream-enwiki-2021-01.tsv.gz,Killing_of_George_Floyd,47554,107104,1311,155969,55397
hdfs://spark-nn.eemcs.utwente.nl/user/s1934538/clickstream/clickstream-enwiki-2021-01.tsv.gz,No_Time_to_Die,171930,181966,4059,357955,228904
hdfs://spark-nn.eemcs.utwente.nl/user/s1934538/clickstream/clickstream-enwiki-2021-01.tsv.gz,Michael_Jordan,100551,525846,5431,631828,219423
hdfs://spark-nn.eemcs.utwente.nl/user/s1934538/clickstream/clickstream-enwiki-2021-01.tsv.gz,Elliot_Page,118339,726144,5786,850269,311012
hdfs://spark-nn.eemcs.utwente.nl/user/s1934538/clickstream/clickstream-enwiki-2021-01.tsv.gz,Hyphen-minus,4583,7207455,7952127,15164165,877
hdfs://spark-nn.eemcs.utwente.nl/user/s1934538/clickstream/clickstream-enwiki-2021-01.tsv.gz,Microsoft_Office,9433,2230611,837,2240881,23560
hdfs://spark-nn.eemcs.utwente.nl/user/s1934538/clickstream/clickstream-enwiki-2021-01.tsv.gz,Croatia,44633,119657,1696,165986,59454
hdfs://spark-nn.eemcs.utwente.nl/user/s1934538/clickstream/clickstream-enwiki-2021-01.tsv.gz,JSON_Web_Token,810,26973,53,27836,1829
hdfs://spark-nn.eemcs.utwente.nl/user/s1934538/clickstream/clickstream-enwiki-2021-01.tsv.gz,William_Murdoch,757,1909,25,2691,439
hdfs://spark-nn.eemcs.utwente.nl/user/s1934538/clickstream/clickstream-enwiki-2021-01.tsv.gz,George_H._W._Bush,513126,376195,4362,893683,509255
hdfs://spark-nn.eemcs.utwente.nl/user/s1934538/clickstream/clickstream-enwiki-2021-01.tsv.gz,Wonder_Woman_1984,203187,1378350,30088,1611625,871671
hdfs://spark-nn.eemcs.utwente.nl/user/s1934538/clickstream/clickstream-enwiki-2021-01.tsv.gz,Saaho,19930,48437,158,68525,22992
hdfs://spark-nn.eemcs.utwente.nl/user/s1934538/clickstream/clickstream-enwiki-2021-01.tsv.gz,List_of_FIFA_World_Cup_finals,2653,48270,35,50958,15999
hdfs://spark-nn.eemcs.utwente.nl/user/s1934538/clickstream/clickstream-enwiki-2021-01.tsv.gz,Main_Page,15856,186346322,5161963,191524141,37521267
hdfs://spark-nn.eemcs.utwente.nl/user/s1934538/clickstream/clickstream-enwiki-2021-01.tsv.gz,The_Irishman,64062,171958,2552,238572,197296
hdfs://spark-nn.eemcs.utwente.nl/user/s1934538/clickstream/clickstream-enwiki-2021-01.tsv.gz,The_Sandman_(TV_series),12829,31429,303,44561,39827
hdfs://spark-nn.eemcs.utwente.nl/user/s1934538/clickstream/clickstream-enwiki-2021-01.tsv.gz,QAnon,322481,4472752,37256,4832489,1060507
hdfs://spark-nn.eemcs.utwente.nl/user/s1934538/clickstream/clickstream-enwiki-2021-01.tsv.gz,Vivek_Ramaswamy,562,9797,12,10371,2242
hdfs://spark-nn.eemcs.utwente.nl/user/s1934538/clickstream/clickstream-enwiki-2021-01.tsv.gz,When_They_See_Us,19278,64239,325,83842,39244
hdfs://spark-nn.eemcs.utwente.nl/user/s1934538/clickstream/clickstream-enwiki-2021-01.tsv.gz,Mulan_(2020_film),34709,257202,3552,295463,223216
hdfs://spark-nn.eemcs.utwente.nl/user/s1934538/clickstream/clickstream-enwiki-2021-01.tsv.gz,Black_Widow_(2021_film),134587,148857,3745,287189,140360
hdfs://spark-nn.eemcs.utwente.nl/user/s1934538/clickstream/clickstream-enwiki-2021-01.tsv.gz,Ray_Liotta,56150,86902,473,143525,48725
hdfs://spark-nn.eemcs.utwente.nl/user/s1934538/clickstream/clickstream-enwiki-2021-01.tsv.gz,Keanu_Reeves,107861,616347,3778,727986,422453
hdfs://spark-nn.eemcs.utwente.nl/user/s1934538/clickstream/clickstream-enwiki-2021-01.tsv.gz,Amy_Coney_Barrett,81913,91288,990,174191,60458
hdfs://spark-nn.eemcs.utwente.nl/user/s1934538/clickstream/clickstream-enwiki-2021-01.tsv.gz,Jenna_Ortega,35962,41116,1914,78992,16814
hdfs://spark-nn.eemcs.utwente.nl/user/s1934538/clickstream/clickstream-enwiki-2021-01.tsv.gz,Kim_Jong-un,71112,183520,2138,256770,138732
hdfs://spark-nn.eemcs.utwente.nl/user/s1934538/clickstream/clickstream-enwiki-2021-01.tsv.gz,Jeffrey_Epstein,51450,329342,3261,384053,162346
hdfs://spark-nn.eemcs.utwente.nl/user/s1934538/clickstream/clickstream-enwiki-2021-01.tsv.gz,Bird_Box_(film),22471,99004,967,122442,39642
hdfs://spark-nn.eemcs.utwente.nl/user/s1934538/clickstream/clickstream-enwiki-2021-01.tsv.gz,The_Falcon_and_the_Winter_Soldier,95108,124518,1040,220666,121321
hdfs://spark-nn.eemcs.utwente.nl/user/s1934538/clickstream/clickstream-enwiki-2021-01.tsv.gz,2016_United_States_presidential_election,402216,317371,2532,722119,556455
hdfs://spark-nn.eemcs.utwente.nl/user/s1934538/clickstream/clickstream-enwiki-2021-01.tsv.gz,Ghislaine_Maxwell,68109,142773,919,211801,70292
hdfs://spark-nn.eemcs.utwente.nl/user/s1934538/clickstream/clickstream-enwiki-2021-01.tsv.gz,Bipin_Rawat,9856,20990,55,30901,15073
hdfs://spark-nn.eemcs.utwente.nl/user/s1934538/clickstream/clickstream-enwiki-2021-01.tsv.gz,Area_51,14720,165790,1438,181948,42478
hdfs://spark-nn.eemcs.utwente.nl/user/s1934538/clickstream/clickstream-enwiki-2021-01.tsv.gz,Murder_of_Dee_Dee_Blanchard,25356,263954,724,290034,49376
hdfs://spark-nn.eemcs.utwente.nl/user/s1934538/clickstream/clickstream-enwiki-2021-01.tsv.gz,Coronavirus_disease_2019,188501,451692,39448,679641,239370
hdfs://spark-nn.eemcs.utwente.nl/user/s1934538/clickstream/clickstream-enwiki-2021-01.tsv.gz,Joe_Biden,1680316,5630494,112107,7422917,4578011
hdfs://spark-nn.eemcs.utwente.nl/user/s1934538/clickstream/clickstream-enwiki-2021-01.tsv.gz,HTTP_cookie,3618,491216,179,495013,26609
hdfs://spark-nn.eemcs.utwente.nl/user/s1934538/clickstream/clickstream-enwiki-2021-01.tsv.gz,Hamilton_(musical),55186,340737,2702,398625,290526
hdfs://spark-nn.eemcs.utwente.nl/user/s1934538/clickstream/clickstream-enwiki-2021-01.tsv.gz,"Meghan,_Duchess_of_Sussex",133058,252916,2037,388011,196991
hdfs://spark-nn.eemcs.utwente.nl/user/s1934538/clickstream/clickstream-enwiki-2021-01.tsv.gz,Charles_Sobhraj,372567,1512155,4782,1889504,288241
hdfs://spark-nn.eemcs.utwente.nl/user/s1934538/clickstream/clickstream-enwiki-2021-01.tsv.gz,Bonnie_and_Clyde,31699,311351,1825,344875,83984
hdfs://spark-nn.eemcs.utwente.nl/user/s1934538/clickstream/clickstream-enwiki-2021-01.tsv.gz,COVID-19_pandemic,516280,772247,6028,1294555,588199
hdfs://spark-nn.eemcs.utwente.nl/user/s1934538/clickstream/clickstream-enwiki-2021-01.tsv.gz,The_Haunting_of_Bly_Manor,32496,164195,1382,198073,97087
hdfs://spark-nn.eemcs.utwente.nl/user/s1934538/clickstream/clickstream-enwiki-2021-01.tsv.gz,RRR_(film),41143,120107,742,161992,86381
hdfs://spark-nn.eemcs.utwente.nl/user/s1934538/clickstream/clickstream-enwiki-2021-01.tsv.gz,XHamster,7891,156733,4595,169219,23834
hdfs://spark-nn.eemcs.utwente.nl/user/s1934538/clickstream/clickstream-enwiki-2021-01.tsv.gz,Jimmy_Buffett,8582,52930,681,62193,21065
hdfs://spark-nn.eemcs.utwente.nl/user/s1934538/clickstream/clickstream-enwiki-2021-01.tsv.gz,Game_of_Thrones,102080,366279,8095,476454,301578
hdfs://spark-nn.eemcs.utwente.nl/user/s1934538/clickstream/clickstream-enwiki-2021-01.tsv.gz,Mac_Miller,42693,296739,2190,341622,107129
hdfs://spark-nn.eemcs.utwente.nl/user/s1934538/clickstream/clickstream-enwiki-2021-01.tsv.gz,Antifa_(United_States),88899,1835584,6031,1930514,301351
hdfs://spark-nn.eemcs.utwente.nl/user/s1934538/clickstream/clickstream-enwiki-2021-01.tsv.gz,Johnny_Depp,148050,465883,2950,616883,452172
hdfs://spark-nn.eemcs.utwente.nl/user/s1934538/clickstream/clickstream-enwiki-2021-01.tsv.gz,2.0_(film),19242,35622,104,54968,15182
hdfs://spark-nn.eemcs.utwente.nl/user/s1934538/clickstream/clickstream-enwiki-2021-01.tsv.gz,A_Star_Is_Born_(2018_film),36521,188215,1083,225819,109835
hdfs://spark-nn.eemcs.utwente.nl/user/s1934538/clickstream/clickstream-enwiki-2021-01.tsv.gz,Shang-Chi_and_the_Legend_of_the_Ten_Rings,132857,49633,388,182878,139962
hdfs://spark-nn.eemcs.utwente.nl/user/s1934538/clickstream/clickstream-enwiki-2021-01.tsv.gz,Thor:_Love_and_Thunder,90997,23109,2150,116256,74537
hdfs://spark-nn.eemcs.utwente.nl/user/s1934538/clickstream/clickstream-enwiki-2021-01.tsv.gz,Christopher_Scarver,71798,22417,28,94243,35299
hdfs://spark-nn.eemcs.utwente.nl/user/s1934538/clickstream/clickstream-enwiki-2021-01.tsv.gz,Brie_Larson,96911,279123,2422,378456,141050
hdfs://spark-nn.eemcs.utwente.nl/user/s1934538/clickstream/clickstream-enwiki-2021-01.tsv.gz,Loki_(TV_series),71465,101635,1694,174794,72977
hdfs://spark-nn.eemcs.utwente.nl/user/s1934538/clickstream/clickstream-enwiki-2021-01.tsv.gz,2018_FIFA_World_Cup,64320,83998,906,149224,90142
hdfs://spark-nn.eemcs.utwente.nl/user/s1934538/clickstream/clickstream-enwiki-2021-01.tsv.gz,Article_370_of_the_Constitution_of_India,2954,50236,15,53205,3340
hdfs://spark-nn.eemcs.utwente.nl/user/s1934538/clickstream/clickstream-enwiki-2021-01.tsv.gz,1234,89,1521,15,1625,158
hdfs://spark-nn.eemcs.utwente.nl/user/s1934538/clickstream/clickstream-enwiki-2021-01.tsv.gz,Darth_Vader,59203,120990,1056,181249,125511
hdfs://spark-nn.eemcs.utwente.nl/user/s1934538/clickstream/clickstream-enwiki-2021-01.tsv.gz,Hamas,26280,28715,238,55233,22449
hdfs://spark-nn.eemcs.utwente.nl/user/s1934538/clickstream/clickstream-enwiki-2021-01.tsv.gz,Mortal_Kombat_(2021_film),68093,210463,3362,281918,401966
hdfs://spark-nn.eemcs.utwente.nl/user/s1934538/clickstream/clickstream-enwiki-2021-01.tsv.gz,Donald_Glover,60954,232723,1825,295502,107196
hdfs://spark-nn.eemcs.utwente.nl/user/s1934538/clickstream/clickstream-enwiki-2021-01.tsv.gz,Death_of_Elisa_Lam,90535,497137,1701,589373,145069
hdfs://spark-nn.eemcs.utwente.nl/user/s1934538/clickstream/clickstream-enwiki-2021-01.tsv.gz,Kobe_Bryant,78754,972530,11001,1062285,243007
hdfs://spark-nn.eemcs.utwente.nl/user/s1934538/clickstream/clickstream-enwiki-2021-01.tsv.gz,Dennis_Nilsen,25310,144938,769,171017,41978
hdfs://spark-nn.eemcs.utwente.nl/user/s1934538/clickstream/clickstream-enwiki-2021-01.tsv.gz,Stranger_Things,69769,279959,6316,356044,282032
hdfs://spark-nn.eemcs.utwente.nl/user/s1934538/clickstream/clickstream-enwiki-2021-01.tsv.gz,Sinéad_O'Connor,16996,130268,1046,148310,49274
hdfs://spark-nn.eemcs.utwente.nl/user/s1934538/clickstream/clickstream-enwiki-2021-01.tsv.gz,Alexander_Hamilton,145004,446367,3442,594813,316304
hdfs://spark-nn.eemcs.utwente.nl/user/s1934538/clickstream/clickstream-enwiki-2021-01.tsv.gz,Simple_Mail_Transfer_Protocol,4203,35014,134,39351,4197
hdfs://spark-nn.eemcs.utwente.nl/user/s1934538/clickstream/clickstream-enwiki-2021-01.tsv.gz,List_of_highest-grossing_Indian_films,54487,190005,1656,246148,149776
hdfs://spark-nn.eemcs.utwente.nl/user/s1934538/clickstream/clickstream-enwiki-2021-01.tsv.gz,Ted_Bundy,61433,575797,6907,644137,146065
hdfs://spark-nn.eemcs.utwente.nl/user/s1934538/clickstream/clickstream-enwiki-2021-01.tsv.gz,2020_Summer_Olympics,66724,135748,4509,206981,156644
hdfs://spark-nn.eemcs.utwente.nl/user/s1934538/clickstream/clickstream-enwiki-2021-01.tsv.gz,Manti_Te'o,8147,356962,1890,366999,34767
hdfs://spark-nn.eemcs.utwente.nl/user/s1934538/clickstream/clickstream-enwiki-2021-01.tsv.gz,Cecil_Hotel_(Los_Angeles),36789,358791,1049,396629,187094
hdfs://spark-nn.eemcs.utwente.nl/user/s1934538/clickstream/clickstream-enwiki-2021-01.tsv.gz,The_Nun_(2018_film),17225,55668,350,73243,41290
hdfs://spark-nn.eemcs.utwente.nl/user/s1934538/clickstream/clickstream-enwiki-2021-01.tsv.gz,Tasuku_Honjo,1451,1237664,116,1239231,38094
hdfs://spark-nn.eemcs.utwente.nl/user/s1934538/clickstream/clickstream-enwiki-2021-01.tsv.gz,Pelé,36141,201303,1690,239134,70792
hdfs://spark-nn.eemcs.utwente.nl/user/s1934538/clickstream/clickstream-enwiki-2021-01.tsv.gz,Star_Wars:_The_Rise_of_Skywalker,130851,151606,3177,285634,155686
hdfs://spark-nn.eemcs.utwente.nl/user/s1934538/clickstream/clickstream-enwiki-2021-01.tsv.gz,Burt_Reynolds,65327,205004,1584,271915,123926
hdfs://spark-nn.eemcs.utwente.nl/user/s1934538/clickstream/clickstream-enwiki-2021-01.tsv.gz,Central_Park_jogger_case,26661,90198,318,117177,16415
hdfs://spark-nn.eemcs.utwente.nl/user/s1934538/clickstream/clickstream-enwiki-2021-01.tsv.gz,Key_frame,797,6330,25,7152,492
hdfs://spark-nn.eemcs.utwente.nl/user/s1934538/clickstream/clickstream-enwiki-2021-01.tsv.gz,Rihanna,78085,290027,4344,372456,189166
hdfs://spark-nn.eemcs.utwente.nl/user/s1934538/clickstream/clickstream-enwiki-2021-01.tsv.gz,State_of_Palestine,45250,108501,147,153898,69468
hdfs://spark-nn.eemcs.utwente.nl/user/s1934538/clickstream/clickstream-enwiki-2021-01.tsv.gz,The_Lion_King_(2019_film),51265,105487,1252,158004,93972
hdfs://spark-nn.eemcs.utwente.nl/user/s1934538/clickstream/clickstream-enwiki-2021-01.tsv.gz,Amber_Heard,134845,230981,1683,367509,164138
hdfs://spark-nn.eemcs.utwente.nl/user/s1934538/clickstream/clickstream-enwiki-2021-01.tsv.gz,Eddie_Van_Halen,49456,133411,1687,184554,62683
hdfs://spark-nn.eemcs.utwente.nl/user/s1934538/clickstream/clickstream-enwiki-2021-01.tsv.gz,Roe_v._Wade,22723,101286,591,124600,38237
hdfs://spark-nn.eemcs.utwente.nl/user/s1934538/clickstream/clickstream-enwiki-2021-01.tsv.gz,Dark_Phoenix_(film),56368,72277,771,129416,78069
hdfs://spark-nn.eemcs.utwente.nl/user/s1934538/clickstream/clickstream-enwiki-2021-04.tsv.gz,2018_Winter_Olympics,23534,15814,281,39629,30690
hdfs://spark-nn.eemcs.utwente.nl/user/s1934538/clickstream/clickstream-enwiki-2021-04.tsv.gz,Game_of_Thrones_(season_8),29383,59395,1200,89978,37543
hdfs://spark-nn.eemcs.utwente.nl/user/s1934538/clickstream/clickstream-enwiki-2021-04.tsv.gz,Grover,1578,5991,48,7617,1864
hdfs://spark-nn.eemcs.utwente.nl/user/s1934538/clickstream/clickstream-enwiki-2021-04.tsv.gz,John_McCain,42276,91742,1114,135132,65880
hdfs://spark-nn.eemcs.utwente.nl/user/s1934538/clickstream/clickstream-enwiki-2021-04.tsv.gz,Burt_Reynolds,58049,164881,1533,224463,106971
hdfs://spark-nn.eemcs.utwente.nl/user/s1934538/clickstream/clickstream-enwiki-2021-04.tsv.gz,Tasuku_Honjo,1496,1216891,251,1218638,34679
hdfs://spark-nn.eemcs.utwente.nl/user/s1934538/clickstream/clickstream-enwiki-2021-04.tsv.gz,2020_Summer_Olympics,92061,222611,10301,324973,343525
hdfs://spark-nn.eemcs.utwente.nl/user/s1934538/clickstream/clickstream-enwiki-2021-04.tsv.gz,HTTP_cookie,3694,408210,149,412053,31521
hdfs://spark-nn.eemcs.utwente.nl/user/s1934538/clickstream/clickstream-enwiki-2021-04.tsv.gz,The_Batman_(film),124540,127839,2752,255131,202891
hdfs://spark-nn.eemcs.utwente.nl/user/s1934538/clickstream/clickstream-enwiki-2021-04.tsv.gz,Mortal_Kombat_(2021_film),357688,3701635,79490,4138813,3990774
hdfs://spark-nn.eemcs.utwente.nl/user/s1934538/clickstream/clickstream-enwiki-2021-04.tsv.gz,Doctor_Strange_in_the_Multiverse_of_Madness,167823,106069,842,274734,164661
hdfs://spark-nn.eemcs.utwente.nl/user/s1934538/clickstream/clickstream-enwiki-2021-04.tsv.gz,JSON_Web_Token,907,25939,29,26875,2233
hdfs://spark-nn.eemcs.utwente.nl/user/s1934538/clickstream/clickstream-enwiki-2021-04.tsv.gz,The_Suicide_Squad_(film),199743,268736,6352,474831,483575
hdfs://spark-nn.eemcs.utwente.nl/user/s1934538/clickstream/clickstream-enwiki-2021-04.tsv.gz,Cristiano_Ronaldo,114789,644431,4879,764099,192946
hdfs://spark-nn.eemcs.utwente.nl/user/s1934538/clickstream/clickstream-enwiki-2021-04.tsv.gz,Gaza_Strip,21277,38794,200,60271,25629
hdfs://spark-nn.eemcs.utwente.nl/user/s1934538/clickstream/clickstream-enwiki-2021-04.tsv.gz,Thor:_Love_and_Thunder,245348,144159,1728,391235,336217
hdfs://spark-nn.eemcs.utwente.nl/user/s1934538/clickstream/clickstream-enwiki-2021-04.tsv.gz,Luke_Perry,38875,144603,705,184183,62426
hdfs://spark-nn.eemcs.utwente.nl/user/s1934538/clickstream/clickstream-enwiki-2021-04.tsv.gz,Cleopatra,58405,2798034,2454,2858893,254943
hdfs://spark-nn.eemcs.utwente.nl/user/s1934538/clickstream/clickstream-enwiki-2021-04.tsv.gz,Naomi_Osaka,20556,92736,495,113787,29684
hdfs://spark-nn.eemcs.utwente.nl/user/s1934538/clickstream/clickstream-enwiki-2021-04.tsv.gz,Indian_Premier_League,75040,552785,1072,628897,360714
hdfs://spark-nn.eemcs.utwente.nl/user/s1934538/clickstream/clickstream-enwiki-2021-04.tsv.gz,Bob_Saget,22019,45456,313,67788,13673
hdfs://spark-nn.eemcs.utwente.nl/user/s1934538/clickstream/clickstream-enwiki-2021-04.tsv.gz,Mac_Miller,32036,190013,1618,223667,67269
hdfs://spark-nn.eemcs.utwente.nl/user/s1934538/clickstream/clickstream-enwiki-2021-04.tsv.gz,Lisa_Marie_Presley,132197,67242,266,199705,107309
hdfs://spark-nn.eemcs.utwente.nl/user/s1934538/clickstream/clickstream-enwiki-2021-04.tsv.gz,List_of_most_popular_websites,9850,38266,136,48252,19666
hdfs://spark-nn.eemcs.utwente.nl/user/s1934538/clickstream/clickstream-enwiki-2021-04.tsv.gz,UEFA_Euro_2020,70716,310767,6463,387946,158948
hdfs://spark-nn.eemcs.utwente.nl/user/s1934538/clickstream/clickstream-enwiki-2021-04.tsv.gz,Aquaman_(film),61819,154625,2615,219059,132007
hdfs://spark-nn.eemcs.utwente.nl/user/s1934538/clickstream/clickstream-enwiki-2021-04.tsv.gz,Asia_Cup,1764,36292,146,38202,16945
hdfs://spark-nn.eemcs.utwente.nl/user/s1934538/clickstream/clickstream-enwiki-2021-04.tsv.gz,The_Umbrella_Academy_(TV_series),35951,141882,2900,180733,104860
hdfs://spark-nn.eemcs.utwente.nl/user/s1934538/clickstream/clickstream-enwiki-2021-04.tsv.gz,"Prince_Philip,_Duke_of_Edinburgh",1539048,7987881,263614,9790543,6464235
hdfs://spark-nn.eemcs.utwente.nl/user/s1934538/clickstream/clickstream-enwiki-2021-04.tsv.gz,1234,98,1665,13,1776,233
hdfs://spark-nn.eemcs.utwente.nl/user/s1934538/clickstream/clickstream-enwiki-2021-04.tsv.gz,IPv4,12137,42116,229,54482,10907
hdfs://spark-nn.eemcs.utwente.nl/user/s1934538/clickstream/clickstream-enwiki-2021-04.tsv.gz,Richard_Jewell,17104,83693,431,101228,35659
hdfs://spark-nn.eemcs.utwente.nl/user/s1934538/clickstream/clickstream-enwiki-2021-04.tsv.gz,Betty_White,65599,309367,4407,379373,119418
hdfs://spark-nn.eemcs.utwente.nl/user/s1934538/clickstream/clickstream-enwiki-2021-04.tsv.gz,Kate_Spade,25090,59227,295,84612,29114
hdfs://spark-nn.eemcs.utwente.nl/user/s1934538/clickstream/clickstream-enwiki-2021-04.tsv.gz,List_of_highest-grossing_films,144100,267422,1590,413112,218027
hdfs://spark-nn.eemcs.utwente.nl/user/s1934538/clickstream/clickstream-enwiki-2021-04.tsv.gz,COVID-19_pandemic_by_country_and_territory,247197,553523,10934,811654,506894
hdfs://spark-nn.eemcs.utwente.nl/user/s1934538/clickstream/clickstream-enwiki-2021-04.tsv.gz,Anthony_Bourdain,21651,235843,2198,259692,86685
hdfs://spark-nn.eemcs.utwente.nl/user/s1934538/clickstream/clickstream-enwiki-2021-04.tsv.gz,Army_of_the_Dead,132194,303887,6687,442768,332614
hdfs://spark-nn.eemcs.utwente.nl/user/s1934538/clickstream/clickstream-enwiki-2021-04.tsv.gz,21_Savage,16996,51812,983,69791,25838
hdfs://spark-nn.eemcs.utwente.nl/user/s1934538/clickstream/clickstream-enwiki-2021-04.tsv.gz,Joker_(2019_film),66315,218929,3504,288748,135914
hdfs://spark-nn.eemcs.utwente.nl/user/s1934538/clickstream/clickstream-enwiki-2021-04.tsv.gz,Kamala_Harris,175193,348775,3938,527906,257393
hdfs://spark-nn.eemcs.utwente.nl/user/s1934538/clickstream/clickstream-enwiki-2021-04.tsv.gz,2020_United_States_presidential_election,259346,414066,11791,685203,682747
hdfs://spark-nn.eemcs.utwente.nl/user/s1934538/clickstream/clickstream-enwiki-2021-04.tsv.gz,Khabib_Nurmagomedov,89288,271347,4280,364915,203482
hdfs://spark-nn.eemcs.utwente.nl/user/s1934538/clickstream/clickstream-enwiki-2021-04.tsv.gz,Zack_Snyder's_Justice_League,260223,993326,12785,1266334,718646
hdfs://spark-nn.eemcs.utwente.nl/user/s1934538/clickstream/clickstream-enwiki-2021-04.tsv.gz,Simple_Mail_Transfer_Protocol,3919,33175,143,37237,4196
hdfs://spark-nn.eemcs.utwente.nl/user/s1934538/clickstream/clickstream-enwiki-2021-04.tsv.gz,Microsoft_Office,8799,2749602,817,2759218,20355
hdfs://spark-nn.eemcs.utwente.nl/user/s1934538/clickstream/clickstream-enwiki-2021-04.tsv.gz,List_of_highest-grossing_Indian_films,56487,147205,20627,224319,132576
hdfs://spark-nn.eemcs.utwente.nl/user/s1934538/clickstream/clickstream-enwiki-2021-04.tsv.gz,WandaVision,112857,560299,11197,684353,369898
hdfs://spark-nn.eemcs.utwente.nl/user/s1934538/clickstream/clickstream-enwiki-2021-04.tsv.gz,Elizabeth_II,2586654,4833448,35523,7455625,5730745
hdfs://spark-nn.eemcs.utwente.nl/user/s1934538/clickstream/clickstream-enwiki-2021-04.tsv.gz,Juneteenth,4749,126978,384,132111,8667
hdfs://spark-nn.eemcs.utwente.nl/user/s1934538/clickstream/clickstream-enwiki-2021-04.tsv.gz,Star_Wars:_The_Rise_of_Skywalker,77982,70651,1857,150490,78955
hdfs://spark-nn.eemcs.utwente.nl/user/s1934538/clickstream/clickstream-enwiki-2021-04.tsv.gz,Antifa_(United_States),16282,91689,560,108531,23310
hdfs://spark-nn.eemcs.utwente.nl/user/s1934538/clickstream/clickstream-enwiki-2021-04.tsv.gz,Crazy_Rich_Asians_(film),39354,128700,1730,169784,156386
hdfs://spark-nn.eemcs.utwente.nl/user/s1934538/clickstream/clickstream-enwiki-2021-04.tsv.gz,Stranger_Things,89287,269676,6129,365092,294356
hdfs://spark-nn.eemcs.utwente.nl/user/s1934538/clickstream/clickstream-enwiki-2021-04.tsv.gz,Media,47,3729,365,4141,1838
hdfs://spark-nn.eemcs.utwente.nl/user/s1934538/clickstream/clickstream-enwiki-2021-04.tsv.gz,George_VI,1798482,805815,3748,2608045,1997706
hdfs://spark-nn.eemcs.utwente.nl/user/s1934538/clickstream/clickstream-enwiki-2021-04.tsv.gz,Hyphen-minus,2962,6744869,4172011,10919842,856
hdfs://spark-nn.eemcs.utwente.nl/user/s1934538/clickstream/clickstream-enwiki-2021-04.tsv.gz,Joe_Exotic,30632,247914,2255,280801,71023
hdfs://spark-nn.eemcs.utwente.nl/user/s1934538/clickstream/clickstream-enwiki-2021-04.tsv.gz,Game_of_Thrones,98906,418141,12696,529743,383741
hdfs://spark-nn.eemcs.utwente.nl/user/s1934538/clickstream/clickstream-enwiki-2021-04.tsv.gz,David_Beckham,49952,227309,1665,278926,108496
hdfs://spark-nn.eemcs.utwente.nl/user/s1934538/clickstream/clickstream-enwiki-2021-04.tsv.gz,Henry_V_of_England,116331,106647,644,223622,170509
hdfs://spark-nn.eemcs.utwente.nl/user/s1934538/clickstream/clickstream-enwiki-2021-04.tsv.gz,Don't_Look_Up_(2021_film),109127,37893,1135,148155,63198
hdfs://spark-nn.eemcs.utwente.nl/user/s1934538/clickstream/clickstream-enwiki-2021-04.tsv.gz,Jenna_Ortega,37131,81568,1486,120185,27430
hdfs://spark-nn.eemcs.utwente.nl/user/s1934538/clickstream/clickstream-enwiki-2021-04.tsv.gz,Aaron_Hernandez,10655,149203,1578,161436,54241
hdfs://spark-nn.eemcs.utwente.nl/user/s1934538/clickstream/clickstream-enwiki-2021-04.tsv.gz,The_Witcher_(TV_series),46510,195586,4458,246554,140695
hdfs://spark-nn.eemcs.utwente.nl/user/s1934538/clickstream/clickstream-enwiki-2021-04.tsv.gz,Loki_(TV_series),109885,275761,5868,391514,231459
hdfs://spark-nn.eemcs.utwente.nl/user/s1934538/clickstream/clickstream-enwiki-2021-04.tsv.gz,Grimes_(musician),158441,210883,890,370214,131541
hdfs://spark-nn.eemcs.utwente.nl/user/s1934538/clickstream/clickstream-enwiki-2021-04.tsv.gz,Charles_Sobhraj,694687,3415796,6674,4117157,748098
hdfs://spark-nn.eemcs.utwente.nl/user/s1934538/clickstream/clickstream-enwiki-2021-04.tsv.gz,Greta_Thunberg,13190,420714,4156,438060,117994
hdfs://spark-nn.eemcs.utwente.nl/user/s1934538/clickstream/clickstream-enwiki-2021-04.tsv.gz,List_of_James_Bond_films,64522,393944,763,459229,271227
hdfs://spark-nn.eemcs.utwente.nl/user/s1934538/clickstream/clickstream-enwiki-2021-04.tsv.gz,Tonya_Harding,37322,166334,1127,204783,55444
hdfs://spark-nn.eemcs.utwente.nl/user/s1934538/clickstream/clickstream-enwiki-2021-04.tsv.gz,2022_FIFA_World_Cup,72883,128179,2778,203840,121836
hdfs://spark-nn.eemcs.utwente.nl/user/s1934538/clickstream/clickstream-enwiki-2021-04.tsv.gz,XHamster,6769,158447,5170,170386,22722
hdfs://spark-nn.eemcs.utwente.nl/user/s1934538/clickstream/clickstream-enwiki-2021-04.tsv.gz,Fyre_Festival,18412,126805,1056,146273,86989
hdfs://spark-nn.eemcs.utwente.nl/user/s1934538/clickstream/clickstream-enwiki-2021-04.tsv.gz,NATO,65765,181697,3465,250927,100667
hdfs://spark-nn.eemcs.utwente.nl/user/s1934538/clickstream/clickstream-enwiki-2021-04.tsv.gz,Priyanka_Chopra,130347,289419,2374,422140,152603
hdfs://spark-nn.eemcs.utwente.nl/user/s1934538/clickstream/clickstream-enwiki-2021-04.tsv.gz,List_of_awards_and_nominations_received_by_Meryl_Streep,34195,20185,285,54665,19928
hdfs://spark-nn.eemcs.utwente.nl/user/s1934538/clickstream/clickstream-enwiki-2021-04.tsv.gz,Michael_Bloomberg,33328,36856,219,70403,32105
hdfs://spark-nn.eemcs.utwente.nl/user/s1934538/clickstream/clickstream-enwiki-2021-04.tsv.gz,Black_Adam_(film),72600,22469,692,95761,82323
hdfs://spark-nn.eemcs.utwente.nl/user/s1934538/clickstream/clickstream-enwiki-2021-04.tsv.gz,It_Chapter_Two,34562,58846,624,94032,63798
hdfs://spark-nn.eemcs.utwente.nl/user/s1934538/clickstream/clickstream-enwiki-2021-04.tsv.gz,Lists_of_deaths_by_year,8560,243583,766,252909,284038
hdfs://spark-nn.eemcs.utwente.nl/user/s1934538/clickstream/clickstream-enwiki-2021-04.tsv.gz,Donald_Trump,296882,629737,12489,939108,471828
hdfs://spark-nn.eemcs.utwente.nl/user/s1934538/clickstream/clickstream-enwiki-2021-04.tsv.gz,Shang-Chi_and_the_Legend_of_the_Ten_Rings,350576,509877,9401,869854,824153
hdfs://spark-nn.eemcs.utwente.nl/user/s1934538/clickstream/clickstream-enwiki-2021-04.tsv.gz,September_11_attacks,104841,296343,3567,404751,214110
hdfs://spark-nn.eemcs.utwente.nl/user/s1934538/clickstream/clickstream-enwiki-2021-04.tsv.gz,The_Falcon_and_the_Winter_Soldier,421012,3131495,108743,3661250,2310422
hdfs://spark-nn.eemcs.utwente.nl/user/s1934538/clickstream/clickstream-enwiki-2021-04.tsv.gz,COVID-19_pandemic,512735,657334,4032,1174101,622505
hdfs://spark-nn.eemcs.utwente.nl/user/s1934538/clickstream/clickstream-enwiki-2021-04.tsv.gz,Avengers:_Infinity_War,89591,124118,2265,215974,133278
hdfs://spark-nn.eemcs.utwente.nl/user/s1934538/clickstream/clickstream-enwiki-2021-04.tsv.gz,Ukraine,77283,285420,7669,370372,188239
hdfs://spark-nn.eemcs.utwente.nl/user/s1934538/clickstream/clickstream-enwiki-2021-04.tsv.gz,Meat_Loaf,51954,170588,2462,225004,98916
hdfs://spark-nn.eemcs.utwente.nl/user/s1934538/clickstream/clickstream-enwiki-2021-04.tsv.gz,Amber_Heard,145566,255911,1553,403030,178281
hdfs://spark-nn.eemcs.utwente.nl/user/s1934538/clickstream/clickstream-enwiki-2021-04.tsv.gz,Venom_(2018_film),31735,122267,1710,155712,87718
hdfs://spark-nn.eemcs.utwente.nl/user/s1934538/clickstream/clickstream-enwiki-2021-04.tsv.gz,2023_Cricket_World_Cup,15049,31764,67,46880,15910
hdfs://spark-nn.eemcs.utwente.nl/user/s1934538/clickstream/clickstream-enwiki-2021-04.tsv.gz,Puneeth_Rajkumar,37890,111641,670,150201,120349
hdfs://spark-nn.eemcs.utwente.nl/user/s1934538/clickstream/clickstream-enwiki-2021-04.tsv.gz,Eternals_(film),361853,218976,1637,582466,550532
hdfs://spark-nn.eemcs.utwente.nl/user/s1934538/clickstream/clickstream-enwiki-2021-04.tsv.gz,Adipurush,36320,15556,35,51911,33329
hdfs://spark-nn.eemcs.utwente.nl/user/s1934538/clickstream/clickstream-enwiki-2021-04.tsv.gz,United_States_Senate,67371,67239,873,135483,69530
hdfs://spark-nn.eemcs.utwente.nl/user/s1934538/clickstream/clickstream-enwiki-2021-04.tsv.gz,Spider-Man:_Far_From_Home,84381,113306,1832,199519,116282
hdfs://spark-nn.eemcs.utwente.nl/user/s1934538/clickstream/clickstream-enwiki-2021-04.tsv.gz,Donald_Glover,50923,174018,1254,226195,95801
hdfs://spark-nn.eemcs.utwente.nl/user/s1934538/clickstream/clickstream-enwiki-2021-04.tsv.gz,Kim_Jong-un,69289,157505,1880,228674,126467
hdfs://spark-nn.eemcs.utwente.nl/user/s1934538/clickstream/clickstream-enwiki-2021-04.tsv.gz,The_Flash_(film),52335,26151,1429,79915,67259
hdfs://spark-nn.eemcs.utwente.nl/user/s1934538/clickstream/clickstream-enwiki-2021-04.tsv.gz,Simone_Biles,13797,94277,824,108898,35598
hdfs://spark-nn.eemcs.utwente.nl/user/s1934538/clickstream/clickstream-enwiki-2021-04.tsv.gz,Chadwick_Boseman,149778,691442,22432,863652,264209
hdfs://spark-nn.eemcs.utwente.nl/user/s1934538/clickstream/clickstream-enwiki-2021-04.tsv.gz,Dune_(2021_film),87481,160764,2949,251194,165869
hdfs://spark-nn.eemcs.utwente.nl/user/s1934538/clickstream/clickstream-enwiki-2021-04.tsv.gz,Rihanna,72780,235887,3638,312305,161946
hdfs://spark-nn.eemcs.utwente.nl/user/s1934538/clickstream/clickstream-enwiki-2021-04.tsv.gz,A_Star_Is_Born_(2018_film),37477,199648,1428,238553,122368
hdfs://spark-nn.eemcs.utwente.nl/user/s1934538/clickstream/clickstream-enwiki-2021-04.tsv.gz,Jeffrey_Dahmer,31538,327899,4474,363911,151686
hdfs://spark-nn.eemcs.utwente.nl/user/s1934538/clickstream/clickstream-enwiki-2021-04.tsv.gz,Qasem_Soleimani,13796,30360,152,44308,21311
hdfs://spark-nn.eemcs.utwente.nl/user/s1934538/clickstream/clickstream-enwiki-2021-04.tsv.gz,Murder_of_Dee_Dee_Blanchard,24196,185611,605,210412,36821
hdfs://spark-nn.eemcs.utwente.nl/user/s1934538/clickstream/clickstream-enwiki-2021-04.tsv.gz,Darth_Vader,28679,60411,741,89831,52593
hdfs://spark-nn.eemcs.utwente.nl/user/s1934538/clickstream/clickstream-enwiki-2021-04.tsv.gz,Wonder_Woman_1984,82629,332116,7357,422102,217940
hdfs://spark-nn.eemcs.utwente.nl/user/s1934538/clickstream/clickstream-enwiki-2021-04.tsv.gz,The_Nun_(2018_film),36924,78399,568,115891,70915
hdfs://spark-nn.eemcs.utwente.nl/user/s1934538/clickstream/clickstream-enwiki-2021-04.tsv.gz,Stan_Lee,64064,155150,1421,220635,75885
hdfs://spark-nn.eemcs.utwente.nl/user/s1934538/clickstream/clickstream-enwiki-2021-04.tsv.gz,"Princess_Margaret,_Countess_of_Snowdon",720722,1543957,9397,2274076,1326556
hdfs://spark-nn.eemcs.utwente.nl/user/s1934538/clickstream/clickstream-enwiki-2021-04.tsv.gz,Brett_Kavanaugh,23108,35721,211,59040,18461
hdfs://spark-nn.eemcs.utwente.nl/user/s1934538/clickstream/clickstream-enwiki-2021-04.tsv.gz,Cardi_B,48453,261897,5038,315388,114646
hdfs://spark-nn.eemcs.utwente.nl/user/s1934538/clickstream/clickstream-enwiki-2021-04.tsv.gz,Eddie_Van_Halen,39627,77915,1000,118542,45719
hdfs://spark-nn.eemcs.utwente.nl/user/s1934538/clickstream/clickstream-enwiki-2021-04.tsv.gz,Chernobyl_(miniseries),34344,166884,3972,205200,212048
hdfs://spark-nn.eemcs.utwente.nl/user/s1934538/clickstream/clickstream-enwiki-2021-04.tsv.gz,Croatia,46658,124822,2045,173525,65523
hdfs://spark-nn.eemcs.utwente.nl/user/s1934538/clickstream/clickstream-enwiki-2021-04.tsv.gz,Freddie_Mercury,116135,754759,6183,877077,320696
hdfs://spark-nn.eemcs.utwente.nl/user/s1934538/clickstream/clickstream-enwiki-2022-06.tsv.gz,Jeffrey_Dahmer,27721,246739,3057,277517,132693
hdfs://spark-nn.eemcs.utwente.nl/user/s1934538/clickstream/clickstream-enwiki-2022-06.tsv.gz,Kenosha_unrest_shooting,7299,209455,1002,217756,30426
hdfs://spark-nn.eemcs.utwente.nl/user/s1934538/clickstream/clickstream-enwiki-2022-06.tsv.gz,XXXTentacion,98699,834739,7336,940774,153313
hdfs://spark-nn.eemcs.utwente.nl/user/s1934538/clickstream/clickstream-enwiki-2022-06.tsv.gz,Queen_(band),96244,381496,4339,482079,474376
hdfs://spark-nn.eemcs.utwente.nl/user/s1934538/clickstream/clickstream-enwiki-2022-06.tsv.gz,Brett_Kavanaugh,96967,159807,1298,258072,87189
hdfs://spark-nn.eemcs.utwente.nl/user/s1934538/clickstream/clickstream-enwiki-2022-06.tsv.gz,Ukraine,119420,443774,13808,577002,295875
hdfs://spark-nn.eemcs.utwente.nl/user/s1934538/clickstream/clickstream-enwiki-2022-06.tsv.gz,The_Haunting_of_Bly_Manor,21103,44811,394,66308,34028
hdfs://spark-nn.eemcs.utwente.nl/user/s1934538/clickstream/clickstream-enwiki-2022-06.tsv.gz,Godzilla_vs._Kong,53280,61709,1239,116228,58134
hdfs://spark-nn.eemcs.utwente.nl/user/s1934538/clickstream/clickstream-enwiki-2022-06.tsv.gz,Mac_Miller,21662,126077,1245,148984,49463
hdfs://spark-nn.eemcs.utwente.nl/user/s1934538/clickstream/clickstream-enwiki-2022-06.tsv.gz,IPv4,10184,37041,137,47362,8741
hdfs://spark-nn.eemcs.utwente.nl/user/s1934538/clickstream/clickstream-enwiki-2022-06.tsv.gz,Deadpool_2,57309,45360,1236,103905,69578
hdfs://spark-nn.eemcs.utwente.nl/user/s1934538/clickstream/clickstream-enwiki-2022-06.tsv.gz,Cardi_B,35134,179532,2693,217359,69946
hdfs://spark-nn.eemcs.utwente.nl/user/s1934538/clickstream/clickstream-enwiki-2022-06.tsv.gz,Us_(2019_film),33612,55724,353,89689,31454
hdfs://spark-nn.eemcs.utwente.nl/user/s1934538/clickstream/clickstream-enwiki-2022-06.tsv.gz,Emma_Raducanu,30225,464085,4199,498509,84319
hdfs://spark-nn.eemcs.utwente.nl/user/s1934538/clickstream/clickstream-enwiki-2022-06.tsv.gz,Eddie_Van_Halen,46204,102341,1077,149622,57964
hdfs://spark-nn.eemcs.utwente.nl/user/s1934538/clickstream/clickstream-enwiki-2022-06.tsv.gz,Kobe_Bryant_sexual_assault_case,11038,33867,48,44953,4582
hdfs://spark-nn.eemcs.utwente.nl/user/s1934538/clickstream/clickstream-enwiki-2022-06.tsv.gz,Deion_Sanders,8528,63267,416,72211,20726
hdfs://spark-nn.eemcs.utwente.nl/user/s1934538/clickstream/clickstream-enwiki-2022-06.tsv.gz,Royal_Rumble_(2018),5444,3542,60,9046,6518
hdfs://spark-nn.eemcs.utwente.nl/user/s1934538/clickstream/clickstream-enwiki-2022-06.tsv.gz,"Prince_Philip,_Duke_of_Edinburgh",315181,304672,2561,622414,351763
hdfs://spark-nn.eemcs.utwente.nl/user/s1934538/clickstream/clickstream-enwiki-2022-06.tsv.gz,Deaths_in_2022,1353263,2260104,14817,3628184,2056771
hdfs://spark-nn.eemcs.utwente.nl/user/s1934538/clickstream/clickstream-enwiki-2022-06.tsv.gz,Fantastic_Beasts:_The_Crimes_of_Grindelwald,166011,166046,3312,335369,167352
hdfs://spark-nn.eemcs.utwente.nl/user/s1934538/clickstream/clickstream-enwiki-2022-06.tsv.gz,Murder_of_Dee_Dee_Blanchard,14441,89386,388,104215,24446
hdfs://spark-nn.eemcs.utwente.nl/user/s1934538/clickstream/clickstream-enwiki-2022-06.tsv.gz,Sridevi,30334,58479,185,88998,44074
hdfs://spark-nn.eemcs.utwente.nl/user/s1934538/clickstream/clickstream-enwiki-2022-06.tsv.gz,List_of_Marvel_Cinematic_Universe_films,260623,676248,3118,939989,564793
hdfs://spark-nn.eemcs.utwente.nl/user/s1934538/clickstream/clickstream-enwiki-2022-06.tsv.gz,Simple_Mail_Transfer_Protocol,2796,33628,103,36527,2907
hdfs://spark-nn.eemcs.utwente.nl/user/s1934538/clickstream/clickstream-enwiki-2022-06.tsv.gz,The_Flash_(film),126465,84581,3732,214778,129454
hdfs://spark-nn.eemcs.utwente.nl/user/s1934538/clickstream/clickstream-enwiki-2022-06.tsv.gz,Glass_(2019_film),37424,65051,702,103177,35378
hdfs://spark-nn.eemcs.utwente.nl/user/s1934538/clickstream/clickstream-enwiki-2022-06.tsv.gz,Squid_Game,24725,247583,5859,278167,135347
hdfs://spark-nn.eemcs.utwente.nl/user/s1934538/clickstream/clickstream-enwiki-2022-06.tsv.gz,Croatia,49214,190553,2329,242096,78666
hdfs://spark-nn.eemcs.utwente.nl/user/s1934538/clickstream/clickstream-enwiki-2022-06.tsv.gz,George_VI,621994,290907,1530,914431,643453
hdfs://spark-nn.eemcs.utwente.nl/user/s1934538/clickstream/clickstream-enwiki-2022-06.tsv.gz,Coronavirus,4435,44872,1012,50319,14894
hdfs://spark-nn.eemcs.utwente.nl/user/s1934538/clickstream/clickstream-enwiki-2022-06.tsv.gz,Cecil_Hotel_(Los_Angeles),8632,81061,166,89859,22743
hdfs://spark-nn.eemcs.utwente.nl/user/s1934538/clickstream/clickstream-enwiki-2022-06.tsv.gz,Dennis_Nilsen,7260,41670,314,49244,12514
hdfs://spark-nn.eemcs.utwente.nl/user/s1934538/clickstream/clickstream-enwiki-2022-06.tsv.gz,Luke_Perry,40559,120342,848,161749,60312
hdfs://spark-nn.eemcs.utwente.nl/user/s1934538/clickstream/clickstream-enwiki-2022-06.tsv.gz,XXX:_Return_of_Xander_Cage,55689,1052522,1191,1109402,108596
hdfs://spark-nn.eemcs.utwente.nl/user/s1934538/clickstream/clickstream-enwiki-2022-06.tsv.gz,The_Suicide_Squad_(film),70524,71658,1276,143458,89284
hdfs://spark-nn.eemcs.utwente.nl/user/s1934538/clickstream/clickstream-enwiki-2022-06.tsv.gz,Parasite_(2019_film),27190,114660,1093,142943,57894
hdfs://spark-nn.eemcs.utwente.nl/user/s1934538/clickstream/clickstream-enwiki-2022-06.tsv.gz,List_of_highest-grossing_Indian_films,175576,820269,12531,1008376,459901
hdfs://spark-nn.eemcs.utwente.nl/user/s1934538/clickstream/clickstream-enwiki-2022-06.tsv.gz,Elizabeth_II,772765,1801195,85921,2659881,1915176
hdfs://spark-nn.eemcs.utwente.nl/user/s1934538/clickstream/clickstream-enwiki-2022-06.tsv.gz,Naomi_Osaka,26114,72213,560,98887,28135
hdfs://spark-nn.eemcs.utwente.nl/user/s1934538/clickstream/clickstream-enwiki-2022-06.tsv.gz,Atal_Bihari_Vajpayee,33481,51577,112,85170,29073
hdfs://spark-nn.eemcs.utwente.nl/user/s1934538/clickstream/clickstream-enwiki-2022-06.tsv.gz,Guardians_of_the_Galaxy_Vol._3,95661,44451,573,140685,100208
hdfs://spark-nn.eemcs.utwente.nl/user/s1934538/clickstream/clickstream-enwiki-2022-06.tsv.gz,Bob_Saget,27795,206736,2235,236766,56387
hdfs://spark-nn.eemcs.utwente.nl/user/s1934538/clickstream/clickstream-enwiki-2022-06.tsv.gz,RRR_(film),94797,952103,17874,1064774,562101
hdfs://spark-nn.eemcs.utwente.nl/user/s1934538/clickstream/clickstream-enwiki-2022-06.tsv.gz,United_States_Senate,59989,70268,972,131229,58814
hdfs://spark-nn.eemcs.utwente.nl/user/s1934538/clickstream/clickstream-enwiki-2022-06.tsv.gz,Death_of_Elisa_Lam,15432,85676,293,101401,28719
hdfs://spark-nn.eemcs.utwente.nl/user/s1934538/clickstream/clickstream-enwiki-2022-06.tsv.gz,Freddie_Mercury,128821,719596,5127,853544,348974
hdfs://spark-nn.eemcs.utwente.nl/user/s1934538/clickstream/clickstream-enwiki-2022-06.tsv.gz,Israel,78446,228589,5257,312292,158497
hdfs://spark-nn.eemcs.utwente.nl/user/s1934538/clickstream/clickstream-enwiki-2022-06.tsv.gz,Juneteenth,33354,3034016,26107,3093477,294286
hdfs://spark-nn.eemcs.utwente.nl/user/s1934538/clickstream/clickstream-enwiki-2022-06.tsv.gz,Manti_Te'o,2131,13032,98,15261,1852
hdfs://spark-nn.eemcs.utwente.nl/user/s1934538/clickstream/clickstream-enwiki-2022-06.tsv.gz,David_Beckham,43364,203165,1560,248089,103457
hdfs://spark-nn.eemcs.utwente.nl/user/s1934538/clickstream/clickstream-enwiki-2022-06.tsv.gz,The_Falcon_and_the_Winter_Soldier,27127,43935,934,71996,44674
hdfs://spark-nn.eemcs.utwente.nl/user/s1934538/clickstream/clickstream-enwiki-2022-06.tsv.gz,COVID-19_pandemic_by_country_and_territory,23238,63056,1667,87961,39499
hdfs://spark-nn.eemcs.utwente.nl/user/s1934538/clickstream/clickstream-enwiki-2022-06.tsv.gz,The_Nun_(2018_film),15169,40194,305,55668,36088
hdfs://spark-nn.eemcs.utwente.nl/user/s1934538/clickstream/clickstream-enwiki-2022-06.tsv.gz,Venom_(2018_film),25679,83376,968,110023,51349
hdfs://spark-nn.eemcs.utwente.nl/user/s1934538/clickstream/clickstream-enwiki-2022-06.tsv.gz,Christopher_Scarver,46655,11218,24,57897,17703
hdfs://spark-nn.eemcs.utwente.nl/user/s1934538/clickstream/clickstream-enwiki-2022-06.tsv.gz,Joe_Exotic,14143,47321,5609,67073,31589
hdfs://spark-nn.eemcs.utwente.nl/user/s1934538/clickstream/clickstream-enwiki-2022-06.tsv.gz,Anthony_Bourdain,30788,369678,2762,403228,144439
hdfs://spark-nn.eemcs.utwente.nl/user/s1934538/clickstream/clickstream-enwiki-2022-06.tsv.gz,List_of_FIFA_World_Cup_finals,6963,127961,131,135055,39406
hdfs://spark-nn.eemcs.utwente.nl/user/s1934538/clickstream/clickstream-enwiki-2022-06.tsv.gz,The_Idol_(TV_series),11223,23376,63,34662,19475
hdfs://spark-nn.eemcs.utwente.nl/user/s1934538/clickstream/clickstream-enwiki-2022-06.tsv.gz,Spider-Man:_No_Way_Home,191914,353859,6413,552186,296055
hdfs://spark-nn.eemcs.utwente.nl/user/s1934538/clickstream/clickstream-enwiki-2022-06.tsv.gz,Charles_Sobhraj,9438,43077,95,52610,9769
hdfs://spark-nn.eemcs.utwente.nl/user/s1934538/clickstream/clickstream-enwiki-2022-06.tsv.gz,K.G.F:_Chapter_2,144974,859582,15886,1020442,362398
hdfs://spark-nn.eemcs.utwente.nl/user/s1934538/clickstream/clickstream-enwiki-2022-06.tsv.gz,Aaron_Carter,12670,54276,301,67247,30144
hdfs://spark-nn.eemcs.utwente.nl/user/s1934538/clickstream/clickstream-enwiki-2022-06.tsv.gz,Brie_Larson,76513,146187,2081,224781,91415
hdfs://spark-nn.eemcs.utwente.nl/user/s1934538/clickstream/clickstream-enwiki-2022-06.tsv.gz,Media,56,2166,295,2517,1081
hdfs://spark-nn.eemcs.utwente.nl/user/s1934538/clickstream/clickstream-enwiki-2022-06.tsv.gz,Chadwick_Boseman,51843,189288,1165,242296,70827
hdfs://spark-nn.eemcs.utwente.nl/user/s1934538/clickstream/clickstream-enwiki-2022-06.tsv.gz,Simone_Biles,10367,50867,339,61573,19736
hdfs://spark-nn.eemcs.utwente.nl/user/s1934538/clickstream/clickstream-enwiki-2022-06.tsv.gz,Carlos_Alcaraz,23373,83195,506,107074,25546
hdfs://spark-nn.eemcs.utwente.nl/user/s1934538/clickstream/clickstream-enwiki-2022-06.tsv.gz,The_Lion_King_(2019_film),44972,41041,711,86724,42792
hdfs://spark-nn.eemcs.utwente.nl/user/s1934538/clickstream/clickstream-enwiki-2022-06.tsv.gz,Black_Panther_(film),39089,76654,1401,117144,70190
hdfs://spark-nn.eemcs.utwente.nl/user/s1934538/clickstream/clickstream-enwiki-2022-06.tsv.gz,Top_Gun:_Maverick,945892,3856190,109001,4911083,3828207
hdfs://spark-nn.eemcs.utwente.nl/user/s1934538/clickstream/clickstream-enwiki-2022-06.tsv.gz,Mulan_(2020_film),17608,34778,571,52957,28658
hdfs://spark-nn.eemcs.utwente.nl/user/s1934538/clickstream/clickstream-enwiki-2022-06.tsv.gz,Ghislaine_Maxwell,70213,411996,3605,485814,216667
hdfs://spark-nn.eemcs.utwente.nl/user/s1934538/clickstream/clickstream-enwiki-2022-06.tsv.gz,2023_Cricket_World_Cup,26227,75444,152,101823,34719
hdfs://spark-nn.eemcs.utwente.nl/user/s1934538/clickstream/clickstream-enwiki-2022-06.tsv.gz,Johnny_Depp,501297,2622520,26414,3150231,1856269
hdfs://spark-nn.eemcs.utwente.nl/user/s1934538/clickstream/clickstream-enwiki-2022-06.tsv.gz,Roe_v._Wade,151715,4184995,43664,4380374,1564369
hdfs://spark-nn.eemcs.utwente.nl/user/s1934538/clickstream/clickstream-enwiki-2022-06.tsv.gz,September_11_attacks,88980,226706,3267,318953,200689
hdfs://spark-nn.eemcs.utwente.nl/user/s1934538/clickstream/clickstream-enwiki-2022-06.tsv.gz,Matthew_Perry,43237,101121,938,145296,102790
hdfs://spark-nn.eemcs.utwente.nl/user/s1934538/clickstream/clickstream-enwiki-2022-06.tsv.gz,Lionel_Messi,117682,694463,7696,819841,225421
hdfs://spark-nn.eemcs.utwente.nl/user/s1934538/clickstream/clickstream-enwiki-2022-06.tsv.gz,Area_51,16320,122342,1243,139905,46393
hdfs://spark-nn.eemcs.utwente.nl/user/s1934538/clickstream/clickstream-enwiki-2022-06.tsv.gz,Khabib_Nurmagomedov,32570,121951,1077,155598,78581
hdfs://spark-nn.eemcs.utwente.nl/user/s1934538/clickstream/clickstream-enwiki-2022-06.tsv.gz,Black_Adam_(film),122653,218168,7204,348025,315863
hdfs://spark-nn.eemcs.utwente.nl/user/s1934538/clickstream/clickstream-enwiki-2022-06.tsv.gz,Taliban,39251,62628,824,102703,74715
hdfs://spark-nn.eemcs.utwente.nl/user/s1934538/clickstream/clickstream-enwiki-2022-06.tsv.gz,Fyre_Festival,8650,58307,439,67396,37481
hdfs://spark-nn.eemcs.utwente.nl/user/s1934538/clickstream/clickstream-enwiki-2022-06.tsv.gz,Army_of_the_Dead,46512,40522,577,87611,48693
hdfs://spark-nn.eemcs.utwente.nl/user/s1934538/clickstream/clickstream-enwiki-2022-06.tsv.gz,Laal_Singh_Chaddha,58939,147907,669,207515,101810
hdfs://spark-nn.eemcs.utwente.nl/user/s1934538/clickstream/clickstream-enwiki-2022-06.tsv.gz,Valentine's_Day,3479,29019,178,32676,2929
hdfs://spark-nn.eemcs.utwente.nl/user/s1934538/clickstream/clickstream-enwiki-2022-06.tsv.gz,Vladimir_Putin,106373,366155,6343,478871,242823
hdfs://spark-nn.eemcs.utwente.nl/user/s1934538/clickstream/clickstream-enwiki-2022-06.tsv.gz,Tenet_(film),45456,91743,1302,138501,65207
hdfs://spark-nn.eemcs.utwente.nl/user/s1934538/clickstream/clickstream-enwiki-2022-06.tsv.gz,Pelé,41098,126161,1205,168464,67258
hdfs://spark-nn.eemcs.utwente.nl/user/s1934538/clickstream/clickstream-enwiki-2022-06.tsv.gz,J._Robert_Oppenheimer,47288,89036,326,136650,45961
hdfs://spark-nn.eemcs.utwente.nl/user/s1934538/clickstream/clickstream-enwiki-2022-06.tsv.gz,Stranger_Things_(season_4),629606,3593597,67048,4290251,2966135
hdfs://spark-nn.eemcs.utwente.nl/user/s1934538/clickstream/clickstream-enwiki-2022-06.tsv.gz,ICC_Men's_T20_World_Cup,15070,110829,634,126533,75051
hdfs://spark-nn.eemcs.utwente.nl/user/s1934538/clickstream/clickstream-enwiki-2022-06.tsv.gz,Lance_Reddick,27834,34318,319,62471,15210
hdfs://spark-nn.eemcs.utwente.nl/user/s1934538/clickstream/clickstream-enwiki-2022-06.tsv.gz,Wikipedia,226178,1477627,1485,1705290,703664
hdfs://spark-nn.eemcs.utwente.nl/user/s1934538/clickstream/clickstream-enwiki-2022-06.tsv.gz,The_Irishman,47050,101170,2550,150770,141380
hdfs://spark-nn.eemcs.utwente.nl/user/s1934538/clickstream/clickstream-enwiki-2022-06.tsv.gz,List_of_Queen_of_the_South_episodes,11778,7122,77,18977,381
hdfs://spark-nn.eemcs.utwente.nl/user/s1934538/clickstream/clickstream-enwiki-2022-06.tsv.gz,Adele,27600,137478,1969,167047,66584
hdfs://spark-nn.eemcs.utwente.nl/user/s1934538/clickstream/clickstream-enwiki-2022-06.tsv.gz,Rihanna,59419,219044,3420,281883,155439
hdfs://spark-nn.eemcs.utwente.nl/user/s1934538/clickstream/clickstream-enwiki-2022-06.tsv.gz,2022_Russian_invasion_of_Ukraine,977510,1763267,6140,2746917,1273974
hdfs://spark-nn.eemcs.utwente.nl/user/s1934538/clickstream/clickstream-enwiki-2022-06.tsv.gz,Bridgerton,37122,219254,4170,260546,202711
hdfs://spark-nn.eemcs.utwente.nl/user/s1934538/clickstream/clickstream-enwiki-2022-06.tsv.gz,Darth_Vader,120296,227343,3263,350902,306036
hdfs://spark-nn.eemcs.utwente.nl/user/s1934538/clickstream/clickstream-enwiki-2022-06.tsv.gz,The_Weeknd,56003,151783,2040,209826,98556
hdfs://spark-nn.eemcs.utwente.nl/user/s1934538/clickstream/clickstream-enwiki-2022-06.tsv.gz,Hamilton_(musical),28287,198765,1956,229008,124623
hdfs://spark-nn.eemcs.utwente.nl/user/s1934538/clickstream/clickstream-enwiki-2022-06.tsv.gz,The_Matrix_Resurrections,65877,160989,3935,230801,120736
hdfs://spark-nn.eemcs.utwente.nl/user/s1934538/clickstream/clickstream-enwiki-2022-06.tsv.gz,Zack_Snyder's_Justice_League,75557,59111,688,135356,63466
hdfs://spark-nn.eemcs.utwente.nl/user/s1934538/clickstream/clickstream-enwiki-2022-06.tsv.gz,"Diana,_Princess_of_Wales",199453,369008,3366,571827,374851
hdfs://spark-nn.eemcs.utwente.nl/user/s1934538/clickstream/clickstream-enwiki-2022-06.tsv.gz,Donald_Glover,41001,112717,888,154606,66687
hdfs://spark-nn.eemcs.utwente.nl/user/s1934538/clickstream/clickstream-enwiki-2022-06.tsv.gz,2020_Summer_Olympics,56704,55288,1724,113716,105765
hdfs://spark-nn.eemcs.utwente.nl/user/s1934538/clickstream/clickstream-enwiki-2022-06.tsv.gz,Donald_Trump,203880,550882,7832,762594,377859
hdfs://spark-nn.eemcs.utwente.nl/user/s1934538/clickstream/clickstream-enwiki-2022-06.tsv.gz,Everything_Everywhere_All_at_Once,97865,863609,16136,977610,525573
hdfs://spark-nn.eemcs.utwente.nl/user/s1934538/clickstream/clickstream-enwiki-2022-06.tsv.gz,Betty_White,39341,126433,1751,167525,44113
hdfs://spark-nn.eemcs.utwente.nl/user/s1934538/clickstream/clickstream-enwiki-2022-06.tsv.gz,COVID-19_pandemic,162834,222826,1272,386932,142744
hdfs://spark-nn.eemcs.utwente.nl/user/s1934538/clickstream/clickstream-enwiki-2022-06.tsv.gz,Asia_Cup,10560,32690,141,43391,27810
hdfs://spark-nn.eemcs.utwente.nl/user/s1934538/clickstream/clickstream-enwiki-2022-06.tsv.gz,XNXX,14447,984593,4366,1003406,52681
hdfs://spark-nn.eemcs.utwente.nl/user/s1934538/clickstream/clickstream-enwiki-2022-06.tsv.gz,1234,45,1130,37,1212,177
hdfs://spark-nn.eemcs.utwente.nl/user/s1934538/clickstream/clickstream-enwiki-2022-06.tsv.gz,Kim_Jong-un,45008,106043,1015,152066,83251
hdfs://spark-nn.eemcs.utwente.nl/user/s1934538/clickstream/clickstream-enwiki-2022-07.tsv.gz,Khabib_Nurmagomedov,63445,225366,2198,291009,156397
hdfs://spark-nn.eemcs.utwente.nl/user/s1934538/clickstream/clickstream-enwiki-2022-07.tsv.gz,Game_of_Thrones_(season_8),21274,45331,596,67201,26409
hdfs://spark-nn.eemcs.utwente.nl/user/s1934538/clickstream/clickstream-enwiki-2022-07.tsv.gz,Tunnel,4215,7101,86,11402,2979
hdfs://spark-nn.eemcs.utwente.nl/user/s1934538/clickstream/clickstream-enwiki-2022-07.tsv.gz,Carlos_Alcaraz,25869,151125,596,177590,36931
hdfs://spark-nn.eemcs.utwente.nl/user/s1934538/clickstream/clickstream-enwiki-2022-07.tsv.gz,United_States_Senate,60444,60950,1089,122483,58137
hdfs://spark-nn.eemcs.utwente.nl/user/s1934538/clickstream/clickstream-enwiki-2022-07.tsv.gz,Loki_(TV_series),62274,114411,2409,179094,134367
hdfs://spark-nn.eemcs.utwente.nl/user/s1934538/clickstream/clickstream-enwiki-2022-07.tsv.gz,2018_Winter_Olympics,8181,5779,139,14099,9766
hdfs://spark-nn.eemcs.utwente.nl/user/s1934538/clickstream/clickstream-enwiki-2022-07.tsv.gz,Shakira,32005,410110,4022,446137,204290
hdfs://spark-nn.eemcs.utwente.nl/user/s1934538/clickstream/clickstream-enwiki-2022-07.tsv.gz,Ted_Bundy,34384,340091,3954,378429,110108
hdfs://spark-nn.eemcs.utwente.nl/user/s1934538/clickstream/clickstream-enwiki-2022-07.tsv.gz,Deadpool_2,66432,59311,1534,127277,91868
hdfs://spark-nn.eemcs.utwente.nl/user/s1934538/clickstream/clickstream-enwiki-2022-07.tsv.gz,Dune_(2021_film),63059,216663,10784,290506,222614
hdfs://spark-nn.eemcs.utwente.nl/user/s1934538/clickstream/clickstream-enwiki-2022-07.tsv.gz,WrestleMania_34,14429,8877,109,23415,14888
hdfs://spark-nn.eemcs.utwente.nl/user/s1934538/clickstream/clickstream-enwiki-2022-07.tsv.gz,George_H._W._Bush,152233,101010,802,254045,157941
hdfs://spark-nn.eemcs.utwente.nl/user/s1934538/clickstream/clickstream-enwiki-2022-07.tsv.gz,Mötley_Crüe,41628,154016,1717,197361,240123
hdfs://spark-nn.eemcs.utwente.nl/user/s1934538/clickstream/clickstream-enwiki-2022-07.tsv.gz,House_of_the_Dragon,68268,418604,8191,495063,434851
hdfs://spark-nn.eemcs.utwente.nl/user/s1934538/clickstream/clickstream-enwiki-2022-07.tsv.gz,Irrfan_Khan,33829,55035,99,88963,39751
hdfs://spark-nn.eemcs.utwente.nl/user/s1934538/clickstream/clickstream-enwiki-2022-07.tsv.gz,Lisa_Marie_Presley,540052,549904,1067,1091023,666975
hdfs://spark-nn.eemcs.utwente.nl/user/s1934538/clickstream/clickstream-enwiki-2022-07.tsv.gz,COVID-19_pandemic,160517,217784,1049,379350,150979
hdfs://spark-nn.eemcs.utwente.nl/user/s1934538/clickstream/clickstream-enwiki-2022-07.tsv.gz,Kim_Jong-un,54598,120605,984,176187,103849
hdfs://spark-nn.eemcs.utwente.nl/user/s1934538/clickstream/clickstream-enwiki-2022-07.tsv.gz,R._Kelly,38172,523342,5974,567488,336916
hdfs://spark-nn.eemcs.utwente.nl/user/s1934538/clickstream/clickstream-enwiki-2022-07.tsv.gz,The_Irishman,51660,84587,1784,138031,123776
hdfs://spark-nn.eemcs.utwente.nl/user/s1934538/clickstream/clickstream-enwiki-2022-07.tsv.gz,Antifa_(United_States),10964,96091,530,107585,17574
hdfs://spark-nn.eemcs.utwente.nl/user/s1934538/clickstream/clickstream-enwiki-2022-07.tsv.gz,Cristiano_Ronaldo,100480,865727,4869,971076,206457
hdfs://spark-nn.eemcs.utwente.nl/user/s1934538/clickstream/clickstream-enwiki-2022-07.tsv.gz,The_Last_of_Us_(TV_series),31706,41801,211,73718,54891
hdfs://spark-nn.eemcs.utwente.nl/user/s1934538/clickstream/clickstream-enwiki-2022-07.tsv.gz,Royal_Rumble_(2018),6512,4066,63,10641,8080
hdfs://spark-nn.eemcs.utwente.nl/user/s1934538/clickstream/clickstream-enwiki-2022-07.tsv.gz,ICC_Men's_T20_World_Cup,19497,133008,868,153373,100599
hdfs://spark-nn.eemcs.utwente.nl/user/s1934538/clickstream/clickstream-enwiki-2022-07.tsv.gz,Death_of_Elisa_Lam,16169,87267,245,103681,30711
hdfs://spark-nn.eemcs.utwente.nl/user/s1934538/clickstream/clickstream-enwiki-2022-07.tsv.gz,JSON_Web_Token,681,23825,36,24542,1934
hdfs://spark-nn.eemcs.utwente.nl/user/s1934538/clickstream/clickstream-enwiki-2022-07.tsv.gz,List_of_Marvel_Cinematic_Universe_films,522433,1038105,13108,1573646,1158293
hdfs://spark-nn.eemcs.utwente.nl/user/s1934538/clickstream/clickstream-enwiki-2022-07.tsv.gz,Spider-Man:_Across_the_Spider-Verse,57666,39253,424,97343,46649
hdfs://spark-nn.eemcs.utwente.nl/user/s1934538/clickstream/clickstream-enwiki-2022-07.tsv.gz,The_Shape_of_Water,19904,36789,384,57077,26219
hdfs://spark-nn.eemcs.utwente.nl/user/s1934538/clickstream/clickstream-enwiki-2022-07.tsv.gz,UEFA_Euro_2020,45518,74761,1514,121793,62272
hdfs://spark-nn.eemcs.utwente.nl/user/s1934538/clickstream/clickstream-enwiki-2022-07.tsv.gz,List_of_FIFA_World_Cup_finals,4053,79325,57,83435,24491
hdfs://spark-nn.eemcs.utwente.nl/user/s1934538/clickstream/clickstream-enwiki-2022-07.tsv.gz,Shinzo_Abe,391841,4216534,158944,4767319,2802315
hdfs://spark-nn.eemcs.utwente.nl/user/s1934538/clickstream/clickstream-enwiki-2022-07.tsv.gz,David_Beckham,48815,195700,1318,245833,101326
hdfs://spark-nn.eemcs.utwente.nl/user/s1934538/clickstream/clickstream-enwiki-2022-07.tsv.gz,Stranger_Things_(season_4),640627,2542103,62427,3245157,1862850
hdfs://spark-nn.eemcs.utwente.nl/user/s1934538/clickstream/clickstream-enwiki-2022-07.tsv.gz,Cecil_Hotel_(Los_Angeles),8753,70444,140,79337,19346
hdfs://spark-nn.eemcs.utwente.nl/user/s1934538/clickstream/clickstream-enwiki-2022-07.tsv.gz,Spanish_flu,18281,65583,538,84402,23091
hdfs://spark-nn.eemcs.utwente.nl/user/s1934538/clickstream/clickstream-enwiki-2022-07.tsv.gz,Lists_of_deaths_by_year,2914,181035,486,184435,204237
hdfs://spark-nn.eemcs.utwente.nl/user/s1934538/clickstream/clickstream-enwiki-2022-07.tsv.gz,Kate_Spade,25186,43211,385,68782,24859
hdfs://spark-nn.eemcs.utwente.nl/user/s1934538/clickstream/clickstream-enwiki-2022-07.tsv.gz,Media,59,2620,171,2850,908
hdfs://spark-nn.eemcs.utwente.nl/user/s1934538/clickstream/clickstream-enwiki-2022-07.tsv.gz,Sushma_Swaraj,11961,20856,62,32879,10010
hdfs://spark-nn.eemcs.utwente.nl/user/s1934538/clickstream/clickstream-enwiki-2022-07.tsv.gz,Barbie_(film),132697,176671,2408,311776,285053
hdfs://spark-nn.eemcs.utwente.nl/user/s1934538/clickstream/clickstream-enwiki-2022-07.tsv.gz,Asia_Cup,22219,98789,185,121193,80347
hdfs://spark-nn.eemcs.utwente.nl/user/s1934538/clickstream/clickstream-enwiki-2022-07.tsv.gz,Crazy_Rich_Asians_(film),44635,71744,936,117315,97746
hdfs://spark-nn.eemcs.utwente.nl/user/s1934538/clickstream/clickstream-enwiki-2022-07.tsv.gz,Sridevi,39986,74796,177,114959,57007
hdfs://spark-nn.eemcs.utwente.nl/user/s1934538/clickstream/clickstream-enwiki-2022-07.tsv.gz,The_Matrix_Resurrections,73868,100586,1977,176431,87447
hdfs://spark-nn.eemcs.utwente.nl/user/s1934538/clickstream/clickstream-enwiki-2022-07.tsv.gz,Coronavirus,7260,42065,988,50313,16989
hdfs://spark-nn.eemcs.utwente.nl/user/s1934538/clickstream/clickstream-enwiki-2022-07.tsv.gz,Spider-Man:_Far_From_Home,75278,93069,856,169203,72787
hdfs://spark-nn.eemcs.utwente.nl/user/s1934538/clickstream/clickstream-enwiki-2022-07.tsv.gz,XXXTentacion,71241,749994,5509,826744,108156
hdfs://spark-nn.eemcs.utwente.nl/user/s1934538/clickstream/clickstream-enwiki-2022-07.tsv.gz,Louis_Tomlinson,41416,57310,235,98961,27483
hdfs://spark-nn.eemcs.utwente.nl/user/s1934538/clickstream/clickstream-enwiki-2022-07.tsv.gz,2016_United_States_presidential_election,113539,87935,1158,202632,169025
hdfs://spark-nn.eemcs.utwente.nl/user/s1934538/clickstream/clickstream-enwiki-2022-07.tsv.gz,Elliot_Page,146219,1149381,5760,1301360,513627
hdfs://spark-nn.eemcs.utwente.nl/user/s1934538/clickstream/clickstream-enwiki-2022-07.tsv.gz,Aquaman_(film),27705,86260,1343,115308,63244
hdfs://spark-nn.eemcs.utwente.nl/user/s1934538/clickstream/clickstream-enwiki-2022-07.tsv.gz,"Prince_Philip,_Duke_of_Edinburgh",149863,150292,1237,301392,182065
hdfs://spark-nn.eemcs.utwente.nl/user/s1934538/clickstream/clickstream-enwiki-2022-07.tsv.gz,COVID-19_pandemic_by_country_and_territory,22324,59243,1648,83215,40026
hdfs://spark-nn.eemcs.utwente.nl/user/s1934538/clickstream/clickstream-enwiki-2022-07.tsv.gz,Elizabeth_II,401372,582772,5157,989301,727910
hdfs://spark-nn.eemcs.utwente.nl/user/s1934538/clickstream/clickstream-enwiki-2022-07.tsv.gz,Laal_Singh_Chaddha,61763,229419,824,292006,150365
hdfs://spark-nn.eemcs.utwente.nl/user/s1934538/clickstream/clickstream-enwiki-2022-07.tsv.gz,Atal_Bihari_Vajpayee,47703,66216,142,114061,43431
hdfs://spark-nn.eemcs.utwente.nl/user/s1934538/clickstream/clickstream-enwiki-2022-07.tsv.gz,Bible,15141,1364074,1501,1380716,27370
hdfs://spark-nn.eemcs.utwente.nl/user/s1934538/clickstream/clickstream-enwiki-2022-07.tsv.gz,2018_Asian_Games,13873,8066,98,22037,21961
hdfs://spark-nn.eemcs.utwente.nl/user/s1934538/clickstream/clickstream-enwiki-2022-07.tsv.gz,Jeffrey_Epstein,79745,333012,3224,415981,202425
hdfs://spark-nn.eemcs.utwente.nl/user/s1934538/clickstream/clickstream-enwiki-2022-07.tsv.gz,Godzilla_vs._Kong,57553,72189,2009,131751,65624
hdfs://spark-nn.eemcs.utwente.nl/user/s1934538/clickstream/clickstream-enwiki-2022-07.tsv.gz,Vivek_Ramaswamy,294,7898,24,8216,1194
hdfs://spark-nn.eemcs.utwente.nl/user/s1934538/clickstream/clickstream-enwiki-2022-07.tsv.gz,"Diana,_Princess_of_Wales",120684,335189,2657,458530,292972
hdfs://spark-nn.eemcs.utwente.nl/user/s1934538/clickstream/clickstream-enwiki-2022-07.tsv.gz,Top_Gun:_Maverick,475272,1579158,39609,2094039,1423084
hdfs://spark-nn.eemcs.utwente.nl/user/s1934538/clickstream/clickstream-enwiki-2022-07.tsv.gz,Aretha_Franklin,33484,287902,1844,323230,157533
hdfs://spark-nn.eemcs.utwente.nl/user/s1934538/clickstream/clickstream-enwiki-2022-07.tsv.gz,Russo-Ukrainian_War,132010,500219,7395,639624,314690
hdfs://spark-nn.eemcs.utwente.nl/user/s1934538/clickstream/clickstream-enwiki-2022-07.tsv.gz,Wikipedia,244519,1508364,848,1753731,767065
hdfs://spark-nn.eemcs.utwente.nl/user/s1934538/clickstream/clickstream-enwiki-2022-07.tsv.gz,The_Queen's_Gambit_(miniseries),25832,84558,940,111330,59954
hdfs://spark-nn.eemcs.utwente.nl/user/s1934538/clickstream/clickstream-enwiki-2022-07.tsv.gz,Kobe_Bryant,68719,335433,2713,406865,131843
hdfs://spark-nn.eemcs.utwente.nl/user/s1934538/clickstream/clickstream-enwiki-2022-07.tsv.gz,WandaVision,103159,150572,2310,256041,108662
hdfs://spark-nn.eemcs.utwente.nl/user/s1934538/clickstream/clickstream-enwiki-2022-07.tsv.gz,2020_Summer_Olympics,87859,68329,3071,159259,145373
hdfs://spark-nn.eemcs.utwente.nl/user/s1934538/clickstream/clickstream-enwiki-2022-07.tsv.gz,The_Umbrella_Academy_(TV_series),137026,1109056,26814,1272896,1027551
hdfs://spark-nn.eemcs.utwente.nl/user/s1934538/clickstream/clickstream-enwiki-2022-07.tsv.gz,J._Robert_Oppenheimer,132167,409085,683,541935,201085
hdfs://spark-nn.eemcs.utwente.nl/user/s1934538/clickstream/clickstream-enwiki-2022-07.tsv.gz,Avicii,18018,174084,1190,193292,55093
hdfs://spark-nn.eemcs.utwente.nl/user/s1934538/clickstream/clickstream-enwiki-2022-07.tsv.gz,Israel,85310,226479,5182,316971,178521
hdfs://spark-nn.eemcs.utwente.nl/user/s1934538/clickstream/clickstream-enwiki-2022-07.tsv.gz,John_McCain,36346,72134,792,109272,56480
hdfs://spark-nn.eemcs.utwente.nl/user/s1934538/clickstream/clickstream-enwiki-2022-07.tsv.gz,United_States_Electoral_College,14007,37335,119,51461,9686
hdfs://spark-nn.eemcs.utwente.nl/user/s1934538/clickstream/clickstream-enwiki-2022-07.tsv.gz,Star_Wars:_The_Rise_of_Skywalker,86700,79158,1841,167699,94831
hdfs://spark-nn.eemcs.utwente.nl/user/s1934538/clickstream/clickstream-enwiki-2022-07.tsv.gz,Tonya_Harding,17617,62583,330,80530,21595
hdfs://spark-nn.eemcs.utwente.nl/user/s1934538/clickstream/clickstream-enwiki-2022-07.tsv.gz,Deion_Sanders,10870,113689,725,125284,35525
hdfs://spark-nn.eemcs.utwente.nl/user/s1934538/clickstream/clickstream-enwiki-2022-07.tsv.gz,Kamala_Harris,84973,193014,2370,280357,126136
hdfs://spark-nn.eemcs.utwente.nl/user/s1934538/clickstream/clickstream-enwiki-2022-07.tsv.gz,Black_Adam_(film),103376,143222,3929,250527,175838
hdfs://spark-nn.eemcs.utwente.nl/user/s1934538/clickstream/clickstream-enwiki-2022-07.tsv.gz,Thor:_Love_and_Thunder,612064,5027309,137979,5777352,3184461
hdfs://spark-nn.eemcs.utwente.nl/user/s1934538/clickstream/clickstream-enwiki-2022-07.tsv.gz,Everything_Everywhere_All_at_Once,96330,675291,12944,784565,426205
hdfs://spark-nn.eemcs.utwente.nl/user/s1934538/clickstream/clickstream-enwiki-2022-07.tsv.gz,Zack_Snyder's_Justice_League,60761,75931,930,137622,67945
hdfs://spark-nn.eemcs.utwente.nl/user/s1934538/clickstream/clickstream-enwiki-2022-07.tsv.gz,Anthony_Bourdain,26770,253445,1872,282087,104837
hdfs://spark-nn.eemcs.utwente.nl/user/s1934538/clickstream/clickstream-enwiki-2022-07.tsv.gz,2018_FIFA_World_Cup,82596,92233,1014,175843,112480
hdfs://spark-nn.eemcs.utwente.nl/user/s1934538/clickstream/clickstream-enwiki-2022-07.tsv.gz,Aaron_Carter,20813,63904,336,85053,38716
hdfs://spark-nn.eemcs.utwente.nl/user/s1934538/clickstream/clickstream-enwiki-2022-07.tsv.gz,IPv4,9111,31245,130,40486,8033
hdfs://spark-nn.eemcs.utwente.nl/user/s1934538/clickstream/clickstream-enwiki-2022-07.tsv.gz,Queen_(band),71913,246475,3558,321946,330243
hdfs://spark-nn.eemcs.utwente.nl/user/s1934538/clickstream/clickstream-enwiki-2022-07.tsv.gz,Michael_Bloomberg,28118,28733,185,57036,25780
hdfs://spark-nn.eemcs.utwente.nl/user/s1934538/clickstream/clickstream-enwiki-2022-07.tsv.gz,Freddie_Mercury,108857,651869,4729,765455,311881
hdfs://spark-nn.eemcs.utwente.nl/user/s1934538/clickstream/clickstream-enwiki-2022-07.tsv.gz,The_Mandalorian,62442,141818,2531,206791,147080
hdfs://spark-nn.eemcs.utwente.nl/user/s1934538/clickstream/clickstream-enwiki-2022-07.tsv.gz,Black_Panther:_Wakanda_Forever,395533,769516,11468,1176517,1232870
hdfs://spark-nn.eemcs.utwente.nl/user/s1934538/clickstream/clickstream-enwiki-2022-07.tsv.gz,State_of_Palestine,46381,94923,176,141480,71863
hdfs://spark-nn.eemcs.utwente.nl/user/s1934538/clickstream/clickstream-enwiki-2022-07.tsv.gz,1234,50,1606,18,1674,165
hdfs://spark-nn.eemcs.utwente.nl/user/s1934538/clickstream/clickstream-enwiki-2022-07.tsv.gz,It_Chapter_Two,45828,81300,875,128003,95127
hdfs://spark-nn.eemcs.utwente.nl/user/s1934538/clickstream/clickstream-enwiki-2022-07.tsv.gz,Eternals_(film),112867,229477,4215,346559,287098
hdfs://spark-nn.eemcs.utwente.nl/user/s1934538/clickstream/clickstream-enwiki-2022-07.tsv.gz,Main_Page,87468,129653643,4782919,134524030,33389542
hdfs://spark-nn.eemcs.utwente.nl/user/s1934538/clickstream/clickstream-enwiki-2022-07.tsv.gz,Croatia,53829,216779,2875,273483,88186
hdfs://spark-nn.eemcs.utwente.nl/user/s1934538/clickstream/clickstream-enwiki-2022-07.tsv.gz,War_(2019_film),34339,44603,96,79038,20471
hdfs://spark-nn.eemcs.utwente.nl/user/s1934538/clickstream/clickstream-enwiki-2022-07.tsv.gz,Luke_Perry,39820,115872,603,156295,56673
hdfs://spark-nn.eemcs.utwente.nl/user/s1934538/clickstream/clickstream-enwiki-2022-07.tsv.gz,The_Flash_(film),84113,53897,1367,139377,83787
hdfs://spark-nn.eemcs.utwente.nl/user/s1934538/clickstream/clickstream-enwiki-2022-07.tsv.gz,Rishi_Sunak,269903,2981758,23330,3274991,1632822
hdfs://spark-nn.eemcs.utwente.nl/user/s1934538/clickstream/clickstream-enwiki-2022-07.tsv.gz,Cameron_Boyce,27339,172908,560,200807,53275
hdfs://spark-nn.eemcs.utwente.nl/user/s1934538/clickstream/clickstream-enwiki-2022-07.tsv.gz,"Princess_Margaret,_Countess_of_Snowdon",79281,163995,1004,244280,145922
hdfs://spark-nn.eemcs.utwente.nl/user/s1934538/clickstream/clickstream-enwiki-2022-07.tsv.gz,Brahmāstra:_Part_One_–_Shiva,86776,239411,1550,327737,49350
hdfs://spark-nn.eemcs.utwente.nl/user/s1934538/clickstream/clickstream-enwiki-2022-07.tsv.gz,Qasem_Soleimani,13050,22642,61,35753,21545
hdfs://spark-nn.eemcs.utwente.nl/user/s1934538/clickstream/clickstream-enwiki-2022-07.tsv.gz,YouTube,122872,3625836,9001,3757709,113363
hdfs://spark-nn.eemcs.utwente.nl/user/s1934538/clickstream/clickstream-enwiki-2022-07.tsv.gz,2022_FIFA_World_Cup,134195,515623,8555,658373,360674
hdfs://spark-nn.eemcs.utwente.nl/user/s1934538/clickstream/clickstream-enwiki-2022-07.tsv.gz,Joe_Exotic,12839,52270,174,65283,28273
hdfs://spark-nn.eemcs.utwente.nl/user/s1934538/clickstream/clickstream-enwiki-2022-07.tsv.gz,Sinéad_O'Connor,14163,70009,576,84748,26682
hdfs://spark-nn.eemcs.utwente.nl/user/s1934538/clickstream/clickstream-enwiki-2022-07.tsv.gz,Game_of_Thrones,99291,330609,9204,439104,308404
hdfs://spark-nn.eemcs.utwente.nl/user/s1934538/clickstream/clickstream-enwiki-2022-07.tsv.gz,Tenet_(film),62921,132381,1664,196966,96369
hdfs://spark-nn.eemcs.utwente.nl/user/s1934538/clickstream/clickstream-enwiki-2022-07.tsv.gz,Bonnie_and_Clyde,21770,181376,1383,204529,59419
hdfs://spark-nn.eemcs.utwente.nl/user/s1934538/clickstream/clickstream-enwiki-2022-07.tsv.gz,Matthew_Perry,41713,98123,738,140574,90851
hdfs://spark-nn.eemcs.utwente.nl/user/s1934538/clickstream/clickstream-enwiki-2022-07.tsv.gz,Kylian_Mbappé,28340,141239,1207,170786,35389
hdfs://spark-nn.eemcs.utwente.nl/user/s1934538/clickstream/clickstream-enwiki-2022-07.tsv.gz,Afghanistan,123335,203504,4177,331016,251943
hdfs://spark-nn.eemcs.utwente.nl/user/s1934538/clickstream/clickstream-enwiki-2022-07.tsv.gz,Stranger_Things_(season_3),205027,339807,3934,548768,308241
hdfs://spark-nn.eemcs.utwente.nl/user/s1934538/clickstream/clickstream-enwiki-2022-07.tsv.gz,List_of_James_Bond_films,86752,393107,2555,482414,299171
hdfs://spark-nn.eemcs.utwente.nl/user/s1934538/clickstream/clickstream-enwiki-2022-07.tsv.gz,2.0_(film),39171,33709,91,72971,19811
hdfs://spark-nn.eemcs.utwente.nl/user/s1934538/clickstream/clickstream-enwiki-2022-07.tsv.gz,The_Kashmir_Files,21136,83188,2018,106342,43649
hdfs://spark-nn.eemcs.utwente.nl/user/s1934538/clickstream/clickstream-enwiki-2022-07.tsv.gz,Bipin_Rawat,8778,27612,29,36419,13481
hdfs://spark-nn.eemcs.utwente.nl/user/s1934538/clickstream/clickstream-enwiki-2022-07.tsv.gz,The_Batman_(film),116549,378224,9071,503844,277175
hdfs://spark-nn.eemcs.utwente.nl/user/s1934538/clickstream/clickstream-enwiki-2022-07.tsv.gz,Saaho,25312,29874,5463,60649,16247
hdfs://spark-nn.eemcs.utwente.nl/user/s1934538/clickstream/clickstream-enwiki-2022-07.tsv.gz,Fantastic_Beasts:_The_Crimes_of_Grindelwald,66310,70429,1098,137837,70740
hdfs://spark-nn.eemcs.utwente.nl/user/s1934538/clickstream/clickstream-enwiki-2022-07.tsv.gz,Donald_Glover,40938,128625,812,170375,68921
hdfs://spark-nn.eemcs.utwente.nl/user/s1934538/clickstream/clickstream-enwiki-2022-07.tsv.gz,Darth_Vader,45209,111835,1247,158291,110342
hdfs://spark-nn.eemcs.utwente.nl/user/s1934538/clickstream/clickstream-enwiki-2022-07.tsv.gz,Black_Widow_(2021_film),81722,109358,1930,193010,102059
hdfs://spark-nn.eemcs.utwente.nl/user/s1934538/clickstream/clickstream-enwiki-2022-07.tsv.gz,Nipsey_Hussle,25993,152592,1029,179614,61827
hdfs://spark-nn.eemcs.utwente.nl/user/s1934538/clickstream/clickstream-enwiki-2022-07.tsv.gz,The_Lion_King_(2019_film),45420,41728,1360,88508,43983
hdfs://spark-nn.eemcs.utwente.nl/user/s1934538/clickstream/clickstream-enwiki-2022-07.tsv.gz,Joker_(2019_film),50048,128640,1808,180496,85320
hdfs://spark-nn.eemcs.utwente.nl/user/s1934538/clickstream/clickstream-enwiki-2022-07.tsv.gz,Glass_(2019_film),34756,37589,315,72660,24448
hdfs://spark-nn.eemcs.utwente.nl/user/s1934538/clickstream/clickstream-enwiki-2022-07.tsv.gz,Jeffrey_Dahmer,27258,266307,2899,296464,146826
hdfs://spark-nn.eemcs.utwente.nl/user/s1934538/clickstream/clickstream-enwiki-2022-07.tsv.gz,QAnon,37846,143409,1051,182306,58776
hdfs://spark-nn.eemcs.utwente.nl/user/s1934538/clickstream/clickstream-enwiki-2022-07.tsv.gz,Cardi_B,37860,202543,2564,242967,83128
hdfs://spark-nn.eemcs.utwente.nl/user/s1934538/clickstream/clickstream-enwiki-2022-07.tsv.gz,Chernobyl_(miniseries),16464,53476,1264,71204,74084
hdfs://spark-nn.eemcs.utwente.nl/user/s1934538/clickstream/clickstream-enwiki-2022-07.tsv.gz,Henry_V_of_England,73680,71196,321,145197,105464
hdfs://spark-nn.eemcs.utwente.nl/user/s1934538/clickstream/clickstream-enwiki-2022-07.tsv.gz,Taliban,42578,58111,1177,101866,76934
hdfs://spark-nn.eemcs.utwente.nl/user/s1934538/clickstream/clickstream-enwiki-2022-07.tsv.gz,Richard_Ramirez,16342,170264,1374,187980,57293
hdfs://spark-nn.eemcs.utwente.nl/user/s1934538/clickstream/clickstream-enwiki-2022-07.tsv.gz,The_Nun_(2018_film),18311,41841,840,60992,35955
hdfs://spark-nn.eemcs.utwente.nl/user/s1934538/clickstream/clickstream-enwiki-2022-07.tsv.gz,Sushant_Singh_Rajput,24201,97868,290,122359,63012
hdfs://spark-nn.eemcs.utwente.nl/user/s1934538/clickstream/clickstream-enwiki-2022-07.tsv.gz,2020_United_States_presidential_election,144087,202882,4605,351574,338786
hdfs://spark-nn.eemcs.utwente.nl/user/s1934538/clickstream/clickstream-enwiki-2022-07.tsv.gz,Cook's_Country,428,1975,27,2430,687
hdfs://spark-nn.eemcs.utwente.nl/user/s1934538/clickstream/clickstream-enwiki-2022-07.tsv.gz,Guardians_of_the_Galaxy_Vol._3,181433,104026,1602,287061,238447
hdfs://spark-nn.eemcs.utwente.nl/user/s1934538/clickstream/clickstream-enwiki-2022-07.tsv.gz,Eddie_Van_Halen,43619,88202,804,132625,50498
hdfs://spark-nn.eemcs.utwente.nl/user/s1934538/clickstream/clickstream-enwiki-2022-07.tsv.gz,Squid_Game,28353,192170,3906,224429,107568
hdfs://spark-nn.eemcs.utwente.nl/user/s1934538/clickstream/clickstream-enwiki-2022-07.tsv.gz,Joaquin_Phoenix,111207,131209,723,243139,153218
hdfs://spark-nn.eemcs.utwente.nl/user/s1934538/clickstream/clickstream-enwiki-2022-07.tsv.gz,Chadwick_Boseman,102543,316807,1688,421038,143689
hdfs://spark-nn.eemcs.utwente.nl/user/s1934538/clickstream/clickstream-enwiki-2023-08.tsv.gz,Russo-Ukrainian_War,102322,381849,2303,486474,328876
hdfs://spark-nn.eemcs.utwente.nl/user/s1934538/clickstream/clickstream-enwiki-2023-08.tsv.gz,Everything_Everywhere_All_at_Once,74305,196461,2974,273740,124670
hdfs://spark-nn.eemcs.utwente.nl/user/s1934538/clickstream/clickstream-enwiki-2023-08.tsv.gz,R._Kelly,43534,148577,1569,193680,107848
hdfs://spark-nn.eemcs.utwente.nl/user/s1934538/clickstream/clickstream-enwiki-2023-08.tsv.gz,Henry_V_of_England,91367,95033,550,186950,131529
hdfs://spark-nn.eemcs.utwente.nl/user/s1934538/clickstream/clickstream-enwiki-2023-08.tsv.gz,Sidharth_Shukla,11937,74809,377,87123,21514
hdfs://spark-nn.eemcs.utwente.nl/user/s1934538/clickstream/clickstream-enwiki-2023-08.tsv.gz,Atal_Bihari_Vajpayee,48474,107697,165,156336,56142
hdfs://spark-nn.eemcs.utwente.nl/user/s1934538/clickstream/clickstream-enwiki-2023-08.tsv.gz,Vladimir_Putin,133665,375385,4616,513666,309663
hdfs://spark-nn.eemcs.utwente.nl/user/s1934538/clickstream/clickstream-enwiki-2023-08.tsv.gz,Irrfan_Khan,28979,65581,146,94706,34716
hdfs://spark-nn.eemcs.utwente.nl/user/s1934538/clickstream/clickstream-enwiki-2023-08.tsv.gz,The_Mandalorian,60221,136493,2964,199678,142469
hdfs://spark-nn.eemcs.utwente.nl/user/s1934538/clickstream/clickstream-enwiki-2023-08.tsv.gz,Nipsey_Hussle,20624,82235,593,103452,32575
hdfs://spark-nn.eemcs.utwente.nl/user/s1934538/clickstream/clickstream-enwiki-2023-08.tsv.gz,Chernobyl_disaster,44009,255839,2424,302272,145428
hdfs://spark-nn.eemcs.utwente.nl/user/s1934538/clickstream/clickstream-enwiki-2023-08.tsv.gz,Thor:_Love_and_Thunder,64645,110685,2185,177515,78421
hdfs://spark-nn.eemcs.utwente.nl/user/s1934538/clickstream/clickstream-enwiki-2023-08.tsv.gz,Sridevi,43543,1167654,426,1211623,196852
hdfs://spark-nn.eemcs.utwente.nl/user/s1934538/clickstream/clickstream-enwiki-2023-08.tsv.gz,Jeffrey_Dahmer,32442,425757,5372,463571,187723
hdfs://spark-nn.eemcs.utwente.nl/user/s1934538/clickstream/clickstream-enwiki-2023-08.tsv.gz,Guardians_of_the_Galaxy_Vol._3,227999,1285655,23906,1537560,1105290
hdfs://spark-nn.eemcs.utwente.nl/user/s1934538/clickstream/clickstream-enwiki-2023-08.tsv.gz,Spider-Man:_Across_the_Spider-Verse,239163,858005,19011,1116179,649991
hdfs://spark-nn.eemcs.utwente.nl/user/s1934538/clickstream/clickstream-enwiki-2023-08.tsv.gz,FIFA_World_Cup,102541,426217,4050,532808,235490
hdfs://spark-nn.eemcs.utwente.nl/user/s1934538/clickstream/clickstream-enwiki-2023-08.tsv.gz,Roe_v._Wade,12622,61587,465,74674,27660
hdfs://spark-nn.eemcs.utwente.nl/user/s1934538/clickstream/clickstream-enwiki-2023-08.tsv.gz,Kate_Spade,28801,61697,346,90844,30851
hdfs://spark-nn.eemcs.utwente.nl/user/s1934538/clickstream/clickstream-enwiki-2023-08.tsv.gz,Hamas,26841,20992,1155,48988,29621
hdfs://spark-nn.eemcs.utwente.nl/user/s1934538/clickstream/clickstream-enwiki-2023-08.tsv.gz,Elon_Musk,163407,1099204,11257,1273868,691074
hdfs://spark-nn.eemcs.utwente.nl/user/s1934538/clickstream/clickstream-enwiki-2023-08.tsv.gz,QAnon,87843,172024,1187,261054,83668
hdfs://spark-nn.eemcs.utwente.nl/user/s1934538/clickstream/clickstream-enwiki-2023-08.tsv.gz,Naya_Rivera,45268,78918,317,124503,59014
hdfs://spark-nn.eemcs.utwente.nl/user/s1934538/clickstream/clickstream-enwiki-2023-08.tsv.gz,Deadpool_2,42465,47858,804,91127,63741
hdfs://spark-nn.eemcs.utwente.nl/user/s1934538/clickstream/clickstream-enwiki-2023-08.tsv.gz,Cecil_Hotel_(Los_Angeles),6002,35384,99,41485,11390
hdfs://spark-nn.eemcs.utwente.nl/user/s1934538/clickstream/clickstream-enwiki-2023-08.tsv.gz,The_Nun_(2018_film),41942,165253,1557,208752,131074
hdfs://spark-nn.eemcs.utwente.nl/user/s1934538/clickstream/clickstream-enwiki-2023-08.tsv.gz,Lionel_Messi,215849,1926321,15599,2157769,547580
hdfs://spark-nn.eemcs.utwente.nl/user/s1934538/clickstream/clickstream-enwiki-2023-08.tsv.gz,Cleopatra,67374,6087071,3758,6158203,539010
hdfs://spark-nn.eemcs.utwente.nl/user/s1934538/clickstream/clickstream-enwiki-2023-08.tsv.gz,Johnny_Depp,183672,681340,3846,868858,627845
hdfs://spark-nn.eemcs.utwente.nl/user/s1934538/clickstream/clickstream-enwiki-2023-08.tsv.gz,Amy_Coney_Barrett,19397,19689,113,39199,13056
hdfs://spark-nn.eemcs.utwente.nl/user/s1934538/clickstream/clickstream-enwiki-2023-08.tsv.gz,Jimmy_Buffett,12004,66661,724,79389,30622
hdfs://spark-nn.eemcs.utwente.nl/user/s1934538/clickstream/clickstream-enwiki-2023-08.tsv.gz,Coronavirus,5138,32655,502,38295,9950
hdfs://spark-nn.eemcs.utwente.nl/user/s1934538/clickstream/clickstream-enwiki-2023-08.tsv.gz,Saltburn_(film),42640,110921,1720,155281,99882
hdfs://spark-nn.eemcs.utwente.nl/user/s1934538/clickstream/clickstream-enwiki-2023-08.tsv.gz,2023_Asia_Cup,50015,1724328,502,1774845,142696
hdfs://spark-nn.eemcs.utwente.nl/user/s1934538/clickstream/clickstream-enwiki-2023-08.tsv.gz,Lisa_Marie_Presley,234997,218127,1030,454154,265217
hdfs://spark-nn.eemcs.utwente.nl/user/s1934538/clickstream/clickstream-enwiki-2023-08.tsv.gz,Keanu_Reeves,92265,558897,3509,654671,404906
hdfs://spark-nn.eemcs.utwente.nl/user/s1934538/clickstream/clickstream-enwiki-2023-08.tsv.gz,John_McCain,36328,72001,807,109136,60747
hdfs://spark-nn.eemcs.utwente.nl/user/s1934538/clickstream/clickstream-enwiki-2023-08.tsv.gz,Tiger_3,88835,105010,758,194603,99056
hdfs://spark-nn.eemcs.utwente.nl/user/s1934538/clickstream/clickstream-enwiki-2023-08.tsv.gz,Dune_(2021_film),65426,253707,5368,324501,231895
hdfs://spark-nn.eemcs.utwente.nl/user/s1934538/clickstream/clickstream-enwiki-2023-08.tsv.gz,Cardi_B,30131,230625,2429,263185,75677
hdfs://spark-nn.eemcs.utwente.nl/user/s1934538/clickstream/clickstream-enwiki-2023-08.tsv.gz,United_States_Senate,59093,43990,635,103718,48384
hdfs://spark-nn.eemcs.utwente.nl/user/s1934538/clickstream/clickstream-enwiki-2023-08.tsv.gz,Eternals_(film),49473,91457,1439,142369,94396
hdfs://spark-nn.eemcs.utwente.nl/user/s1934538/clickstream/clickstream-enwiki-2023-08.tsv.gz,Lance_Reddick,65928,161931,779,228638,57868
hdfs://spark-nn.eemcs.utwente.nl/user/s1934538/clickstream/clickstream-enwiki-2023-08.tsv.gz,HTTP_cookie,2058,360836,196,363090,20362
hdfs://spark-nn.eemcs.utwente.nl/user/s1934538/clickstream/clickstream-enwiki-2023-08.tsv.gz,List_of_awards_and_nominations_received_by_Meryl_Streep,11150,10704,41,21895,10049
hdfs://spark-nn.eemcs.utwente.nl/user/s1934538/clickstream/clickstream-enwiki-2023-08.tsv.gz,United_States_Electoral_College,18112,36407,160,54679,12204
hdfs://spark-nn.eemcs.utwente.nl/user/s1934538/clickstream/clickstream-enwiki-2023-08.tsv.gz,Juice_Wrld,43032,143772,1752,188556,77602
hdfs://spark-nn.eemcs.utwente.nl/user/s1934538/clickstream/clickstream-enwiki-2023-08.tsv.gz,Pornhub,52433,384227,13321,449981,79457
hdfs://spark-nn.eemcs.utwente.nl/user/s1934538/clickstream/clickstream-enwiki-2023-08.tsv.gz,Crazy_Rich_Asians_(film),31613,75337,847,107797,84040
hdfs://spark-nn.eemcs.utwente.nl/user/s1934538/clickstream/clickstream-enwiki-2023-08.tsv.gz,Doctor_Strange_in_the_Multiverse_of_Madness,58907,96479,3242,158628,72327
hdfs://spark-nn.eemcs.utwente.nl/user/s1934538/clickstream/clickstream-enwiki-2023-08.tsv.gz,Juneteenth,9407,44084,166,53657,5032
hdfs://spark-nn.eemcs.utwente.nl/user/s1934538/clickstream/clickstream-enwiki-2023-08.tsv.gz,Aretha_Franklin,22953,105844,1017,129814,56595
hdfs://spark-nn.eemcs.utwente.nl/user/s1934538/clickstream/clickstream-enwiki-2023-08.tsv.gz,Mötley_Crüe,29363,96463,1476,127302,150100
hdfs://spark-nn.eemcs.utwente.nl/user/s1934538/clickstream/clickstream-enwiki-2023-08.tsv.gz,List_of_highest-grossing_Indian_films,219044,781160,3666,1003870,571089
hdfs://spark-nn.eemcs.utwente.nl/user/s1934538/clickstream/clickstream-enwiki-2023-08.tsv.gz,Queen_(band),49716,159554,2591,211861,210409
hdfs://spark-nn.eemcs.utwente.nl/user/s1934538/clickstream/clickstream-enwiki-2023-08.tsv.gz,Anna_Sorokin,12660,111134,396,124190,43853
hdfs://spark-nn.eemcs.utwente.nl/user/s1934538/clickstream/clickstream-enwiki-2023-08.tsv.gz,Bridgerton,35511,95065,1485,132061,91087
hdfs://spark-nn.eemcs.utwente.nl/user/s1934538/clickstream/clickstream-enwiki-2023-08.tsv.gz,Jawan_(film),133936,760613,17661,912210,527678
hdfs://spark-nn.eemcs.utwente.nl/user/s1934538/clickstream/clickstream-enwiki-2023-08.tsv.gz,The_Last_of_Us_(TV_series),48208,268406,4243,320857,127445
hdfs://spark-nn.eemcs.utwente.nl/user/s1934538/clickstream/clickstream-enwiki-2023-08.tsv.gz,Freddie_Mercury,84864,456631,3649,545144,210324
hdfs://spark-nn.eemcs.utwente.nl/user/s1934538/clickstream/clickstream-enwiki-2023-08.tsv.gz,"Diana,_Princess_of_Wales",104730,235537,2030,342297,189270
hdfs://spark-nn.eemcs.utwente.nl/user/s1934538/clickstream/clickstream-enwiki-2023-08.tsv.gz,UEFA_Euro_2020,48370,40321,598,89289,58073
hdfs://spark-nn.eemcs.utwente.nl/user/s1934538/clickstream/clickstream-enwiki-2023-08.tsv.gz,Gadar_2,418794,6149375,33928,6602097,2348444
hdfs://spark-nn.eemcs.utwente.nl/user/s1934538/clickstream/clickstream-enwiki-2023-08.tsv.gz,1234,71,2188,24,2283,271
hdfs://spark-nn.eemcs.utwente.nl/user/s1934538/clickstream/clickstream-enwiki-2023-08.tsv.gz,Chernobyl_(miniseries),18381,62631,1414,82426,92065
hdfs://spark-nn.eemcs.utwente.nl/user/s1934538/clickstream/clickstream-enwiki-2023-08.tsv.gz,Greta_Thunberg,11494,151109,1112,163715,41829
hdfs://spark-nn.eemcs.utwente.nl/user/s1934538/clickstream/clickstream-enwiki-2023-08.tsv.gz,David_Beckham,94783,384549,1688,481020,207503
hdfs://spark-nn.eemcs.utwente.nl/user/s1934538/clickstream/clickstream-enwiki-2023-08.tsv.gz,Olivia_Newton-John,41497,195894,1806,239197,104523
hdfs://spark-nn.eemcs.utwente.nl/user/s1934538/clickstream/clickstream-enwiki-2023-08.tsv.gz,Volodymyr_Zelenskyy,68146,127318,1392,196856,110227
hdfs://spark-nn.eemcs.utwente.nl/user/s1934538/clickstream/clickstream-enwiki-2023-08.tsv.gz,Adele,26737,190881,1917,219535,87469
hdfs://spark-nn.eemcs.utwente.nl/user/s1934538/clickstream/clickstream-enwiki-2023-08.tsv.gz,Grover,1251,10760,144,12155,3124
hdfs://spark-nn.eemcs.utwente.nl/user/s1934538/clickstream/clickstream-enwiki-2023-08.tsv.gz,George_H._W._Bush,180354,121947,972,303273,196386
hdfs://spark-nn.eemcs.utwente.nl/user/s1934538/clickstream/clickstream-enwiki-2023-08.tsv.gz,The_Matrix_Resurrections,53447,94230,1448,149125,76578
hdfs://spark-nn.eemcs.utwente.nl/user/s1934538/clickstream/clickstream-enwiki-2023-08.tsv.gz,XHamster,6556,386814,6099,399469,28292
hdfs://spark-nn.eemcs.utwente.nl/user/s1934538/clickstream/clickstream-enwiki-2023-08.tsv.gz,The_Lion_King_(2019_film),72201,71386,509,144096,47043
hdfs://spark-nn.eemcs.utwente.nl/user/s1934538/clickstream/clickstream-enwiki-2023-08.tsv.gz,"Prince_Philip,_Duke_of_Edinburgh",102941,98418,808,202167,126979
hdfs://spark-nn.eemcs.utwente.nl/user/s1934538/clickstream/clickstream-enwiki-2023-08.tsv.gz,Ray_Liotta,66384,276699,1834,344917,131667
hdfs://spark-nn.eemcs.utwente.nl/user/s1934538/clickstream/clickstream-enwiki-2023-08.tsv.gz,Mortal_Kombat_(2021_film),29117,68915,922,98954,94097
hdfs://spark-nn.eemcs.utwente.nl/user/s1934538/clickstream/clickstream-enwiki-2023-08.tsv.gz,2020_Summer_Olympics,83037,65053,3213,151303,123921
hdfs://spark-nn.eemcs.utwente.nl/user/s1934538/clickstream/clickstream-enwiki-2023-08.tsv.gz,Rami_Malek,112797,215026,1357,329180,131249
hdfs://spark-nn.eemcs.utwente.nl/user/s1934538/clickstream/clickstream-enwiki-2023-08.tsv.gz,Article_370_of_the_Constitution_of_India,4857,153016,98,157971,9256
hdfs://spark-nn.eemcs.utwente.nl/user/s1934538/clickstream/clickstream-enwiki-2023-08.tsv.gz,Black_Panther_(film),28499,79000,767,108266,47853
hdfs://spark-nn.eemcs.utwente.nl/user/s1934538/clickstream/clickstream-enwiki-2023-08.tsv.gz,The_Irishman,54886,101322,1408,157616,131122
hdfs://spark-nn.eemcs.utwente.nl/user/s1934538/clickstream/clickstream-enwiki-2023-08.tsv.gz,Stranger_Things,59391,255042,4759,319192,244600
hdfs://spark-nn.eemcs.utwente.nl/user/s1934538/clickstream/clickstream-enwiki-2023-08.tsv.gz,Michael_Jordan,91008,474539,4148,569695,190331
hdfs://spark-nn.eemcs.utwente.nl/user/s1934538/clickstream/clickstream-enwiki-2023-08.tsv.gz,Tonya_Harding,35473,137963,3886,177322,51833
hdfs://spark-nn.eemcs.utwente.nl/user/s1934538/clickstream/clickstream-enwiki-2023-08.tsv.gz,Deaths_in_2023,1521786,2622116,24442,4168344,2648676
hdfs://spark-nn.eemcs.utwente.nl/user/s1934538/clickstream/clickstream-enwiki-2023-08.tsv.gz,Taliban,41750,66011,1772,109533,89279
hdfs://spark-nn.eemcs.utwente.nl/user/s1934538/clickstream/clickstream-enwiki-2023-08.tsv.gz,Mac_Miller,31275,254692,1901,287868,80304
hdfs://spark-nn.eemcs.utwente.nl/user/s1934538/clickstream/clickstream-enwiki-2023-08.tsv.gz,Black_Adam_(film),48729,137735,2252,188716,72696
hdfs://spark-nn.eemcs.utwente.nl/user/s1934538/clickstream/clickstream-enwiki-2023-08.tsv.gz,Shang-Chi_and_the_Legend_of_the_Ten_Rings,40803,85206,877,126886,63191
hdfs://spark-nn.eemcs.utwente.nl/user/s1934538/clickstream/clickstream-enwiki-2023-08.tsv.gz,2022_FIFA_World_Cup,182232,247240,3510,432982,264225
hdfs://spark-nn.eemcs.utwente.nl/user/s1934538/clickstream/clickstream-enwiki-2023-08.tsv.gz,"Princess_Margaret,_Countess_of_Snowdon",58884,110661,694,170239,98650
hdfs://spark-nn.eemcs.utwente.nl/user/s1934538/clickstream/clickstream-enwiki-2023-08.tsv.gz,ChatGPT,19683,1877105,3730,1900518,101725
hdfs://spark-nn.eemcs.utwente.nl/user/s1934538/clickstream/clickstream-enwiki-2023-08.tsv.gz,Asia_Cup,23531,677929,662,702122,108029
hdfs://spark-nn.eemcs.utwente.nl/user/s1934538/clickstream/clickstream-enwiki-2023-08.tsv.gz,Bible,20639,108613,1624,130876,38014
hdfs://spark-nn.eemcs.utwente.nl/user/s1934538/clickstream/clickstream-enwiki-2023-08.tsv.gz,Parasite_(2019_film),24553,141060,1325,166938,66088
hdfs://spark-nn.eemcs.utwente.nl/user/s1934538/clickstream/clickstream-enwiki-2023-08.tsv.gz,Tunnel,4599,8126,136,12861,3458
hdfs://spark-nn.eemcs.utwente.nl/user/s1934538/clickstream/clickstream-enwiki-2023-08.tsv.gz,XXXTentacion,55848,1126497,5133,1187478,100242
hdfs://spark-nn.eemcs.utwente.nl/user/s1934538/clickstream/clickstream-enwiki-2023-08.tsv.gz,Watts_family_murders,6231,167124,366,173721,50138
hdfs://spark-nn.eemcs.utwente.nl/user/s1934538/clickstream/clickstream-enwiki-2023-08.tsv.gz,Cook's_Country,397,1715,21,2133,463
hdfs://spark-nn.eemcs.utwente.nl/user/s1934538/clickstream/clickstream-enwiki-2023-08.tsv.gz,Adipurush,120159,549363,2598,672120,294965
hdfs://spark-nn.eemcs.utwente.nl/user/s1934538/clickstream/clickstream-enwiki-2023-08.tsv.gz,Central_Park_jogger_case,13727,59780,235,73742,23846
hdfs://spark-nn.eemcs.utwente.nl/user/s1934538/clickstream/clickstream-enwiki-2023-08.tsv.gz,Burt_Reynolds,59704,145569,1096,206369,106860
hdfs://spark-nn.eemcs.utwente.nl/user/s1934538/clickstream/clickstream-enwiki-2023-08.tsv.gz,Charles_III,335825,206547,2863,545235,360120
hdfs://spark-nn.eemcs.utwente.nl/user/s1934538/clickstream/clickstream-enwiki-2023-08.tsv.gz,Christopher_Scarver,57342,34518,22,91882,35099
hdfs://spark-nn.eemcs.utwente.nl/user/s1934538/clickstream/clickstream-enwiki-2023-08.tsv.gz,Manti_Te'o,8834,240207,889,249930,30634
hdfs://spark-nn.eemcs.utwente.nl/user/s1934538/clickstream/clickstream-enwiki-2023-08.tsv.gz,Jimmy_Hoffa,33561,133269,901,167731,64008
hdfs://spark-nn.eemcs.utwente.nl/user/s1934538/clickstream/clickstream-enwiki-2023-08.tsv.gz,Avatar:_The_Way_of_Water,104278,280696,4824,389798,202305
hdfs://spark-nn.eemcs.utwente.nl/user/s1934538/clickstream/clickstream-enwiki-2023-08.tsv.gz,Anne_Heche,52368,162981,902,216251,78920
hdfs://spark-nn.eemcs.utwente.nl/user/s1934538/clickstream/clickstream-enwiki-2023-08.tsv.gz,NATO,63644,170266,4172,238082,115522
hdfs://spark-nn.eemcs.utwente.nl/user/s1934538/clickstream/clickstream-enwiki-2023-08.tsv.gz,Kelly_Preston,88008,73394,271,161673,50227
hdfs://spark-nn.eemcs.utwente.nl/user/s1934538/clickstream/clickstream-enwiki-2023-08.tsv.gz,Venom_(2018_film),19033,69224,835,89092,38535
hdfs://spark-nn.eemcs.utwente.nl/user/s1934538/clickstream/clickstream-enwiki-2023-08.tsv.gz,Glass_(2019_film),40420,54189,342,94951,33055
hdfs://spark-nn.eemcs.utwente.nl/user/s1934538/clickstream/clickstream-enwiki-2023-08.tsv.gz,It_Chapter_Two,29146,39850,365,69361,38884
hdfs://spark-nn.eemcs.utwente.nl/user/s1934538/clickstream/clickstream-enwiki-2023-08.tsv.gz,Kobe_Bryant,62424,505610,3477,571511,143019
hdfs://spark-nn.eemcs.utwente.nl/user/s1934538/clickstream/clickstream-enwiki-2023-08.tsv.gz,Jurassic_World_Dominion,77272,120156,1136,198564,115358
hdfs://spark-nn.eemcs.utwente.nl/user/s1934538/clickstream/clickstream-enwiki-2023-08.tsv.gz,Avengers:_Endgame,91822,144065,2046,237933,111147
hdfs://spark-nn.eemcs.utwente.nl/user/s1934538/clickstream/clickstream-enwiki-2023-08.tsv.gz,Hyphen-minus,808,4937216,21882,4959906,929
hdfs://spark-nn.eemcs.utwente.nl/user/s1934538/clickstream/clickstream-enwiki-2023-08.tsv.gz,Emma_Raducanu,9772,71338,370,81480,15335
hdfs://spark-nn.eemcs.utwente.nl/user/s1934538/clickstream/clickstream-enwiki-2023-08.tsv.gz,Army_of_the_Dead,48580,41644,421,90645,47332
hdfs://spark-nn.eemcs.utwente.nl/user/s1934538/clickstream/clickstream-enwiki-2023-08.tsv.gz,September_11_attacks,120832,356068,5091,481991,337414
hdfs://spark-nn.eemcs.utwente.nl/user/s1934538/clickstream/clickstream-enwiki-2023-08.tsv.gz,Aaron_Hernandez,30379,217232,1185,248796,81701
hdfs://spark-nn.eemcs.utwente.nl/user/s1934538/clickstream/clickstream-enwiki-2023-08.tsv.gz,List_of_highest-grossing_films,227797,769970,4549,1002316,486126
hdfs://spark-nn.eemcs.utwente.nl/user/s1934538/clickstream/clickstream-enwiki-2023-08.tsv.gz,Jailer_(2023_Tamil_film),449644,4983461,33261,5466366,375904
hdfs://spark-nn.eemcs.utwente.nl/user/s1934538/clickstream/clickstream-enwiki-2023-08.tsv.gz,Mission:_Impossible_–_Dead_Reckoning_Part_One,333872,1115542,39498,1488912,749991
hdfs://spark-nn.eemcs.utwente.nl/user/s1934538/clickstream/clickstream-enwiki-2023-08.tsv.gz,Dark_Phoenix_(film),39288,35778,289,75355,39731
hdfs://spark-nn.eemcs.utwente.nl/user/s1934538/clickstream/clickstream-enwiki-2023-08.tsv.gz,Jenna_Ortega,76394,345772,3804,425970,121377
hdfs://spark-nn.eemcs.utwente.nl/user/s1934538/clickstream/clickstream-enwiki-2023-08.tsv.gz,Murder_of_Dee_Dee_Blanchard,16016,76426,245,92687,22057
hdfs://spark-nn.eemcs.utwente.nl/user/s1934538/clickstream/clickstream-enwiki-2023-08.tsv.gz,Matthew_Perry,46715,143282,941,190938,94062
hdfs://spark-nn.eemcs.utwente.nl/user/s1934538/clickstream/clickstream-enwiki-2023-08.tsv.gz,Kylian_Mbappé,67678,580477,3588,651743,106534
hdfs://spark-nn.eemcs.utwente.nl/user/s1934538/clickstream/clickstream-enwiki-2023-08.tsv.gz,2018_Asian_Games,16119,8904,37,25060,27317
hdfs://spark-nn.eemcs.utwente.nl/user/s1934538/clickstream/clickstream-enwiki-2023-10.tsv.gz,Tonya_Harding,22327,82000,455,104782,27323
hdfs://spark-nn.eemcs.utwente.nl/user/s1934538/clickstream/clickstream-enwiki-2023-10.tsv.gz,Black_Panther_(film),22296,69461,686,92443,38109
hdfs://spark-nn.eemcs.utwente.nl/user/s1934538/clickstream/clickstream-enwiki-2023-10.tsv.gz,Sinéad_O'Connor,22061,204267,2390,228718,64112
hdfs://spark-nn.eemcs.utwente.nl/user/s1934538/clickstream/clickstream-enwiki-2023-10.tsv.gz,Priyanka_Chopra,96140,287817,547,384504,115154
hdfs://spark-nn.eemcs.utwente.nl/user/s1934538/clickstream/clickstream-enwiki-2023-10.tsv.gz,Aretha_Franklin,20383,85807,726,106916,49051
hdfs://spark-nn.eemcs.utwente.nl/user/s1934538/clickstream/clickstream-enwiki-2023-10.tsv.gz,Charles_Sobhraj,8401,37731,68,46200,11199
hdfs://spark-nn.eemcs.utwente.nl/user/s1934538/clickstream/clickstream-enwiki-2023-10.tsv.gz,John_McCain,39523,68032,632,108187,59000
hdfs://spark-nn.eemcs.utwente.nl/user/s1934538/clickstream/clickstream-enwiki-2023-10.tsv.gz,Oppenheimer_(film),190075,1055493,17587,1263155,507894
hdfs://spark-nn.eemcs.utwente.nl/user/s1934538/clickstream/clickstream-enwiki-2023-10.tsv.gz,Taliban,73887,112934,1806,188627,139025
hdfs://spark-nn.eemcs.utwente.nl/user/s1934538/clickstream/clickstream-enwiki-2023-10.tsv.gz,Microsoft_Office,5115,326309,521,331945,17299
hdfs://spark-nn.eemcs.utwente.nl/user/s1934538/clickstream/clickstream-enwiki-2023-10.tsv.gz,Jurassic_World_Dominion,44505,75405,760,120670,70206
hdfs://spark-nn.eemcs.utwente.nl/user/s1934538/clickstream/clickstream-enwiki-2023-10.tsv.gz,Animal_(2023_film),66934,344559,434,411927,185887
hdfs://spark-nn.eemcs.utwente.nl/user/s1934538/clickstream/clickstream-enwiki-2023-10.tsv.gz,Michael_Jordan,72203,385082,3155,460440,140038
hdfs://spark-nn.eemcs.utwente.nl/user/s1934538/clickstream/clickstream-enwiki-2023-10.tsv.gz,Israel,1137179,5772481,80457,6990117,3217457
hdfs://spark-nn.eemcs.utwente.nl/user/s1934538/clickstream/clickstream-enwiki-2023-10.tsv.gz,Black_Adam_(film),27803,79077,842,107722,43917
hdfs://spark-nn.eemcs.utwente.nl/user/s1934538/clickstream/clickstream-enwiki-2023-10.tsv.gz,XHamster,10417,443542,5767,459726,39551
hdfs://spark-nn.eemcs.utwente.nl/user/s1934538/clickstream/clickstream-enwiki-2023-10.tsv.gz,COVID-19_pandemic_by_country_and_territory,4607,25625,380,30612,7072
hdfs://spark-nn.eemcs.utwente.nl/user/s1934538/clickstream/clickstream-enwiki-2023-10.tsv.gz,Tunnel,4331,9700,120,14151,3888
hdfs://spark-nn.eemcs.utwente.nl/user/s1934538/clickstream/clickstream-enwiki-2023-10.tsv.gz,The_Weeknd,53231,188426,1593,243250,104272
hdfs://spark-nn.eemcs.utwente.nl/user/s1934538/clickstream/clickstream-enwiki-2023-10.tsv.gz,Squid_Game,28399,168208,2379,198986,89421
hdfs://spark-nn.eemcs.utwente.nl/user/s1934538/clickstream/clickstream-enwiki-2023-10.tsv.gz,A_Star_Is_Born_(2018_film),20903,55375,321,76599,35696
hdfs://spark-nn.eemcs.utwente.nl/user/s1934538/clickstream/clickstream-enwiki-2023-10.tsv.gz,1234,63,3639,28,3730,208
hdfs://spark-nn.eemcs.utwente.nl/user/s1934538/clickstream/clickstream-enwiki-2023-10.tsv.gz,Adipurush,46886,200828,527,248241,57591
hdfs://spark-nn.eemcs.utwente.nl/user/s1934538/clickstream/clickstream-enwiki-2023-10.tsv.gz,The_Shape_of_Water,21444,52671,368,74483,30777
hdfs://spark-nn.eemcs.utwente.nl/user/s1934538/clickstream/clickstream-enwiki-2023-10.tsv.gz,Gadar_2,75676,477178,1803,554657,190237
hdfs://spark-nn.eemcs.utwente.nl/user/s1934538/clickstream/clickstream-enwiki-2023-10.tsv.gz,Simple_Mail_Transfer_Protocol,2623,26589,123,29335,2886
hdfs://spark-nn.eemcs.utwente.nl/user/s1934538/clickstream/clickstream-enwiki-2023-10.tsv.gz,Army_of_the_Dead,30009,28949,273,59231,31825
hdfs://spark-nn.eemcs.utwente.nl/user/s1934538/clickstream/clickstream-enwiki-2023-10.tsv.gz,The_Lion_King_(2019_film),30822,82502,388,113712,39248
hdfs://spark-nn.eemcs.utwente.nl/user/s1934538/clickstream/clickstream-enwiki-2023-10.tsv.gz,Kenosha_unrest_shooting,7307,16703,90,24100,6357
hdfs://spark-nn.eemcs.utwente.nl/user/s1934538/clickstream/clickstream-enwiki-2023-10.tsv.gz,Royal_Rumble_(2018),5056,3086,39,8181,6321
hdfs://spark-nn.eemcs.utwente.nl/user/s1934538/clickstream/clickstream-enwiki-2023-10.tsv.gz,Avengers:_Endgame,63295,132591,1577,197463,90118
hdfs://spark-nn.eemcs.utwente.nl/user/s1934538/clickstream/clickstream-enwiki-2023-10.tsv.gz,Emma_Raducanu,3821,49326,280,53427,8804
hdfs://spark-nn.eemcs.utwente.nl/user/s1934538/clickstream/clickstream-enwiki-2023-10.tsv.gz,"Meghan,_Duchess_of_Sussex",65301,278013,1582,344896,171907
hdfs://spark-nn.eemcs.utwente.nl/user/s1934538/clickstream/clickstream-enwiki-2023-10.tsv.gz,Freddie_Mercury,71353,354575,2582,428510,164437
hdfs://spark-nn.eemcs.utwente.nl/user/s1934538/clickstream/clickstream-enwiki-2023-10.tsv.gz,List_of_Queen_of_the_South_episodes,4037,3154,37,7228,160
hdfs://spark-nn.eemcs.utwente.nl/user/s1934538/clickstream/clickstream-enwiki-2023-10.tsv.gz,Lisa_Marie_Presley,239527,194257,709,434493,261562
hdfs://spark-nn.eemcs.utwente.nl/user/s1934538/clickstream/clickstream-enwiki-2023-10.tsv.gz,Area_51,15050,102091,851,117992,37421
hdfs://spark-nn.eemcs.utwente.nl/user/s1934538/clickstream/clickstream-enwiki-2023-10.tsv.gz,Zack_Snyder's_Justice_League,31009,46040,293,77342,29942
hdfs://spark-nn.eemcs.utwente.nl/user/s1934538/clickstream/clickstream-enwiki-2023-10.tsv.gz,Avicii,17977,150696,989,169662,50233
hdfs://spark-nn.eemcs.utwente.nl/user/s1934538/clickstream/clickstream-enwiki-2023-10.tsv.gz,Louis_Tomlinson,29848,46260,220,76328,20155
hdfs://spark-nn.eemcs.utwente.nl/user/s1934538/clickstream/clickstream-enwiki-2023-10.tsv.gz,Adele,48197,226598,4811,279606,123217
hdfs://spark-nn.eemcs.utwente.nl/user/s1934538/clickstream/clickstream-enwiki-2023-10.tsv.gz,List_of_James_Bond_films,67114,432364,2025,501503,324367
hdfs://spark-nn.eemcs.utwente.nl/user/s1934538/clickstream/clickstream-enwiki-2023-10.tsv.gz,XXX:_Return_of_Xander_Cage,59864,5217587,1511,5278962,215540
hdfs://spark-nn.eemcs.utwente.nl/user/s1934538/clickstream/clickstream-enwiki-2023-10.tsv.gz,Olivia_Newton-John,27953,126361,1101,155415,68326
hdfs://spark-nn.eemcs.utwente.nl/user/s1934538/clickstream/clickstream-enwiki-2023-10.tsv.gz,Amber_Heard,85599,192595,1352,279546,126258
hdfs://spark-nn.eemcs.utwente.nl/user/s1934538/clickstream/clickstream-enwiki-2023-10.tsv.gz,Shinzo_Abe,38687,73037,1031,112755,78941
hdfs://spark-nn.eemcs.utwente.nl/user/s1934538/clickstream/clickstream-enwiki-2023-10.tsv.gz,COVID-19_pandemic,74902,183192,3697,261791,80857
hdfs://spark-nn.eemcs.utwente.nl/user/s1934538/clickstream/clickstream-enwiki-2023-10.tsv.gz,UEFA_Euro_2020,76040,67318,1391,144749,83948
hdfs://spark-nn.eemcs.utwente.nl/user/s1934538/clickstream/clickstream-enwiki-2023-10.tsv.gz,United_States_Senate,78421,73005,1326,152752,75446
hdfs://spark-nn.eemcs.utwente.nl/user/s1934538/clickstream/clickstream-enwiki-2023-10.tsv.gz,Grover,1062,7835,29,8926,1562
hdfs://spark-nn.eemcs.utwente.nl/user/s1934538/clickstream/clickstream-enwiki-2023-10.tsv.gz,The_Last_of_Us_(TV_series),48159,259275,3226,310660,102451
hdfs://spark-nn.eemcs.utwente.nl/user/s1934538/clickstream/clickstream-enwiki-2023-10.tsv.gz,"Princess_Margaret,_Countess_of_Snowdon",60305,129585,1049,190939,112807
hdfs://spark-nn.eemcs.utwente.nl/user/s1934538/clickstream/clickstream-enwiki-2023-10.tsv.gz,List_of_awards_and_nominations_received_by_Meryl_Streep,8679,8186,119,16984,7799
hdfs://spark-nn.eemcs.utwente.nl/user/s1934538/clickstream/clickstream-enwiki-2023-10.tsv.gz,List_of_FIFA_World_Cup_finals,4946,106874,60,111880,25341
hdfs://spark-nn.eemcs.utwente.nl/user/s1934538/clickstream/clickstream-enwiki-2023-10.tsv.gz,William_Murdoch,637,1490,12,2139,318
hdfs://spark-nn.eemcs.utwente.nl/user/s1934538/clickstream/clickstream-enwiki-2023-10.tsv.gz,Jimmy_Buffett,13462,133896,1884,149242,58849
hdfs://spark-nn.eemcs.utwente.nl/user/s1934538/clickstream/clickstream-enwiki-2023-10.tsv.gz,HTTP_cookie,2166,352231,144,354541,18776
hdfs://spark-nn.eemcs.utwente.nl/user/s1934538/clickstream/clickstream-enwiki-2023-10.tsv.gz,The_Batman_(film),61895,164367,2430,228692,118369
hdfs://spark-nn.eemcs.utwente.nl/user/s1934538/clickstream/clickstream-enwiki-2023-10.tsv.gz,ICC_Men's_T20_World_Cup,60704,383422,4569,448695,173031
hdfs://spark-nn.eemcs.utwente.nl/user/s1934538/clickstream/clickstream-enwiki-2023-10.tsv.gz,Cameron_Boyce,27293,131549,357,159199,39296
hdfs://spark-nn.eemcs.utwente.nl/user/s1934538/clickstream/clickstream-enwiki-2023-10.tsv.gz,Pathaan_(film),107247,237288,1008,345543,78392
hdfs://spark-nn.eemcs.utwente.nl/user/s1934538/clickstream/clickstream-enwiki-2023-10.tsv.gz,Guardians_of_the_Galaxy_Vol._3,74590,231277,3051,308918,143635
hdfs://spark-nn.eemcs.utwente.nl/user/s1934538/clickstream/clickstream-enwiki-2023-10.tsv.gz,Spider-Man:_Far_From_Home,30900,40856,343,72099,27528
hdfs://spark-nn.eemcs.utwente.nl/user/s1934538/clickstream/clickstream-enwiki-2023-10.tsv.gz,Anna_Sorokin,55400,503336,740,559476,236403
hdfs://spark-nn.eemcs.utwente.nl/user/s1934538/clickstream/clickstream-enwiki-2023-10.tsv.gz,Barbie_(film),179399,556381,12600,748380,520365
hdfs://spark-nn.eemcs.utwente.nl/user/s1934538/clickstream/clickstream-enwiki-2023-10.tsv.gz,Mulan_(2020_film),14346,35913,276,50535,23910
hdfs://spark-nn.eemcs.utwente.nl/user/s1934538/clickstream/clickstream-enwiki-2023-10.tsv.gz,Brett_Kavanaugh,14126,19937,87,34150,12997
hdfs://spark-nn.eemcs.utwente.nl/user/s1934538/clickstream/clickstream-enwiki-2023-10.tsv.gz,Juice_Wrld,26238,129711,1506,157455,62197
hdfs://spark-nn.eemcs.utwente.nl/user/s1934538/clickstream/clickstream-enwiki-2023-10.tsv.gz,Kylian_Mbappé,61406,373712,2837,437955,84604
hdfs://spark-nn.eemcs.utwente.nl/user/s1934538/clickstream/clickstream-enwiki-2023-10.tsv.gz,Volodymyr_Zelenskyy,59188,154887,2406,216481,101600
hdfs://spark-nn.eemcs.utwente.nl/user/s1934538/clickstream/clickstream-enwiki-2023-10.tsv.gz,Kelly_Preston,99571,151323,615,251509,76823
hdfs://spark-nn.eemcs.utwente.nl/user/s1934538/clickstream/clickstream-enwiki-2023-10.tsv.gz,Elizabeth_II,272846,412729,3601,689176,443637
hdfs://spark-nn.eemcs.utwente.nl/user/s1934538/clickstream/clickstream-enwiki-2023-10.tsv.gz,Ted_Bundy,24717,284482,3391,312590,70250
hdfs://spark-nn.eemcs.utwente.nl/user/s1934538/clickstream/clickstream-enwiki-2023-10.tsv.gz,Godzilla_vs._Kong,39065,68014,732,107811,60115
hdfs://spark-nn.eemcs.utwente.nl/user/s1934538/clickstream/clickstream-enwiki-2023-10.tsv.gz,Sylvester_Stallone,110073,416735,3347,530155,374925
hdfs://spark-nn.eemcs.utwente.nl/user/s1934538/clickstream/clickstream-enwiki-2023-10.tsv.gz,"Prince_Philip,_Duke_of_Edinburgh",104174,101908,860,206942,132263
hdfs://spark-nn.eemcs.utwente.nl/user/s1934538/clickstream/clickstream-enwiki-2023-10.tsv.gz,George_VI,233166,90300,553,324019,233160
hdfs://spark-nn.eemcs.utwente.nl/user/s1934538/clickstream/clickstream-enwiki-2023-10.tsv.gz,The_Kashmir_Files,18966,33258,709,52933,19477
hdfs://spark-nn.eemcs.utwente.nl/user/s1934538/clickstream/clickstream-enwiki-2023-10.tsv.gz,WrestleMania_34,11850,6488,77,18415,12345
hdfs://spark-nn.eemcs.utwente.nl/user/s1934538/clickstream/clickstream-enwiki-2023-10.tsv.gz,Dark_Phoenix_(film),31281,26839,206,58326,26607
hdfs://spark-nn.eemcs.utwente.nl/user/s1934538/clickstream/clickstream-enwiki-2023-10.tsv.gz,Donald_Trump,219677,626104,8631,854412,442358
hdfs://spark-nn.eemcs.utwente.nl/user/s1934538/clickstream/clickstream-enwiki-2023-10.tsv.gz,Chernobyl_disaster,35357,243172,2252,280781,115167
hdfs://spark-nn.eemcs.utwente.nl/user/s1934538/clickstream/clickstream-enwiki-2023-10.tsv.gz,Aquaman_(film),23615,85116,938,109669,42427
hdfs://spark-nn.eemcs.utwente.nl/user/s1934538/clickstream/clickstream-enwiki-2023-10.tsv.gz,Thor:_Love_and_Thunder,45029,77128,1055,123212,53671
hdfs://spark-nn.eemcs.utwente.nl/user/s1934538/clickstream/clickstream-enwiki-2023-10.tsv.gz,Dune_(2021_film),52384,235772,11670,299826,218471
hdfs://spark-nn.eemcs.utwente.nl/user/s1934538/clickstream/clickstream-enwiki-2023-10.tsv.gz,Wonder_Woman_1984,20836,47484,748,69068,32059
hdfs://spark-nn.eemcs.utwente.nl/user/s1934538/clickstream/clickstream-enwiki-2023-10.tsv.gz,Avengers:_Infinity_War,31870,56082,552,88504,40967
hdfs://spark-nn.eemcs.utwente.nl/user/s1934538/clickstream/clickstream-enwiki-2023-10.tsv.gz,Shakira,21662,204391,1832,227885,95631
hdfs://spark-nn.eemcs.utwente.nl/user/s1934538/clickstream/clickstream-enwiki-2023-10.tsv.gz,The_Umbrella_Academy_(TV_series),18050,63513,1217,82780,50123
hdfs://spark-nn.eemcs.utwente.nl/user/s1934538/clickstream/clickstream-enwiki-2023-10.tsv.gz,Deaths_in_2023,1443376,2613034,16493,4072903,2609720
hdfs://spark-nn.eemcs.utwente.nl/user/s1934538/clickstream/clickstream-enwiki-2023-10.tsv.gz,Jeffrey_Dahmer,33601,447283,4023,484907,182997
hdfs://spark-nn.eemcs.utwente.nl/user/s1934538/clickstream/clickstream-enwiki-2023-10.tsv.gz,List_of_Marvel_Cinematic_Universe_films,120781,418738,1267,540786,324894
hdfs://spark-nn.eemcs.utwente.nl/user/s1934538/clickstream/clickstream-enwiki-2023-10.tsv.gz,The_Sandman_(TV_series),27168,57063,801,85032,51348
hdfs://spark-nn.eemcs.utwente.nl/user/s1934538/clickstream/clickstream-enwiki-2023-10.tsv.gz,Puneeth_Rajkumar,21949,115090,69,137108,44383
hdfs://spark-nn.eemcs.utwente.nl/user/s1934538/clickstream/clickstream-enwiki-2023-10.tsv.gz,Henry_V_of_England,83241,108017,2752,194010,128027
hdfs://spark-nn.eemcs.utwente.nl/user/s1934538/clickstream/clickstream-enwiki-2023-10.tsv.gz,Rihanna,64287,262759,2496,329542,183860
hdfs://spark-nn.eemcs.utwente.nl/user/s1934538/clickstream/clickstream-enwiki-2023-10.tsv.gz,Rishi_Sunak,138069,515930,3426,657425,289075
hdfs://spark-nn.eemcs.utwente.nl/user/s1934538/clickstream/clickstream-enwiki-2023-10.tsv.gz,Cricket_World_Cup,86239,9934768,8021,10029028,653571
hdfs://spark-nn.eemcs.utwente.nl/user/s1934538/clickstream/clickstream-enwiki-2023-10.tsv.gz,Stan_Lee,33387,74711,932,109030,37996
hdfs://spark-nn.eemcs.utwente.nl/user/s1934538/clickstream/clickstream-enwiki-2023-10.tsv.gz,Afghanistan,175427,383620,6613,565660,380662
hdfs://spark-nn.eemcs.utwente.nl/user/s1934538/clickstream/clickstream-enwiki-2023-10.tsv.gz,Dunki_(film),125888,281643,2465,409996,235267
hdfs://spark-nn.eemcs.utwente.nl/user/s1934538/clickstream/clickstream-enwiki-2023-10.tsv.gz,Meat_Loaf,31320,104524,1055,136899,49792
hdfs://spark-nn.eemcs.utwente.nl/user/s1934538/clickstream/clickstream-enwiki-2023-10.tsv.gz,Media,32,1977,239,2248,1189
hdfs://spark-nn.eemcs.utwente.nl/user/s1934538/clickstream/clickstream-enwiki-2023-10.tsv.gz,R._Kelly,38004,130598,1349,169951,104173
hdfs://spark-nn.eemcs.utwente.nl/user/s1934538/clickstream/clickstream-enwiki-2023-10.tsv.gz,Aaron_Carter,29476,108469,955,138900,92968
hdfs://spark-nn.eemcs.utwente.nl/user/s1934538/clickstream/clickstream-enwiki-2023-10.tsv.gz,Central_Park_jogger_case,8671,36993,98,45762,13959
hdfs://spark-nn.eemcs.utwente.nl/user/s1934538/clickstream/clickstream-enwiki-2023-10.tsv.gz,The_Idol_(TV_series),34090,46653,687,81430,46230
hdfs://spark-nn.eemcs.utwente.nl/user/s1934538/clickstream/clickstream-enwiki-2023-10.tsv.gz,Richard_Jewell,9271,32208,146,41625,15240
hdfs://spark-nn.eemcs.utwente.nl/user/s1934538/clickstream/clickstream-enwiki-2023-10.tsv.gz,Christopher_Scarver,54410,28154,13,82577,28934
hdfs://spark-nn.eemcs.utwente.nl/user/s1934538/clickstream/clickstream-enwiki-2023-10.tsv.gz,Leave_the_World_Behind_(film),45433,205928,2110,253471,125617
hdfs://spark-nn.eemcs.utwente.nl/user/s1934538/clickstream/clickstream-enwiki-2023-10.tsv.gz,List_of_highest-grossing_Indian_films,287321,1089458,1838,1378617,536596
hdfs://spark-nn.eemcs.utwente.nl/user/s1934538/clickstream/clickstream-enwiki-2023-10.tsv.gz,WandaVision,16994,37758,566,55318,25372
hdfs://spark-nn.eemcs.utwente.nl/user/s1934538/clickstream/clickstream-enwiki-2023-10.tsv.gz,Atal_Bihari_Vajpayee,29496,54191,84,83771,28541
hdfs://spark-nn.eemcs.utwente.nl/user/s1934538/clickstream/clickstream-enwiki-2023-10.tsv.gz,Main_Page,81582,136669496,5048107,141799185,33017203
hdfs://spark-nn.eemcs.utwente.nl/user/s1934538/clickstream/clickstream-enwiki-2023-10.tsv.gz,Jeffrey_Epstein,48026,182968,1297,232291,105551
hdfs://spark-nn.eemcs.utwente.nl/user/s1934538/clickstream/clickstream-enwiki-2023-10.tsv.gz,Mortal_Kombat_(2021_film),25943,86728,1009,113680,89449
hdfs://spark-nn.eemcs.utwente.nl/user/s1934538/clickstream/clickstream-enwiki-2023-10.tsv.gz,Hamilton_(musical),24542,174491,1184,200217,115459
hdfs://spark-nn.eemcs.utwente.nl/user/s1934538/clickstream/clickstream-enwiki-2023-10.tsv.gz,The_Queen's_Gambit_(miniseries),18482,122389,718,141589,66831
hdfs://spark-nn.eemcs.utwente.nl/user/s1934538/clickstream/clickstream-enwiki-2023-10.tsv.gz,Eternals_(film),40945,78560,804,120309,78166
hdfs://spark-nn.eemcs.utwente.nl/user/s1934538/clickstream/clickstream-enwiki-2023-10.tsv.gz,Simone_Biles,44652,448912,3460,497024,226524
hdfs://spark-nn.eemcs.utwente.nl/user/s1934538/clickstream/clickstream-enwiki-2023-10.tsv.gz,Qasem_Soleimani,68883,118590,741,188214,111694
hdfs://spark-nn.eemcs.utwente.nl/user/s1934538/clickstream/clickstream-enwiki-2023-10.tsv.gz,Deion_Sanders,40340,524659,3960,568959,164512
hdfs://spark-nn.eemcs.utwente.nl/user/s1934538/clickstream/clickstream-enwiki-2023-10.tsv.gz,Key_frame,569,3043,10,3622,275
hdfs://spark-nn.eemcs.utwente.nl/user/s1934538/clickstream/clickstream-enwiki-2023-10.tsv.gz,Sushant_Singh_Rajput,23378,91773,99,115250,49771
hdfs://spark-nn.eemcs.utwente.nl/user/s1934538/clickstream/clickstream-enwiki-2023-10.tsv.gz,Ukraine,74050,282680,7435,364165,151883
hdfs://spark-nn.eemcs.utwente.nl/user/s1934538/clickstream/clickstream-enwiki-2023-10.tsv.gz,Top_Gun:_Maverick,67041,135783,2121,204945,134335
hdfs://spark-nn.eemcs.utwente.nl/user/s1934538/clickstream/clickstream-enwiki-2023-11.tsv.gz,Bird_Box_(film),11758,54362,506,66626,27432
hdfs://spark-nn.eemcs.utwente.nl/user/s1934538/clickstream/clickstream-enwiki-2023-11.tsv.gz,1234,46,4675684,122,4675852,2657
hdfs://spark-nn.eemcs.utwente.nl/user/s1934538/clickstream/clickstream-enwiki-2023-11.tsv.gz,Bridgerton,32504,108195,1705,142404,95935
hdfs://spark-nn.eemcs.utwente.nl/user/s1934538/clickstream/clickstream-enwiki-2023-11.tsv.gz,Leave_the_World_Behind_(film),37928,199756,1880,239564,66749
hdfs://spark-nn.eemcs.utwente.nl/user/s1934538/clickstream/clickstream-enwiki-2023-11.tsv.gz,UEFA_Euro_2020,74470,60327,704,135501,85418
hdfs://spark-nn.eemcs.utwente.nl/user/s1934538/clickstream/clickstream-enwiki-2023-11.tsv.gz,Fyre_Festival,5281,42776,372,48429,23727
hdfs://spark-nn.eemcs.utwente.nl/user/s1934538/clickstream/clickstream-enwiki-2023-11.tsv.gz,Kamala_Harris,71977,139853,1178,213008,101110
hdfs://spark-nn.eemcs.utwente.nl/user/s1934538/clickstream/clickstream-enwiki-2023-11.tsv.gz,Russo-Ukrainian_War,74282,334793,2924,411999,260912
hdfs://spark-nn.eemcs.utwente.nl/user/s1934538/clickstream/clickstream-enwiki-2023-11.tsv.gz,Saaho,17577,24177,55,41809,9697
hdfs://spark-nn.eemcs.utwente.nl/user/s1934538/clickstream/clickstream-enwiki-2023-11.tsv.gz,Freddie_Mercury,71484,403740,3162,478386,182453
hdfs://spark-nn.eemcs.utwente.nl/user/s1934538/clickstream/clickstream-enwiki-2023-11.tsv.gz,Bonnie_and_Clyde,19179,180186,929,200294,55746
hdfs://spark-nn.eemcs.utwente.nl/user/s1934538/clickstream/clickstream-enwiki-2023-11.tsv.gz,Microsoft_Office,5036,382853,467,388356,16326
hdfs://spark-nn.eemcs.utwente.nl/user/s1934538/clickstream/clickstream-enwiki-2023-11.tsv.gz,The_Lion_King_(2019_film),34385,66818,388,101591,38803
hdfs://spark-nn.eemcs.utwente.nl/user/s1934538/clickstream/clickstream-enwiki-2023-11.tsv.gz,Anna_Sorokin,30027,261909,477,292413,115634
hdfs://spark-nn.eemcs.utwente.nl/user/s1934538/clickstream/clickstream-enwiki-2023-11.tsv.gz,Main_Page,67632,139115469,4741514,143924615,31036112
hdfs://spark-nn.eemcs.utwente.nl/user/s1934538/clickstream/clickstream-enwiki-2023-11.tsv.gz,Central_Park_jogger_case,13403,72180,379,85962,26371
hdfs://spark-nn.eemcs.utwente.nl/user/s1934538/clickstream/clickstream-enwiki-2023-11.tsv.gz,2.0_(film),36086,46754,216,83056,15392
hdfs://spark-nn.eemcs.utwente.nl/user/s1934538/clickstream/clickstream-enwiki-2023-11.tsv.gz,The_Shape_of_Water,19247,44796,288,64331,25530
hdfs://spark-nn.eemcs.utwente.nl/user/s1934538/clickstream/clickstream-enwiki-2023-11.tsv.gz,Doctor_Strange_in_the_Multiverse_of_Madness,77151,123439,1607,202197,88228
hdfs://spark-nn.eemcs.utwente.nl/user/s1934538/clickstream/clickstream-enwiki-2023-11.tsv.gz,The_Falcon_and_the_Winter_Soldier,19841,23007,286,43134,23418
hdfs://spark-nn.eemcs.utwente.nl/user/s1934538/clickstream/clickstream-enwiki-2023-11.tsv.gz,Dunki_(film),110521,445541,2339,558401,253783
hdfs://spark-nn.eemcs.utwente.nl/user/s1934538/clickstream/clickstream-enwiki-2023-11.tsv.gz,Watts_family_murders,4706,195925,234,200865,37769
hdfs://spark-nn.eemcs.utwente.nl/user/s1934538/clickstream/clickstream-enwiki-2023-11.tsv.gz,Notre-Dame_de_Paris,17671,80231,720,98622,26088
hdfs://spark-nn.eemcs.utwente.nl/user/s1934538/clickstream/clickstream-enwiki-2023-11.tsv.gz,Chadwick_Boseman,32350,122833,617,155800,44918
hdfs://spark-nn.eemcs.utwente.nl/user/s1934538/clickstream/clickstream-enwiki-2023-11.tsv.gz,Laal_Singh_Chaddha,20051,44737,80,64868,21609
hdfs://spark-nn.eemcs.utwente.nl/user/s1934538/clickstream/clickstream-enwiki-2023-11.tsv.gz,2023_Asia_Cup,28919,154684,860,184463,33777
hdfs://spark-nn.eemcs.utwente.nl/user/s1934538/clickstream/clickstream-enwiki-2023-11.tsv.gz,Burt_Reynolds,49701,106580,892,157173,83652
hdfs://spark-nn.eemcs.utwente.nl/user/s1934538/clickstream/clickstream-enwiki-2023-11.tsv.gz,Rihanna,64284,305396,2659,372339,197544
hdfs://spark-nn.eemcs.utwente.nl/user/s1934538/clickstream/clickstream-enwiki-2023-11.tsv.gz,United_States_Senate,53640,53522,1285,108447,47491
hdfs://spark-nn.eemcs.utwente.nl/user/s1934538/clickstream/clickstream-enwiki-2023-11.tsv.gz,Ukraine,66724,225553,5923,298200,132944
hdfs://spark-nn.eemcs.utwente.nl/user/s1934538/clickstream/clickstream-enwiki-2023-11.tsv.gz,R._Kelly,36948,159773,1451,198172,121839
hdfs://spark-nn.eemcs.utwente.nl/user/s1934538/clickstream/clickstream-enwiki-2023-11.tsv.gz,Jenna_Ortega,92170,331502,4292,427964,167437
hdfs://spark-nn.eemcs.utwente.nl/user/s1934538/clickstream/clickstream-enwiki-2023-11.tsv.gz,The_Super_Mario_Bros._Movie,78277,240514,2808,321599,126492
hdfs://spark-nn.eemcs.utwente.nl/user/s1934538/clickstream/clickstream-enwiki-2023-11.tsv.gz,Sylvester_Stallone,223199,991709,7130,1222038,1123419
hdfs://spark-nn.eemcs.utwente.nl/user/s1934538/clickstream/clickstream-enwiki-2023-11.tsv.gz,Kate_Spade,25296,52660,268,78224,27394
hdfs://spark-nn.eemcs.utwente.nl/user/s1934538/clickstream/clickstream-enwiki-2023-11.tsv.gz,2022_FIFA_World_Cup,146900,265587,2845,415332,216470
hdfs://spark-nn.eemcs.utwente.nl/user/s1934538/clickstream/clickstream-enwiki-2023-11.tsv.gz,QAnon,61869,101770,553,164192,54516
hdfs://spark-nn.eemcs.utwente.nl/user/s1934538/clickstream/clickstream-enwiki-2023-11.tsv.gz,Elizabeth_II,381118,550552,7016,938686,676005
hdfs://spark-nn.eemcs.utwente.nl/user/s1934538/clickstream/clickstream-enwiki-2023-11.tsv.gz,2023_Israel–Hamas_war,1014218,1748573,11155,2773946,1870168
hdfs://spark-nn.eemcs.utwente.nl/user/s1934538/clickstream/clickstream-enwiki-2023-11.tsv.gz,Shakira,25392,306669,2591,334652,133916
hdfs://spark-nn.eemcs.utwente.nl/user/s1934538/clickstream/clickstream-enwiki-2023-11.tsv.gz,Shang-Chi_and_the_Legend_of_the_Ten_Rings,49788,75500,710,125998,57209
hdfs://spark-nn.eemcs.utwente.nl/user/s1934538/clickstream/clickstream-enwiki-2023-11.tsv.gz,The_Idol_(TV_series),36209,44916,437,81562,44534
hdfs://spark-nn.eemcs.utwente.nl/user/s1934538/clickstream/clickstream-enwiki-2023-11.tsv.gz,Zack_Snyder's_Justice_League,33557,50920,326,84803,32758
hdfs://spark-nn.eemcs.utwente.nl/user/s1934538/clickstream/clickstream-enwiki-2023-11.tsv.gz,Israel,323312,1212989,24989,1561290,756305
hdfs://spark-nn.eemcs.utwente.nl/user/s1934538/clickstream/clickstream-enwiki-2023-11.tsv.gz,XXX:_Return_of_Xander_Cage,76907,3250425,1463,3328795,138870
hdfs://spark-nn.eemcs.utwente.nl/user/s1934538/clickstream/clickstream-enwiki-2023-11.tsv.gz,Bipin_Rawat,7814,15336,23,23173,10646
hdfs://spark-nn.eemcs.utwente.nl/user/s1934538/clickstream/clickstream-enwiki-2023-11.tsv.gz,Antifa_(United_States),9599,51596,209,61404,10657
hdfs://spark-nn.eemcs.utwente.nl/user/s1934538/clickstream/clickstream-enwiki-2023-11.tsv.gz,Thor:_Love_and_Thunder,72401,109930,1354,183685,80413
hdfs://spark-nn.eemcs.utwente.nl/user/s1934538/clickstream/clickstream-enwiki-2023-11.tsv.gz,Wikipedia,248169,1245960,1213,1495342,607433
hdfs://spark-nn.eemcs.utwente.nl/user/s1934538/clickstream/clickstream-enwiki-2023-11.tsv.gz,2023_Indian_Premier_League,24239,89370,172,113781,39125
hdfs://spark-nn.eemcs.utwente.nl/user/s1934538/clickstream/clickstream-enwiki-2023-11.tsv.gz,Critical_race_theory,10528,54794,320,65642,8775
hdfs://spark-nn.eemcs.utwente.nl/user/s1934538/clickstream/clickstream-enwiki-2023-11.tsv.gz,Kobe_Bryant,54085,297707,2096,353888,102968
hdfs://spark-nn.eemcs.utwente.nl/user/s1934538/clickstream/clickstream-enwiki-2023-11.tsv.gz,John_McCain,36349,62946,795,100090,54123
hdfs://spark-nn.eemcs.utwente.nl/user/s1934538/clickstream/clickstream-enwiki-2023-11.tsv.gz,Deaths_in_2023,1240983,2503150,14892,3759025,2389313
hdfs://spark-nn.eemcs.utwente.nl/user/s1934538/clickstream/clickstream-enwiki-2023-11.tsv.gz,Dennis_Nilsen,8916,39636,257,48809,11806
hdfs://spark-nn.eemcs.utwente.nl/user/s1934538/clickstream/clickstream-enwiki-2023-11.tsv.gz,Media,26,1853,213,2092,1005
hdfs://spark-nn.eemcs.utwente.nl/user/s1934538/clickstream/clickstream-enwiki-2023-11.tsv.gz,Aquaman_(film),24791,117061,1271,143123,61083
hdfs://spark-nn.eemcs.utwente.nl/user/s1934538/clickstream/clickstream-enwiki-2023-11.tsv.gz,Deion_Sanders,27281,236646,1450,265377,77671
hdfs://spark-nn.eemcs.utwente.nl/user/s1934538/clickstream/clickstream-enwiki-2023-11.tsv.gz,Amber_Heard,135629,146682,972,283283,112430
hdfs://spark-nn.eemcs.utwente.nl/user/s1934538/clickstream/clickstream-enwiki-2023-11.tsv.gz,"Princess_Margaret,_Countess_of_Snowdon",111979,288686,1980,402645,235491
hdfs://spark-nn.eemcs.utwente.nl/user/s1934538/clickstream/clickstream-enwiki-2023-11.tsv.gz,Animal_(2023_film),125733,1304695,3817,1434245,676953
hdfs://spark-nn.eemcs.utwente.nl/user/s1934538/clickstream/clickstream-enwiki-2023-11.tsv.gz,Ponniyin_Selvan:_I,29890,44024,114,74028,32851
hdfs://spark-nn.eemcs.utwente.nl/user/s1934538/clickstream/clickstream-enwiki-2023-11.tsv.gz,Star_Wars:_The_Rise_of_Skywalker,58067,43124,899,102090,52838
hdfs://spark-nn.eemcs.utwente.nl/user/s1934538/clickstream/clickstream-enwiki-2023-11.tsv.gz,Sinéad_O'Connor,32156,217322,2495,251973,71923
hdfs://spark-nn.eemcs.utwente.nl/user/s1934538/clickstream/clickstream-enwiki-2023-11.tsv.gz,2018_Winter_Olympics,9931,7642,86,17659,11923
hdfs://spark-nn.eemcs.utwente.nl/user/s1934538/clickstream/clickstream-enwiki-2023-11.tsv.gz,Queen_(band),47153,157568,2423,207144,201328
hdfs://spark-nn.eemcs.utwente.nl/user/s1934538/clickstream/clickstream-enwiki-2023-11.tsv.gz,Anne_Heche,41430,127900,893,170223,63373
hdfs://spark-nn.eemcs.utwente.nl/user/s1934538/clickstream/clickstream-enwiki-2023-11.tsv.gz,Shinzo_Abe,38377,62557,824,101758,71173
hdfs://spark-nn.eemcs.utwente.nl/user/s1934538/clickstream/clickstream-enwiki-2023-11.tsv.gz,The_Matrix_Resurrections,45699,57459,764,103922,47268
hdfs://spark-nn.eemcs.utwente.nl/user/s1934538/clickstream/clickstream-enwiki-2023-11.tsv.gz,2018_FIFA_World_Cup,71567,52316,531,124414,86938
hdfs://spark-nn.eemcs.utwente.nl/user/s1934538/clickstream/clickstream-enwiki-2023-11.tsv.gz,Lists_of_deaths_by_year,16817,157946,637,175400,85295
hdfs://spark-nn.eemcs.utwente.nl/user/s1934538/clickstream/clickstream-enwiki-2023-11.tsv.gz,Joaquin_Phoenix,235440,451466,4014,690920,468096
hdfs://spark-nn.eemcs.utwente.nl/user/s1934538/clickstream/clickstream-enwiki-2023-11.tsv.gz,Joe_Exotic,22320,54603,237,77160,35851
hdfs://spark-nn.eemcs.utwente.nl/user/s1934538/clickstream/clickstream-enwiki-2023-11.tsv.gz,Us_(2019_film),21548,85485,1367,108400,33307
hdfs://spark-nn.eemcs.utwente.nl/user/s1934538/clickstream/clickstream-enwiki-2023-11.tsv.gz,ICC_Men's_T20_World_Cup,117231,1370742,11882,1499855,373813
hdfs://spark-nn.eemcs.utwente.nl/user/s1934538/clickstream/clickstream-enwiki-2023-11.tsv.gz,Henry_V_of_England,82897,87560,464,170921,118387
hdfs://spark-nn.eemcs.utwente.nl/user/s1934538/clickstream/clickstream-enwiki-2023-11.tsv.gz,The_Weeknd,47496,156499,1360,205355,90466
hdfs://spark-nn.eemcs.utwente.nl/user/s1934538/clickstream/clickstream-enwiki-2023-11.tsv.gz,List_of_FIFA_World_Cup_finals,4066,149044,77,153187,26098
hdfs://spark-nn.eemcs.utwente.nl/user/s1934538/clickstream/clickstream-enwiki-2023-11.tsv.gz,Ghislaine_Maxwell,56020,96806,389,153215,69998
hdfs://spark-nn.eemcs.utwente.nl/user/s1934538/clickstream/clickstream-enwiki-2023-11.tsv.gz,Cook's_Country,401,2868,35,3304,501
hdfs://spark-nn.eemcs.utwente.nl/user/s1934538/clickstream/clickstream-enwiki-2023-11.tsv.gz,Chernobyl_disaster,40802,295002,2551,338355,127279
hdfs://spark-nn.eemcs.utwente.nl/user/s1934538/clickstream/clickstream-enwiki-2023-11.tsv.gz,Jeffrey_Dahmer,28104,399709,3951,431764,174602
hdfs://spark-nn.eemcs.utwente.nl/user/s1934538/clickstream/clickstream-enwiki-2023-11.tsv.gz,Google_logo,1612,19936,54,21602,1674
hdfs://spark-nn.eemcs.utwente.nl/user/s1934538/clickstream/clickstream-enwiki-2023-11.tsv.gz,The_Batman_(film),70216,178673,2899,251788,131973
hdfs://spark-nn.eemcs.utwente.nl/user/s1934538/clickstream/clickstream-enwiki-2023-11.tsv.gz,Bible,25020,102306,1753,129079,40962
hdfs://spark-nn.eemcs.utwente.nl/user/s1934538/clickstream/clickstream-enwiki-2023-11.tsv.gz,Taliban,47086,75316,769,123171,95240
hdfs://spark-nn.eemcs.utwente.nl/user/s1934538/clickstream/clickstream-enwiki-2023-11.tsv.gz,When_They_See_Us,11294,17509,69,28872,13101
hdfs://spark-nn.eemcs.utwente.nl/user/s1934538/clickstream/clickstream-enwiki-2023-11.tsv.gz,Mission:_Impossible_–_Dead_Reckoning_Part_One,124043,330137,6537,460717,315237
hdfs://spark-nn.eemcs.utwente.nl/user/s1934538/clickstream/clickstream-enwiki-2023-11.tsv.gz,"Prince_Philip,_Duke_of_Edinburgh",170069,191707,10369,372145,231906
hdfs://spark-nn.eemcs.utwente.nl/user/s1934538/clickstream/clickstream-enwiki-2023-11.tsv.gz,Khabib_Nurmagomedov,54037,195491,1015,250543,138790
hdfs://spark-nn.eemcs.utwente.nl/user/s1934538/clickstream/clickstream-enwiki-2023-11.tsv.gz,Godzilla_vs._Kong,87037,128527,1341,216905,128153
hdfs://spark-nn.eemcs.utwente.nl/user/s1934538/clickstream/clickstream-enwiki-2023-11.tsv.gz,Sushant_Singh_Rajput,23890,100447,97,124434,53117
hdfs://spark-nn.eemcs.utwente.nl/user/s1934538/clickstream/clickstream-enwiki-2023-11.tsv.gz,Brett_Kavanaugh,14399,21417,123,35939,13324
hdfs://spark-nn.eemcs.utwente.nl/user/s1934538/clickstream/clickstream-enwiki-2023-11.tsv.gz,Glass_(2019_film),40755,43060,189,84004,27197
hdfs://spark-nn.eemcs.utwente.nl/user/s1934538/clickstream/clickstream-enwiki-2023-11.tsv.gz,Murder_of_Dee_Dee_Blanchard,17365,335675,905,353945,71884
hdfs://spark-nn.eemcs.utwente.nl/user/s1934538/clickstream/clickstream-enwiki-2023-11.tsv.gz,Pathaan_(film),135505,264661,707,400873,107123
hdfs://spark-nn.eemcs.utwente.nl/user/s1934538/clickstream/clickstream-enwiki-2023-11.tsv.gz,Spider-Man:_No_Way_Home,102452,151945,1616,256013,109017
hdfs://spark-nn.eemcs.utwente.nl/user/s1934538/clickstream/clickstream-enwiki-2023-11.tsv.gz,Joker_(2019_film),54448,168760,1474,224682,101274
hdfs://spark-nn.eemcs.utwente.nl/user/s1934538/clickstream/clickstream-enwiki-2023-11.tsv.gz,Tonya_Harding,18609,68577,420,87606,22844
hdfs://spark-nn.eemcs.utwente.nl/user/s1934538/clickstream/clickstream-enwiki-2023-11.tsv.gz,Everything_Everywhere_All_at_Once,72995,196410,2329,271734,117130
hdfs://spark-nn.eemcs.utwente.nl/user/s1934538/clickstream/clickstream-enwiki-2023-11.tsv.gz,COVID-19_pandemic_by_country_and_territory,4571,17049,379,21999,7095
hdfs://spark-nn.eemcs.utwente.nl/user/s1934538/clickstream/clickstream-enwiki-2023-11.tsv.gz,Richard_Jewell,6846,25992,123,32961,12875
hdfs://spark-nn.eemcs.utwente.nl/user/s1934538/clickstream/clickstream-enwiki-2023-11.tsv.gz,Vikram_(2022_film),78619,176633,968,256220,85174
hdfs://spark-nn.eemcs.utwente.nl/user/s1934538/clickstream/clickstream-enwiki-2023-11.tsv.gz,Richard_Ramirez,13960,128122,985,143067,48380
hdfs://spark-nn.eemcs.utwente.nl/user/s1934538/clickstream/clickstream-enwiki-2023-11.tsv.gz,Stranger_Things_(season_3),9224,16738,108,26070,14228
hdfs://spark-nn.eemcs.utwente.nl/user/s1934538/clickstream/clickstream-enwiki-2023-11.tsv.gz,Mac_Miller,20957,113595,916,135468,41215
hdfs://spark-nn.eemcs.utwente.nl/user/s1934538/clickstream/clickstream-enwiki-2023-11.tsv.gz,The_Nun_(2018_film),36170,159080,989,196239,110752
hdfs://spark-nn.eemcs.utwente.nl/user/s1934538/clickstream/clickstream-enwiki-2023-11.tsv.gz,Squid_Game,46733,487774,5135,539642,223608
hdfs://spark-nn.eemcs.utwente.nl/user/s1934538/clickstream/clickstream-enwiki-2023-11.tsv.gz,Crazy_Rich_Asians_(film),22109,81391,660,104160,79157
hdfs://spark-nn.eemcs.utwente.nl/user/s1934538/clickstream/clickstream-enwiki-2023-11.tsv.gz,List_of_Marvel_Cinematic_Universe_films,230789,642908,2927,876624,652456
hdfs://spark-nn.eemcs.utwente.nl/user/s1934538/clickstream/clickstream-enwiki-2023-11.tsv.gz,Tina_Turner,27716,261715,7324,296755,89486
hdfs://spark-nn.eemcs.utwente.nl/user/s1934538/clickstream/clickstream-enwiki-2023-11.tsv.gz,Naya_Rivera,37876,46990,160,85026,36802
hdfs://spark-nn.eemcs.utwente.nl/user/s1934538/clickstream/clickstream-enwiki-2023-11.tsv.gz,Dark_Phoenix_(film),40191,34522,317,75030,38127
hdfs://spark-nn.eemcs.utwente.nl/user/s1934538/clickstream/clickstream-enwiki-2023-11.tsv.gz,Michael_Jordan,98363,451210,3450,553023,186566
hdfs://spark-nn.eemcs.utwente.nl/user/s1934538/clickstream/clickstream-enwiki-2023-11.tsv.gz,Vladimir_Putin,89989,351217,4372,445578,217731
hdfs://spark-nn.eemcs.utwente.nl/user/s1934538/clickstream/clickstream-enwiki-2023-11.tsv.gz,Donald_Glover,38937,107718,864,147519,61871
hdfs://spark-nn.eemcs.utwente.nl/user/s1934538/clickstream/clickstream-enwiki-2023-11.tsv.gz,A_Star_Is_Born_(2018_film),22873,75032,452,98357,46865
hdfs://spark-nn.eemcs.utwente.nl/user/s1934538/clickstream/clickstream-enwiki-2023-11.tsv.gz,Fantastic_Beasts:_The_Crimes_of_Grindelwald,28299,28396,227,56922,30796
hdfs://spark-nn.eemcs.utwente.nl/user/s1934538/clickstream/clickstream-enwiki-2023-11.tsv.gz,Charles_Sobhraj,8378,56111,93,64582,14691
hdfs://spark-nn.eemcs.utwente.nl/user/s1934538/clickstream/clickstream-enwiki-2023-11.tsv.gz,2020_United_States_presidential_election,159614,164680,3478,327772,321243
hdfs://spark-nn.eemcs.utwente.nl/user/s1934538/clickstream/clickstream-enwiki-2023-11.tsv.gz,Juice_Wrld,26942,142036,1399,170377,66643
hdfs://spark-nn.eemcs.utwente.nl/user/s1934538/clickstream/clickstream-enwiki-2023-11.tsv.gz,Sridevi,31629,94213,286,126128,47712
hdfs://spark-nn.eemcs.utwente.nl/user/s1934538/clickstream/clickstream-enwiki-2023-11.tsv.gz,Priyanka_Chopra,79357,253430,441,333228,101098
hdfs://spark-nn.eemcs.utwente.nl/user/s1934538/clickstream/clickstream-enwiki-2018-11.tsv.gz,Fyre_Festival,2827,22325,120,25272,13518
hdfs://spark-nn.eemcs.utwente.nl/user/s1934538/clickstream/clickstream-enwiki-2018-11.tsv.gz,Elizabeth_II,455732,735326,6728,1197786,904421
hdfs://spark-nn.eemcs.utwente.nl/user/s1934538/clickstream/clickstream-enwiki-2018-11.tsv.gz,Death_of_Elisa_Lam,9674,70889,244,80807,20972
hdfs://spark-nn.eemcs.utwente.nl/user/s1934538/clickstream/clickstream-enwiki-2018-11.tsv.gz,Crazy_Rich_Asians_(film),94389,769647,8258,872294,938617
hdfs://spark-nn.eemcs.utwente.nl/user/s1934538/clickstream/clickstream-enwiki-2018-11.tsv.gz,Central_Park_jogger_case,4465,31789,180,36434,3832
hdfs://spark-nn.eemcs.utwente.nl/user/s1934538/clickstream/clickstream-enwiki-2018-11.tsv.gz,Deaths_in_2018,1137066,1885954,7904,3030924,1562118
hdfs://spark-nn.eemcs.utwente.nl/user/s1934538/clickstream/clickstream-enwiki-2018-11.tsv.gz,The_Umbrella_Academy_(TV_series),9241,7740,73,17054,7060
hdfs://spark-nn.eemcs.utwente.nl/user/s1934538/clickstream/clickstream-enwiki-2018-11.tsv.gz,Hyphen-minus,6112,32720015,8175507,40901634,953
hdfs://spark-nn.eemcs.utwente.nl/user/s1934538/clickstream/clickstream-enwiki-2018-11.tsv.gz,Tonya_Harding,34984,204594,835,240413,51934
hdfs://spark-nn.eemcs.utwente.nl/user/s1934538/clickstream/clickstream-enwiki-2018-11.tsv.gz,2020_Summer_Olympics,37681,87377,1160,126218,88994
hdfs://spark-nn.eemcs.utwente.nl/user/s1934538/clickstream/clickstream-enwiki-2018-11.tsv.gz,HTTP_cookie,5423,312115,135,317673,40467
hdfs://spark-nn.eemcs.utwente.nl/user/s1934538/clickstream/clickstream-enwiki-2018-11.tsv.gz,Christopher_Scarver,58322,19436,12,77770,25688
hdfs://spark-nn.eemcs.utwente.nl/user/s1934538/clickstream/clickstream-enwiki-2018-11.tsv.gz,September_11_attacks,68716,331890,2512,403118,153350
hdfs://spark-nn.eemcs.utwente.nl/user/s1934538/clickstream/clickstream-enwiki-2018-11.tsv.gz,Black_Panther_(film),81245,247445,4648,333338,219418
hdfs://spark-nn.eemcs.utwente.nl/user/s1934538/clickstream/clickstream-enwiki-2018-11.tsv.gz,Croatia,33417,118036,1792,153245,52604
hdfs://spark-nn.eemcs.utwente.nl/user/s1934538/clickstream/clickstream-enwiki-2018-11.tsv.gz,QAnon,5010,146130,596,151736,33933
hdfs://spark-nn.eemcs.utwente.nl/user/s1934538/clickstream/clickstream-enwiki-2018-11.tsv.gz,Donald_Trump,279412,1639976,20625,1940013,888632
hdfs://spark-nn.eemcs.utwente.nl/user/s1934538/clickstream/clickstream-enwiki-2018-11.tsv.gz,Wonder_Woman_1984,84256,35965,359,120580,69525
hdfs://spark-nn.eemcs.utwente.nl/user/s1934538/clickstream/clickstream-enwiki-2018-11.tsv.gz,Godzilla_vs._Kong,46537,18314,199,65050,52664
hdfs://spark-nn.eemcs.utwente.nl/user/s1934538/clickstream/clickstream-enwiki-2018-11.tsv.gz,Lionel_Messi,47854,457476,4581,509911,98225
hdfs://spark-nn.eemcs.utwente.nl/user/s1934538/clickstream/clickstream-enwiki-2018-11.tsv.gz,Nipsey_Hussle,14241,29664,322,44227,17470
hdfs://spark-nn.eemcs.utwente.nl/user/s1934538/clickstream/clickstream-enwiki-2018-11.tsv.gz,YouTube,107371,970895,10294,1088560,148572
hdfs://spark-nn.eemcs.utwente.nl/user/s1934538/clickstream/clickstream-enwiki-2018-11.tsv.gz,List_of_highest-grossing_Indian_films,81787,517582,1589,600958,287663
hdfs://spark-nn.eemcs.utwente.nl/user/s1934538/clickstream/clickstream-enwiki-2018-11.tsv.gz,Rami_Malek,400662,1828301,12738,2241701,669285
hdfs://spark-nn.eemcs.utwente.nl/user/s1934538/clickstream/clickstream-enwiki-2018-11.tsv.gz,Mulan_(2020_film),31698,38383,567,70648,81531
hdfs://spark-nn.eemcs.utwente.nl/user/s1934538/clickstream/clickstream-enwiki-2018-11.tsv.gz,Bible,17373,89491,1695,108559,33445
hdfs://spark-nn.eemcs.utwente.nl/user/s1934538/clickstream/clickstream-enwiki-2018-11.tsv.gz,Avengers:_Infinity_War,170151,383317,11086,564554,384478
hdfs://spark-nn.eemcs.utwente.nl/user/s1934538/clickstream/clickstream-enwiki-2018-11.tsv.gz,Kobe_Bryant_sexual_assault_case,2672,20471,25,23168,2599
hdfs://spark-nn.eemcs.utwente.nl/user/s1934538/clickstream/clickstream-enwiki-2018-11.tsv.gz,Jenna_Ortega,4877,14759,201,19837,3019
hdfs://spark-nn.eemcs.utwente.nl/user/s1934538/clickstream/clickstream-enwiki-2018-11.tsv.gz,United_States_Senate,191586,475199,5756,672541,255120
hdfs://spark-nn.eemcs.utwente.nl/user/s1934538/clickstream/clickstream-enwiki-2018-11.tsv.gz,Game_of_Thrones,88140,496563,13713,598416,393701
hdfs://spark-nn.eemcs.utwente.nl/user/s1934538/clickstream/clickstream-enwiki-2018-11.tsv.gz,Joker_(2019_film),75690,87237,458,163385,114364
hdfs://spark-nn.eemcs.utwente.nl/user/s1934538/clickstream/clickstream-enwiki-2018-11.tsv.gz,Hamas,16347,47915,601,64863,23398
hdfs://spark-nn.eemcs.utwente.nl/user/s1934538/clickstream/clickstream-enwiki-2018-11.tsv.gz,Glass_(2019_film),74368,103129,1088,178585,83209
hdfs://spark-nn.eemcs.utwente.nl/user/s1934538/clickstream/clickstream-enwiki-2018-11.tsv.gz,Ruth_Bader_Ginsburg,65493,610811,4118,680422,216004
hdfs://spark-nn.eemcs.utwente.nl/user/s1934538/clickstream/clickstream-enwiki-2018-11.tsv.gz,George_H._W._Bush,145662,179978,622,326262,170224
hdfs://spark-nn.eemcs.utwente.nl/user/s1934538/clickstream/clickstream-enwiki-2018-11.tsv.gz,Charles_Sobhraj,3452,38298,138,41888,6260
hdfs://spark-nn.eemcs.utwente.nl/user/s1934538/clickstream/clickstream-enwiki-2018-11.tsv.gz,Michael_Bloomberg,38713,188436,1249,228398,83700
hdfs://spark-nn.eemcs.utwente.nl/user/s1934538/clickstream/clickstream-enwiki-2018-11.tsv.gz,2018_Asian_Games,10041,80248,218,90507,29386
hdfs://spark-nn.eemcs.utwente.nl/user/s1934538/clickstream/clickstream-enwiki-2018-11.tsv.gz,Lists_of_deaths_by_year,6571,103133,261,109965,98140
hdfs://spark-nn.eemcs.utwente.nl/user/s1934538/clickstream/clickstream-enwiki-2018-11.tsv.gz,Bird_Box_(film),27831,56765,1052,85648,32151
hdfs://spark-nn.eemcs.utwente.nl/user/s1934538/clickstream/clickstream-enwiki-2018-11.tsv.gz,Brett_Kavanaugh,56895,155404,1565,213864,67863
hdfs://spark-nn.eemcs.utwente.nl/user/s1934538/clickstream/clickstream-enwiki-2018-11.tsv.gz,Alexander_Hamilton,71465,388344,2026,461835,163971
hdfs://spark-nn.eemcs.utwente.nl/user/s1934538/clickstream/clickstream-enwiki-2018-11.tsv.gz,Ted_Bundy,47094,413671,4419,465184,114788
hdfs://spark-nn.eemcs.utwente.nl/user/s1934538/clickstream/clickstream-enwiki-2018-11.tsv.gz,The_Nun_(2018_film),59240,476257,4920,540417,355678
hdfs://spark-nn.eemcs.utwente.nl/user/s1934538/clickstream/clickstream-enwiki-2018-11.tsv.gz,Anthony_Bourdain,16134,289617,2693,308444,80444
hdfs://spark-nn.eemcs.utwente.nl/user/s1934538/clickstream/clickstream-enwiki-2018-11.tsv.gz,List_of_James_Bond_films,12397,214045,290,226732,86247
hdfs://spark-nn.eemcs.utwente.nl/user/s1934538/clickstream/clickstream-enwiki-2018-11.tsv.gz,"Diana,_Princess_of_Wales",132625,276525,2235,411385,227960
hdfs://spark-nn.eemcs.utwente.nl/user/s1934538/clickstream/clickstream-enwiki-2018-11.tsv.gz,List_of_most_popular_websites,21878,84651,135,106664,43274
hdfs://spark-nn.eemcs.utwente.nl/user/s1934538/clickstream/clickstream-enwiki-2018-11.tsv.gz,Cardi_B,71023,616581,6794,694398,243503
hdfs://spark-nn.eemcs.utwente.nl/user/s1934538/clickstream/clickstream-enwiki-2018-11.tsv.gz,Freddie_Mercury,1212755,8571245,63480,9847480,4374866
hdfs://spark-nn.eemcs.utwente.nl/user/s1934538/clickstream/clickstream-enwiki-2018-11.tsv.gz,Salman_Rushdie,23699,53148,350,77197,33042
hdfs://spark-nn.eemcs.utwente.nl/user/s1934538/clickstream/clickstream-enwiki-2018-11.tsv.gz,Notre-Dame_de_Paris,9451,70139,467,80057,12920
hdfs://spark-nn.eemcs.utwente.nl/user/s1934538/clickstream/clickstream-enwiki-2018-11.tsv.gz,Ukraine,48192,209499,4999,262690,125817
hdfs://spark-nn.eemcs.utwente.nl/user/s1934538/clickstream/clickstream-enwiki-2018-11.tsv.gz,Manti_Te'o,7658,52901,157,60716,2855
hdfs://spark-nn.eemcs.utwente.nl/user/s1934538/clickstream/clickstream-enwiki-2018-11.tsv.gz,Grimes_(musician),41207,66327,555,108089,39422
hdfs://spark-nn.eemcs.utwente.nl/user/s1934538/clickstream/clickstream-enwiki-2018-11.tsv.gz,Tunnel,3949,14083,144,18176,3931
hdfs://spark-nn.eemcs.utwente.nl/user/s1934538/clickstream/clickstream-enwiki-2018-11.tsv.gz,Kim_Jong-un,37759,119332,959,158050,80551
hdfs://spark-nn.eemcs.utwente.nl/user/s1934538/clickstream/clickstream-enwiki-2018-11.tsv.gz,Burt_Reynolds,40470,172160,1756,214386,77114
hdfs://spark-nn.eemcs.utwente.nl/user/s1934538/clickstream/clickstream-enwiki-2018-11.tsv.gz,Main_Page,29873,453610659,4128690,457769222,33842019
hdfs://spark-nn.eemcs.utwente.nl/user/s1934538/clickstream/clickstream-enwiki-2018-11.tsv.gz,Betty_White,36699,257899,2824,297422,57916
hdfs://spark-nn.eemcs.utwente.nl/user/s1934538/clickstream/clickstream-enwiki-2018-11.tsv.gz,Mac_Miller,118282,605529,5957,729768,195558
hdfs://spark-nn.eemcs.utwente.nl/user/s1934538/clickstream/clickstream-enwiki-2018-11.tsv.gz,Royal_Rumble_(2018),18603,29233,625,48461,32114
hdfs://spark-nn.eemcs.utwente.nl/user/s1934538/clickstream/clickstream-enwiki-2018-11.tsv.gz,List_of_FIFA_World_Cup_finals,1338,41034,51,42423,11384
hdfs://spark-nn.eemcs.utwente.nl/user/s1934538/clickstream/clickstream-enwiki-2018-11.tsv.gz,Atal_Bihari_Vajpayee,19210,88760,222,108192,18831
hdfs://spark-nn.eemcs.utwente.nl/user/s1934538/clickstream/clickstream-enwiki-2018-11.tsv.gz,Michael_Jordan,66368,458119,4218,528705,165242
hdfs://spark-nn.eemcs.utwente.nl/user/s1934538/clickstream/clickstream-enwiki-2018-11.tsv.gz,IPv4,14242,52534,189,66965,11787
hdfs://spark-nn.eemcs.utwente.nl/user/s1934538/clickstream/clickstream-enwiki-2018-11.tsv.gz,Taliban,16901,118375,448,135724,48031
hdfs://spark-nn.eemcs.utwente.nl/user/s1934538/clickstream/clickstream-enwiki-2018-11.tsv.gz,21_Savage,18811,72562,1019,92392,36351
hdfs://spark-nn.eemcs.utwente.nl/user/s1934538/clickstream/clickstream-enwiki-2018-11.tsv.gz,Henry_V_of_England,63102,27840,220,91162,66943
hdfs://spark-nn.eemcs.utwente.nl/user/s1934538/clickstream/clickstream-enwiki-2018-11.tsv.gz,Spider-Man:_Far_From_Home,126520,94740,1250,222510,126743
hdfs://spark-nn.eemcs.utwente.nl/user/s1934538/clickstream/clickstream-enwiki-2018-11.tsv.gz,Microsoft_Office,9778,85530,849,96157,26045
hdfs://spark-nn.eemcs.utwente.nl/user/s1934538/clickstream/clickstream-enwiki-2018-11.tsv.gz,Meat_Loaf,17877,73750,767,92394,31497
hdfs://spark-nn.eemcs.utwente.nl/user/s1934538/clickstream/clickstream-enwiki-2018-11.tsv.gz,Bob_Saget,16443,46762,276,63481,9884
hdfs://spark-nn.eemcs.utwente.nl/user/s1934538/clickstream/clickstream-enwiki-2018-11.tsv.gz,List_of_awards_and_nominations_received_by_Meryl_Streep,11071,9532,87,20690,6340
hdfs://spark-nn.eemcs.utwente.nl/user/s1934538/clickstream/clickstream-enwiki-2018-11.tsv.gz,Venom_(2018_film),111227,875921,21357,1008505,401820
hdfs://spark-nn.eemcs.utwente.nl/user/s1934538/clickstream/clickstream-enwiki-2018-11.tsv.gz,Ray_Liotta,29540,281691,1223,312454,64458
hdfs://spark-nn.eemcs.utwente.nl/user/s1934538/clickstream/clickstream-enwiki-2018-11.tsv.gz,Shakira,13118,181942,1788,196848,82910
hdfs://spark-nn.eemcs.utwente.nl/user/s1934538/clickstream/clickstream-enwiki-2018-11.tsv.gz,Stan_Lee,262791,6152657,185236,6600684,1617555
hdfs://spark-nn.eemcs.utwente.nl/user/s1934538/clickstream/clickstream-enwiki-2018-11.tsv.gz,Amber_Heard,115874,167086,908,283868,150733
hdfs://spark-nn.eemcs.utwente.nl/user/s1934538/clickstream/clickstream-enwiki-2018-11.tsv.gz,UEFA_Euro_2020,49170,137641,2161,188972,78647
hdfs://spark-nn.eemcs.utwente.nl/user/s1934538/clickstream/clickstream-enwiki-2018-11.tsv.gz,Jason_Momoa,142487,682251,2301,827039,319017
hdfs://spark-nn.eemcs.utwente.nl/user/s1934538/clickstream/clickstream-enwiki-2018-11.tsv.gz,Bonnie_and_Clyde,14684,170081,1092,185857,38305
hdfs://spark-nn.eemcs.utwente.nl/user/s1934538/clickstream/clickstream-enwiki-2018-11.tsv.gz,Top_Gun:_Maverick,64310,41331,490,106131,84164
hdfs://spark-nn.eemcs.utwente.nl/user/s1934538/clickstream/clickstream-enwiki-2018-11.tsv.gz,Jimmy_Buffett,6216,40362,463,47041,15541
hdfs://spark-nn.eemcs.utwente.nl/user/s1934538/clickstream/clickstream-enwiki-2018-11.tsv.gz,Richard_Jewell,2161,6654,55,8870,2397
hdfs://spark-nn.eemcs.utwente.nl/user/s1934538/clickstream/clickstream-enwiki-2018-11.tsv.gz,Adele,21295,168565,2198,192058,58344
hdfs://spark-nn.eemcs.utwente.nl/user/s1934538/clickstream/clickstream-enwiki-2018-11.tsv.gz,Murder_of_Dee_Dee_Blanchard,4621,188821,450,193892,35720
hdfs://spark-nn.eemcs.utwente.nl/user/s1934538/clickstream/clickstream-enwiki-2018-11.tsv.gz,Once_Upon_a_Time_in_Hollywood,156689,70216,678,227583,236759
hdfs://spark-nn.eemcs.utwente.nl/user/s1934538/clickstream/clickstream-enwiki-2018-11.tsv.gz,Valentine's_Day,3361,46297,352,50010,543
hdfs://spark-nn.eemcs.utwente.nl/user/s1934538/clickstream/clickstream-enwiki-2018-11.tsv.gz,Qasem_Soleimani,2112,9378,36,11526,5259
hdfs://spark-nn.eemcs.utwente.nl/user/s1934538/clickstream/clickstream-enwiki-2018-12.tsv.gz,September_11_attacks,67295,290018,2314,359627,148975
hdfs://spark-nn.eemcs.utwente.nl/user/s1934538/clickstream/clickstream-enwiki-2018-12.tsv.gz,Godzilla_vs._Kong,80087,24913,91,105091,78234
hdfs://spark-nn.eemcs.utwente.nl/user/s1934538/clickstream/clickstream-enwiki-2018-12.tsv.gz,Brett_Kavanaugh,36219,96170,812,133201,43602
hdfs://spark-nn.eemcs.utwente.nl/user/s1934538/clickstream/clickstream-enwiki-2018-12.tsv.gz,Area_51,18428,187991,1281,207700,56917
hdfs://spark-nn.eemcs.utwente.nl/user/s1934538/clickstream/clickstream-enwiki-2018-12.tsv.gz,Adele,22955,166938,2101,191994,58169
hdfs://spark-nn.eemcs.utwente.nl/user/s1934538/clickstream/clickstream-enwiki-2018-12.tsv.gz,Dark_Phoenix_(film),110918,72027,1297,184242,123156
hdfs://spark-nn.eemcs.utwente.nl/user/s1934538/clickstream/clickstream-enwiki-2018-12.tsv.gz,Jimmy_Hoffa,23970,91016,626,115612,38015
hdfs://spark-nn.eemcs.utwente.nl/user/s1934538/clickstream/clickstream-enwiki-2018-12.tsv.gz,Venom_(2018_film),126463,1135892,23605,1285960,702740
hdfs://spark-nn.eemcs.utwente.nl/user/s1934538/clickstream/clickstream-enwiki-2018-12.tsv.gz,Greta_Thunberg,1111,37257,214,38582,16473
hdfs://spark-nn.eemcs.utwente.nl/user/s1934538/clickstream/clickstream-enwiki-2018-12.tsv.gz,Avengers:_Endgame,603912,1063089,24559,1691560,936193
hdfs://spark-nn.eemcs.utwente.nl/user/s1934538/clickstream/clickstream-enwiki-2018-12.tsv.gz,Anthony_Bourdain,16242,266362,2682,285286,73071
hdfs://spark-nn.eemcs.utwente.nl/user/s1934538/clickstream/clickstream-enwiki-2018-12.tsv.gz,Central_Park_jogger_case,4125,22541,112,26778,3101
hdfs://spark-nn.eemcs.utwente.nl/user/s1934538/clickstream/clickstream-enwiki-2018-12.tsv.gz,A_Star_Is_Born_(2018_film),100602,831213,10064,941879,447397
hdfs://spark-nn.eemcs.utwente.nl/user/s1934538/clickstream/clickstream-enwiki-2018-12.tsv.gz,Simone_Biles,8692,48578,309,57579,13677
hdfs://spark-nn.eemcs.utwente.nl/user/s1934538/clickstream/clickstream-enwiki-2018-12.tsv.gz,Lionel_Messi,57804,542647,5965,606416,131689
hdfs://spark-nn.eemcs.utwente.nl/user/s1934538/clickstream/clickstream-enwiki-2018-12.tsv.gz,Qasem_Soleimani,2164,6938,24,9126,3467
hdfs://spark-nn.eemcs.utwente.nl/user/s1934538/clickstream/clickstream-enwiki-2018-12.tsv.gz,XXXTentacion,126264,651226,13588,791078,253678
hdfs://spark-nn.eemcs.utwente.nl/user/s1934538/clickstream/clickstream-enwiki-2018-12.tsv.gz,Meat_Loaf,17857,79453,776,98086,32392
hdfs://spark-nn.eemcs.utwente.nl/user/s1934538/clickstream/clickstream-enwiki-2018-12.tsv.gz,Luke_Perry,28796,43098,326,72220,13274
hdfs://spark-nn.eemcs.utwente.nl/user/s1934538/clickstream/clickstream-enwiki-2018-12.tsv.gz,Media,65,31868,289,32222,2635
hdfs://spark-nn.eemcs.utwente.nl/user/s1934538/clickstream/clickstream-enwiki-2018-12.tsv.gz,Burt_Reynolds,48543,266863,2907,318313,113988
hdfs://spark-nn.eemcs.utwente.nl/user/s1934538/clickstream/clickstream-enwiki-2018-12.tsv.gz,Wonder_Woman_1984,115145,62229,1248,178622,105054
hdfs://spark-nn.eemcs.utwente.nl/user/s1934538/clickstream/clickstream-enwiki-2018-12.tsv.gz,Donald_Trump,386037,1205149,14903,1606089,943245
hdfs://spark-nn.eemcs.utwente.nl/user/s1934538/clickstream/clickstream-enwiki-2018-12.tsv.gz,William_Murdoch,586,2228,15,2829,339
hdfs://spark-nn.eemcs.utwente.nl/user/s1934538/clickstream/clickstream-enwiki-2018-12.tsv.gz,Lance_Reddick,24452,17484,102,42038,8282
hdfs://spark-nn.eemcs.utwente.nl/user/s1934538/clickstream/clickstream-enwiki-2018-12.tsv.gz,Cardi_B,102223,1221634,12107,1335964,520346
hdfs://spark-nn.eemcs.utwente.nl/user/s1934538/clickstream/clickstream-enwiki-2018-12.tsv.gz,List_of_James_Bond_films,17556,333319,357,351232,118047
hdfs://spark-nn.eemcs.utwente.nl/user/s1934538/clickstream/clickstream-enwiki-2018-12.tsv.gz,Jason_Momoa,639353,4600295,21613,5261261,2276655
hdfs://spark-nn.eemcs.utwente.nl/user/s1934538/clickstream/clickstream-enwiki-2018-12.tsv.gz,List_of_FIFA_World_Cup_finals,1351,44111,66,45528,11418
hdfs://spark-nn.eemcs.utwente.nl/user/s1934538/clickstream/clickstream-enwiki-2018-12.tsv.gz,Bird_Box_(film),682992,3983082,44264,4710338,2072216
hdfs://spark-nn.eemcs.utwente.nl/user/s1934538/clickstream/clickstream-enwiki-2018-12.tsv.gz,David_Beckham,30583,174307,1359,206249,60605
hdfs://spark-nn.eemcs.utwente.nl/user/s1934538/clickstream/clickstream-enwiki-2018-12.tsv.gz,Cleopatra,41329,190537,1965,233831,90556
hdfs://spark-nn.eemcs.utwente.nl/user/s1934538/clickstream/clickstream-enwiki-2018-12.tsv.gz,Kelly_Preston,71917,58275,170,130362,35545
hdfs://spark-nn.eemcs.utwente.nl/user/s1934538/clickstream/clickstream-enwiki-2018-12.tsv.gz,List_of_awards_and_nominations_received_by_Meryl_Streep,13710,10248,76,24034,9058
hdfs://spark-nn.eemcs.utwente.nl/user/s1934538/clickstream/clickstream-enwiki-2018-12.tsv.gz,The_Shape_of_Water,44294,197626,3027,244947,131346
hdfs://spark-nn.eemcs.utwente.nl/user/s1934538/clickstream/clickstream-enwiki-2018-12.tsv.gz,Cecil_Hotel_(Los_Angeles),4848,24778,64,29690,10332
hdfs://spark-nn.eemcs.utwente.nl/user/s1934538/clickstream/clickstream-enwiki-2018-12.tsv.gz,Kim_Jong-un,36862,106232,894,143988,75604
hdfs://spark-nn.eemcs.utwente.nl/user/s1934538/clickstream/clickstream-enwiki-2018-12.tsv.gz,Ruth_Bader_Ginsburg,65039,669154,4159,738352,269201
hdfs://spark-nn.eemcs.utwente.nl/user/s1934538/clickstream/clickstream-enwiki-2018-12.tsv.gz,Key_frame,673,6536,20,7229,594
hdfs://spark-nn.eemcs.utwente.nl/user/s1934538/clickstream/clickstream-enwiki-2018-12.tsv.gz,Captain_Marvel_(film),173562,466617,9371,649550,439862
hdfs://spark-nn.eemcs.utwente.nl/user/s1934538/clickstream/clickstream-enwiki-2018-12.tsv.gz,The_Irishman,62,330,45,437,565
hdfs://spark-nn.eemcs.utwente.nl/user/s1934538/clickstream/clickstream-enwiki-2018-12.tsv.gz,Murder_of_Dee_Dee_Blanchard,4565,135575,324,140464,23212
hdfs://spark-nn.eemcs.utwente.nl/user/s1934538/clickstream/clickstream-enwiki-2018-12.tsv.gz,Richard_Ramirez,9060,130519,1768,141347,34045
hdfs://spark-nn.eemcs.utwente.nl/user/s1934538/clickstream/clickstream-enwiki-2018-12.tsv.gz,Queen_(band),208468,851359,10991,1070818,1069644
hdfs://spark-nn.eemcs.utwente.nl/user/s1934538/clickstream/clickstream-enwiki-2018-12.tsv.gz,Avicii,24161,315489,3842,343492,73875
hdfs://spark-nn.eemcs.utwente.nl/user/s1934538/clickstream/clickstream-enwiki-2018-12.tsv.gz,Stranger_Things,49007,324345,8277,381629,249657
hdfs://spark-nn.eemcs.utwente.nl/user/s1934538/clickstream/clickstream-enwiki-2018-12.tsv.gz,RRR_(film),48631,21946,2282,72859,19875
hdfs://spark-nn.eemcs.utwente.nl/user/s1934538/clickstream/clickstream-enwiki-2018-12.tsv.gz,Michael_Bloomberg,32349,119054,941,152344,53503
hdfs://spark-nn.eemcs.utwente.nl/user/s1934538/clickstream/clickstream-enwiki-2018-12.tsv.gz,Elon_Musk,137801,975827,15304,1128932,703340
hdfs://spark-nn.eemcs.utwente.nl/user/s1934538/clickstream/clickstream-enwiki-2018-12.tsv.gz,Stephen_Hawking,56461,752603,5884,814948,342202
hdfs://spark-nn.eemcs.utwente.nl/user/s1934538/clickstream/clickstream-enwiki-2018-12.tsv.gz,Deadpool_2,114962,286323,11922,413207,244922
hdfs://spark-nn.eemcs.utwente.nl/user/s1934538/clickstream/clickstream-enwiki-2018-12.tsv.gz,2018_Winter_Olympics,31884,90072,887,122843,48360
hdfs://spark-nn.eemcs.utwente.nl/user/s1934538/clickstream/clickstream-enwiki-2018-12.tsv.gz,Kamala_Harris,20050,269151,2574,291775,95733
hdfs://spark-nn.eemcs.utwente.nl/user/s1934538/clickstream/clickstream-enwiki-2018-12.tsv.gz,Croatia,33709,110983,1562,146254,51873
hdfs://spark-nn.eemcs.utwente.nl/user/s1934538/clickstream/clickstream-enwiki-2018-12.tsv.gz,"Prince_Philip,_Duke_of_Edinburgh",216274,263807,6222,486303,280519
hdfs://spark-nn.eemcs.utwente.nl/user/s1934538/clickstream/clickstream-enwiki-2018-12.tsv.gz,The_Lion_King_(2019_film),76453,194931,2383,273767,236172
hdfs://spark-nn.eemcs.utwente.nl/user/s1934538/clickstream/clickstream-enwiki-2018-12.tsv.gz,Spanish_flu,24150,94546,878,119574,26186
hdfs://spark-nn.eemcs.utwente.nl/user/s1934538/clickstream/clickstream-enwiki-2018-12.tsv.gz,Alexander_Hamilton,90077,458678,2631,551386,191231
hdfs://spark-nn.eemcs.utwente.nl/user/s1934538/clickstream/clickstream-enwiki-2018-12.tsv.gz,Jeffrey_Epstein,11474,216641,1556,229671,74354
hdfs://spark-nn.eemcs.utwente.nl/user/s1934538/clickstream/clickstream-enwiki-2018-12.tsv.gz,2020_United_States_presidential_election,57597,153012,2707,213316,165386
hdfs://spark-nn.eemcs.utwente.nl/user/s1934538/clickstream/clickstream-enwiki-2018-12.tsv.gz,Ghislaine_Maxwell,6150,7786,133,14069,3722
hdfs://spark-nn.eemcs.utwente.nl/user/s1934538/clickstream/clickstream-enwiki-2018-12.tsv.gz,Sridevi,40567,152627,783,193977,68943
hdfs://spark-nn.eemcs.utwente.nl/user/s1934538/clickstream/clickstream-enwiki-2018-12.tsv.gz,Amber_Heard,387830,817284,3984,1209098,670089
hdfs://spark-nn.eemcs.utwente.nl/user/s1934538/clickstream/clickstream-enwiki-2018-12.tsv.gz,Once_Upon_a_Time_in_Hollywood,153988,76383,902,231273,236589
hdfs://spark-nn.eemcs.utwente.nl/user/s1934538/clickstream/clickstream-enwiki-2018-12.tsv.gz,Top_Gun:_Maverick,80116,52779,862,133757,105086
hdfs://spark-nn.eemcs.utwente.nl/user/s1934538/clickstream/clickstream-enwiki-2018-12.tsv.gz,Sushant_Singh_Rajput,71658,169573,618,241849,154234
hdfs://spark-nn.eemcs.utwente.nl/user/s1934538/clickstream/clickstream-enwiki-2018-12.tsv.gz,Coronavirus,941,11537,54,12532,1512
hdfs://spark-nn.eemcs.utwente.nl/user/s1934538/clickstream/clickstream-enwiki-2018-12.tsv.gz,Avengers:_Infinity_War,279129,745079,27135,1051343,806036
hdfs://spark-nn.eemcs.utwente.nl/user/s1934538/clickstream/clickstream-enwiki-2018-12.tsv.gz,NATO,36149,127525,2506,166180,56828
hdfs://spark-nn.eemcs.utwente.nl/user/s1934538/clickstream/clickstream-enwiki-2018-12.tsv.gz,The_Witcher_(TV_series),16870,27695,260,44825,26110
hdfs://spark-nn.eemcs.utwente.nl/user/s1934538/clickstream/clickstream-enwiki-2018-12.tsv.gz,Mac_Miller,120062,456037,6624,582723,156021
hdfs://spark-nn.eemcs.utwente.nl/user/s1934538/clickstream/clickstream-enwiki-2018-12.tsv.gz,List_of_Marvel_Cinematic_Universe_films,128889,1154220,3010,1286119,404998
hdfs://spark-nn.eemcs.utwente.nl/user/s1934538/clickstream/clickstream-enwiki-2018-12.tsv.gz,Bob_Saget,21972,56010,349,78331,12979
hdfs://spark-nn.eemcs.utwente.nl/user/s1934538/clickstream/clickstream-enwiki-2018-12.tsv.gz,Simple_Mail_Transfer_Protocol,4317,37790,184,42291,4385
hdfs://spark-nn.eemcs.utwente.nl/user/s1934538/clickstream/clickstream-enwiki-2018-12.tsv.gz,The_Nun_(2018_film),56210,351315,3623,411148,269478
hdfs://spark-nn.eemcs.utwente.nl/user/s1934538/clickstream/clickstream-enwiki-2018-12.tsv.gz,Nipsey_Hussle,23242,57984,311,81537,36535
hdfs://spark-nn.eemcs.utwente.nl/user/s1934538/clickstream/clickstream-enwiki-2018-12.tsv.gz,Bonnie_and_Clyde,14412,158278,928,173618,39464
hdfs://spark-nn.eemcs.utwente.nl/user/s1934538/clickstream/clickstream-enwiki-2018-12.tsv.gz,Grimes_(musician),154430,94757,880,250067,59012
hdfs://spark-nn.eemcs.utwente.nl/user/s1934538/clickstream/clickstream-enwiki-2018-12.tsv.gz,UEFA_Euro_2020,29280,175470,2715,207465,84832
hdfs://spark-nn.eemcs.utwente.nl/user/s1934538/clickstream/clickstream-enwiki-2018-12.tsv.gz,21_Savage,29807,235372,3513,268692,161323
hdfs://spark-nn.eemcs.utwente.nl/user/s1934538/clickstream/clickstream-enwiki-2018-12.tsv.gz,Juneteenth,20976,27086,66,48128,4629
hdfs://spark-nn.eemcs.utwente.nl/user/s1934538/clickstream/clickstream-enwiki-2018-12.tsv.gz,Game_of_Thrones_(season_8),50212,366238,1135,417585,128593
hdfs://spark-nn.eemcs.utwente.nl/user/s1934538/clickstream/clickstream-enwiki-2018-12.tsv.gz,Spider-Man:_Far_From_Home,224170,235590,3952,463712,324490
hdfs://spark-nn.eemcs.utwente.nl/user/s1934538/clickstream/clickstream-enwiki-2018-12.tsv.gz,Kate_Spade,68710,137581,1423,207714,64477
hdfs://spark-nn.eemcs.utwente.nl/user/s1934538/clickstream/clickstream-enwiki-2018-12.tsv.gz,Betty_White,41368,265589,2386,309343,60389
hdfs://spark-nn.eemcs.utwente.nl/user/s1934538/clickstream/clickstream-enwiki-2018-12.tsv.gz,Priyanka_Chopra,575481,2531979,10220,3117680,1258509
hdfs://spark-nn.eemcs.utwente.nl/user/s1934538/clickstream/clickstream-enwiki-2018-12.tsv.gz,"Princess_Margaret,_Countess_of_Snowdon",115044,318548,2129,435721,260159
hdfs://spark-nn.eemcs.utwente.nl/user/s1934538/clickstream/clickstream-enwiki-2018-12.tsv.gz,Roe_v._Wade,11210,93920,556,105686,22271
hdfs://spark-nn.eemcs.utwente.nl/user/s1934538/clickstream/clickstream-enwiki-2018-12.tsv.gz,Rami_Malek,141949,551713,3078,696740,177847
hdfs://spark-nn.eemcs.utwente.nl/user/s1934538/clickstream/clickstream-enwiki-2018-12.tsv.gz,2018_Asian_Games,10941,71114,341,82396,29340
hdfs://spark-nn.eemcs.utwente.nl/user/s1934538/clickstream/clickstream-enwiki-2018-12.tsv.gz,Hyphen-minus,5653,34737502,7557718,42300873,826
hdfs://spark-nn.eemcs.utwente.nl/user/s1934538/clickstream/clickstream-enwiki-2018-12.tsv.gz,Bipin_Rawat,5175,19972,18,25165,8704
hdfs://spark-nn.eemcs.utwente.nl/user/s1934538/clickstream/clickstream-enwiki-2018-12.tsv.gz,Microsoft_Office,8549,76935,732,86216,24373
hdfs://spark-nn.eemcs.utwente.nl/user/s1934538/clickstream/clickstream-enwiki-2018-12.tsv.gz,Rihanna,57272,233640,3107,294019,149742
hdfs://spark-nn.eemcs.utwente.nl/user/s1934538/clickstream/clickstream-enwiki-2018-12.tsv.gz,2020_Summer_Olympics,36887,89652,1163,127702,86791
hdfs://spark-nn.eemcs.utwente.nl/user/s1934538/clickstream/clickstream-enwiki-2018-12.tsv.gz,List_of_highest-grossing_films,165927,420499,2544,588970,278981
hdfs://spark-nn.eemcs.utwente.nl/user/s1934538/clickstream/clickstream-enwiki-2018-12.tsv.gz,George_VI,342419,185590,772,528781,371173
hdfs://spark-nn.eemcs.utwente.nl/user/s1934538/clickstream/clickstream-enwiki-2018-12.tsv.gz,Deion_Sanders,14567,111602,675,126844,32153
hdfs://spark-nn.eemcs.utwente.nl/user/s1934538/clickstream/clickstream-enwiki-2018-12.tsv.gz,The_Mandalorian,39273,55212,663,95148,76238
hdfs://spark-nn.eemcs.utwente.nl/user/s1934538/clickstream/clickstream-enwiki-2018-12.tsv.gz,Anne_Heche,45009,58494,284,103787,27672
hdfs://spark-nn.eemcs.utwente.nl/user/s1934538/clickstream/clickstream-enwiki-2018-12.tsv.gz,Gaza_Strip,12470,34635,751,47856,17177
hdfs://spark-nn.eemcs.utwente.nl/user/s1934538/clickstream/clickstream-enwiki-2018-12.tsv.gz,Chadwick_Boseman,63542,111592,1044,176178,50626
hdfs://spark-nn.eemcs.utwente.nl/user/s1934538/clickstream/clickstream-enwiki-2018-12.tsv.gz,Louis_Tomlinson,34110,102461,504,137075,19138
hdfs://spark-nn.eemcs.utwente.nl/user/s1934538/clickstream/clickstream-enwiki-2018-12.tsv.gz,JSON_Web_Token,918,20055,22,20995,1694
hdfs://spark-nn.eemcs.utwente.nl/user/s1934538/clickstream/clickstream-enwiki-2018-12.tsv.gz,Hamilton_(musical),48280,394656,2448,445384,220205
hdfs://spark-nn.eemcs.utwente.nl/user/s1934538/clickstream/clickstream-enwiki-2018-12.tsv.gz,Dennis_Nilsen,5007,28765,145,33917,6698
hdfs://spark-nn.eemcs.utwente.nl/user/s1934538/clickstream/clickstream-enwiki-2018-12.tsv.gz,HTTP_cookie,6251,276015,119,282385,35270
hdfs://spark-nn.eemcs.utwente.nl/user/s1934538/clickstream/clickstream-enwiki-2018-12.tsv.gz,Exo_(band),34826,1359025,913,1394764,1640674
hdfs://spark-nn.eemcs.utwente.nl/user/s1934538/clickstream/clickstream-enwiki-2018-12.tsv.gz,Khabib_Nurmagomedov,71070,155831,1948,228849,108505
hdfs://spark-nn.eemcs.utwente.nl/user/s1934538/clickstream/clickstream-enwiki-2018-12.tsv.gz,Shakira,13753,202706,2013,218472,91302
hdfs://spark-nn.eemcs.utwente.nl/user/s1934538/clickstream/clickstream-enwiki-2019-03.tsv.gz,Juice_Wrld,20641,193838,2144,216623,84272
hdfs://spark-nn.eemcs.utwente.nl/user/s1934538/clickstream/clickstream-enwiki-2019-03.tsv.gz,When_They_See_Us,14165,11397,206,25768,12251
hdfs://spark-nn.eemcs.utwente.nl/user/s1934538/clickstream/clickstream-enwiki-2019-03.tsv.gz,Wikipedia,45545,754080,1324,800949,228289
hdfs://spark-nn.eemcs.utwente.nl/user/s1934538/clickstream/clickstream-enwiki-2019-03.tsv.gz,Kamala_Harris,34509,320833,3147,358489,109600
hdfs://spark-nn.eemcs.utwente.nl/user/s1934538/clickstream/clickstream-enwiki-2019-03.tsv.gz,Rishi_Sunak,3795,3270,15,7080,1365
hdfs://spark-nn.eemcs.utwente.nl/user/s1934538/clickstream/clickstream-enwiki-2019-03.tsv.gz,IPv4,13922,52889,169,66980,11162
hdfs://spark-nn.eemcs.utwente.nl/user/s1934538/clickstream/clickstream-enwiki-2019-03.tsv.gz,Area_51,17596,212612,1439,231647,62424
hdfs://spark-nn.eemcs.utwente.nl/user/s1934538/clickstream/clickstream-enwiki-2019-03.tsv.gz,Tina_Turner,18695,262728,2164,283587,72118
hdfs://spark-nn.eemcs.utwente.nl/user/s1934538/clickstream/clickstream-enwiki-2019-03.tsv.gz,Fyre_Festival,29720,440661,1987,472368,213253
hdfs://spark-nn.eemcs.utwente.nl/user/s1934538/clickstream/clickstream-enwiki-2019-03.tsv.gz,Jeffrey_Epstein,9820,111103,685,121608,35461
hdfs://spark-nn.eemcs.utwente.nl/user/s1934538/clickstream/clickstream-enwiki-2019-03.tsv.gz,Chernobyl_(miniseries),5095,32807,358,38260,24401
hdfs://spark-nn.eemcs.utwente.nl/user/s1934538/clickstream/clickstream-enwiki-2019-03.tsv.gz,Aaron_Carter,17146,57590,640,75376,23467
hdfs://spark-nn.eemcs.utwente.nl/user/s1934538/clickstream/clickstream-enwiki-2019-03.tsv.gz,Media,66,27182,425,27673,2704
hdfs://spark-nn.eemcs.utwente.nl/user/s1934538/clickstream/clickstream-enwiki-2019-03.tsv.gz,The_Umbrella_Academy_(TV_series),312510,1707606,22113,2042229,1382343
hdfs://spark-nn.eemcs.utwente.nl/user/s1934538/clickstream/clickstream-enwiki-2019-03.tsv.gz,Bible,16955,1949205,1682,1967842,34417
hdfs://spark-nn.eemcs.utwente.nl/user/s1934538/clickstream/clickstream-enwiki-2019-03.tsv.gz,Tonya_Harding,39050,203640,950,243640,54845
hdfs://spark-nn.eemcs.utwente.nl/user/s1934538/clickstream/clickstream-enwiki-2019-03.tsv.gz,List_of_highest-grossing_Indian_films,73852,299763,2918,376533,186768
hdfs://spark-nn.eemcs.utwente.nl/user/s1934538/clickstream/clickstream-enwiki-2019-03.tsv.gz,Spanish_flu,20928,121588,995,143511,27327
hdfs://spark-nn.eemcs.utwente.nl/user/s1934538/clickstream/clickstream-enwiki-2019-03.tsv.gz,Tunnel,3570,13334,120,17024,4080
hdfs://spark-nn.eemcs.utwente.nl/user/s1934538/clickstream/clickstream-enwiki-2019-03.tsv.gz,Captain_Marvel_(film),626355,6190163,182530,6999048,3880759
hdfs://spark-nn.eemcs.utwente.nl/user/s1934538/clickstream/clickstream-enwiki-2019-03.tsv.gz,Johnny_Depp,141875,424193,3814,569882,354804
hdfs://spark-nn.eemcs.utwente.nl/user/s1934538/clickstream/clickstream-enwiki-2019-03.tsv.gz,Eddie_Van_Halen,49064,57410,669,107143,54465
hdfs://spark-nn.eemcs.utwente.nl/user/s1934538/clickstream/clickstream-enwiki-2019-03.tsv.gz,Louis_Tomlinson,32915,344745,2144,379804,41929
hdfs://spark-nn.eemcs.utwente.nl/user/s1934538/clickstream/clickstream-enwiki-2019-03.tsv.gz,Ruth_Bader_Ginsburg,48695,346135,2193,397023,145159
hdfs://spark-nn.eemcs.utwente.nl/user/s1934538/clickstream/clickstream-enwiki-2019-03.tsv.gz,Chadwick_Boseman,54782,96450,651,151883,45848
hdfs://spark-nn.eemcs.utwente.nl/user/s1934538/clickstream/clickstream-enwiki-2019-03.tsv.gz,Shakira,16128,199839,1860,217827,92899
hdfs://spark-nn.eemcs.utwente.nl/user/s1934538/clickstream/clickstream-enwiki-2019-03.tsv.gz,Lisa_Marie_Presley,342123,267829,1165,611117,290041
hdfs://spark-nn.eemcs.utwente.nl/user/s1934538/clickstream/clickstream-enwiki-2019-03.tsv.gz,Ray_Liotta,35272,64201,419,99892,32444
hdfs://spark-nn.eemcs.utwente.nl/user/s1934538/clickstream/clickstream-enwiki-2019-03.tsv.gz,Betty_White,48128,223695,2136,273959,64800
hdfs://spark-nn.eemcs.utwente.nl/user/s1934538/clickstream/clickstream-enwiki-2019-03.tsv.gz,Afghanistan,50134,167436,2128,219698,131398
hdfs://spark-nn.eemcs.utwente.nl/user/s1934538/clickstream/clickstream-enwiki-2019-03.tsv.gz,Anthony_Bourdain,13814,174581,1567,189962,53237
hdfs://spark-nn.eemcs.utwente.nl/user/s1934538/clickstream/clickstream-enwiki-2019-03.tsv.gz,Henry_V_of_England,43015,30520,210,73745,50223
hdfs://spark-nn.eemcs.utwente.nl/user/s1934538/clickstream/clickstream-enwiki-2019-03.tsv.gz,JSON_Web_Token,1242,22682,35,23959,2238
hdfs://spark-nn.eemcs.utwente.nl/user/s1934538/clickstream/clickstream-enwiki-2019-03.tsv.gz,YouTube,125307,878730,9482,1013519,154936
hdfs://spark-nn.eemcs.utwente.nl/user/s1934538/clickstream/clickstream-enwiki-2019-03.tsv.gz,Dennis_Nilsen,4835,26050,159,31044,6255
hdfs://spark-nn.eemcs.utwente.nl/user/s1934538/clickstream/clickstream-enwiki-2019-03.tsv.gz,"Prince_Philip,_Duke_of_Edinburgh",190094,201079,5367,396540,232038
hdfs://spark-nn.eemcs.utwente.nl/user/s1934538/clickstream/clickstream-enwiki-2019-03.tsv.gz,Jimmy_Buffett,12048,52502,498,65048,19591
hdfs://spark-nn.eemcs.utwente.nl/user/s1934538/clickstream/clickstream-enwiki-2019-03.tsv.gz,Tasuku_Honjo,2329,4298,12,6639,1816
hdfs://spark-nn.eemcs.utwente.nl/user/s1934538/clickstream/clickstream-enwiki-2019-03.tsv.gz,Freddie_Mercury,495975,3715584,21698,4233257,1551317
hdfs://spark-nn.eemcs.utwente.nl/user/s1934538/clickstream/clickstream-enwiki-2019-03.tsv.gz,Ukraine,44279,153572,3410,201261,84474
hdfs://spark-nn.eemcs.utwente.nl/user/s1934538/clickstream/clickstream-enwiki-2019-03.tsv.gz,Greta_Thunberg,11145,246088,1836,259069,98499
hdfs://spark-nn.eemcs.utwente.nl/user/s1934538/clickstream/clickstream-enwiki-2019-03.tsv.gz,Cook's_Country,316,2883,27,3226,28
hdfs://spark-nn.eemcs.utwente.nl/user/s1934538/clickstream/clickstream-enwiki-2019-03.tsv.gz,Deaths_in_2019,1413004,2076287,8949,3498240,2037283
hdfs://spark-nn.eemcs.utwente.nl/user/s1934538/clickstream/clickstream-enwiki-2019-03.tsv.gz,George_H._W._Bush,151756,199408,1646,352810,200595
hdfs://spark-nn.eemcs.utwente.nl/user/s1934538/clickstream/clickstream-enwiki-2019-03.tsv.gz,Central_Park_jogger_case,13911,103923,334,118168,14927
hdfs://spark-nn.eemcs.utwente.nl/user/s1934538/clickstream/clickstream-enwiki-2019-03.tsv.gz,Donald_Trump,246768,925682,13401,1185851,720147
hdfs://spark-nn.eemcs.utwente.nl/user/s1934538/clickstream/clickstream-enwiki-2019-03.tsv.gz,The_Shape_of_Water,34738,115771,1476,151985,71536
hdfs://spark-nn.eemcs.utwente.nl/user/s1934538/clickstream/clickstream-enwiki-2019-03.tsv.gz,Simone_Biles,11101,89420,6289,106810,30010
hdfs://spark-nn.eemcs.utwente.nl/user/s1934538/clickstream/clickstream-enwiki-2019-03.tsv.gz,Brett_Kavanaugh,27893,89419,543,117855,32217
hdfs://spark-nn.eemcs.utwente.nl/user/s1934538/clickstream/clickstream-enwiki-2019-03.tsv.gz,Vladimir_Putin,64340,218288,2793,285421,146682
hdfs://spark-nn.eemcs.utwente.nl/user/s1934538/clickstream/clickstream-enwiki-2019-03.tsv.gz,Israel,93912,401528,6590,502030,232789
hdfs://spark-nn.eemcs.utwente.nl/user/s1934538/clickstream/clickstream-enwiki-2019-03.tsv.gz,Croatia,38852,148060,1881,188793,61400
hdfs://spark-nn.eemcs.utwente.nl/user/s1934538/clickstream/clickstream-enwiki-2019-03.tsv.gz,Lists_of_deaths_by_year,13144,242497,403,256044,249303
hdfs://spark-nn.eemcs.utwente.nl/user/s1934538/clickstream/clickstream-enwiki-2019-03.tsv.gz,A_Star_Is_Born_(2018_film),127860,1199312,9229,1336401,655618
hdfs://spark-nn.eemcs.utwente.nl/user/s1934538/clickstream/clickstream-enwiki-2019-03.tsv.gz,Line_shaft,630,1105,32,1767,107
hdfs://spark-nn.eemcs.utwente.nl/user/s1934538/clickstream/clickstream-enwiki-2019-03.tsv.gz,2.0_(film),42512,242664,975,286151,57301
hdfs://spark-nn.eemcs.utwente.nl/user/s1934538/clickstream/clickstream-enwiki-2019-03.tsv.gz,Ghislaine_Maxwell,4206,12430,155,16791,4600
hdfs://spark-nn.eemcs.utwente.nl/user/s1934538/clickstream/clickstream-enwiki-2019-03.tsv.gz,2022_FIFA_World_Cup,55512,104476,2079,162067,84353
hdfs://spark-nn.eemcs.utwente.nl/user/s1934538/clickstream/clickstream-enwiki-2019-03.tsv.gz,Hamas,23207,60679,540,84426,31786
hdfs://spark-nn.eemcs.utwente.nl/user/s1934538/clickstream/clickstream-enwiki-2019-03.tsv.gz,List_of_Marvel_Cinematic_Universe_films,223132,1936098,4680,2163910,648874
hdfs://spark-nn.eemcs.utwente.nl/user/s1934538/clickstream/clickstream-enwiki-2019-03.tsv.gz,WrestleMania_34,98512,88746,1886,189144,133799
hdfs://spark-nn.eemcs.utwente.nl/user/s1934538/clickstream/clickstream-enwiki-2019-03.tsv.gz,Puneeth_Rajkumar,8672,27769,33,36474,16284
hdfs://spark-nn.eemcs.utwente.nl/user/s1934538/clickstream/clickstream-enwiki-2019-03.tsv.gz,Main_Page,30503,470792377,4483625,475306505,34556959
hdfs://spark-nn.eemcs.utwente.nl/user/s1934538/clickstream/clickstream-enwiki-2019-03.tsv.gz,List_of_most_popular_websites,25895,76325,152,102372,48982
hdfs://spark-nn.eemcs.utwente.nl/user/s1934538/clickstream/clickstream-enwiki-2019-03.tsv.gz,Hamilton_(musical),34819,275790,1610,312219,149321
hdfs://spark-nn.eemcs.utwente.nl/user/s1934538/clickstream/clickstream-enwiki-2019-03.tsv.gz,Dark_Phoenix_(film),138521,233282,5911,377714,258356
hdfs://spark-nn.eemcs.utwente.nl/user/s1934538/clickstream/clickstream-enwiki-2019-03.tsv.gz,Salman_Rushdie,38223,79671,624,118518,49851
hdfs://spark-nn.eemcs.utwente.nl/user/s1934538/clickstream/clickstream-enwiki-2019-03.tsv.gz,Richard_Ramirez,10222,130328,1789,142339,32861
hdfs://spark-nn.eemcs.utwente.nl/user/s1934538/clickstream/clickstream-enwiki-2019-03.tsv.gz,Elizabeth_II,439234,624873,3513,1067620,806567
hdfs://spark-nn.eemcs.utwente.nl/user/s1934538/clickstream/clickstream-enwiki-2019-03.tsv.gz,Death_of_Elisa_Lam,8273,61963,186,70422,17870
hdfs://spark-nn.eemcs.utwente.nl/user/s1934538/clickstream/clickstream-enwiki-2019-03.tsv.gz,1234,110,1570,12,1692,154
hdfs://spark-nn.eemcs.utwente.nl/user/s1934538/clickstream/clickstream-enwiki-2019-03.tsv.gz,The_Irishman,75,510,146,731,869
hdfs://spark-nn.eemcs.utwente.nl/user/s1934538/clickstream/clickstream-enwiki-2019-03.tsv.gz,Crazy_Rich_Asians_(film),53732,225030,2523,281285,261467
hdfs://spark-nn.eemcs.utwente.nl/user/s1934538/clickstream/clickstream-enwiki-2019-03.tsv.gz,"Princess_Margaret,_Countess_of_Snowdon",103994,278361,1816,384171,233695
hdfs://spark-nn.eemcs.utwente.nl/user/s1934538/clickstream/clickstream-enwiki-2019-03.tsv.gz,Elon_Musk,193261,905218,6101,1104580,702857
hdfs://spark-nn.eemcs.utwente.nl/user/s1934538/clickstream/clickstream-enwiki-2019-03.tsv.gz,Deion_Sanders,9847,119846,483,130176,35548
hdfs://spark-nn.eemcs.utwente.nl/user/s1934538/clickstream/clickstream-enwiki-2019-03.tsv.gz,Brie_Larson,555453,2303840,97990,2957283,1377928
hdfs://spark-nn.eemcs.utwente.nl/user/s1934538/clickstream/clickstream-enwiki-2019-03.tsv.gz,Avengers:_Infinity_War,306024,583917,11585,901526,609333
hdfs://spark-nn.eemcs.utwente.nl/user/s1934538/clickstream/clickstream-enwiki-2019-03.tsv.gz,2018_Asian_Games,6746,24351,83,31180,15897
hdfs://spark-nn.eemcs.utwente.nl/user/s1934538/clickstream/clickstream-enwiki-2019-03.tsv.gz,Deadpool_2,91812,235085,6071,332968,282098
hdfs://spark-nn.eemcs.utwente.nl/user/s1934538/clickstream/clickstream-enwiki-2019-03.tsv.gz,Aaron_Hernandez,9214,108365,1769,119348,37258
hdfs://spark-nn.eemcs.utwente.nl/user/s1934538/clickstream/clickstream-enwiki-2019-03.tsv.gz,Glass_(2019_film),107590,399061,4021,510672,100459
hdfs://spark-nn.eemcs.utwente.nl/user/s1934538/clickstream/clickstream-enwiki-2019-03.tsv.gz,Sylvester_Stallone,95657,449743,2359,547759,351339
hdfs://spark-nn.eemcs.utwente.nl/user/s1934538/clickstream/clickstream-enwiki-2019-03.tsv.gz,Michael_Bloomberg,29989,77668,1008,108665,44185
hdfs://spark-nn.eemcs.utwente.nl/user/s1934538/clickstream/clickstream-enwiki-2019-03.tsv.gz,DMX_(rapper),13378,88407,488,102273,35737
hdfs://spark-nn.eemcs.utwente.nl/user/s1934538/clickstream/clickstream-enwiki-2019-03.tsv.gz,Naomi_Osaka,14405,99996,669,115070,21930
hdfs://spark-nn.eemcs.utwente.nl/user/s1934538/clickstream/clickstream-enwiki-2019-03.tsv.gz,The_Mandalorian,42372,39711,270,82353,59741
hdfs://spark-nn.eemcs.utwente.nl/user/s1934538/clickstream/clickstream-enwiki-2019-03.tsv.gz,George_VI,334799,165691,645,501135,348561
hdfs://spark-nn.eemcs.utwente.nl/user/s1934538/clickstream/clickstream-enwiki-2019-03.tsv.gz,Sridevi,22028,104728,305,127061,42222
hdfs://spark-nn.eemcs.utwente.nl/user/s1934538/clickstream/clickstream-enwiki-2019-03.tsv.gz,Mulan_(2020_film),38945,48970,375,88290,103298
hdfs://spark-nn.eemcs.utwente.nl/user/s1934538/clickstream/clickstream-enwiki-2019-03.tsv.gz,Gaza_Strip,21645,88386,638,110669,38748
hdfs://spark-nn.eemcs.utwente.nl/user/s1934538/clickstream/clickstream-enwiki-2019-03.tsv.gz,Jason_Momoa,188144,801947,3650,993741,462071
hdfs://spark-nn.eemcs.utwente.nl/user/s1934538/clickstream/clickstream-enwiki-2019-03.tsv.gz,Chernobyl_disaster,44735,401405,2500,448640,132153
hdfs://spark-nn.eemcs.utwente.nl/user/s1934538/clickstream/clickstream-enwiki-2019-03.tsv.gz,Anne_Heche,26173,38776,213,65162,19435
hdfs://spark-nn.eemcs.utwente.nl/user/s1934538/clickstream/clickstream-enwiki-2019-03.tsv.gz,Bonnie_and_Clyde,136770,1815365,10284,1962419,472083
hdfs://spark-nn.eemcs.utwente.nl/user/s1934538/clickstream/clickstream-enwiki-2019-04.tsv.gz,List_of_most_popular_websites,36865,74033,149,111047,51773
hdfs://spark-nn.eemcs.utwente.nl/user/s1934538/clickstream/clickstream-enwiki-2019-04.tsv.gz,Qasem_Soleimani,5416,11625,48,17089,7781
hdfs://spark-nn.eemcs.utwente.nl/user/s1934538/clickstream/clickstream-enwiki-2019-04.tsv.gz,Henry_V_of_England,45333,31902,287,77522,51608
hdfs://spark-nn.eemcs.utwente.nl/user/s1934538/clickstream/clickstream-enwiki-2019-04.tsv.gz,Spider-Man:_Far_From_Home,388291,318245,5745,712281,452446
hdfs://spark-nn.eemcs.utwente.nl/user/s1934538/clickstream/clickstream-enwiki-2019-04.tsv.gz,List_of_highest-grossing_films,520708,1457257,6086,1984051,696882
hdfs://spark-nn.eemcs.utwente.nl/user/s1934538/clickstream/clickstream-enwiki-2019-04.tsv.gz,21_Savage,28455,133314,1713,163482,46416
hdfs://spark-nn.eemcs.utwente.nl/user/s1934538/clickstream/clickstream-enwiki-2019-04.tsv.gz,Avengers:_Endgame,1401370,11728518,297161,13427049,8261835
hdfs://spark-nn.eemcs.utwente.nl/user/s1934538/clickstream/clickstream-enwiki-2019-04.tsv.gz,Bird_Box_(film),25361,166963,1897,194221,65548
hdfs://spark-nn.eemcs.utwente.nl/user/s1934538/clickstream/clickstream-enwiki-2019-04.tsv.gz,Stranger_Things,53843,236278,5025,295146,224554
hdfs://spark-nn.eemcs.utwente.nl/user/s1934538/clickstream/clickstream-enwiki-2019-04.tsv.gz,Sridevi,20111,90740,595,111446,37558
hdfs://spark-nn.eemcs.utwente.nl/user/s1934538/clickstream/clickstream-enwiki-2019-04.tsv.gz,Cristiano_Ronaldo,125070,721795,4939,851804,174310
hdfs://spark-nn.eemcs.utwente.nl/user/s1934538/clickstream/clickstream-enwiki-2019-04.tsv.gz,JSON_Web_Token,1100,21397,26,22523,2115
hdfs://spark-nn.eemcs.utwente.nl/user/s1934538/clickstream/clickstream-enwiki-2019-04.tsv.gz,Cecil_Hotel_(Los_Angeles),4467,17067,35,21569,7937
hdfs://spark-nn.eemcs.utwente.nl/user/s1934538/clickstream/clickstream-enwiki-2019-04.tsv.gz,Simone_Biles,10152,47828,229,58209,14791
hdfs://spark-nn.eemcs.utwente.nl/user/s1934538/clickstream/clickstream-enwiki-2019-04.tsv.gz,Jason_Momoa,251004,999522,5002,1255528,564230
hdfs://spark-nn.eemcs.utwente.nl/user/s1934538/clickstream/clickstream-enwiki-2019-04.tsv.gz,Michael_Jordan,79335,444509,4943,528787,170942
hdfs://spark-nn.eemcs.utwente.nl/user/s1934538/clickstream/clickstream-enwiki-2019-04.tsv.gz,Alexander_Hamilton,65958,277640,1692,345290,149935
hdfs://spark-nn.eemcs.utwente.nl/user/s1934538/clickstream/clickstream-enwiki-2019-04.tsv.gz,Michael_Bloomberg,39589,49975,784,90348,33627
hdfs://spark-nn.eemcs.utwente.nl/user/s1934538/clickstream/clickstream-enwiki-2019-04.tsv.gz,Gaza_Strip,18804,43532,379,62715,24261
hdfs://spark-nn.eemcs.utwente.nl/user/s1934538/clickstream/clickstream-enwiki-2019-04.tsv.gz,Adele,22858,305345,3769,331972,86381
hdfs://spark-nn.eemcs.utwente.nl/user/s1934538/clickstream/clickstream-enwiki-2019-04.tsv.gz,Media,73,22651,552,23276,2635
hdfs://spark-nn.eemcs.utwente.nl/user/s1934538/clickstream/clickstream-enwiki-2019-04.tsv.gz,Afghanistan,43227,136912,1758,181897,108114
hdfs://spark-nn.eemcs.utwente.nl/user/s1934538/clickstream/clickstream-enwiki-2019-04.tsv.gz,J._Robert_Oppenheimer,18129,75080,260,93469,28572
hdfs://spark-nn.eemcs.utwente.nl/user/s1934538/clickstream/clickstream-enwiki-2019-04.tsv.gz,Antifa_(United_States),8516,75114,203,83833,12672
hdfs://spark-nn.eemcs.utwente.nl/user/s1934538/clickstream/clickstream-enwiki-2019-04.tsv.gz,Shakira,22421,166608,1562,190591,77467
hdfs://spark-nn.eemcs.utwente.nl/user/s1934538/clickstream/clickstream-enwiki-2019-04.tsv.gz,List_of_highest-grossing_Indian_films,67998,375024,1727,444749,204974
hdfs://spark-nn.eemcs.utwente.nl/user/s1934538/clickstream/clickstream-enwiki-2019-04.tsv.gz,UEFA_Euro_2020,24438,94898,1179,120515,37557
hdfs://spark-nn.eemcs.utwente.nl/user/s1934538/clickstream/clickstream-enwiki-2019-04.tsv.gz,George_H._W._Bush,121039,141081,1019,263139,134933
hdfs://spark-nn.eemcs.utwente.nl/user/s1934538/clickstream/clickstream-enwiki-2019-04.tsv.gz,The_Lion_King_(2019_film),119722,304547,5881,430150,470754
hdfs://spark-nn.eemcs.utwente.nl/user/s1934538/clickstream/clickstream-enwiki-2019-04.tsv.gz,Parasite_(2019_film),12769,10558,27,23354,7209
hdfs://spark-nn.eemcs.utwente.nl/user/s1934538/clickstream/clickstream-enwiki-2019-04.tsv.gz,2018_Winter_Olympics,18634,24124,361,43119,25415
hdfs://spark-nn.eemcs.utwente.nl/user/s1934538/clickstream/clickstream-enwiki-2019-04.tsv.gz,Rishi_Sunak,3222,2056,10,5288,845
hdfs://spark-nn.eemcs.utwente.nl/user/s1934538/clickstream/clickstream-enwiki-2019-04.tsv.gz,Richard_Ramirez,9040,124989,2128,136157,30808
hdfs://spark-nn.eemcs.utwente.nl/user/s1934538/clickstream/clickstream-enwiki-2019-04.tsv.gz,Pelé,27545,205764,1623,234932,57436
hdfs://spark-nn.eemcs.utwente.nl/user/s1934538/clickstream/clickstream-enwiki-2019-04.tsv.gz,Rihanna,74008,265413,3747,343168,168959
hdfs://spark-nn.eemcs.utwente.nl/user/s1934538/clickstream/clickstream-enwiki-2019-04.tsv.gz,Kate_Spade,23380,57195,430,81005,25357
hdfs://spark-nn.eemcs.utwente.nl/user/s1934538/clickstream/clickstream-enwiki-2019-04.tsv.gz,Rami_Malek,116266,384152,2649,503067,161987
hdfs://spark-nn.eemcs.utwente.nl/user/s1934538/clickstream/clickstream-enwiki-2019-04.tsv.gz,George_VI,318610,154037,602,473249,327356
hdfs://spark-nn.eemcs.utwente.nl/user/s1934538/clickstream/clickstream-enwiki-2019-04.tsv.gz,Sinéad_O'Connor,10512,67518,682,78712,21064
hdfs://spark-nn.eemcs.utwente.nl/user/s1934538/clickstream/clickstream-enwiki-2019-04.tsv.gz,The_Witcher_(TV_series),17736,50430,455,68621,38703
hdfs://spark-nn.eemcs.utwente.nl/user/s1934538/clickstream/clickstream-enwiki-2019-04.tsv.gz,Aaron_Carter,18345,49911,316,68572,22553
hdfs://spark-nn.eemcs.utwente.nl/user/s1934538/clickstream/clickstream-enwiki-2019-04.tsv.gz,Captain_Marvel_(film),452096,2152650,38961,2643707,1238134
hdfs://spark-nn.eemcs.utwente.nl/user/s1934538/clickstream/clickstream-enwiki-2019-04.tsv.gz,"Diana,_Princess_of_Wales",141183,292754,2175,436112,275470
hdfs://spark-nn.eemcs.utwente.nl/user/s1934538/clickstream/clickstream-enwiki-2019-04.tsv.gz,September_11_attacks,87051,362069,3221,452341,178904
hdfs://spark-nn.eemcs.utwente.nl/user/s1934538/clickstream/clickstream-enwiki-2019-04.tsv.gz,Deion_Sanders,9638,91303,421,101362,28996
hdfs://spark-nn.eemcs.utwente.nl/user/s1934538/clickstream/clickstream-enwiki-2019-04.tsv.gz,Chernobyl_disaster,89382,824583,5643,919608,299401
hdfs://spark-nn.eemcs.utwente.nl/user/s1934538/clickstream/clickstream-enwiki-2019-04.tsv.gz,Stephen_Hawking,32375,370805,2644,405824,146656
hdfs://spark-nn.eemcs.utwente.nl/user/s1934538/clickstream/clickstream-enwiki-2019-04.tsv.gz,Glass_(2019_film),157136,997396,11871,1166403,381825
hdfs://spark-nn.eemcs.utwente.nl/user/s1934538/clickstream/clickstream-enwiki-2019-04.tsv.gz,Kim_Jong-un,41611,131153,1355,174119,93515
hdfs://spark-nn.eemcs.utwente.nl/user/s1934538/clickstream/clickstream-enwiki-2019-04.tsv.gz,XXX:_Return_of_Xander_Cage,31137,60505,606,92248,33828
hdfs://spark-nn.eemcs.utwente.nl/user/s1934538/clickstream/clickstream-enwiki-2019-04.tsv.gz,Joker_(2019_film),186595,869296,12596,1068487,878242
hdfs://spark-nn.eemcs.utwente.nl/user/s1934538/clickstream/clickstream-enwiki-2019-04.tsv.gz,"Meghan,_Duchess_of_Sussex",122539,548799,5871,677209,322980
hdfs://spark-nn.eemcs.utwente.nl/user/s1934538/clickstream/clickstream-enwiki-2019-04.tsv.gz,Amy_Coney_Barrett,1359,24368,163,25890,7099
hdfs://spark-nn.eemcs.utwente.nl/user/s1934538/clickstream/clickstream-enwiki-2019-04.tsv.gz,Ray_Liotta,30181,47671,267,78119,24159
hdfs://spark-nn.eemcs.utwente.nl/user/s1934538/clickstream/clickstream-enwiki-2019-04.tsv.gz,Ukraine,55265,220449,5150,280864,128748
hdfs://spark-nn.eemcs.utwente.nl/user/s1934538/clickstream/clickstream-enwiki-2019-04.tsv.gz,Kobe_Bryant_sexual_assault_case,3131,24692,23,27846,2840
hdfs://spark-nn.eemcs.utwente.nl/user/s1934538/clickstream/clickstream-enwiki-2019-04.tsv.gz,Vladimir_Putin,62321,207166,2762,272249,141464
hdfs://spark-nn.eemcs.utwente.nl/user/s1934538/clickstream/clickstream-enwiki-2019-04.tsv.gz,Tom_Brady,48554,217908,2409,268871,81032
hdfs://spark-nn.eemcs.utwente.nl/user/s1934538/clickstream/clickstream-enwiki-2019-04.tsv.gz,Lisa_Marie_Presley,121883,84715,309,206907,103314
hdfs://spark-nn.eemcs.utwente.nl/user/s1934538/clickstream/clickstream-enwiki-2019-04.tsv.gz,Olivia_Newton-John,20558,88789,950,110297,47533
hdfs://spark-nn.eemcs.utwente.nl/user/s1934538/clickstream/clickstream-enwiki-2019-04.tsv.gz,Avicii,35343,611838,4931,652112,164928
hdfs://spark-nn.eemcs.utwente.nl/user/s1934538/clickstream/clickstream-enwiki-2019-04.tsv.gz,William_Murdoch,640,8398,20,9058,272
hdfs://spark-nn.eemcs.utwente.nl/user/s1934538/clickstream/clickstream-enwiki-2019-04.tsv.gz,When_They_See_Us,9880,33770,492,44142,27785
hdfs://spark-nn.eemcs.utwente.nl/user/s1934538/clickstream/clickstream-enwiki-2019-04.tsv.gz,List_of_awards_and_nominations_received_by_Meryl_Streep,10187,7295,187,17669,5647
hdfs://spark-nn.eemcs.utwente.nl/user/s1934538/clickstream/clickstream-enwiki-2019-04.tsv.gz,Aretha_Franklin,21381,114806,1365,137552,44196
hdfs://spark-nn.eemcs.utwente.nl/user/s1934538/clickstream/clickstream-enwiki-2019-04.tsv.gz,Key_frame,580,6624,11,7215,563
hdfs://spark-nn.eemcs.utwente.nl/user/s1934538/clickstream/clickstream-enwiki-2019-04.tsv.gz,Keanu_Reeves,90140,620097,4455,714692,315564
hdfs://spark-nn.eemcs.utwente.nl/user/s1934538/clickstream/clickstream-enwiki-2019-04.tsv.gz,Donald_Trump,235612,861604,11260,1108476,659703
hdfs://spark-nn.eemcs.utwente.nl/user/s1934538/clickstream/clickstream-enwiki-2019-04.tsv.gz,Sushma_Swaraj,6204,37571,62,43837,10999
hdfs://spark-nn.eemcs.utwente.nl/user/s1934538/clickstream/clickstream-enwiki-2019-04.tsv.gz,Lionel_Messi,107378,750372,9245,866995,171775
hdfs://spark-nn.eemcs.utwente.nl/user/s1934538/clickstream/clickstream-enwiki-2019-04.tsv.gz,A_Star_Is_Born_(2018_film),67004,499101,3186,569291,252254
hdfs://spark-nn.eemcs.utwente.nl/user/s1934538/clickstream/clickstream-enwiki-2019-04.tsv.gz,Johnny_Depp,109824,305118,2782,417724,252797
hdfs://spark-nn.eemcs.utwente.nl/user/s1934538/clickstream/clickstream-enwiki-2019-04.tsv.gz,Naomi_Osaka,9847,52592,278,62717,11849
hdfs://spark-nn.eemcs.utwente.nl/user/s1934538/clickstream/clickstream-enwiki-2019-04.tsv.gz,Venom_(2018_film),57761,294417,4435,356613,194566
hdfs://spark-nn.eemcs.utwente.nl/user/s1934538/clickstream/clickstream-enwiki-2019-04.tsv.gz,Amber_Heard,175328,333074,1735,510137,261173
hdfs://spark-nn.eemcs.utwente.nl/user/s1934538/clickstream/clickstream-enwiki-2019-04.tsv.gz,Line_shaft,560,9189,18,9767,193
hdfs://spark-nn.eemcs.utwente.nl/user/s1934538/clickstream/clickstream-enwiki-2019-04.tsv.gz,Queen_(band),134457,585689,6767,726913,683437
hdfs://spark-nn.eemcs.utwente.nl/user/s1934538/clickstream/clickstream-enwiki-2019-04.tsv.gz,The_Irishman_(2019_film),71169,74703,780,146652,110752
hdfs://spark-nn.eemcs.utwente.nl/user/s1934538/clickstream/clickstream-enwiki-2019-04.tsv.gz,State_of_Palestine,48979,99472,124,148575,66811
hdfs://spark-nn.eemcs.utwente.nl/user/s1934538/clickstream/clickstream-enwiki-2019-04.tsv.gz,Chernobyl_(miniseries),13266,173956,1952,189174,117220
hdfs://spark-nn.eemcs.utwente.nl/user/s1934538/clickstream/clickstream-enwiki-2019-04.tsv.gz,XXXTentacion,93855,571104,10327,675286,139882
hdfs://spark-nn.eemcs.utwente.nl/user/s1934538/clickstream/clickstream-enwiki-2019-04.tsv.gz,List_of_James_Bond_films,21251,254441,678,276370,120710
hdfs://spark-nn.eemcs.utwente.nl/user/s1934538/clickstream/clickstream-enwiki-2019-04.tsv.gz,Microsoft_Office,8570,74725,701,83996,22682
hdfs://spark-nn.eemcs.utwente.nl/user/s1934538/clickstream/clickstream-enwiki-2019-04.tsv.gz,Grover,1209,5821,45,7075,1423
hdfs://spark-nn.eemcs.utwente.nl/user/s1934538/clickstream/clickstream-enwiki-2019-04.tsv.gz,Kylian_Mbappé,29867,190628,2703,223198,39297
hdfs://spark-nn.eemcs.utwente.nl/user/s1934538/clickstream/clickstream-enwiki-2019-04.tsv.gz,Taliban,21926,68513,419,90858,45325
hdfs://spark-nn.eemcs.utwente.nl/user/s1934538/clickstream/clickstream-enwiki-2019-04.tsv.gz,Khabib_Nurmagomedov,58624,180568,1746,240938,125605
hdfs://spark-nn.eemcs.utwente.nl/user/s1934538/clickstream/clickstream-enwiki-2019-04.tsv.gz,2016_United_States_presidential_election,102615,205864,2568,311047,216891
hdfs://spark-nn.eemcs.utwente.nl/user/s1934538/clickstream/clickstream-enwiki-2019-04.tsv.gz,Notre-Dame_de_Paris,247073,6822545,156396,7226014,1654677
hdfs://spark-nn.eemcs.utwente.nl/user/s1934538/clickstream/clickstream-enwiki-2019-04.tsv.gz,Cook's_Country,352,2647,25,3024,830
hdfs://spark-nn.eemcs.utwente.nl/user/s1934538/clickstream/clickstream-enwiki-2019-04.tsv.gz,Burt_Reynolds,48182,140393,1123,189698,72482
hdfs://spark-nn.eemcs.utwente.nl/user/s1934538/clickstream/clickstream-enwiki-2019-04.tsv.gz,Cardi_B,59693,547572,6752,614017,224827
hdfs://spark-nn.eemcs.utwente.nl/user/s1934538/clickstream/clickstream-enwiki-2019-04.tsv.gz,Anthony_Bourdain,13212,165207,1349,179768,50744
hdfs://spark-nn.eemcs.utwente.nl/user/s1934538/clickstream/clickstream-enwiki-2019-04.tsv.gz,Sushant_Singh_Rajput,29208,56158,122,85488,50595
hdfs://spark-nn.eemcs.utwente.nl/user/s1934538/clickstream/clickstream-enwiki-2019-04.tsv.gz,Nipsey_Hussle,629950,7880830,122989,8633769,3046433
hdfs://spark-nn.eemcs.utwente.nl/user/s1934538/clickstream/clickstream-enwiki-2019-04.tsv.gz,The_Shape_of_Water,28380,76920,1484,106784,48751
hdfs://spark-nn.eemcs.utwente.nl/user/s1934538/clickstream/clickstream-enwiki-2019-04.tsv.gz,Bonnie_and_Clyde,270770,4206541,23484,4500795,1002598
hdfs://spark-nn.eemcs.utwente.nl/user/s1934538/clickstream/clickstream-enwiki-2019-04.tsv.gz,Area_51,26276,188739,1322,216337,65531
hdfs://spark-nn.eemcs.utwente.nl/user/s1934538/clickstream/clickstream-enwiki-2019-04.tsv.gz,Eddie_Van_Halen,38512,49999,476,88987,46503
hdfs://spark-nn.eemcs.utwente.nl/user/s1934538/clickstream/clickstream-enwiki-2019-04.tsv.gz,YouTube,124269,880607,8573,1013449,147637
hdfs://spark-nn.eemcs.utwente.nl/user/s1934538/clickstream/clickstream-enwiki-2019-04.tsv.gz,Royal_Rumble_(2018),10352,8617,66,19035,12745
hdfs://spark-nn.eemcs.utwente.nl/user/s1934538/clickstream/clickstream-enwiki-2019-04.tsv.gz,HTTP_cookie,10468,297296,115,307879,39480
hdfs://spark-nn.eemcs.utwente.nl/user/s1934538/clickstream/clickstream-enwiki-2019-04.tsv.gz,Louis_Tomlinson,24359,73277,452,98088,14002
hdfs://spark-nn.eemcs.utwente.nl/user/s1934538/clickstream/clickstream-enwiki-2019-04.tsv.gz,Dark_Phoenix_(film),167631,214397,4576,386604,241747
hdfs://spark-nn.eemcs.utwente.nl/user/s1934538/clickstream/clickstream-enwiki-2019-04.tsv.gz,Kobe_Bryant,43517,230621,1768,275906,68853
hdfs://spark-nn.eemcs.utwente.nl/user/s1934538/clickstream/clickstream-enwiki-2019-06.tsv.gz,Venom_(2018_film),46835,277833,4442,329110,163859
hdfs://spark-nn.eemcs.utwente.nl/user/s1934538/clickstream/clickstream-enwiki-2019-06.tsv.gz,Bipin_Rawat,5132,15112,35,20279,7457
hdfs://spark-nn.eemcs.utwente.nl/user/s1934538/clickstream/clickstream-enwiki-2019-06.tsv.gz,Wikipedia,33113,1858947,620,1892680,173772
hdfs://spark-nn.eemcs.utwente.nl/user/s1934538/clickstream/clickstream-enwiki-2019-06.tsv.gz,Stan_Lee,68532,210227,1808,280567,85240
hdfs://spark-nn.eemcs.utwente.nl/user/s1934538/clickstream/clickstream-enwiki-2019-06.tsv.gz,John_McCain,39191,99107,1344,139642,61309
hdfs://spark-nn.eemcs.utwente.nl/user/s1934538/clickstream/clickstream-enwiki-2019-06.tsv.gz,The_Nun_(2018_film),56519,222639,1619,280777,197139
hdfs://spark-nn.eemcs.utwente.nl/user/s1934538/clickstream/clickstream-enwiki-2019-06.tsv.gz,Indian_Premier_League,28558,78365,170,107093,60811
hdfs://spark-nn.eemcs.utwente.nl/user/s1934538/clickstream/clickstream-enwiki-2019-06.tsv.gz,2016_United_States_presidential_election,94385,201544,2446,298375,221475
hdfs://spark-nn.eemcs.utwente.nl/user/s1934538/clickstream/clickstream-enwiki-2019-06.tsv.gz,2022_FIFA_World_Cup,156476,307583,6064,470123,227678
hdfs://spark-nn.eemcs.utwente.nl/user/s1934538/clickstream/clickstream-enwiki-2019-06.tsv.gz,"Prince_Philip,_Duke_of_Edinburgh",259151,306857,5404,571412,348053
hdfs://spark-nn.eemcs.utwente.nl/user/s1934538/clickstream/clickstream-enwiki-2019-06.tsv.gz,Kobe_Bryant_sexual_assault_case,3865,22325,17,26207,3272
hdfs://spark-nn.eemcs.utwente.nl/user/s1934538/clickstream/clickstream-enwiki-2019-06.tsv.gz,Alexander_Hamilton,60992,235771,1586,298349,141756
hdfs://spark-nn.eemcs.utwente.nl/user/s1934538/clickstream/clickstream-enwiki-2019-06.tsv.gz,Avicii,37297,510594,4029,551920,162268
hdfs://spark-nn.eemcs.utwente.nl/user/s1934538/clickstream/clickstream-enwiki-2019-06.tsv.gz,Bonnie_and_Clyde,36264,460037,3007,499308,116421
hdfs://spark-nn.eemcs.utwente.nl/user/s1934538/clickstream/clickstream-enwiki-2019-06.tsv.gz,2020_United_States_presidential_election,98845,292511,6125,397481,304543
hdfs://spark-nn.eemcs.utwente.nl/user/s1934538/clickstream/clickstream-enwiki-2019-06.tsv.gz,NATO,38315,115671,1708,155694,52345
hdfs://spark-nn.eemcs.utwente.nl/user/s1934538/clickstream/clickstream-enwiki-2019-06.tsv.gz,Sylvester_Stallone,87601,373080,2651,463332,300154
hdfs://spark-nn.eemcs.utwente.nl/user/s1934538/clickstream/clickstream-enwiki-2019-06.tsv.gz,Ghislaine_Maxwell,1878,1982,42,3902,989
hdfs://spark-nn.eemcs.utwente.nl/user/s1934538/clickstream/clickstream-enwiki-2019-06.tsv.gz,Aaron_Carter,15885,28022,154,44061,13051
hdfs://spark-nn.eemcs.utwente.nl/user/s1934538/clickstream/clickstream-enwiki-2019-06.tsv.gz,It_Chapter_Two,81712,92092,1744,175548,156726
hdfs://spark-nn.eemcs.utwente.nl/user/s1934538/clickstream/clickstream-enwiki-2019-06.tsv.gz,David_Beckham,44543,210349,1539,256431,84978
hdfs://spark-nn.eemcs.utwente.nl/user/s1934538/clickstream/clickstream-enwiki-2019-06.tsv.gz,Bible,15046,1113995,1411,1130452,30795
hdfs://spark-nn.eemcs.utwente.nl/user/s1934538/clickstream/clickstream-enwiki-2019-06.tsv.gz,Lionel_Messi,99115,629544,8388,737047,153261
hdfs://spark-nn.eemcs.utwente.nl/user/s1934538/clickstream/clickstream-enwiki-2019-06.tsv.gz,Critical_race_theory,1687,17696,60,19443,3594
hdfs://spark-nn.eemcs.utwente.nl/user/s1934538/clickstream/clickstream-enwiki-2019-06.tsv.gz,Black_Panther_(film),60197,148485,2640,211322,131365
hdfs://spark-nn.eemcs.utwente.nl/user/s1934538/clickstream/clickstream-enwiki-2019-06.tsv.gz,United_States_Electoral_College,21936,97873,183,119992,13663
hdfs://spark-nn.eemcs.utwente.nl/user/s1934538/clickstream/clickstream-enwiki-2019-06.tsv.gz,Exo_(band),23122,124847,495,148464,143300
hdfs://spark-nn.eemcs.utwente.nl/user/s1934538/clickstream/clickstream-enwiki-2019-06.tsv.gz,State_of_Palestine,34010,89968,109,124087,52703
hdfs://spark-nn.eemcs.utwente.nl/user/s1934538/clickstream/clickstream-enwiki-2019-06.tsv.gz,Asia_Cup,4530,50889,700,56119,35824
hdfs://spark-nn.eemcs.utwente.nl/user/s1934538/clickstream/clickstream-enwiki-2019-06.tsv.gz,Hamas,14793,27412,173,42378,14843
hdfs://spark-nn.eemcs.utwente.nl/user/s1934538/clickstream/clickstream-enwiki-2019-06.tsv.gz,Tenet_(film),89630,74458,664,164752,156442
hdfs://spark-nn.eemcs.utwente.nl/user/s1934538/clickstream/clickstream-enwiki-2019-06.tsv.gz,Kamala_Harris,51184,1341062,10694,1402940,461293
hdfs://spark-nn.eemcs.utwente.nl/user/s1934538/clickstream/clickstream-enwiki-2019-06.tsv.gz,Simple_Mail_Transfer_Protocol,4262,29442,115,33819,4302
hdfs://spark-nn.eemcs.utwente.nl/user/s1934538/clickstream/clickstream-enwiki-2019-06.tsv.gz,IPv4,11680,41834,122,53636,8945
hdfs://spark-nn.eemcs.utwente.nl/user/s1934538/clickstream/clickstream-enwiki-2019-06.tsv.gz,Donald_Glover,68534,213349,1686,283569,87865
hdfs://spark-nn.eemcs.utwente.nl/user/s1934538/clickstream/clickstream-enwiki-2019-06.tsv.gz,Chernobyl_disaster,860195,8317333,65105,9242633,3976516
hdfs://spark-nn.eemcs.utwente.nl/user/s1934538/clickstream/clickstream-enwiki-2019-06.tsv.gz,Cardi_B,56966,554042,9686,620694,253025
hdfs://spark-nn.eemcs.utwente.nl/user/s1934538/clickstream/clickstream-enwiki-2019-06.tsv.gz,Cook's_Country,273,1946,14,2233,553
hdfs://spark-nn.eemcs.utwente.nl/user/s1934538/clickstream/clickstream-enwiki-2019-06.tsv.gz,Irrfan_Khan,23120,40483,57,63660,27621
hdfs://spark-nn.eemcs.utwente.nl/user/s1934538/clickstream/clickstream-enwiki-2019-06.tsv.gz,Nipsey_Hussle,46316,341800,3396,391512,148043
hdfs://spark-nn.eemcs.utwente.nl/user/s1934538/clickstream/clickstream-enwiki-2019-06.tsv.gz,FIFA_World_Cup,86445,428374,5732,520551,394657
hdfs://spark-nn.eemcs.utwente.nl/user/s1934538/clickstream/clickstream-enwiki-2019-06.tsv.gz,Darth_Vader,21183,167855,560,189598,45493
hdfs://spark-nn.eemcs.utwente.nl/user/s1934538/clickstream/clickstream-enwiki-2019-06.tsv.gz,Rami_Malek,87262,181945,1137,270344,96072
hdfs://spark-nn.eemcs.utwente.nl/user/s1934538/clickstream/clickstream-enwiki-2019-06.tsv.gz,Sushant_Singh_Rajput,24063,54282,106,78451,46134
hdfs://spark-nn.eemcs.utwente.nl/user/s1934538/clickstream/clickstream-enwiki-2019-06.tsv.gz,Chernobyl_(miniseries),282489,3094253,61855,3438597,3058832
hdfs://spark-nn.eemcs.utwente.nl/user/s1934538/clickstream/clickstream-enwiki-2019-06.tsv.gz,Aquaman_(film),76240,237815,3505,317560,167526
hdfs://spark-nn.eemcs.utwente.nl/user/s1934538/clickstream/clickstream-enwiki-2019-06.tsv.gz,Tom_Brady,40116,160781,1294,202191,70199
hdfs://spark-nn.eemcs.utwente.nl/user/s1934538/clickstream/clickstream-enwiki-2019-06.tsv.gz,Joe_Biden,62090,487134,7748,556972,165782
hdfs://spark-nn.eemcs.utwente.nl/user/s1934538/clickstream/clickstream-enwiki-2019-06.tsv.gz,Burt_Reynolds,41412,135176,1313,177901,68498
hdfs://spark-nn.eemcs.utwente.nl/user/s1934538/clickstream/clickstream-enwiki-2019-06.tsv.gz,R._Kelly,25056,125861,1537,152454,62459
hdfs://spark-nn.eemcs.utwente.nl/user/s1934538/clickstream/clickstream-enwiki-2019-06.tsv.gz,Stephen_Hawking,25219,335763,2424,363406,123682
hdfs://spark-nn.eemcs.utwente.nl/user/s1934538/clickstream/clickstream-enwiki-2019-06.tsv.gz,Royal_Rumble_(2018),7932,5740,50,13722,9244
hdfs://spark-nn.eemcs.utwente.nl/user/s1934538/clickstream/clickstream-enwiki-2019-06.tsv.gz,Notre-Dame_de_Paris,16165,117116,1367,134648,31840
hdfs://spark-nn.eemcs.utwente.nl/user/s1934538/clickstream/clickstream-enwiki-2019-06.tsv.gz,Rihanna,86636,365117,4891,456644,220364
hdfs://spark-nn.eemcs.utwente.nl/user/s1934538/clickstream/clickstream-enwiki-2019-06.tsv.gz,Cleopatra,43801,240138,48086,332025,150009
hdfs://spark-nn.eemcs.utwente.nl/user/s1934538/clickstream/clickstream-enwiki-2019-06.tsv.gz,Article_370_of_the_Constitution_of_India,10254,137844,68,148166,10220
hdfs://spark-nn.eemcs.utwente.nl/user/s1934538/clickstream/clickstream-enwiki-2019-06.tsv.gz,Jimmy_Hoffa,18492,66947,537,85976,31640
hdfs://spark-nn.eemcs.utwente.nl/user/s1934538/clickstream/clickstream-enwiki-2019-06.tsv.gz,Chadwick_Boseman,31616,77892,529,110037,35479
hdfs://spark-nn.eemcs.utwente.nl/user/s1934538/clickstream/clickstream-enwiki-2019-06.tsv.gz,The_Weeknd,41505,83515,721,125741,60537
hdfs://spark-nn.eemcs.utwente.nl/user/s1934538/clickstream/clickstream-enwiki-2019-06.tsv.gz,Roe_v._Wade,15686,148089,990,164765,44608
hdfs://spark-nn.eemcs.utwente.nl/user/s1934538/clickstream/clickstream-enwiki-2019-06.tsv.gz,Key_frame,566,5411,10,5987,552
hdfs://spark-nn.eemcs.utwente.nl/user/s1934538/clickstream/clickstream-enwiki-2019-06.tsv.gz,RRR_(film),40019,40067,574,80660,48257
hdfs://spark-nn.eemcs.utwente.nl/user/s1934538/clickstream/clickstream-enwiki-2019-06.tsv.gz,Elon_Musk,69383,634466,4201,708050,370944
hdfs://spark-nn.eemcs.utwente.nl/user/s1934538/clickstream/clickstream-enwiki-2019-06.tsv.gz,Joaquin_Phoenix,136775,159262,775,296812,204672
hdfs://spark-nn.eemcs.utwente.nl/user/s1934538/clickstream/clickstream-enwiki-2019-06.tsv.gz,Simone_Biles,9598,35946,174,45718,10846
hdfs://spark-nn.eemcs.utwente.nl/user/s1934538/clickstream/clickstream-enwiki-2019-06.tsv.gz,Ruth_Bader_Ginsburg,31543,159011,1073,191627,73749
hdfs://spark-nn.eemcs.utwente.nl/user/s1934538/clickstream/clickstream-enwiki-2019-06.tsv.gz,Michael_Jordan,128541,517082,5193,650816,248962
hdfs://spark-nn.eemcs.utwente.nl/user/s1934538/clickstream/clickstream-enwiki-2019-06.tsv.gz,List_of_highest-grossing_films,948019,2614431,14680,3577130,674884
hdfs://spark-nn.eemcs.utwente.nl/user/s1934538/clickstream/clickstream-enwiki-2019-06.tsv.gz,Sridevi,21720,86847,275,108842,38095
hdfs://spark-nn.eemcs.utwente.nl/user/s1934538/clickstream/clickstream-enwiki-2019-06.tsv.gz,21_Savage,24909,87167,1456,113532,34827
hdfs://spark-nn.eemcs.utwente.nl/user/s1934538/clickstream/clickstream-enwiki-2019-06.tsv.gz,Anna_Sorokin,5999,99195,272,105466,27209
hdfs://spark-nn.eemcs.utwente.nl/user/s1934538/clickstream/clickstream-enwiki-2019-06.tsv.gz,Atal_Bihari_Vajpayee,27655,65266,243,93164,24076
hdfs://spark-nn.eemcs.utwente.nl/user/s1934538/clickstream/clickstream-enwiki-2019-06.tsv.gz,Lance_Reddick,53011,36302,137,89450,17715
hdfs://spark-nn.eemcs.utwente.nl/user/s1934538/clickstream/clickstream-enwiki-2019-06.tsv.gz,Jenna_Ortega,7493,10660,774,18927,4140
hdfs://spark-nn.eemcs.utwente.nl/user/s1934538/clickstream/clickstream-enwiki-2019-06.tsv.gz,Kobe_Bryant,75088,336252,2808,414148,118831
hdfs://spark-nn.eemcs.utwente.nl/user/s1934538/clickstream/clickstream-enwiki-2019-06.tsv.gz,XXXTentacion,68981,659921,8198,737100,149061
hdfs://spark-nn.eemcs.utwente.nl/user/s1934538/clickstream/clickstream-enwiki-2019-06.tsv.gz,September_11_attacks,78050,298293,2679,379022,167836
hdfs://spark-nn.eemcs.utwente.nl/user/s1934538/clickstream/clickstream-enwiki-2019-06.tsv.gz,Naya_Rivera,19934,26434,87,46455,9640
hdfs://spark-nn.eemcs.utwente.nl/user/s1934538/clickstream/clickstream-enwiki-2019-06.tsv.gz,Wonder_Woman_1984,82930,78271,1366,162567,98609
hdfs://spark-nn.eemcs.utwente.nl/user/s1934538/clickstream/clickstream-enwiki-2019-06.tsv.gz,YouTube,113535,759265,7509,880309,124100
hdfs://spark-nn.eemcs.utwente.nl/user/s1934538/clickstream/clickstream-enwiki-2019-06.tsv.gz,Tina_Turner,20363,228136,1676,250175,55885
hdfs://spark-nn.eemcs.utwente.nl/user/s1934538/clickstream/clickstream-enwiki-2019-06.tsv.gz,Star_Wars:_The_Rise_of_Skywalker,154587,128578,4074,287239,196779
hdfs://spark-nn.eemcs.utwente.nl/user/s1934538/clickstream/clickstream-enwiki-2019-06.tsv.gz,Line_shaft,487,1265,22,1774,130
hdfs://spark-nn.eemcs.utwente.nl/user/s1934538/clickstream/clickstream-enwiki-2019-06.tsv.gz,Fyre_Festival,18549,165911,992,185452,83837
hdfs://spark-nn.eemcs.utwente.nl/user/s1934538/clickstream/clickstream-enwiki-2019-06.tsv.gz,Crazy_Rich_Asians_(film),47121,249950,3516,300587,334726
hdfs://spark-nn.eemcs.utwente.nl/user/s1934538/clickstream/clickstream-enwiki-2019-06.tsv.gz,Murder_of_Dee_Dee_Blanchard,63177,513289,791,577257,89344
hdfs://spark-nn.eemcs.utwente.nl/user/s1934538/clickstream/clickstream-enwiki-2019-06.tsv.gz,Anne_Heche,36330,50799,223,87352,23976
hdfs://spark-nn.eemcs.utwente.nl/user/s1934538/clickstream/clickstream-enwiki-2019-06.tsv.gz,Captain_Marvel_(film),145261,775157,11628,932046,522288
hdfs://spark-nn.eemcs.utwente.nl/user/s1934538/clickstream/clickstream-enwiki-2019-06.tsv.gz,Jeffrey_Dahmer,28174,378261,3287,409722,164825
hdfs://spark-nn.eemcs.utwente.nl/user/s1934538/clickstream/clickstream-enwiki-2019-06.tsv.gz,Brett_Kavanaugh,22969,48073,354,71396,25262
hdfs://spark-nn.eemcs.utwente.nl/user/s1934538/clickstream/clickstream-enwiki-2019-06.tsv.gz,Bob_Saget,19278,34306,190,53774,10059
hdfs://spark-nn.eemcs.utwente.nl/user/s1934538/clickstream/clickstream-enwiki-2019-06.tsv.gz,Pelé,37301,130535,1404,169240,55434
hdfs://spark-nn.eemcs.utwente.nl/user/s1934538/clickstream/clickstream-enwiki-2019-06.tsv.gz,2018_FIFA_World_Cup,166705,351695,5100,523500,226736
hdfs://spark-nn.eemcs.utwente.nl/user/s1934538/clickstream/clickstream-enwiki-2019-06.tsv.gz,Mac_Miller,35583,289105,1837,326525,89638
hdfs://spark-nn.eemcs.utwente.nl/user/s1934538/clickstream/clickstream-enwiki-2019-06.tsv.gz,2023_Cricket_World_Cup,138970,217472,181,356623,109281
hdfs://spark-nn.eemcs.utwente.nl/user/s1934538/clickstream/clickstream-enwiki-2019-06.tsv.gz,Microsoft_Office,7703,106904,537,115144,22413
hdfs://spark-nn.eemcs.utwente.nl/user/s1934538/clickstream/clickstream-enwiki-2019-06.tsv.gz,The_Lion_King_(2019_film),114729,384197,6457,505383,391477
hdfs://spark-nn.eemcs.utwente.nl/user/s1934538/clickstream/clickstream-enwiki-2019-06.tsv.gz,"Diana,_Princess_of_Wales",146925,278164,2291,427380,271420
hdfs://spark-nn.eemcs.utwente.nl/user/s1934538/clickstream/clickstream-enwiki-2019-06.tsv.gz,Avengers:_Infinity_War,121964,209071,3184,334219,197440
hdfs://spark-nn.eemcs.utwente.nl/user/s1934538/clickstream/clickstream-enwiki-2019-06.tsv.gz,Michael_Bloomberg,76080,60441,307,136828,46626
hdfs://spark-nn.eemcs.utwente.nl/user/s1934538/clickstream/clickstream-enwiki-2019-06.tsv.gz,Ray_Liotta,29121,45685,271,75077,23146
hdfs://spark-nn.eemcs.utwente.nl/user/s1934538/clickstream/clickstream-enwiki-2019-10.tsv.gz,Exo_(band),30047,95175,364,125586,128635
hdfs://spark-nn.eemcs.utwente.nl/user/s1934538/clickstream/clickstream-enwiki-2019-10.tsv.gz,Stranger_Things,76063,449956,8635,534654,409022
hdfs://spark-nn.eemcs.utwente.nl/user/s1934538/clickstream/clickstream-enwiki-2019-10.tsv.gz,"Prince_Philip,_Duke_of_Edinburgh",226975,233819,5717,466511,299439
hdfs://spark-nn.eemcs.utwente.nl/user/s1934538/clickstream/clickstream-enwiki-2019-10.tsv.gz,Brie_Larson,71886,221327,8130,301343,114219
hdfs://spark-nn.eemcs.utwente.nl/user/s1934538/clickstream/clickstream-enwiki-2019-10.tsv.gz,Stephen_Hawking,32312,461490,2593,496395,177635
hdfs://spark-nn.eemcs.utwente.nl/user/s1934538/clickstream/clickstream-enwiki-2019-10.tsv.gz,Cameron_Boyce,47075,291176,1918,340169,101044
hdfs://spark-nn.eemcs.utwente.nl/user/s1934538/clickstream/clickstream-enwiki-2019-10.tsv.gz,When_They_See_Us,29482,178639,931,209052,124824
hdfs://spark-nn.eemcs.utwente.nl/user/s1934538/clickstream/clickstream-enwiki-2019-10.tsv.gz,War_(2019_film),205162,3244348,14579,3464089,792407
hdfs://spark-nn.eemcs.utwente.nl/user/s1934538/clickstream/clickstream-enwiki-2019-10.tsv.gz,The_Falcon_and_the_Winter_Soldier,21647,6349,111,28107,13757
hdfs://spark-nn.eemcs.utwente.nl/user/s1934538/clickstream/clickstream-enwiki-2019-10.tsv.gz,Rishi_Sunak,4774,8762,46,13582,3861
hdfs://spark-nn.eemcs.utwente.nl/user/s1934538/clickstream/clickstream-enwiki-2019-10.tsv.gz,Pornhub,39882,334752,12972,387606,68344
hdfs://spark-nn.eemcs.utwente.nl/user/s1934538/clickstream/clickstream-enwiki-2019-10.tsv.gz,Sridevi,23312,84851,196,108359,39929
hdfs://spark-nn.eemcs.utwente.nl/user/s1934538/clickstream/clickstream-enwiki-2019-10.tsv.gz,List_of_Queen_of_the_South_episodes,12795,10505,123,23423,662
hdfs://spark-nn.eemcs.utwente.nl/user/s1934538/clickstream/clickstream-enwiki-2019-10.tsv.gz,Kate_Spade,25179,61247,393,86819,28288
hdfs://spark-nn.eemcs.utwente.nl/user/s1934538/clickstream/clickstream-enwiki-2019-10.tsv.gz,Adele,24461,250857,5652,280970,85087
hdfs://spark-nn.eemcs.utwente.nl/user/s1934538/clickstream/clickstream-enwiki-2019-10.tsv.gz,Donald_Glover,64828,177325,1262,243415,73127
hdfs://spark-nn.eemcs.utwente.nl/user/s1934538/clickstream/clickstream-enwiki-2019-10.tsv.gz,Ghislaine_Maxwell,24368,46888,429,71685,27552
hdfs://spark-nn.eemcs.utwente.nl/user/s1934538/clickstream/clickstream-enwiki-2019-10.tsv.gz,Antifa_(United_States),9248,170053,458,179759,22212
hdfs://spark-nn.eemcs.utwente.nl/user/s1934538/clickstream/clickstream-enwiki-2019-10.tsv.gz,"Diana,_Princess_of_Wales",145703,327291,2547,475541,293806
hdfs://spark-nn.eemcs.utwente.nl/user/s1934538/clickstream/clickstream-enwiki-2019-10.tsv.gz,Lionel_Messi,89263,614516,6505,710284,137990
hdfs://spark-nn.eemcs.utwente.nl/user/s1934538/clickstream/clickstream-enwiki-2019-10.tsv.gz,Sushma_Swaraj,5342,49788,85,55215,6897
hdfs://spark-nn.eemcs.utwente.nl/user/s1934538/clickstream/clickstream-enwiki-2019-10.tsv.gz,John_McCain,37107,96643,1145,134895,60946
hdfs://spark-nn.eemcs.utwente.nl/user/s1934538/clickstream/clickstream-enwiki-2019-10.tsv.gz,Kylian_Mbappé,26007,157714,1951,185672,32906
hdfs://spark-nn.eemcs.utwente.nl/user/s1934538/clickstream/clickstream-enwiki-2019-10.tsv.gz,Mac_Miller,27598,151212,1309,180119,54201
hdfs://spark-nn.eemcs.utwente.nl/user/s1934538/clickstream/clickstream-enwiki-2019-10.tsv.gz,A_Star_Is_Born_(2018_film),58895,252158,1584,312637,143800
hdfs://spark-nn.eemcs.utwente.nl/user/s1934538/clickstream/clickstream-enwiki-2019-10.tsv.gz,Wikipedia,42058,14531755,1112,14574925,221177
hdfs://spark-nn.eemcs.utwente.nl/user/s1934538/clickstream/clickstream-enwiki-2019-10.tsv.gz,21_Savage,23053,77370,1583,102006,30095
hdfs://spark-nn.eemcs.utwente.nl/user/s1934538/clickstream/clickstream-enwiki-2019-10.tsv.gz,Khabib_Nurmagomedov,64648,203292,3167,271107,128678
hdfs://spark-nn.eemcs.utwente.nl/user/s1934538/clickstream/clickstream-enwiki-2019-10.tsv.gz,Tenet_(film),130576,119274,769,250619,211660
hdfs://spark-nn.eemcs.utwente.nl/user/s1934538/clickstream/clickstream-enwiki-2019-10.tsv.gz,Game_of_Thrones,64728,269218,8561,342507,219177
hdfs://spark-nn.eemcs.utwente.nl/user/s1934538/clickstream/clickstream-enwiki-2019-10.tsv.gz,Bird_Box_(film),20709,96268,1055,118032,35017
hdfs://spark-nn.eemcs.utwente.nl/user/s1934538/clickstream/clickstream-enwiki-2019-10.tsv.gz,Amber_Heard,110691,192651,836,304178,143421
hdfs://spark-nn.eemcs.utwente.nl/user/s1934538/clickstream/clickstream-enwiki-2019-10.tsv.gz,Cricket_World_Cup,7482,52810,373,60665,26319
hdfs://spark-nn.eemcs.utwente.nl/user/s1934538/clickstream/clickstream-enwiki-2019-10.tsv.gz,1917_(2019_film),46028,178862,4144,229034,136866
hdfs://spark-nn.eemcs.utwente.nl/user/s1934538/clickstream/clickstream-enwiki-2019-10.tsv.gz,George_VI,382200,185469,3017,570686,399932
hdfs://spark-nn.eemcs.utwente.nl/user/s1934538/clickstream/clickstream-enwiki-2019-10.tsv.gz,Deion_Sanders,15559,152827,925,169311,49227
hdfs://spark-nn.eemcs.utwente.nl/user/s1934538/clickstream/clickstream-enwiki-2019-10.tsv.gz,The_Witcher_(TV_series),20749,171379,2061,194189,94256
hdfs://spark-nn.eemcs.utwente.nl/user/s1934538/clickstream/clickstream-enwiki-2019-10.tsv.gz,List_of_Marvel_Cinematic_Universe_films,115778,648740,6053,770571,349718
hdfs://spark-nn.eemcs.utwente.nl/user/s1934538/clickstream/clickstream-enwiki-2019-10.tsv.gz,Kobe_Bryant_sexual_assault_case,2041,15804,39,17884,1803
hdfs://spark-nn.eemcs.utwente.nl/user/s1934538/clickstream/clickstream-enwiki-2019-10.tsv.gz,XHamster,8203,64246,2553,75002,13142
hdfs://spark-nn.eemcs.utwente.nl/user/s1934538/clickstream/clickstream-enwiki-2019-10.tsv.gz,Irrfan_Khan,24414,38749,59,63222,27989
hdfs://spark-nn.eemcs.utwente.nl/user/s1934538/clickstream/clickstream-enwiki-2019-10.tsv.gz,R._Kelly,43484,340470,2973,386927,154135
hdfs://spark-nn.eemcs.utwente.nl/user/s1934538/clickstream/clickstream-enwiki-2019-10.tsv.gz,Jeffrey_Dahmer,29772,371120,3991,404883,162491
hdfs://spark-nn.eemcs.utwente.nl/user/s1934538/clickstream/clickstream-enwiki-2019-10.tsv.gz,Richard_Ramirez,50614,410365,2667,463646,121829
hdfs://spark-nn.eemcs.utwente.nl/user/s1934538/clickstream/clickstream-enwiki-2019-10.tsv.gz,Bob_Saget,17812,38389,359,56560,10929
hdfs://spark-nn.eemcs.utwente.nl/user/s1934538/clickstream/clickstream-enwiki-2019-10.tsv.gz,2022_FIFA_World_Cup,65100,134486,3780,203366,111021
hdfs://spark-nn.eemcs.utwente.nl/user/s1934538/clickstream/clickstream-enwiki-2019-10.tsv.gz,Kelly_Preston,75152,46025,124,121301,33983
hdfs://spark-nn.eemcs.utwente.nl/user/s1934538/clickstream/clickstream-enwiki-2019-10.tsv.gz,Simone_Biles,30121,500406,4562,535089,144808
hdfs://spark-nn.eemcs.utwente.nl/user/s1934538/clickstream/clickstream-enwiki-2019-10.tsv.gz,Bible,17416,1943542,1561,1962519,34833
hdfs://spark-nn.eemcs.utwente.nl/user/s1934538/clickstream/clickstream-enwiki-2019-10.tsv.gz,Grover,1671,9526,69,11266,2087
hdfs://spark-nn.eemcs.utwente.nl/user/s1934538/clickstream/clickstream-enwiki-2019-10.tsv.gz,Cleopatra,38915,167990,1669,208574,82452
hdfs://spark-nn.eemcs.utwente.nl/user/s1934538/clickstream/clickstream-enwiki-2019-10.tsv.gz,Fyre_Festival,10345,88693,518,99556,45821
hdfs://spark-nn.eemcs.utwente.nl/user/s1934538/clickstream/clickstream-enwiki-2019-10.tsv.gz,The_Suicide_Squad_(film),195691,83422,1354,280467,295829
hdfs://spark-nn.eemcs.utwente.nl/user/s1934538/clickstream/clickstream-enwiki-2019-10.tsv.gz,Naomi_Osaka,18634,101897,636,121167,30845
hdfs://spark-nn.eemcs.utwente.nl/user/s1934538/clickstream/clickstream-enwiki-2019-10.tsv.gz,HTTP_cookie,12277,383316,126,395719,56512
hdfs://spark-nn.eemcs.utwente.nl/user/s1934538/clickstream/clickstream-enwiki-2019-10.tsv.gz,Bonnie_and_Clyde,24614,260388,1618,286620,66648
hdfs://spark-nn.eemcs.utwente.nl/user/s1934538/clickstream/clickstream-enwiki-2019-10.tsv.gz,Tom_Brady,109886,530595,5153,645634,219559
hdfs://spark-nn.eemcs.utwente.nl/user/s1934538/clickstream/clickstream-enwiki-2019-10.tsv.gz,Spider-Man:_Far_From_Home,142197,480494,9871,632562,389400
hdfs://spark-nn.eemcs.utwente.nl/user/s1934538/clickstream/clickstream-enwiki-2019-10.tsv.gz,Stan_Lee,38233,136908,1420,176561,49931
hdfs://spark-nn.eemcs.utwente.nl/user/s1934538/clickstream/clickstream-enwiki-2019-10.tsv.gz,A_Quiet_Place_(film),34190,195273,1848,231311,68807
hdfs://spark-nn.eemcs.utwente.nl/user/s1934538/clickstream/clickstream-enwiki-2019-10.tsv.gz,Charles_Sobhraj,4190,23905,57,28152,6702
hdfs://spark-nn.eemcs.utwente.nl/user/s1934538/clickstream/clickstream-enwiki-2019-10.tsv.gz,Murder_of_Dee_Dee_Blanchard,21390,196012,613,218015,38672
hdfs://spark-nn.eemcs.utwente.nl/user/s1934538/clickstream/clickstream-enwiki-2019-10.tsv.gz,2020_Summer_Olympics,70172,213859,5595,289626,255723
hdfs://spark-nn.eemcs.utwente.nl/user/s1934538/clickstream/clickstream-enwiki-2019-10.tsv.gz,Crazy_Rich_Asians_(film),38633,131544,1420,171597,161028
hdfs://spark-nn.eemcs.utwente.nl/user/s1934538/clickstream/clickstream-enwiki-2019-10.tsv.gz,Hamas,17963,28582,184,46729,16130
hdfs://spark-nn.eemcs.utwente.nl/user/s1934538/clickstream/clickstream-enwiki-2019-10.tsv.gz,The_Shape_of_Water,35728,75128,720,111576,44102
hdfs://spark-nn.eemcs.utwente.nl/user/s1934538/clickstream/clickstream-enwiki-2019-10.tsv.gz,Jenna_Ortega,7826,10398,1163,19387,4309
hdfs://spark-nn.eemcs.utwente.nl/user/s1934538/clickstream/clickstream-enwiki-2019-10.tsv.gz,Article_370_of_the_Constitution_of_India,6919,294063,298,301280,25780
hdfs://spark-nn.eemcs.utwente.nl/user/s1934538/clickstream/clickstream-enwiki-2019-10.tsv.gz,Fantastic_Beasts:_The_Crimes_of_Grindelwald,69258,123878,1922,195058,108210
hdfs://spark-nn.eemcs.utwente.nl/user/s1934538/clickstream/clickstream-enwiki-2019-10.tsv.gz,Mötley_Crüe,29950,104235,1211,135396,158212
hdfs://spark-nn.eemcs.utwente.nl/user/s1934538/clickstream/clickstream-enwiki-2019-10.tsv.gz,Bipin_Rawat,8532,29951,74,38557,17455
hdfs://spark-nn.eemcs.utwente.nl/user/s1934538/clickstream/clickstream-enwiki-2019-10.tsv.gz,Puneeth_Rajkumar,10140,24761,14,34915,17629
hdfs://spark-nn.eemcs.utwente.nl/user/s1934538/clickstream/clickstream-enwiki-2019-10.tsv.gz,Tonya_Harding,27160,103860,401,131421,27828
hdfs://spark-nn.eemcs.utwente.nl/user/s1934538/clickstream/clickstream-enwiki-2019-10.tsv.gz,Johnny_Depp,129842,309948,2056,441846,258770
hdfs://spark-nn.eemcs.utwente.nl/user/s1934538/clickstream/clickstream-enwiki-2019-10.tsv.gz,Sylvester_Stallone,100235,395620,2756,498611,350394
hdfs://spark-nn.eemcs.utwente.nl/user/s1934538/clickstream/clickstream-enwiki-2019-10.tsv.gz,Rihanna,67354,264627,3822,335803,160994
hdfs://spark-nn.eemcs.utwente.nl/user/s1934538/clickstream/clickstream-enwiki-2019-10.tsv.gz,Mulan_(2020_film),33352,45952,1223,80527,67150
hdfs://spark-nn.eemcs.utwente.nl/user/s1934538/clickstream/clickstream-enwiki-2019-10.tsv.gz,Luke_Perry,62846,495892,2682,561420,130758
hdfs://spark-nn.eemcs.utwente.nl/user/s1934538/clickstream/clickstream-enwiki-2019-10.tsv.gz,Media,71,22532,347,22950,2154
hdfs://spark-nn.eemcs.utwente.nl/user/s1934538/clickstream/clickstream-enwiki-2019-10.tsv.gz,Deaths_in_2019,1201561,2148657,9288,3359506,1816213
hdfs://spark-nn.eemcs.utwente.nl/user/s1934538/clickstream/clickstream-enwiki-2019-10.tsv.gz,Wonder_Woman_1984,93543,55977,736,150256,90724
hdfs://spark-nn.eemcs.utwente.nl/user/s1934538/clickstream/clickstream-enwiki-2019-10.tsv.gz,Brett_Kavanaugh,25268,55782,403,81453,26553
hdfs://spark-nn.eemcs.utwente.nl/user/s1934538/clickstream/clickstream-enwiki-2019-10.tsv.gz,Michael_Jordan,58690,358309,3140,420139,126132
hdfs://spark-nn.eemcs.utwente.nl/user/s1934538/clickstream/clickstream-enwiki-2019-10.tsv.gz,Croatia,36881,141740,2074,180695,57048
hdfs://spark-nn.eemcs.utwente.nl/user/s1934538/clickstream/clickstream-enwiki-2019-10.tsv.gz,Royal_Rumble_(2018),7559,4991,46,12596,9136
hdfs://spark-nn.eemcs.utwente.nl/user/s1934538/clickstream/clickstream-enwiki-2019-10.tsv.gz,Once_Upon_a_Time_in_Hollywood,149596,378149,10002,537747,363937
hdfs://spark-nn.eemcs.utwente.nl/user/s1934538/clickstream/clickstream-enwiki-2019-10.tsv.gz,Charles_III,73,285,58,416,357
hdfs://spark-nn.eemcs.utwente.nl/user/s1934538/clickstream/clickstream-enwiki-2019-10.tsv.gz,The_Weeknd,58110,97718,857,156685,67992
hdfs://spark-nn.eemcs.utwente.nl/user/s1934538/clickstream/clickstream-enwiki-2019-10.tsv.gz,Chadwick_Boseman,27034,59797,554,87385,30771
hdfs://spark-nn.eemcs.utwente.nl/user/s1934538/clickstream/clickstream-enwiki-2019-10.tsv.gz,Eddie_Van_Halen,39094,111942,1311,152347,75451
hdfs://spark-nn.eemcs.utwente.nl/user/s1934538/clickstream/clickstream-enwiki-2019-10.tsv.gz,Taliban,28299,82394,502,111195,63436
hdfs://spark-nn.eemcs.utwente.nl/user/s1934538/clickstream/clickstream-enwiki-2019-10.tsv.gz,List_of_James_Bond_films,22207,198575,391,221173,111331
hdfs://spark-nn.eemcs.utwente.nl/user/s1934538/clickstream/clickstream-enwiki-2019-10.tsv.gz,Rami_Malek,123995,298506,1633,424134,143788
hdfs://spark-nn.eemcs.utwente.nl/user/s1934538/clickstream/clickstream-enwiki-2019-10.tsv.gz,Valentine's_Day,3367,36858,251,40476,3092
hdfs://spark-nn.eemcs.utwente.nl/user/s1934538/clickstream/clickstream-enwiki-2019-10.tsv.gz,Nipsey_Hussle,30960,290307,1289,322556,80056
hdfs://spark-nn.eemcs.utwente.nl/user/s1934538/clickstream/clickstream-enwiki-2019-10.tsv.gz,Queen_(band),82954,289473,3545,375972,342881
hdfs://spark-nn.eemcs.utwente.nl/user/s1934538/clickstream/clickstream-enwiki-2019-10.tsv.gz,Sushant_Singh_Rajput,30468,71442,252,102162,63772
hdfs://spark-nn.eemcs.utwente.nl/user/s1934538/clickstream/clickstream-enwiki-2019-10.tsv.gz,Olivia_Newton-John,26113,167707,1463,195283,80432
hdfs://spark-nn.eemcs.utwente.nl/user/s1934538/clickstream/clickstream-enwiki-2019-10.tsv.gz,J._Robert_Oppenheimer,17776,80080,253,98109,31958
hdfs://spark-nn.eemcs.utwente.nl/user/s1934538/clickstream/clickstream-enwiki-2019-10.tsv.gz,September_11_attacks,83156,369690,2476,455322,176294
hdfs://spark-nn.eemcs.utwente.nl/user/s1934538/clickstream/clickstream-enwiki-2019-10.tsv.gz,"Meghan,_Duchess_of_Sussex",112525,371449,3695,487669,299377
hdfs://spark-nn.eemcs.utwente.nl/user/s1934538/clickstream/clickstream-enwiki-2019-10.tsv.gz,Venom_(2018_film),88481,156654,2922,248057,118980
hdfs://spark-nn.eemcs.utwente.nl/user/s1934538/clickstream/clickstream-enwiki-2019-10.tsv.gz,Amy_Coney_Barrett,1169,4572,27,5768,1368
hdfs://spark-nn.eemcs.utwente.nl/user/s1934538/clickstream/clickstream-enwiki-2019-10.tsv.gz,Jimmy_Buffett,8278,45778,512,54568,17465
hdfs://spark-nn.eemcs.utwente.nl/user/s1934538/clickstream/clickstream-enwiki-2019-10.tsv.gz,Betty_White,54343,243693,2549,300585,75125
hdfs://spark-nn.eemcs.utwente.nl/user/s1934538/clickstream/clickstream-enwiki-2019-10.tsv.gz,IPv4,15855,2351341,165,2367361,12472
hdfs://spark-nn.eemcs.utwente.nl/user/s1934538/clickstream/clickstream-enwiki-2019-10.tsv.gz,Michael_Bloomberg,57308,105570,653,163531,57131
hdfs://spark-nn.eemcs.utwente.nl/user/s1934538/clickstream/clickstream-enwiki-2019-10.tsv.gz,DMX_(rapper),15357,81803,438,97598,38184
hdfs://spark-nn.eemcs.utwente.nl/user/s1934538/clickstream/clickstream-enwiki-2019-10.tsv.gz,Salman_Rushdie,24920,70473,917,96310,45144
hdfs://spark-nn.eemcs.utwente.nl/user/s1934538/clickstream/clickstream-enwiki-2019-10.tsv.gz,Game_of_Thrones_(season_8),17998,79083,1403,98484,36342
hdfs://spark-nn.eemcs.utwente.nl/user/s1934538/clickstream/clickstream-enwiki-2019-10.tsv.gz,Indian_Premier_League,15690,46996,148,62834,36037
hdfs://spark-nn.eemcs.utwente.nl/user/s1934538/clickstream/clickstream-enwiki-2019-10.tsv.gz,Vladimir_Putin,80691,237038,3347,321076,184396
hdfs://spark-nn.eemcs.utwente.nl/user/s1934538/clickstream/clickstream-enwiki-2019-10.tsv.gz,Glass_(2019_film),78855,274743,2735,356333,134204
hdfs://spark-nn.eemcs.utwente.nl/user/s1934538/clickstream/clickstream-enwiki-2019-10.tsv.gz,2018_Asian_Games,7878,15721,118,23717,15394
hdfs://spark-nn.eemcs.utwente.nl/user/s1934538/clickstream/clickstream-enwiki-2019-10.tsv.gz,Asia_Cup,1110,13757,78,14945,8416
hdfs://spark-nn.eemcs.utwente.nl/user/s1934538/clickstream/clickstream-enwiki-2019-10.tsv.gz,Watts_family_murders,3711,123652,285,127648,33982
hdfs://spark-nn.eemcs.utwente.nl/user/s1934538/clickstream/clickstream-enwiki-2019-10.tsv.gz,K.G.F:_Chapter_2,35665,55917,110,91692,38622
hdfs://spark-nn.eemcs.utwente.nl/user/s1934538/clickstream/clickstream-enwiki-2019-10.tsv.gz,Kobe_Bryant,28030,152254,1043,181327,42682
hdfs://spark-nn.eemcs.utwente.nl/user/s1934538/clickstream/clickstream-enwiki-2021-02.tsv.gz,Ruth_Bader_Ginsburg,26261,139606,1090,166957,55847
hdfs://spark-nn.eemcs.utwente.nl/user/s1934538/clickstream/clickstream-enwiki-2021-02.tsv.gz,Ant-Man_and_the_Wasp:_Quantumania,112086,16969,428,129483,107134
hdfs://spark-nn.eemcs.utwente.nl/user/s1934538/clickstream/clickstream-enwiki-2021-02.tsv.gz,Khabib_Nurmagomedov,69993,221594,2488,294075,157889
hdfs://spark-nn.eemcs.utwente.nl/user/s1934538/clickstream/clickstream-enwiki-2021-02.tsv.gz,John_McCain,52647,114088,1354,168089,86147
hdfs://spark-nn.eemcs.utwente.nl/user/s1934538/clickstream/clickstream-enwiki-2021-02.tsv.gz,Antifa_(United_States),19860,188730,1186,209776,40012
hdfs://spark-nn.eemcs.utwente.nl/user/s1934538/clickstream/clickstream-enwiki-2021-02.tsv.gz,Dark_Phoenix_(film),86205,107363,1216,194784,122788
hdfs://spark-nn.eemcs.utwente.nl/user/s1934538/clickstream/clickstream-enwiki-2021-02.tsv.gz,Sridevi,28125,95461,224,123810,53787
hdfs://spark-nn.eemcs.utwente.nl/user/s1934538/clickstream/clickstream-enwiki-2021-02.tsv.gz,List_of_Marvel_Cinematic_Universe_films,158908,825749,3033,987690,533787
hdfs://spark-nn.eemcs.utwente.nl/user/s1934538/clickstream/clickstream-enwiki-2021-02.tsv.gz,FIFA_World_Cup,39345,186432,1865,227642,139460
hdfs://spark-nn.eemcs.utwente.nl/user/s1934538/clickstream/clickstream-enwiki-2021-02.tsv.gz,Spanish_flu,42470,353279,4461,400210,88337
hdfs://spark-nn.eemcs.utwente.nl/user/s1934538/clickstream/clickstream-enwiki-2021-02.tsv.gz,Indian_Premier_League,23230,113067,202,136499,95827
hdfs://spark-nn.eemcs.utwente.nl/user/s1934538/clickstream/clickstream-enwiki-2021-02.tsv.gz,Wikipedia,217290,1354634,1118,1573042,572555
hdfs://spark-nn.eemcs.utwente.nl/user/s1934538/clickstream/clickstream-enwiki-2021-02.tsv.gz,The_Shape_of_Water,27988,80326,921,109235,53227
hdfs://spark-nn.eemcs.utwente.nl/user/s1934538/clickstream/clickstream-enwiki-2021-02.tsv.gz,Avicii,21692,222357,1589,245638,110792
hdfs://spark-nn.eemcs.utwente.nl/user/s1934538/clickstream/clickstream-enwiki-2021-02.tsv.gz,Shang-Chi_and_the_Legend_of_the_Ten_Rings,182981,75558,565,259104,196116
hdfs://spark-nn.eemcs.utwente.nl/user/s1934538/clickstream/clickstream-enwiki-2021-02.tsv.gz,COVID-19_pandemic,452773,620056,4643,1077472,496258
hdfs://spark-nn.eemcs.utwente.nl/user/s1934538/clickstream/clickstream-enwiki-2021-02.tsv.gz,Main_Page,62911,170602496,4557750,175223157,34686778
hdfs://spark-nn.eemcs.utwente.nl/user/s1934538/clickstream/clickstream-enwiki-2021-02.tsv.gz,Killing_of_George_Floyd,36951,88083,153,125187,43089
hdfs://spark-nn.eemcs.utwente.nl/user/s1934538/clickstream/clickstream-enwiki-2021-02.tsv.gz,2016_United_States_presidential_election,180923,121492,1280,303695,275289
hdfs://spark-nn.eemcs.utwente.nl/user/s1934538/clickstream/clickstream-enwiki-2021-02.tsv.gz,George_H._W._Bush,182025,149519,1068,332612,198858
hdfs://spark-nn.eemcs.utwente.nl/user/s1934538/clickstream/clickstream-enwiki-2021-02.tsv.gz,Anthony_Bourdain,20168,215491,1613,237272,75989
hdfs://spark-nn.eemcs.utwente.nl/user/s1934538/clickstream/clickstream-enwiki-2021-02.tsv.gz,Darth_Vader,33619,80961,757,115337,71598
hdfs://spark-nn.eemcs.utwente.nl/user/s1934538/clickstream/clickstream-enwiki-2021-02.tsv.gz,Venom_(2018_film),25517,113533,1458,140508,72884
hdfs://spark-nn.eemcs.utwente.nl/user/s1934538/clickstream/clickstream-enwiki-2021-02.tsv.gz,Kelly_Preston,136828,312798,1349,450975,127024
hdfs://spark-nn.eemcs.utwente.nl/user/s1934538/clickstream/clickstream-enwiki-2021-02.tsv.gz,Lionel_Messi,96376,501737,6139,604252,138169
hdfs://spark-nn.eemcs.utwente.nl/user/s1934538/clickstream/clickstream-enwiki-2021-02.tsv.gz,Lance_Reddick,32837,44528,202,77567,16704
hdfs://spark-nn.eemcs.utwente.nl/user/s1934538/clickstream/clickstream-enwiki-2021-02.tsv.gz,Spider-Man:_Far_From_Home,95090,160379,8856,264325,165969
hdfs://spark-nn.eemcs.utwente.nl/user/s1934538/clickstream/clickstream-enwiki-2021-02.tsv.gz,J._Robert_Oppenheimer,20597,83612,336,104545,34207
hdfs://spark-nn.eemcs.utwente.nl/user/s1934538/clickstream/clickstream-enwiki-2021-02.tsv.gz,Us_(2019_film),28511,123916,460,152887,51348
hdfs://spark-nn.eemcs.utwente.nl/user/s1934538/clickstream/clickstream-enwiki-2021-02.tsv.gz,2022_FIFA_World_Cup,60285,119535,1773,181593,95884
hdfs://spark-nn.eemcs.utwente.nl/user/s1934538/clickstream/clickstream-enwiki-2021-02.tsv.gz,Louis_Tomlinson,32452,68274,848,101574,22248
hdfs://spark-nn.eemcs.utwente.nl/user/s1934538/clickstream/clickstream-enwiki-2021-02.tsv.gz,Atal_Bihari_Vajpayee,28726,50223,112,79061,26427
hdfs://spark-nn.eemcs.utwente.nl/user/s1934538/clickstream/clickstream-enwiki-2021-02.tsv.gz,Bridgerton,122837,1795799,21150,1939786,1472328
hdfs://spark-nn.eemcs.utwente.nl/user/s1934538/clickstream/clickstream-enwiki-2021-02.tsv.gz,War_(2019_film),14989,48527,108,63624,17837
hdfs://spark-nn.eemcs.utwente.nl/user/s1934538/clickstream/clickstream-enwiki-2021-02.tsv.gz,State_of_Palestine,44148,99105,127,143380,66090
hdfs://spark-nn.eemcs.utwente.nl/user/s1934538/clickstream/clickstream-enwiki-2021-02.tsv.gz,Rihanna,81334,708619,6080,796033,276681
hdfs://spark-nn.eemcs.utwente.nl/user/s1934538/clickstream/clickstream-enwiki-2021-02.tsv.gz,The_Irishman,54861,112209,1864,168934,146696
hdfs://spark-nn.eemcs.utwente.nl/user/s1934538/clickstream/clickstream-enwiki-2021-02.tsv.gz,XHamster,8712,193563,3838,206113,25444
hdfs://spark-nn.eemcs.utwente.nl/user/s1934538/clickstream/clickstream-enwiki-2021-02.tsv.gz,Tenet_(film),112997,459540,5411,577948,288460
hdfs://spark-nn.eemcs.utwente.nl/user/s1934538/clickstream/clickstream-enwiki-2021-02.tsv.gz,Kobe_Bryant_sexual_assault_case,12459,59337,87,71883,5723
hdfs://spark-nn.eemcs.utwente.nl/user/s1934538/clickstream/clickstream-enwiki-2021-02.tsv.gz,Eddie_Van_Halen,50370,109161,1039,160570,59954
hdfs://spark-nn.eemcs.utwente.nl/user/s1934538/clickstream/clickstream-enwiki-2021-02.tsv.gz,Lisa_Marie_Presley,131956,88787,1121,221864,119037
hdfs://spark-nn.eemcs.utwente.nl/user/s1934538/clickstream/clickstream-enwiki-2021-02.tsv.gz,Parasite_(2019_film),45627,256649,2259,304535,125385
hdfs://spark-nn.eemcs.utwente.nl/user/s1934538/clickstream/clickstream-enwiki-2021-02.tsv.gz,Cook's_Country,459,3283,30,3772,1120
hdfs://spark-nn.eemcs.utwente.nl/user/s1934538/clickstream/clickstream-enwiki-2021-02.tsv.gz,Bible,17963,4153431,1934,4173328,37343
hdfs://spark-nn.eemcs.utwente.nl/user/s1934538/clickstream/clickstream-enwiki-2021-02.tsv.gz,Thor:_Love_and_Thunder,210545,84850,1626,297021,275045
hdfs://spark-nn.eemcs.utwente.nl/user/s1934538/clickstream/clickstream-enwiki-2021-02.tsv.gz,Salman_Rushdie,27822,64175,398,92395,38571
hdfs://spark-nn.eemcs.utwente.nl/user/s1934538/clickstream/clickstream-enwiki-2021-02.tsv.gz,Coronavirus,18144,298526,3811,320481,70631
hdfs://spark-nn.eemcs.utwente.nl/user/s1934538/clickstream/clickstream-enwiki-2021-02.tsv.gz,WrestleMania_34,30970,15002,189,46161,32306
hdfs://spark-nn.eemcs.utwente.nl/user/s1934538/clickstream/clickstream-enwiki-2021-02.tsv.gz,Joe_Exotic,19818,95780,483,116081,30545
hdfs://spark-nn.eemcs.utwente.nl/user/s1934538/clickstream/clickstream-enwiki-2021-02.tsv.gz,Captain_Marvel_(film),147814,278810,3446,430070,253479
hdfs://spark-nn.eemcs.utwente.nl/user/s1934538/clickstream/clickstream-enwiki-2021-02.tsv.gz,Cleopatra,45100,2474997,2143,2522240,218603
hdfs://spark-nn.eemcs.utwente.nl/user/s1934538/clickstream/clickstream-enwiki-2021-02.tsv.gz,Deadpool_2,64318,93632,2110,160060,135295
hdfs://spark-nn.eemcs.utwente.nl/user/s1934538/clickstream/clickstream-enwiki-2021-02.tsv.gz,Coronavirus_disease_2019,124037,320322,12629,456988,154361
hdfs://spark-nn.eemcs.utwente.nl/user/s1934538/clickstream/clickstream-enwiki-2021-02.tsv.gz,The_Sandman_(TV_series),15993,21795,273,38061,31512
hdfs://spark-nn.eemcs.utwente.nl/user/s1934538/clickstream/clickstream-enwiki-2021-02.tsv.gz,2018_Asian_Games,5703,7536,31,13270,10609
hdfs://spark-nn.eemcs.utwente.nl/user/s1934538/clickstream/clickstream-enwiki-2021-02.tsv.gz,Grover,1814,6943,56,8813,1880
hdfs://spark-nn.eemcs.utwente.nl/user/s1934538/clickstream/clickstream-enwiki-2021-02.tsv.gz,William_Murdoch,583,1934,14,2531,372
hdfs://spark-nn.eemcs.utwente.nl/user/s1934538/clickstream/clickstream-enwiki-2021-02.tsv.gz,Mulan_(2020_film),25722,147409,2135,175266,116170
hdfs://spark-nn.eemcs.utwente.nl/user/s1934538/clickstream/clickstream-enwiki-2021-02.tsv.gz,Bonnie_and_Clyde,25774,266086,1590,293450,69715
hdfs://spark-nn.eemcs.utwente.nl/user/s1934538/clickstream/clickstream-enwiki-2021-02.tsv.gz,List_of_most_popular_websites,10217,44042,77,54336,19797
hdfs://spark-nn.eemcs.utwente.nl/user/s1934538/clickstream/clickstream-enwiki-2021-02.tsv.gz,Joaquin_Phoenix,126964,183607,930,311501,193928
hdfs://spark-nn.eemcs.utwente.nl/user/s1934538/clickstream/clickstream-enwiki-2021-02.tsv.gz,Pornhub,43682,368777,14574,427033,93411
hdfs://spark-nn.eemcs.utwente.nl/user/s1934538/clickstream/clickstream-enwiki-2021-02.tsv.gz,Anne_Heche,36155,82217,325,118697,38957
hdfs://spark-nn.eemcs.utwente.nl/user/s1934538/clickstream/clickstream-enwiki-2021-02.tsv.gz,Stranger_Things_(season_3),16952,41685,395,59032,31838
hdfs://spark-nn.eemcs.utwente.nl/user/s1934538/clickstream/clickstream-enwiki-2021-02.tsv.gz,Lists_of_deaths_by_year,7603,334480,756,342839,356149
hdfs://spark-nn.eemcs.utwente.nl/user/s1934538/clickstream/clickstream-enwiki-2021-02.tsv.gz,David_Beckham,34911,188122,1175,224208,78787
hdfs://spark-nn.eemcs.utwente.nl/user/s1934538/clickstream/clickstream-enwiki-2021-02.tsv.gz,Aaron_Carter,17678,65558,447,83683,35852
hdfs://spark-nn.eemcs.utwente.nl/user/s1934538/clickstream/clickstream-enwiki-2021-02.tsv.gz,United_States_Electoral_College,17847,50728,177,68752,10946
hdfs://spark-nn.eemcs.utwente.nl/user/s1934538/clickstream/clickstream-enwiki-2021-02.tsv.gz,Wonder_Woman_1984,87587,363194,7755,458536,218904
hdfs://spark-nn.eemcs.utwente.nl/user/s1934538/clickstream/clickstream-enwiki-2021-02.tsv.gz,Deion_Sanders,19243,169208,1116,189567,72022
hdfs://spark-nn.eemcs.utwente.nl/user/s1934538/clickstream/clickstream-enwiki-2021-02.tsv.gz,Once_Upon_a_Time_in_Hollywood,101974,183181,2784,287939,298421
hdfs://spark-nn.eemcs.utwente.nl/user/s1934538/clickstream/clickstream-enwiki-2021-02.tsv.gz,Valentine's_Day,36408,1468812,13067,1518287,135329
hdfs://spark-nn.eemcs.utwente.nl/user/s1934538/clickstream/clickstream-enwiki-2021-02.tsv.gz,Sylvester_Stallone,92069,287349,2234,381652,283074
hdfs://spark-nn.eemcs.utwente.nl/user/s1934538/clickstream/clickstream-enwiki-2021-02.tsv.gz,Rishi_Sunak,17034,111934,794,129762,67380
hdfs://spark-nn.eemcs.utwente.nl/user/s1934538/clickstream/clickstream-enwiki-2021-02.tsv.gz,Bob_Saget,30550,57612,427,88589,14586
hdfs://spark-nn.eemcs.utwente.nl/user/s1934538/clickstream/clickstream-enwiki-2021-02.tsv.gz,Top_Gun:_Maverick,54035,64231,1878,120144,83307
hdfs://spark-nn.eemcs.utwente.nl/user/s1934538/clickstream/clickstream-enwiki-2021-02.tsv.gz,Freddie_Mercury,109024,823800,5383,938207,339171
hdfs://spark-nn.eemcs.utwente.nl/user/s1934538/clickstream/clickstream-enwiki-2021-02.tsv.gz,Kim_Jong-un,67949,173550,2759,244258,133388
hdfs://spark-nn.eemcs.utwente.nl/user/s1934538/clickstream/clickstream-enwiki-2021-02.tsv.gz,Kenosha_unrest_shooting,10480,108691,942,120113,17360
hdfs://spark-nn.eemcs.utwente.nl/user/s1934538/clickstream/clickstream-enwiki-2021-02.tsv.gz,The_Lion_King_(2019_film),41708,59129,549,101386,51117
hdfs://spark-nn.eemcs.utwente.nl/user/s1934538/clickstream/clickstream-enwiki-2021-02.tsv.gz,Taliban,26880,64968,603,92451,64033
hdfs://spark-nn.eemcs.utwente.nl/user/s1934538/clickstream/clickstream-enwiki-2021-02.tsv.gz,Mötley_Crüe,32410,103409,1293,137112,167648
hdfs://spark-nn.eemcs.utwente.nl/user/s1934538/clickstream/clickstream-enwiki-2021-02.tsv.gz,Anna_Sorokin,10155,131801,740,142696,41250
hdfs://spark-nn.eemcs.utwente.nl/user/s1934538/clickstream/clickstream-enwiki-2021-02.tsv.gz,RRR_(film),36862,60533,181,97576,53438
hdfs://spark-nn.eemcs.utwente.nl/user/s1934538/clickstream/clickstream-enwiki-2021-02.tsv.gz,Johnny_Depp,156667,400646,3397,560710,411172
hdfs://spark-nn.eemcs.utwente.nl/user/s1934538/clickstream/clickstream-enwiki-2021-02.tsv.gz,Hyphen-minus,4724,6476460,7187883,13669067,761
hdfs://spark-nn.eemcs.utwente.nl/user/s1934538/clickstream/clickstream-enwiki-2021-02.tsv.gz,Don't_Look_Up_(2021_film),105317,89727,306,195350,96121
hdfs://spark-nn.eemcs.utwente.nl/user/s1934538/clickstream/clickstream-enwiki-2021-02.tsv.gz,Qasem_Soleimani,13364,30644,153,44161,21224
hdfs://spark-nn.eemcs.utwente.nl/user/s1934538/clickstream/clickstream-enwiki-2021-02.tsv.gz,Roe_v._Wade,12992,62986,336,76314,23248
hdfs://spark-nn.eemcs.utwente.nl/user/s1934538/clickstream/clickstream-enwiki-2021-02.tsv.gz,Ukraine,47641,121184,2975,171800,86342
hdfs://spark-nn.eemcs.utwente.nl/user/s1934538/clickstream/clickstream-enwiki-2021-02.tsv.gz,The_Suicide_Squad_(film),147861,79603,1160,228624,199155
hdfs://spark-nn.eemcs.utwente.nl/user/s1934538/clickstream/clickstream-enwiki-2021-02.tsv.gz,Glass_(2019_film),68316,80895,694,149905,54011
hdfs://spark-nn.eemcs.utwente.nl/user/s1934538/clickstream/clickstream-enwiki-2021-02.tsv.gz,List_of_highest-grossing_films,117299,217206,943,335448,180825
hdfs://spark-nn.eemcs.utwente.nl/user/s1934538/clickstream/clickstream-enwiki-2021-02.tsv.gz,Sinéad_O'Connor,18920,102636,1045,122601,39260
hdfs://spark-nn.eemcs.utwente.nl/user/s1934538/clickstream/clickstream-enwiki-2021-02.tsv.gz,"Meghan,_Duchess_of_Sussex",141428,417156,3540,562124,274216
hdfs://spark-nn.eemcs.utwente.nl/user/s1934538/clickstream/clickstream-enwiki-2021-02.tsv.gz,Dune_(2021_film),78916,174561,2102,255579,160374
hdfs://spark-nn.eemcs.utwente.nl/user/s1934538/clickstream/clickstream-enwiki-2021-02.tsv.gz,Juice_Wrld,40192,360500,5999,406691,125375
hdfs://spark-nn.eemcs.utwente.nl/user/s1934538/clickstream/clickstream-enwiki-2021-02.tsv.gz,Richard_Ramirez,130744,1707228,32244,1870216,540550
hdfs://spark-nn.eemcs.utwente.nl/user/s1934538/clickstream/clickstream-enwiki-2021-02.tsv.gz,"Prince_Philip,_Duke_of_Edinburgh",392948,825870,9023,1227841,750929
hdfs://spark-nn.eemcs.utwente.nl/user/s1934538/clickstream/clickstream-enwiki-2021-02.tsv.gz,Aretha_Franklin,31727,166498,1349,199574,69808
hdfs://spark-nn.eemcs.utwente.nl/user/s1934538/clickstream/clickstream-enwiki-2021-02.tsv.gz,QAnon,88220,1396175,10252,1494647,257463
hdfs://spark-nn.eemcs.utwente.nl/user/s1934538/clickstream/clickstream-enwiki-2021-02.tsv.gz,K.G.F:_Chapter_2,24640,128962,578,154180,53255
hdfs://spark-nn.eemcs.utwente.nl/user/s1934538/clickstream/clickstream-enwiki-2021-02.tsv.gz,Dennis_Nilsen,17759,117458,637,135854,29497
hdfs://spark-nn.eemcs.utwente.nl/user/s1934538/clickstream/clickstream-enwiki-2021-05.tsv.gz,Sinéad_O'Connor,18949,274370,3209,296528,100674
hdfs://spark-nn.eemcs.utwente.nl/user/s1934538/clickstream/clickstream-enwiki-2021-05.tsv.gz,2016_United_States_presidential_election,147475,97118,2088,246681,227791
hdfs://spark-nn.eemcs.utwente.nl/user/s1934538/clickstream/clickstream-enwiki-2021-05.tsv.gz,Mac_Miller,49612,208385,1595,259592,72666
hdfs://spark-nn.eemcs.utwente.nl/user/s1934538/clickstream/clickstream-enwiki-2021-05.tsv.gz,Tasuku_Honjo,1194,736059,240,737493,20391
hdfs://spark-nn.eemcs.utwente.nl/user/s1934538/clickstream/clickstream-enwiki-2021-05.tsv.gz,List_of_Marvel_Cinematic_Universe_films,167544,910390,1950,1079884,513536
hdfs://spark-nn.eemcs.utwente.nl/user/s1934538/clickstream/clickstream-enwiki-2021-05.tsv.gz,Grover,1582,5550,53,7185,1755
hdfs://spark-nn.eemcs.utwente.nl/user/s1934538/clickstream/clickstream-enwiki-2021-05.tsv.gz,Once_Upon_a_Time_in_Hollywood,110923,197921,4026,312870,311379
hdfs://spark-nn.eemcs.utwente.nl/user/s1934538/clickstream/clickstream-enwiki-2021-05.tsv.gz,Luke_Perry,40288,144266,875,185429,63548
hdfs://spark-nn.eemcs.utwente.nl/user/s1934538/clickstream/clickstream-enwiki-2021-05.tsv.gz,2018_FIFA_World_Cup,120109,135326,1956,257391,162082
hdfs://spark-nn.eemcs.utwente.nl/user/s1934538/clickstream/clickstream-enwiki-2021-05.tsv.gz,Eternals_(film),367756,1303999,15660,1687415,2070686
hdfs://spark-nn.eemcs.utwente.nl/user/s1934538/clickstream/clickstream-enwiki-2021-05.tsv.gz,The_Nun_(2018_film),43307,92626,716,136649,80914
hdfs://spark-nn.eemcs.utwente.nl/user/s1934538/clickstream/clickstream-enwiki-2021-05.tsv.gz,Ted_Bundy,44604,443910,5662,494176,117104
hdfs://spark-nn.eemcs.utwente.nl/user/s1934538/clickstream/clickstream-enwiki-2021-05.tsv.gz,List_of_Queen_of_the_South_episodes,42461,32954,148,75563,2605
hdfs://spark-nn.eemcs.utwente.nl/user/s1934538/clickstream/clickstream-enwiki-2021-05.tsv.gz,Top_Gun:_Maverick,75806,97983,4165,177954,110365
hdfs://spark-nn.eemcs.utwente.nl/user/s1934538/clickstream/clickstream-enwiki-2021-05.tsv.gz,Spider-Man:_No_Way_Home,244478,276012,4243,524733,323080
hdfs://spark-nn.eemcs.utwente.nl/user/s1934538/clickstream/clickstream-enwiki-2021-05.tsv.gz,Joe_Exotic,24501,122053,798,147352,43815
hdfs://spark-nn.eemcs.utwente.nl/user/s1934538/clickstream/clickstream-enwiki-2021-05.tsv.gz,Bridgerton,36921,311994,4842,353757,238664
hdfs://spark-nn.eemcs.utwente.nl/user/s1934538/clickstream/clickstream-enwiki-2021-05.tsv.gz,Stranger_Things_(season_3),24979,53984,452,79415,45224
hdfs://spark-nn.eemcs.utwente.nl/user/s1934538/clickstream/clickstream-enwiki-2021-05.tsv.gz,William_Murdoch,634,1181,10,1825,390
hdfs://spark-nn.eemcs.utwente.nl/user/s1934538/clickstream/clickstream-enwiki-2021-05.tsv.gz,House_of_the_Dragon,45061,86784,14948,146793,139133
hdfs://spark-nn.eemcs.utwente.nl/user/s1934538/clickstream/clickstream-enwiki-2021-05.tsv.gz,Bird_Box_(film),24314,92624,1223,118161,36916
hdfs://spark-nn.eemcs.utwente.nl/user/s1934538/clickstream/clickstream-enwiki-2021-05.tsv.gz,J._Robert_Oppenheimer,25178,91142,347,116667,40602
hdfs://spark-nn.eemcs.utwente.nl/user/s1934538/clickstream/clickstream-enwiki-2021-05.tsv.gz,Key_frame,619,4980,23,5622,400
hdfs://spark-nn.eemcs.utwente.nl/user/s1934538/clickstream/clickstream-enwiki-2021-05.tsv.gz,"Diana,_Princess_of_Wales",239773,684557,6678,931008,577592
hdfs://spark-nn.eemcs.utwente.nl/user/s1934538/clickstream/clickstream-enwiki-2021-05.tsv.gz,Russo-Ukrainian_War,24542,45307,156,70005,36863
hdfs://spark-nn.eemcs.utwente.nl/user/s1934538/clickstream/clickstream-enwiki-2021-05.tsv.gz,ICC_Men's_T20_World_Cup,9384,118886,201,128471,60448
hdfs://spark-nn.eemcs.utwente.nl/user/s1934538/clickstream/clickstream-enwiki-2021-05.tsv.gz,Hamilton_(musical),42044,217960,1964,261968,164916
hdfs://spark-nn.eemcs.utwente.nl/user/s1934538/clickstream/clickstream-enwiki-2021-05.tsv.gz,Anne_Heche,32258,75962,629,108849,37843
hdfs://spark-nn.eemcs.utwente.nl/user/s1934538/clickstream/clickstream-enwiki-2021-05.tsv.gz,Joe_Biden,276467,576569,11592,864628,454333
hdfs://spark-nn.eemcs.utwente.nl/user/s1934538/clickstream/clickstream-enwiki-2021-05.tsv.gz,"Meghan,_Duchess_of_Sussex",111560,301976,6644,420180,198345
hdfs://spark-nn.eemcs.utwente.nl/user/s1934538/clickstream/clickstream-enwiki-2021-05.tsv.gz,Elliot_Page,127096,1227056,7660,1361812,553550
hdfs://spark-nn.eemcs.utwente.nl/user/s1934538/clickstream/clickstream-enwiki-2021-05.tsv.gz,Vladimir_Putin,114564,289690,3926,408180,245270
hdfs://spark-nn.eemcs.utwente.nl/user/s1934538/clickstream/clickstream-enwiki-2021-05.tsv.gz,Ruth_Bader_Ginsburg,29847,177580,999,208426,82166
hdfs://spark-nn.eemcs.utwente.nl/user/s1934538/clickstream/clickstream-enwiki-2021-05.tsv.gz,Tom_Brady,70608,276094,3446,350148,132315
hdfs://spark-nn.eemcs.utwente.nl/user/s1934538/clickstream/clickstream-enwiki-2021-05.tsv.gz,XHamster,9053,195668,5350,210071,28353
hdfs://spark-nn.eemcs.utwente.nl/user/s1934538/clickstream/clickstream-enwiki-2021-05.tsv.gz,Irrfan_Khan,45234,99336,182,144752,60296
hdfs://spark-nn.eemcs.utwente.nl/user/s1934538/clickstream/clickstream-enwiki-2021-05.tsv.gz,FIFA_World_Cup,64947,249379,3390,317716,219078
hdfs://spark-nn.eemcs.utwente.nl/user/s1934538/clickstream/clickstream-enwiki-2021-05.tsv.gz,Microsoft_Office,8029,3278254,863,3287146,20863
hdfs://spark-nn.eemcs.utwente.nl/user/s1934538/clickstream/clickstream-enwiki-2021-05.tsv.gz,Deion_Sanders,11050,131402,784,143236,48969
hdfs://spark-nn.eemcs.utwente.nl/user/s1934538/clickstream/clickstream-enwiki-2021-05.tsv.gz,2018_Winter_Olympics,22781,16377,281,39439,28010
hdfs://spark-nn.eemcs.utwente.nl/user/s1934538/clickstream/clickstream-enwiki-2021-05.tsv.gz,Bipin_Rawat,9949,15917,13,25879,13247
hdfs://spark-nn.eemcs.utwente.nl/user/s1934538/clickstream/clickstream-enwiki-2021-05.tsv.gz,Venom_(2018_film),70375,268888,4189,343452,208583
hdfs://spark-nn.eemcs.utwente.nl/user/s1934538/clickstream/clickstream-enwiki-2021-05.tsv.gz,Main_Page,57383,178492011,5308940,183858334,37786663
hdfs://spark-nn.eemcs.utwente.nl/user/s1934538/clickstream/clickstream-enwiki-2021-05.tsv.gz,Star_Wars:_The_Rise_of_Skywalker,90850,83739,2159,176748,95932
hdfs://spark-nn.eemcs.utwente.nl/user/s1934538/clickstream/clickstream-enwiki-2021-05.tsv.gz,When_They_See_Us,17018,38840,261,56119,26897
hdfs://spark-nn.eemcs.utwente.nl/user/s1934538/clickstream/clickstream-enwiki-2021-05.tsv.gz,Joker_(2019_film),61750,210858,2683,275291,128141
hdfs://spark-nn.eemcs.utwente.nl/user/s1934538/clickstream/clickstream-enwiki-2021-05.tsv.gz,Adele,24805,170758,2567,198130,65008
hdfs://spark-nn.eemcs.utwente.nl/user/s1934538/clickstream/clickstream-enwiki-2021-05.tsv.gz,Notre-Dame_de_Paris,13017,78499,974,92490,21974
hdfs://spark-nn.eemcs.utwente.nl/user/s1934538/clickstream/clickstream-enwiki-2021-05.tsv.gz,K.G.F:_Chapter_2,29527,102242,272,132041,58059
hdfs://spark-nn.eemcs.utwente.nl/user/s1934538/clickstream/clickstream-enwiki-2021-05.tsv.gz,Wikipedia,265989,695631,1698,963318,243123
hdfs://spark-nn.eemcs.utwente.nl/user/s1934538/clickstream/clickstream-enwiki-2021-05.tsv.gz,Christopher_Scarver,59002,16926,21,75949,27693
hdfs://spark-nn.eemcs.utwente.nl/user/s1934538/clickstream/clickstream-enwiki-2021-05.tsv.gz,Wonder_Woman_1984,70105,372852,6155,449112,237916
hdfs://spark-nn.eemcs.utwente.nl/user/s1934538/clickstream/clickstream-enwiki-2021-05.tsv.gz,Asia_Cup,2881,54312,62,57255,25839
hdfs://spark-nn.eemcs.utwente.nl/user/s1934538/clickstream/clickstream-enwiki-2021-05.tsv.gz,Godzilla_vs._Kong,105288,563033,12791,681112,300164
hdfs://spark-nn.eemcs.utwente.nl/user/s1934538/clickstream/clickstream-enwiki-2021-05.tsv.gz,Brett_Kavanaugh,18896,30277,249,49422,16197
hdfs://spark-nn.eemcs.utwente.nl/user/s1934538/clickstream/clickstream-enwiki-2021-05.tsv.gz,2018_Asian_Games,7305,7104,54,14463,14429
hdfs://spark-nn.eemcs.utwente.nl/user/s1934538/clickstream/clickstream-enwiki-2021-05.tsv.gz,Keanu_Reeves,107566,588925,3786,700277,383161
hdfs://spark-nn.eemcs.utwente.nl/user/s1934538/clickstream/clickstream-enwiki-2021-05.tsv.gz,Antifa_(United_States),13459,78416,744,92619,20108
hdfs://spark-nn.eemcs.utwente.nl/user/s1934538/clickstream/clickstream-enwiki-2021-05.tsv.gz,George_H._W._Bush,162999,120119,1324,284442,171077
hdfs://spark-nn.eemcs.utwente.nl/user/s1934538/clickstream/clickstream-enwiki-2021-05.tsv.gz,The_Weeknd,83702,332986,4643,421331,172210
hdfs://spark-nn.eemcs.utwente.nl/user/s1934538/clickstream/clickstream-enwiki-2021-05.tsv.gz,NATO,65817,196814,3777,266408,101003
hdfs://spark-nn.eemcs.utwente.nl/user/s1934538/clickstream/clickstream-enwiki-2021-05.tsv.gz,Henry_V_of_England,94931,108353,956,204240,149921
hdfs://spark-nn.eemcs.utwente.nl/user/s1934538/clickstream/clickstream-enwiki-2021-05.tsv.gz,War_(2019_film),20145,55434,203,75782,23959
hdfs://spark-nn.eemcs.utwente.nl/user/s1934538/clickstream/clickstream-enwiki-2021-05.tsv.gz,Chernobyl_(miniseries),34210,149872,3089,187171,178372
hdfs://spark-nn.eemcs.utwente.nl/user/s1934538/clickstream/clickstream-enwiki-2021-05.tsv.gz,The_Falcon_and_the_Winter_Soldier,106486,572066,11122,689674,421669
hdfs://spark-nn.eemcs.utwente.nl/user/s1934538/clickstream/clickstream-enwiki-2021-05.tsv.gz,Sushma_Swaraj,9768,21986,56,31810,9733
hdfs://spark-nn.eemcs.utwente.nl/user/s1934538/clickstream/clickstream-enwiki-2021-05.tsv.gz,Amber_Heard,176373,224633,1454,402460,165073
hdfs://spark-nn.eemcs.utwente.nl/user/s1934538/clickstream/clickstream-enwiki-2021-05.tsv.gz,2023_Cricket_World_Cup,15374,28131,72,43577,16572
hdfs://spark-nn.eemcs.utwente.nl/user/s1934538/clickstream/clickstream-enwiki-2021-05.tsv.gz,The_Suicide_Squad_(film),145368,97891,2286,245545,190533
hdfs://spark-nn.eemcs.utwente.nl/user/s1934538/clickstream/clickstream-enwiki-2021-05.tsv.gz,Matthew_Perry,356001,1457160,7566,1820727,839512
hdfs://spark-nn.eemcs.utwente.nl/user/s1934538/clickstream/clickstream-enwiki-2021-05.tsv.gz,Avengers:_Infinity_War,72594,102675,1684,176953,108770
hdfs://spark-nn.eemcs.utwente.nl/user/s1934538/clickstream/clickstream-enwiki-2021-05.tsv.gz,Stranger_Things,78570,310145,6847,395562,307030
hdfs://spark-nn.eemcs.utwente.nl/user/s1934538/clickstream/clickstream-enwiki-2021-05.tsv.gz,Donald_Trump,270200,600239,11082,881521,479342
hdfs://spark-nn.eemcs.utwente.nl/user/s1934538/clickstream/clickstream-enwiki-2021-05.tsv.gz,Elizabeth_II,594937,937452,4686,1537075,1170870
hdfs://spark-nn.eemcs.utwente.nl/user/s1934538/clickstream/clickstream-enwiki-2021-05.tsv.gz,COVID-19_pandemic_by_country_and_territory,219306,537363,10361,767030,449370
hdfs://spark-nn.eemcs.utwente.nl/user/s1934538/clickstream/clickstream-enwiki-2021-05.tsv.gz,IPv4,11404,38052,214,49670,9602
hdfs://spark-nn.eemcs.utwente.nl/user/s1934538/clickstream/clickstream-enwiki-2021-05.tsv.gz,WrestleMania_34,18110,10254,301,28665,19385
hdfs://spark-nn.eemcs.utwente.nl/user/s1934538/clickstream/clickstream-enwiki-2021-05.tsv.gz,Taliban,47000,132672,1409,181081,120641
hdfs://spark-nn.eemcs.utwente.nl/user/s1934538/clickstream/clickstream-enwiki-2021-05.tsv.gz,The_Flash_(film),80758,41614,442,122814,95776
hdfs://spark-nn.eemcs.utwente.nl/user/s1934538/clickstream/clickstream-enwiki-2021-05.tsv.gz,Game_of_Thrones_(season_8),26677,58578,1120,86375,35202
hdfs://spark-nn.eemcs.utwente.nl/user/s1934538/clickstream/clickstream-enwiki-2021-05.tsv.gz,Don't_Look_Up_(2021_film),136498,35498,619,172615,73446
hdfs://spark-nn.eemcs.utwente.nl/user/s1934538/clickstream/clickstream-enwiki-2021-05.tsv.gz,Critical_race_theory,17547,1514069,9378,1540994,226059
hdfs://spark-nn.eemcs.utwente.nl/user/s1934538/clickstream/clickstream-enwiki-2021-05.tsv.gz,1234,119,1363,24,1506,212
hdfs://spark-nn.eemcs.utwente.nl/user/s1934538/clickstream/clickstream-enwiki-2021-05.tsv.gz,Salman_Rushdie,39551,80983,685,121219,49577
hdfs://spark-nn.eemcs.utwente.nl/user/s1934538/clickstream/clickstream-enwiki-2021-05.tsv.gz,Richard_Ramirez,27207,395208,2444,424859,122438
hdfs://spark-nn.eemcs.utwente.nl/user/s1934538/clickstream/clickstream-enwiki-2021-05.tsv.gz,Ukraine,65451,181086,4175,250712,121098
hdfs://spark-nn.eemcs.utwente.nl/user/s1934538/clickstream/clickstream-enwiki-2021-05.tsv.gz,Us_(2019_film),32018,143767,864,176649,58159
hdfs://spark-nn.eemcs.utwente.nl/user/s1934538/clickstream/clickstream-enwiki-2021-05.tsv.gz,Charles_III,149,231,94,474,448
hdfs://spark-nn.eemcs.utwente.nl/user/s1934538/clickstream/clickstream-enwiki-2021-05.tsv.gz,Stephen_Hawking,37655,430492,2850,470997,192045
hdfs://spark-nn.eemcs.utwente.nl/user/s1934538/clickstream/clickstream-enwiki-2021-05.tsv.gz,The_Mandalorian,83486,259184,5204,347874,248094
hdfs://spark-nn.eemcs.utwente.nl/user/s1934538/clickstream/clickstream-enwiki-2021-05.tsv.gz,The_Umbrella_Academy_(TV_series),48011,161174,3157,212342,124714
hdfs://spark-nn.eemcs.utwente.nl/user/s1934538/clickstream/clickstream-enwiki-2021-05.tsv.gz,Dennis_Nilsen,15605,96090,681,112376,30555
hdfs://spark-nn.eemcs.utwente.nl/user/s1934538/clickstream/clickstream-enwiki-2021-05.tsv.gz,Meat_Loaf,31091,114688,1389,147168,56640
hdfs://spark-nn.eemcs.utwente.nl/user/s1934538/clickstream/clickstream-enwiki-2021-05.tsv.gz,Dune_(2021_film),106687,168025,3439,278151,190454
hdfs://spark-nn.eemcs.utwente.nl/user/s1934538/clickstream/clickstream-enwiki-2021-05.tsv.gz,Deadpool_2,57588,77535,2079,137202,104949
hdfs://spark-nn.eemcs.utwente.nl/user/s1934538/clickstream/clickstream-enwiki-2021-05.tsv.gz,List_of_awards_and_nominations_received_by_Meryl_Streep,21694,13959,104,35757,14563
hdfs://spark-nn.eemcs.utwente.nl/user/s1934538/clickstream/clickstream-enwiki-2021-05.tsv.gz,Crazy_Rich_Asians_(film),43035,121984,1570,166589,151137
hdfs://spark-nn.eemcs.utwente.nl/user/s1934538/clickstream/clickstream-enwiki-2021-05.tsv.gz,Saaho,20834,57908,214,78956,31275
hdfs://spark-nn.eemcs.utwente.nl/user/s1934538/clickstream/clickstream-enwiki-2021-05.tsv.gz,Murder_of_Dee_Dee_Blanchard,19552,453589,903,474044,67877
hdfs://spark-nn.eemcs.utwente.nl/user/s1934538/clickstream/clickstream-enwiki-2021-05.tsv.gz,Chernobyl_disaster,90095,521909,5675,617679,273970
hdfs://spark-nn.eemcs.utwente.nl/user/s1934538/clickstream/clickstream-enwiki-2021-05.tsv.gz,Game_of_Thrones,103745,404223,11095,519063,366641
hdfs://spark-nn.eemcs.utwente.nl/user/s1934538/clickstream/clickstream-enwiki-2021-05.tsv.gz,No_Time_to_Die,230199,182796,2856,415851,236983
hdfs://spark-nn.eemcs.utwente.nl/user/s1934538/clickstream/clickstream-enwiki-2021-05.tsv.gz,Rishi_Sunak,17887,47246,293,65426,28444
hdfs://spark-nn.eemcs.utwente.nl/user/s1934538/clickstream/clickstream-enwiki-2021-05.tsv.gz,Fantastic_Beasts:_The_Crimes_of_Grindelwald,55092,73869,1026,129987,79934
hdfs://spark-nn.eemcs.utwente.nl/user/s1934538/clickstream/clickstream-enwiki-2021-05.tsv.gz,Kenosha_unrest_shooting,14737,62122,357,77216,11976
hdfs://spark-nn.eemcs.utwente.nl/user/s1934538/clickstream/clickstream-enwiki-2021-05.tsv.gz,Area_51,23611,175797,1685,201093,51265
hdfs://spark-nn.eemcs.utwente.nl/user/s1934538/clickstream/clickstream-enwiki-2021-05.tsv.gz,Alexander_Hamilton,75636,251621,2021,329278,173319
hdfs://spark-nn.eemcs.utwente.nl/user/s1934538/clickstream/clickstream-enwiki-2021-05.tsv.gz,Laal_Singh_Chaddha,45410,54137,13306,112853,55537
hdfs://spark-nn.eemcs.utwente.nl/user/s1934538/clickstream/clickstream-enwiki-2021-05.tsv.gz,Mulan_(2020_film),31647,103454,1930,137031,84791
hdfs://spark-nn.eemcs.utwente.nl/user/s1934538/clickstream/clickstream-enwiki-2021-05.tsv.gz,Bob_Saget,21586,45168,2064,68818,14287
hdfs://spark-nn.eemcs.utwente.nl/user/s1934538/clickstream/clickstream-enwiki-2021-05.tsv.gz,Ray_Liotta,42617,54025,492,97134,36473
hdfs://spark-nn.eemcs.utwente.nl/user/s1934538/clickstream/clickstream-enwiki-2021-05.tsv.gz,JSON_Web_Token,845,24345,40,25230,2125
hdfs://spark-nn.eemcs.utwente.nl/user/s1934538/clickstream/clickstream-enwiki-2021-05.tsv.gz,List_of_highest-grossing_films,133620,294113,1494,429227,219128
hdfs://spark-nn.eemcs.utwente.nl/user/s1934538/clickstream/clickstream-enwiki-2021-05.tsv.gz,Tonya_Harding,38864,177727,826,217417,59517
hdfs://spark-nn.eemcs.utwente.nl/user/s1934538/clickstream/clickstream-enwiki-2021-05.tsv.gz,Atal_Bihari_Vajpayee,49252,72450,91,121793,47004
hdfs://spark-nn.eemcs.utwente.nl/user/s1934538/clickstream/clickstream-enwiki-2021-05.tsv.gz,Hyphen-minus,773,6054746,24853,6080372,824
hdfs://spark-nn.eemcs.utwente.nl/user/s1934538/clickstream/clickstream-enwiki-2021-05.tsv.gz,Jimmy_Hoffa,32463,135940,1205,169608,64020
hdfs://spark-nn.eemcs.utwente.nl/user/s1934538/clickstream/clickstream-enwiki-2021-05.tsv.gz,Media,50,3322,586,3958,1908
hdfs://spark-nn.eemcs.utwente.nl/user/s1934538/clickstream/clickstream-enwiki-2021-05.tsv.gz,Kobe_Bryant,72878,540824,5699,619401,176472
hdfs://spark-nn.eemcs.utwente.nl/user/s1934538/clickstream/clickstream-enwiki-2021-05.tsv.gz,The_Shape_of_Water,28976,70688,963,100627,47122
hdfs://spark-nn.eemcs.utwente.nl/user/s1934538/clickstream/clickstream-enwiki-2021-05.tsv.gz,Shakira,24621,179511,1729,205861,95762
hdfs://spark-nn.eemcs.utwente.nl/user/s1934538/clickstream/clickstream-enwiki-2021-05.tsv.gz,R._Kelly,34153,161839,1955,197947,91602
hdfs://spark-nn.eemcs.utwente.nl/user/s1934538/clickstream/clickstream-enwiki-2021-05.tsv.gz,Sridevi,42479,107669,1928,152076,69323
hdfs://spark-nn.eemcs.utwente.nl/user/s1934538/clickstream/clickstream-enwiki-2021-05.tsv.gz,Croatia,51498,145775,2380,199653,73396
hdfs://spark-nn.eemcs.utwente.nl/user/s1934538/clickstream/clickstream-enwiki-2021-05.tsv.gz,September_11_attacks,117189,353448,4331,474968,248445
hdfs://spark-nn.eemcs.utwente.nl/user/s1934538/clickstream/clickstream-enwiki-2021-05.tsv.gz,State_of_Palestine,546413,2790647,1147,3338207,1325126
hdfs://spark-nn.eemcs.utwente.nl/user/s1934538/clickstream/clickstream-enwiki-2021-05.tsv.gz,DMX_(rapper),39850,363575,3486,406911,145428
hdfs://spark-nn.eemcs.utwente.nl/user/s1934538/clickstream/clickstream-enwiki-2021-05.tsv.gz,Naomi_Osaka,27224,326470,2903,356597,104209
hdfs://spark-nn.eemcs.utwente.nl/user/s1934538/clickstream/clickstream-enwiki-2021-06.tsv.gz,Bipin_Rawat,11430,22679,14,34123,17326
hdfs://spark-nn.eemcs.utwente.nl/user/s1934538/clickstream/clickstream-enwiki-2021-06.tsv.gz,September_11_attacks,102990,294509,4544,402043,226093
hdfs://spark-nn.eemcs.utwente.nl/user/s1934538/clickstream/clickstream-enwiki-2021-06.tsv.gz,Richard_Jewell,15935,81569,361,97865,34068
hdfs://spark-nn.eemcs.utwente.nl/user/s1934538/clickstream/clickstream-enwiki-2021-06.tsv.gz,Simone_Biles,67767,896073,6161,970001,335002
hdfs://spark-nn.eemcs.utwente.nl/user/s1934538/clickstream/clickstream-enwiki-2021-06.tsv.gz,The_Suicide_Squad_(film),144106,187734,5700,337540,327880
hdfs://spark-nn.eemcs.utwente.nl/user/s1934538/clickstream/clickstream-enwiki-2021-06.tsv.gz,The_Batman_(film),100007,93216,3068,196291,150189
hdfs://spark-nn.eemcs.utwente.nl/user/s1934538/clickstream/clickstream-enwiki-2021-06.tsv.gz,Rishi_Sunak,25352,71595,374,97321,43777
hdfs://spark-nn.eemcs.utwente.nl/user/s1934538/clickstream/clickstream-enwiki-2021-06.tsv.gz,Ghislaine_Maxwell,68563,207298,1410,277271,118146
hdfs://spark-nn.eemcs.utwente.nl/user/s1934538/clickstream/clickstream-enwiki-2021-06.tsv.gz,The_Haunting_of_Bly_Manor,20924,62873,544,84341,40937
hdfs://spark-nn.eemcs.utwente.nl/user/s1934538/clickstream/clickstream-enwiki-2021-06.tsv.gz,Ted_Bundy,38216,395665,4800,438681,102625
hdfs://spark-nn.eemcs.utwente.nl/user/s1934538/clickstream/clickstream-enwiki-2021-06.tsv.gz,Christopher_Scarver,57834,20235,23,78092,28766
hdfs://spark-nn.eemcs.utwente.nl/user/s1934538/clickstream/clickstream-enwiki-2021-06.tsv.gz,Kim_Jong-un,81466,221413,2507,305386,184587
hdfs://spark-nn.eemcs.utwente.nl/user/s1934538/clickstream/clickstream-enwiki-2021-06.tsv.gz,Eternals_(film),147559,180990,2021,330570,308259
hdfs://spark-nn.eemcs.utwente.nl/user/s1934538/clickstream/clickstream-enwiki-2021-06.tsv.gz,List_of_highest-grossing_Indian_films,66243,162979,1076,230298,135060
hdfs://spark-nn.eemcs.utwente.nl/user/s1934538/clickstream/clickstream-enwiki-2021-06.tsv.gz,Freddie_Mercury,85906,482139,4485,572530,219667
hdfs://spark-nn.eemcs.utwente.nl/user/s1934538/clickstream/clickstream-enwiki-2021-06.tsv.gz,Johnny_Depp,140664,358729,3004,502397,372650
hdfs://spark-nn.eemcs.utwente.nl/user/s1934538/clickstream/clickstream-enwiki-2021-06.tsv.gz,Grover,1217,4988,46,6251,1353
hdfs://spark-nn.eemcs.utwente.nl/user/s1934538/clickstream/clickstream-enwiki-2021-06.tsv.gz,"Diana,_Princess_of_Wales",172877,465816,1147,639840,371637
hdfs://spark-nn.eemcs.utwente.nl/user/s1934538/clickstream/clickstream-enwiki-2021-06.tsv.gz,HTTP_cookie,3074,329435,225,332734,25900
hdfs://spark-nn.eemcs.utwente.nl/user/s1934538/clickstream/clickstream-enwiki-2021-06.tsv.gz,Asia_Cup,2888,33168,187,36243,17157
hdfs://spark-nn.eemcs.utwente.nl/user/s1934538/clickstream/clickstream-enwiki-2021-06.tsv.gz,The_Sandman_(TV_series),36754,55537,551,92842,85021
hdfs://spark-nn.eemcs.utwente.nl/user/s1934538/clickstream/clickstream-enwiki-2021-06.tsv.gz,Cleopatra,48112,3379866,2064,3430042,288873
hdfs://spark-nn.eemcs.utwente.nl/user/s1934538/clickstream/clickstream-enwiki-2021-06.tsv.gz,Don't_Look_Up_(2021_film),98042,39925,583,138550,58537
hdfs://spark-nn.eemcs.utwente.nl/user/s1934538/clickstream/clickstream-enwiki-2021-06.tsv.gz,RRR_(film),41813,63653,252,105718,60700
hdfs://spark-nn.eemcs.utwente.nl/user/s1934538/clickstream/clickstream-enwiki-2021-06.tsv.gz,Coronavirus,19109,213340,4336,236785,63708
hdfs://spark-nn.eemcs.utwente.nl/user/s1934538/clickstream/clickstream-enwiki-2021-06.tsv.gz,"Meghan,_Duchess_of_Sussex",121733,327341,3274,452348,269555
hdfs://spark-nn.eemcs.utwente.nl/user/s1934538/clickstream/clickstream-enwiki-2021-06.tsv.gz,Bridgerton,26337,211602,3150,241089,165924
hdfs://spark-nn.eemcs.utwente.nl/user/s1934538/clickstream/clickstream-enwiki-2021-06.tsv.gz,Adipurush,38581,23053,94,61728,41412
hdfs://spark-nn.eemcs.utwente.nl/user/s1934538/clickstream/clickstream-enwiki-2021-06.tsv.gz,Tenet_(film),79434,438846,5440,523720,292405
hdfs://spark-nn.eemcs.utwente.nl/user/s1934538/clickstream/clickstream-enwiki-2021-06.tsv.gz,The_Queen's_Gambit_(miniseries),42324,210797,2057,255178,133876
hdfs://spark-nn.eemcs.utwente.nl/user/s1934538/clickstream/clickstream-enwiki-2021-06.tsv.gz,Amy_Coney_Barrett,27845,38592,281,66718,24791
hdfs://spark-nn.eemcs.utwente.nl/user/s1934538/clickstream/clickstream-enwiki-2021-06.tsv.gz,Media,42,3346,583,3971,1572
hdfs://spark-nn.eemcs.utwente.nl/user/s1934538/clickstream/clickstream-enwiki-2021-06.tsv.gz,Burt_Reynolds,65450,143495,1518,210463,102211
hdfs://spark-nn.eemcs.utwente.nl/user/s1934538/clickstream/clickstream-enwiki-2021-06.tsv.gz,Shinzo_Abe,39697,32969,371,73037,44841
hdfs://spark-nn.eemcs.utwente.nl/user/s1934538/clickstream/clickstream-enwiki-2021-06.tsv.gz,Shang-Chi_and_the_Legend_of_the_Ten_Rings,148136,180979,5738,334853,256242
hdfs://spark-nn.eemcs.utwente.nl/user/s1934538/clickstream/clickstream-enwiki-2021-06.tsv.gz,Murder_of_Dee_Dee_Blanchard,15304,186469,539,202312,34762
hdfs://spark-nn.eemcs.utwente.nl/user/s1934538/clickstream/clickstream-enwiki-2021-06.tsv.gz,Anthony_Bourdain,28132,486597,4196,518925,172392
hdfs://spark-nn.eemcs.utwente.nl/user/s1934538/clickstream/clickstream-enwiki-2021-06.tsv.gz,2018_Winter_Olympics,33022,20808,310,54140,36967
hdfs://spark-nn.eemcs.utwente.nl/user/s1934538/clickstream/clickstream-enwiki-2021-06.tsv.gz,Wikipedia,271557,575094,1172,847823,212176
hdfs://spark-nn.eemcs.utwente.nl/user/s1934538/clickstream/clickstream-enwiki-2021-06.tsv.gz,NATO,58540,201591,3481,263612,103087
hdfs://spark-nn.eemcs.utwente.nl/user/s1934538/clickstream/clickstream-enwiki-2021-06.tsv.gz,Juneteenth,45191,3619394,31019,3695604,369900
hdfs://spark-nn.eemcs.utwente.nl/user/s1934538/clickstream/clickstream-enwiki-2021-06.tsv.gz,Spider-Man:_No_Way_Home,206698,287828,3409,497935,285378
hdfs://spark-nn.eemcs.utwente.nl/user/s1934538/clickstream/clickstream-enwiki-2021-06.tsv.gz,Loki_(TV_series),272989,2803031,89066,3165086,1733935
hdfs://spark-nn.eemcs.utwente.nl/user/s1934538/clickstream/clickstream-enwiki-2021-06.tsv.gz,Game_of_Thrones,79547,312273,7282,399102,272660
hdfs://spark-nn.eemcs.utwente.nl/user/s1934538/clickstream/clickstream-enwiki-2021-06.tsv.gz,Eddie_Van_Halen,51536,98035,1081,150652,61427
hdfs://spark-nn.eemcs.utwente.nl/user/s1934538/clickstream/clickstream-enwiki-2021-06.tsv.gz,Emma_Raducanu,3171,30648,323,34142,2498
hdfs://spark-nn.eemcs.utwente.nl/user/s1934538/clickstream/clickstream-enwiki-2021-06.tsv.gz,JSON_Web_Token,843,24515,49,25407,2134
hdfs://spark-nn.eemcs.utwente.nl/user/s1934538/clickstream/clickstream-enwiki-2021-06.tsv.gz,Greta_Thunberg,9050,153543,1339,163932,37582
hdfs://spark-nn.eemcs.utwente.nl/user/s1934538/clickstream/clickstream-enwiki-2021-06.tsv.gz,Pelé,76371,189897,1972,268240,89025
hdfs://spark-nn.eemcs.utwente.nl/user/s1934538/clickstream/clickstream-enwiki-2021-06.tsv.gz,Meat_Loaf,25450,77869,909,104228,38822
hdfs://spark-nn.eemcs.utwente.nl/user/s1934538/clickstream/clickstream-enwiki-2021-06.tsv.gz,Queen_(band),60615,196992,3076,260683,245570
hdfs://spark-nn.eemcs.utwente.nl/user/s1934538/clickstream/clickstream-enwiki-2021-06.tsv.gz,Aaron_Carter,27040,254704,840,282584,72994
hdfs://spark-nn.eemcs.utwente.nl/user/s1934538/clickstream/clickstream-enwiki-2021-06.tsv.gz,Hamas,40577,95355,2100,138032,55819
hdfs://spark-nn.eemcs.utwente.nl/user/s1934538/clickstream/clickstream-enwiki-2021-06.tsv.gz,Sidharth_Shukla,13988,44158,280,58426,17527
hdfs://spark-nn.eemcs.utwente.nl/user/s1934538/clickstream/clickstream-enwiki-2021-06.tsv.gz,Valentine's_Day,3246,27209,188,30643,3076
hdfs://spark-nn.eemcs.utwente.nl/user/s1934538/clickstream/clickstream-enwiki-2021-06.tsv.gz,Doctor_Strange_in_the_Multiverse_of_Madness,145293,91866,767,237926,134792
hdfs://spark-nn.eemcs.utwente.nl/user/s1934538/clickstream/clickstream-enwiki-2021-06.tsv.gz,XXX:_Return_of_Xander_Cage,53582,437987,1158,492727,84429
hdfs://spark-nn.eemcs.utwente.nl/user/s1934538/clickstream/clickstream-enwiki-2021-06.tsv.gz,Rihanna,78827,262225,4255,345307,164148
hdfs://spark-nn.eemcs.utwente.nl/user/s1934538/clickstream/clickstream-enwiki-2021-06.tsv.gz,Avengers:_Endgame,135658,209450,5115,350223,214066
hdfs://spark-nn.eemcs.utwente.nl/user/s1934538/clickstream/clickstream-enwiki-2021-06.tsv.gz,Ukraine,69757,244210,5071,319038,146198
hdfs://spark-nn.eemcs.utwente.nl/user/s1934538/clickstream/clickstream-enwiki-2021-06.tsv.gz,Sushant_Singh_Rajput,42760,332004,1150,375914,147727
hdfs://spark-nn.eemcs.utwente.nl/user/s1934538/clickstream/clickstream-enwiki-2021-06.tsv.gz,Henry_V_of_England,72236,74973,419,147628,108735
hdfs://spark-nn.eemcs.utwente.nl/user/s1934538/clickstream/clickstream-enwiki-2021-06.tsv.gz,IPv4,11362,38226,131,49719,9636
hdfs://spark-nn.eemcs.utwente.nl/user/s1934538/clickstream/clickstream-enwiki-2021-06.tsv.gz,Anna_Sorokin,5392,41710,119,47221,13793
hdfs://spark-nn.eemcs.utwente.nl/user/s1934538/clickstream/clickstream-enwiki-2021-06.tsv.gz,Donald_Trump,224355,494671,10320,729346,413656
hdfs://spark-nn.eemcs.utwente.nl/user/s1934538/clickstream/clickstream-enwiki-2021-06.tsv.gz,Glass_(2019_film),57646,72299,755,130700,50871
hdfs://spark-nn.eemcs.utwente.nl/user/s1934538/clickstream/clickstream-enwiki-2021-06.tsv.gz,Gaza_Strip,27521,90587,496,118604,37284
hdfs://spark-nn.eemcs.utwente.nl/user/s1934538/clickstream/clickstream-enwiki-2021-06.tsv.gz,Kobe_Bryant,72416,367919,3685,444020,131975
hdfs://spark-nn.eemcs.utwente.nl/user/s1934538/clickstream/clickstream-enwiki-2021-06.tsv.gz,The_Lion_King_(2019_film),39432,54306,571,94309,47319
hdfs://spark-nn.eemcs.utwente.nl/user/s1934538/clickstream/clickstream-enwiki-2021-06.tsv.gz,2022_FIFA_World_Cup,310805,721797,14475,1047077,557796
hdfs://spark-nn.eemcs.utwente.nl/user/s1934538/clickstream/clickstream-enwiki-2021-06.tsv.gz,Alexander_Hamilton,72704,225893,1934,300531,156374
hdfs://spark-nn.eemcs.utwente.nl/user/s1934538/clickstream/clickstream-enwiki-2021-06.tsv.gz,Dark_Phoenix_(film),42942,43154,536,86632,49894
hdfs://spark-nn.eemcs.utwente.nl/user/s1934538/clickstream/clickstream-enwiki-2021-06.tsv.gz,Kobe_Bryant_sexual_assault_case,6685,50812,34,57531,3079
hdfs://spark-nn.eemcs.utwente.nl/user/s1934538/clickstream/clickstream-enwiki-2021-06.tsv.gz,Avengers:_Infinity_War,61987,87561,1337,150885,89007
hdfs://spark-nn.eemcs.utwente.nl/user/s1934538/clickstream/clickstream-enwiki-2021-06.tsv.gz,UEFA_Euro_2020,1139872,9075351,323998,10539221,4054198
hdfs://spark-nn.eemcs.utwente.nl/user/s1934538/clickstream/clickstream-enwiki-2021-06.tsv.gz,2016_United_States_presidential_election,119856,78349,1191,199396,187189
hdfs://spark-nn.eemcs.utwente.nl/user/s1934538/clickstream/clickstream-enwiki-2021-06.tsv.gz,Betty_White,57258,202440,3186,262884,86559
hdfs://spark-nn.eemcs.utwente.nl/user/s1934538/clickstream/clickstream-enwiki-2021-06.tsv.gz,Croatia,68781,291233,3846,363860,117099
hdfs://spark-nn.eemcs.utwente.nl/user/s1934538/clickstream/clickstream-enwiki-2021-06.tsv.gz,No_Time_to_Die,200122,151877,5201,357200,187454
hdfs://spark-nn.eemcs.utwente.nl/user/s1934538/clickstream/clickstream-enwiki-2021-06.tsv.gz,Black_Adam_(film),68857,25906,293,95056,80058
hdfs://spark-nn.eemcs.utwente.nl/user/s1934538/clickstream/clickstream-enwiki-2021-06.tsv.gz,Area_51,19399,161669,29450,210518,69366
hdfs://spark-nn.eemcs.utwente.nl/user/s1934538/clickstream/clickstream-enwiki-2021-06.tsv.gz,Ant-Man_and_the_Wasp:_Quantumania,91258,29246,268,120772,91201
hdfs://spark-nn.eemcs.utwente.nl/user/s1934538/clickstream/clickstream-enwiki-2021-06.tsv.gz,Top_Gun:_Maverick,57741,102980,2340,163061,92525
hdfs://spark-nn.eemcs.utwente.nl/user/s1934538/clickstream/clickstream-enwiki-2021-06.tsv.gz,XXXTentacion,63037,545424,6655,615116,109740
hdfs://spark-nn.eemcs.utwente.nl/user/s1934538/clickstream/clickstream-enwiki-2021-06.tsv.gz,State_of_Palestine,64875,202306,246,267427,102717
hdfs://spark-nn.eemcs.utwente.nl/user/s1934538/clickstream/clickstream-enwiki-2021-06.tsv.gz,Deaths_in_2021,1383476,2241705,16412,3641593,2007511
hdfs://spark-nn.eemcs.utwente.nl/user/s1934538/clickstream/clickstream-enwiki-2021-06.tsv.gz,Chernobyl_disaster,67087,385007,3970,456064,194637
hdfs://spark-nn.eemcs.utwente.nl/user/s1934538/clickstream/clickstream-enwiki-2021-06.tsv.gz,The_Nun_(2018_film),127608,223427,1585,352620,237360
hdfs://spark-nn.eemcs.utwente.nl/user/s1934538/clickstream/clickstream-enwiki-2021-06.tsv.gz,Lisa_Marie_Presley,149343,80114,542,229999,129941
hdfs://spark-nn.eemcs.utwente.nl/user/s1934538/clickstream/clickstream-enwiki-2021-06.tsv.gz,Microsoft_Office,8276,4182366,876,4191518,22137
hdfs://spark-nn.eemcs.utwente.nl/user/s1934538/clickstream/clickstream-enwiki-2021-06.tsv.gz,Manti_Te'o,2237,11615,41,13893,1414
hdfs://spark-nn.eemcs.utwente.nl/user/s1934538/clickstream/clickstream-enwiki-2021-06.tsv.gz,Dune_(2021_film),83617,150169,3423,237209,162536
hdfs://spark-nn.eemcs.utwente.nl/user/s1934538/clickstream/clickstream-enwiki-2021-06.tsv.gz,It_Chapter_Two,36633,63864,705,101202,68414
hdfs://spark-nn.eemcs.utwente.nl/user/s1934538/clickstream/clickstream-enwiki-2021-06.tsv.gz,Joker_(2019_film),50509,170789,2438,223736,108529
hdfs://spark-nn.eemcs.utwente.nl/user/s1934538/clickstream/clickstream-enwiki-2021-06.tsv.gz,Mulan_(2020_film),26677,83280,1551,111508,66445
hdfs://spark-nn.eemcs.utwente.nl/user/s1934538/clickstream/clickstream-enwiki-2021-06.tsv.gz,Sinéad_O'Connor,17723,237205,2537,257465,86470
hdfs://spark-nn.eemcs.utwente.nl/user/s1934538/clickstream/clickstream-enwiki-2021-06.tsv.gz,21_Savage,14823,51209,596,66628,26791
hdfs://spark-nn.eemcs.utwente.nl/user/s1934538/clickstream/clickstream-enwiki-2021-06.tsv.gz,Captain_Marvel_(film),40577,105105,1852,147534,81936
hdfs://spark-nn.eemcs.utwente.nl/user/s1934538/clickstream/clickstream-enwiki-2021-06.tsv.gz,List_of_Marvel_Cinematic_Universe_films,228694,676208,1599,906501,496870
hdfs://spark-nn.eemcs.utwente.nl/user/s1934538/clickstream/clickstream-enwiki-2021-06.tsv.gz,Black_Panther:_Wakanda_Forever,33236,2404,224,35864,3447
hdfs://spark-nn.eemcs.utwente.nl/user/s1934538/clickstream/clickstream-enwiki-2021-06.tsv.gz,Stranger_Things,67400,257315,5566,330281,253223
hdfs://spark-nn.eemcs.utwente.nl/user/s1934538/clickstream/clickstream-enwiki-2021-06.tsv.gz,Jeffrey_Dahmer,32820,290527,3566,326913,149778
hdfs://spark-nn.eemcs.utwente.nl/user/s1934538/clickstream/clickstream-enwiki-2021-06.tsv.gz,YouTube,133694,554016,10840,698550,114881
hdfs://spark-nn.eemcs.utwente.nl/user/s1934538/clickstream/clickstream-enwiki-2021-06.tsv.gz,COVID-19_pandemic_by_country_and_territory,162858,382298,7978,553134,342633
hdfs://spark-nn.eemcs.utwente.nl/user/s1934538/clickstream/clickstream-enwiki-2021-06.tsv.gz,Irrfan_Khan,38506,77063,181,115750,45796
hdfs://spark-nn.eemcs.utwente.nl/user/s1934538/clickstream/clickstream-enwiki-2021-06.tsv.gz,Cricket_World_Cup,16712,107962,1786,126460,68237
hdfs://spark-nn.eemcs.utwente.nl/user/s1934538/clickstream/clickstream-enwiki-2021-06.tsv.gz,"Citizenship_(Amendment)_Act,_2019",3858,30215,123,34196,4065
hdfs://spark-nn.eemcs.utwente.nl/user/s1934538/clickstream/clickstream-enwiki-2021-06.tsv.gz,J._Robert_Oppenheimer,20508,74369,309,95186,33860
hdfs://spark-nn.eemcs.utwente.nl/user/s1934538/clickstream/clickstream-enwiki-2021-06.tsv.gz,Deadpool_2,45704,54454,1345,101503,73475
hdfs://spark-nn.eemcs.utwente.nl/user/s1934538/clickstream/clickstream-enwiki-2021-06.tsv.gz,Adele,20247,107893,1543,129683,48320
hdfs://spark-nn.eemcs.utwente.nl/user/s1934538/clickstream/clickstream-enwiki-2021-06.tsv.gz,Tasuku_Honjo,1016,367003,141,368160,9938
hdfs://spark-nn.eemcs.utwente.nl/user/s1934538/clickstream/clickstream-enwiki-2021-06.tsv.gz,Army_of_the_Dead,84083,601266,11257,696606,608547
hdfs://spark-nn.eemcs.utwente.nl/user/s1934538/clickstream/clickstream-enwiki-2021-06.tsv.gz,"Prince_Philip,_Duke_of_Edinburgh",204573,266458,8543,479574,279919
hdfs://spark-nn.eemcs.utwente.nl/user/s1934538/clickstream/clickstream-enwiki-2021-06.tsv.gz,Sushma_Swaraj,6682,18375,38,25095,7237
hdfs://spark-nn.eemcs.utwente.nl/user/s1934538/clickstream/clickstream-enwiki-2021-06.tsv.gz,The_Shape_of_Water,22733,77588,1090,101411,48291
hdfs://spark-nn.eemcs.utwente.nl/user/s1934538/clickstream/clickstream-enwiki-2021-06.tsv.gz,The_Weeknd,65737,227890,2544,296171,130267
hdfs://spark-nn.eemcs.utwente.nl/user/s1934538/clickstream/clickstream-enwiki-2021-06.tsv.gz,Central_Park_jogger_case,15328,50050,221,65599,9423
hdfs://spark-nn.eemcs.utwente.nl/user/s1934538/clickstream/clickstream-enwiki-2021-06.tsv.gz,Donald_Glover,41023,129416,1001,171440,73934
hdfs://spark-nn.eemcs.utwente.nl/user/s1934538/clickstream/clickstream-enwiki-2021-06.tsv.gz,Louis_Tomlinson,31936,54112,250,86298,30427
hdfs://spark-nn.eemcs.utwente.nl/user/s1934538/clickstream/clickstream-enwiki-2021-06.tsv.gz,Bob_Saget,19310,48717,296,68323,12680
hdfs://spark-nn.eemcs.utwente.nl/user/s1934538/clickstream/clickstream-enwiki-2021-06.tsv.gz,Tunnel,3189,9760,121,13070,3574
hdfs://spark-nn.eemcs.utwente.nl/user/s1934538/clickstream/clickstream-enwiki-2021-06.tsv.gz,Ray_Liotta,44513,47437,344,92294,35333
hdfs://spark-nn.eemcs.utwente.nl/user/s1934538/clickstream/clickstream-enwiki-2021-06.tsv.gz,ICC_Men's_T20_World_Cup,16020,167404,571,183995,90240
hdfs://spark-nn.eemcs.utwente.nl/user/s1934538/clickstream/clickstream-enwiki-2021-06.tsv.gz,Stranger_Things_(season_3),20418,38579,378,59375,33427
hdfs://spark-nn.eemcs.utwente.nl/user/s1934538/clickstream/clickstream-enwiki-2021-06.tsv.gz,Charles_III,87,152,65,304,289
hdfs://spark-nn.eemcs.utwente.nl/user/s1934538/clickstream/clickstream-enwiki-2021-06.tsv.gz,Saaho,19091,47013,131,66235,25627
hdfs://spark-nn.eemcs.utwente.nl/user/s1934538/clickstream/clickstream-enwiki-2021-06.tsv.gz,Grimes_(musician),133189,211907,1095,346191,137499
hdfs://spark-nn.eemcs.utwente.nl/user/s1934538/clickstream/clickstream-enwiki-2021-06.tsv.gz,Tina_Turner,31548,412885,4705,449138,135039
hdfs://spark-nn.eemcs.utwente.nl/user/s1934538/clickstream/clickstream-enwiki-2021-06.tsv.gz,Vivek_Ramaswamy,1287,12089,39,13415,3247
hdfs://spark-nn.eemcs.utwente.nl/user/s1934538/clickstream/clickstream-enwiki-2021-06.tsv.gz,Amber_Heard,112438,202425,1232,316095,147977
hdfs://spark-nn.eemcs.utwente.nl/user/s1934538/clickstream/clickstream-enwiki-2021-06.tsv.gz,Critical_race_theory,27692,3304636,22759,3355087,433392
hdfs://spark-nn.eemcs.utwente.nl/user/s1934538/clickstream/clickstream-enwiki-2021-11.tsv.gz,Naya_Rivera,52394,89718,327,142439,50919
hdfs://spark-nn.eemcs.utwente.nl/user/s1934538/clickstream/clickstream-enwiki-2021-11.tsv.gz,Microsoft_Office,8276,1348989,701,1357966,19084
hdfs://spark-nn.eemcs.utwente.nl/user/s1934538/clickstream/clickstream-enwiki-2021-11.tsv.gz,Kim_Jong-un,57946,148082,1394,207422,111747
hdfs://spark-nn.eemcs.utwente.nl/user/s1934538/clickstream/clickstream-enwiki-2021-11.tsv.gz,Vikram_(2022_film),34348,61222,150,95720,18242
hdfs://spark-nn.eemcs.utwente.nl/user/s1934538/clickstream/clickstream-enwiki-2021-11.tsv.gz,John_Wick:_Chapter_4,66251,82759,772,149782,95981
hdfs://spark-nn.eemcs.utwente.nl/user/s1934538/clickstream/clickstream-enwiki-2021-11.tsv.gz,Simple_Mail_Transfer_Protocol,2951,36227,144,39322,3407
hdfs://spark-nn.eemcs.utwente.nl/user/s1934538/clickstream/clickstream-enwiki-2021-11.tsv.gz,John_McCain,25285,60841,556,86682,43454
hdfs://spark-nn.eemcs.utwente.nl/user/s1934538/clickstream/clickstream-enwiki-2021-11.tsv.gz,Zack_Snyder's_Justice_League,74869,103212,1189,179270,90703
hdfs://spark-nn.eemcs.utwente.nl/user/s1934538/clickstream/clickstream-enwiki-2021-11.tsv.gz,George_VI,300450,113315,863,414628,305640
hdfs://spark-nn.eemcs.utwente.nl/user/s1934538/clickstream/clickstream-enwiki-2021-11.tsv.gz,WandaVision,61136,132792,2541,196469,99993
hdfs://spark-nn.eemcs.utwente.nl/user/s1934538/clickstream/clickstream-enwiki-2021-11.tsv.gz,When_They_See_Us,11624,26992,235,38851,18621
hdfs://spark-nn.eemcs.utwente.nl/user/s1934538/clickstream/clickstream-enwiki-2021-11.tsv.gz,Pornhub,46809,428060,13139,488008,88000
hdfs://spark-nn.eemcs.utwente.nl/user/s1934538/clickstream/clickstream-enwiki-2021-11.tsv.gz,Black_Panther_(film),39444,93409,1905,134758,79105
hdfs://spark-nn.eemcs.utwente.nl/user/s1934538/clickstream/clickstream-enwiki-2021-11.tsv.gz,Kobe_Bryant_sexual_assault_case,5094,577158,93,582345,7903
hdfs://spark-nn.eemcs.utwente.nl/user/s1934538/clickstream/clickstream-enwiki-2021-11.tsv.gz,Emma_Raducanu,11317,84527,854,96698,21772
hdfs://spark-nn.eemcs.utwente.nl/user/s1934538/clickstream/clickstream-enwiki-2021-11.tsv.gz,1234,92,1796,15,1903,216
hdfs://spark-nn.eemcs.utwente.nl/user/s1934538/clickstream/clickstream-enwiki-2021-11.tsv.gz,Star_Wars:_The_Rise_of_Skywalker,76191,88764,2912,167867,94624
hdfs://spark-nn.eemcs.utwente.nl/user/s1934538/clickstream/clickstream-enwiki-2021-11.tsv.gz,Keanu_Reeves,102501,582199,5419,690119,399693
hdfs://spark-nn.eemcs.utwente.nl/user/s1934538/clickstream/clickstream-enwiki-2021-11.tsv.gz,House_of_the_Dragon,29045,62549,823,92417,71415
hdfs://spark-nn.eemcs.utwente.nl/user/s1934538/clickstream/clickstream-enwiki-2021-11.tsv.gz,Kate_Spade,19582,55034,299,74915,27667
hdfs://spark-nn.eemcs.utwente.nl/user/s1934538/clickstream/clickstream-enwiki-2021-11.tsv.gz,Sidharth_Shukla,14999,87817,126,102942,22803
hdfs://spark-nn.eemcs.utwente.nl/user/s1934538/clickstream/clickstream-enwiki-2021-11.tsv.gz,September_11_attacks,69089,217647,2931,289667,134130
hdfs://spark-nn.eemcs.utwente.nl/user/s1934538/clickstream/clickstream-enwiki-2021-11.tsv.gz,Meat_Loaf,26092,82920,990,110002,41007
hdfs://spark-nn.eemcs.utwente.nl/user/s1934538/clickstream/clickstream-enwiki-2021-11.tsv.gz,Bird_Box_(film),15085,53118,632,68835,22576
hdfs://spark-nn.eemcs.utwente.nl/user/s1934538/clickstream/clickstream-enwiki-2021-11.tsv.gz,Jimmy_Hoffa,31800,232546,2801,267147,107940
hdfs://spark-nn.eemcs.utwente.nl/user/s1934538/clickstream/clickstream-enwiki-2021-11.tsv.gz,Royal_Rumble_(2018),5583,3659,94,9336,6939
hdfs://spark-nn.eemcs.utwente.nl/user/s1934538/clickstream/clickstream-enwiki-2021-11.tsv.gz,Ukraine,55765,215632,5263,276660,130741
hdfs://spark-nn.eemcs.utwente.nl/user/s1934538/clickstream/clickstream-enwiki-2021-11.tsv.gz,Kylian_Mbappé,31394,198002,2170,231566,47542
hdfs://spark-nn.eemcs.utwente.nl/user/s1934538/clickstream/clickstream-enwiki-2021-11.tsv.gz,HTTP_cookie,2584,299466,109,302159,20736
hdfs://spark-nn.eemcs.utwente.nl/user/s1934538/clickstream/clickstream-enwiki-2021-11.tsv.gz,FIFA_World_Cup,66267,273827,9357,349451,236031
hdfs://spark-nn.eemcs.utwente.nl/user/s1934538/clickstream/clickstream-enwiki-2021-11.tsv.gz,Thor:_Love_and_Thunder,156411,76975,592,233978,164550
hdfs://spark-nn.eemcs.utwente.nl/user/s1934538/clickstream/clickstream-enwiki-2021-11.tsv.gz,The_Nun_(2018_film),19072,42693,326,62091,33250
hdfs://spark-nn.eemcs.utwente.nl/user/s1934538/clickstream/clickstream-enwiki-2021-11.tsv.gz,The_Shape_of_Water,23498,53477,594,77569,34377
hdfs://spark-nn.eemcs.utwente.nl/user/s1934538/clickstream/clickstream-enwiki-2021-11.tsv.gz,Jenna_Ortega,51802,50072,1818,103692,22966
hdfs://spark-nn.eemcs.utwente.nl/user/s1934538/clickstream/clickstream-enwiki-2021-11.tsv.gz,Article_370_of_the_Constitution_of_India,1948,36267,16,38231,2055
hdfs://spark-nn.eemcs.utwente.nl/user/s1934538/clickstream/clickstream-enwiki-2021-11.tsv.gz,The_Queen's_Gambit_(miniseries),31783,142040,1558,175381,91706
hdfs://spark-nn.eemcs.utwente.nl/user/s1934538/clickstream/clickstream-enwiki-2021-11.tsv.gz,2018_FIFA_World_Cup,101534,104283,1320,207137,121833
hdfs://spark-nn.eemcs.utwente.nl/user/s1934538/clickstream/clickstream-enwiki-2021-11.tsv.gz,United_States_Electoral_College,10637,31035,92,41764,6304
hdfs://spark-nn.eemcs.utwente.nl/user/s1934538/clickstream/clickstream-enwiki-2021-11.tsv.gz,Burt_Reynolds,45124,112878,1056,159058,72345
hdfs://spark-nn.eemcs.utwente.nl/user/s1934538/clickstream/clickstream-enwiki-2021-11.tsv.gz,The_Falcon_and_the_Winter_Soldier,36933,79296,1514,117743,72213
hdfs://spark-nn.eemcs.utwente.nl/user/s1934538/clickstream/clickstream-enwiki-2021-11.tsv.gz,Freddie_Mercury,103425,825708,8765,937898,321979
hdfs://spark-nn.eemcs.utwente.nl/user/s1934538/clickstream/clickstream-enwiki-2021-11.tsv.gz,Rihanna,77171,299657,4416,381244,195483
hdfs://spark-nn.eemcs.utwente.nl/user/s1934538/clickstream/clickstream-enwiki-2021-11.tsv.gz,The_Batman_(film),116983,128398,3634,249015,173046
hdfs://spark-nn.eemcs.utwente.nl/user/s1934538/clickstream/clickstream-enwiki-2021-11.tsv.gz,A_Star_Is_Born_(2018_film),33701,88018,825,122544,57406
hdfs://spark-nn.eemcs.utwente.nl/user/s1934538/clickstream/clickstream-enwiki-2021-11.tsv.gz,Squid_Game,95093,1878755,39145,2012993,941353
hdfs://spark-nn.eemcs.utwente.nl/user/s1934538/clickstream/clickstream-enwiki-2021-11.tsv.gz,Wonder_Woman_1984,45298,110306,2399,158003,80496
hdfs://spark-nn.eemcs.utwente.nl/user/s1934538/clickstream/clickstream-enwiki-2021-11.tsv.gz,Sushma_Swaraj,4994,18805,22,23821,6159
hdfs://spark-nn.eemcs.utwente.nl/user/s1934538/clickstream/clickstream-enwiki-2021-11.tsv.gz,2018_Winter_Olympics,19834,18348,188,38370,26470
hdfs://spark-nn.eemcs.utwente.nl/user/s1934538/clickstream/clickstream-enwiki-2021-11.tsv.gz,"Princess_Margaret,_Countess_of_Snowdon",89406,192601,1527,283534,161182
hdfs://spark-nn.eemcs.utwente.nl/user/s1934538/clickstream/clickstream-enwiki-2021-11.tsv.gz,The_Mandalorian,75380,198668,4383,278431,200805
hdfs://spark-nn.eemcs.utwente.nl/user/s1934538/clickstream/clickstream-enwiki-2021-11.tsv.gz,Tom_Brady,79161,411463,4500,495124,186598
hdfs://spark-nn.eemcs.utwente.nl/user/s1934538/clickstream/clickstream-enwiki-2021-11.tsv.gz,R._Kelly,24617,141856,1784,168257,84947
hdfs://spark-nn.eemcs.utwente.nl/user/s1934538/clickstream/clickstream-enwiki-2021-11.tsv.gz,Dark_Phoenix_(film),40680,43190,507,84377,48800
hdfs://spark-nn.eemcs.utwente.nl/user/s1934538/clickstream/clickstream-enwiki-2021-11.tsv.gz,Doctor_Strange_in_the_Multiverse_of_Madness,151529,96011,1784,249324,132475
hdfs://spark-nn.eemcs.utwente.nl/user/s1934538/clickstream/clickstream-enwiki-2021-11.tsv.gz,Us_(2019_film),19781,64118,400,84299,28874
hdfs://spark-nn.eemcs.utwente.nl/user/s1934538/clickstream/clickstream-enwiki-2021-11.tsv.gz,Critical_race_theory,27866,1102443,7752,1138061,126615
hdfs://spark-nn.eemcs.utwente.nl/user/s1934538/clickstream/clickstream-enwiki-2021-11.tsv.gz,List_of_Queen_of_the_South_episodes,7967,5284,257,13508,377
hdfs://spark-nn.eemcs.utwente.nl/user/s1934538/clickstream/clickstream-enwiki-2021-11.tsv.gz,Vivek_Ramaswamy,718,9254,37,10009,1696
hdfs://spark-nn.eemcs.utwente.nl/user/s1934538/clickstream/clickstream-enwiki-2021-11.tsv.gz,War_(2019_film),18407,44739,68,63214,17652
hdfs://spark-nn.eemcs.utwente.nl/user/s1934538/clickstream/clickstream-enwiki-2021-11.tsv.gz,1917_(2019_film),30190,101129,2183,133502,80744
hdfs://spark-nn.eemcs.utwente.nl/user/s1934538/clickstream/clickstream-enwiki-2021-11.tsv.gz,Jeffrey_Dahmer,26509,234306,3105,263920,111805
hdfs://spark-nn.eemcs.utwente.nl/user/s1934538/clickstream/clickstream-enwiki-2021-11.tsv.gz,State_of_Palestine,35283,83981,189,119453,48686
hdfs://spark-nn.eemcs.utwente.nl/user/s1934538/clickstream/clickstream-enwiki-2021-11.tsv.gz,Cecil_Hotel_(Los_Angeles),6133,64046,152,70331,20068
hdfs://spark-nn.eemcs.utwente.nl/user/s1934538/clickstream/clickstream-enwiki-2021-11.tsv.gz,Aaron_Hernandez,10122,125632,704,136458,46131
hdfs://spark-nn.eemcs.utwente.nl/user/s1934538/clickstream/clickstream-enwiki-2021-11.tsv.gz,Murder_of_Dee_Dee_Blanchard,16812,117110,508,134430,24650
hdfs://spark-nn.eemcs.utwente.nl/user/s1934538/clickstream/clickstream-enwiki-2021-11.tsv.gz,Aaron_Carter,19392,75982,562,95936,42245
hdfs://spark-nn.eemcs.utwente.nl/user/s1934538/clickstream/clickstream-enwiki-2021-11.tsv.gz,Salman_Rushdie,32287,74025,477,106789,41347
hdfs://spark-nn.eemcs.utwente.nl/user/s1934538/clickstream/clickstream-enwiki-2021-11.tsv.gz,2020_Summer_Olympics,50771,92653,2172,145596,116061
hdfs://spark-nn.eemcs.utwente.nl/user/s1934538/clickstream/clickstream-enwiki-2021-11.tsv.gz,Priyanka_Chopra,128129,381097,2642,511868,176445
hdfs://spark-nn.eemcs.utwente.nl/user/s1934538/clickstream/clickstream-enwiki-2021-11.tsv.gz,Death_of_Elisa_Lam,13621,65639,213,79473,20235
hdfs://spark-nn.eemcs.utwente.nl/user/s1934538/clickstream/clickstream-enwiki-2021-11.tsv.gz,Crazy_Rich_Asians_(film),65863,88498,1227,155588,118452
hdfs://spark-nn.eemcs.utwente.nl/user/s1934538/clickstream/clickstream-enwiki-2021-11.tsv.gz,Carlos_Alcaraz,6955,29881,429,37265,9184
hdfs://spark-nn.eemcs.utwente.nl/user/s1934538/clickstream/clickstream-enwiki-2021-11.tsv.gz,Dune_(2021_film),325745,2174415,51514,2551674,1862485
hdfs://spark-nn.eemcs.utwente.nl/user/s1934538/clickstream/clickstream-enwiki-2021-11.tsv.gz,Nipsey_Hussle,23399,86546,781,110726,32600
hdfs://spark-nn.eemcs.utwente.nl/user/s1934538/clickstream/clickstream-enwiki-2021-11.tsv.gz,Deaths_in_2021,1224430,2198895,12899,3436224,2058203
hdfs://spark-nn.eemcs.utwente.nl/user/s1934538/clickstream/clickstream-enwiki-2021-11.tsv.gz,Lisa_Marie_Presley,106858,63019,212,170089,97119
hdfs://spark-nn.eemcs.utwente.nl/user/s1934538/clickstream/clickstream-enwiki-2021-11.tsv.gz,Stranger_Things_(season_4),37455,295481,1833,334769,158185
hdfs://spark-nn.eemcs.utwente.nl/user/s1934538/clickstream/clickstream-enwiki-2021-11.tsv.gz,Black_Panther:_Wakanda_Forever,123743,67416,913,192072,148275
hdfs://spark-nn.eemcs.utwente.nl/user/s1934538/clickstream/clickstream-enwiki-2021-11.tsv.gz,Media,43,3346,313,3702,1395
hdfs://spark-nn.eemcs.utwente.nl/user/s1934538/clickstream/clickstream-enwiki-2021-11.tsv.gz,Tenet_(film),59012,149084,1904,210000,108520
hdfs://spark-nn.eemcs.utwente.nl/user/s1934538/clickstream/clickstream-enwiki-2021-11.tsv.gz,Alexander_Hamilton,68407,215614,2023,286044,141806
hdfs://spark-nn.eemcs.utwente.nl/user/s1934538/clickstream/clickstream-enwiki-2021-11.tsv.gz,Bridgerton,56715,122478,2135,181328,115252
hdfs://spark-nn.eemcs.utwente.nl/user/s1934538/clickstream/clickstream-enwiki-2021-11.tsv.gz,The_Witcher_(TV_series),32840,219211,5914,257965,150398
hdfs://spark-nn.eemcs.utwente.nl/user/s1934538/clickstream/clickstream-enwiki-2021-11.tsv.gz,Charles_Sobhraj,13715,60217,185,74117,13588
hdfs://spark-nn.eemcs.utwente.nl/user/s1934538/clickstream/clickstream-enwiki-2021-11.tsv.gz,Area_51,11820,103605,1124,116549,32140
hdfs://spark-nn.eemcs.utwente.nl/user/s1934538/clickstream/clickstream-enwiki-2021-11.tsv.gz,Ponniyin_Selvan:_I,60069,54125,121,114315,96998
hdfs://spark-nn.eemcs.utwente.nl/user/s1934538/clickstream/clickstream-enwiki-2021-11.tsv.gz,Juneteenth,6695,57097,391,64183,5191
hdfs://spark-nn.eemcs.utwente.nl/user/s1934538/clickstream/clickstream-enwiki-2021-11.tsv.gz,Manti_Te'o,5400,23662,60,29122,3152
hdfs://spark-nn.eemcs.utwente.nl/user/s1934538/clickstream/clickstream-enwiki-2021-11.tsv.gz,21_Savage,14466,56159,526,71151,24554
hdfs://spark-nn.eemcs.utwente.nl/user/s1934538/clickstream/clickstream-enwiki-2021-11.tsv.gz,2022_FIFA_World_Cup,227293,721303,22601,971197,649156
hdfs://spark-nn.eemcs.utwente.nl/user/s1934538/clickstream/clickstream-enwiki-2021-11.tsv.gz,Juice_Wrld,121236,257543,3678,382457,127793
hdfs://spark-nn.eemcs.utwente.nl/user/s1934538/clickstream/clickstream-enwiki-2021-11.tsv.gz,Asia_Cup,5512,80200,327,86039,43592
hdfs://spark-nn.eemcs.utwente.nl/user/s1934538/clickstream/clickstream-enwiki-2021-11.tsv.gz,Ghislaine_Maxwell,72284,390222,2854,465360,199889
hdfs://spark-nn.eemcs.utwente.nl/user/s1934538/clickstream/clickstream-enwiki-2021-11.tsv.gz,Spider-Man:_Far_From_Home,132980,152804,2956,288740,156032
hdfs://spark-nn.eemcs.utwente.nl/user/s1934538/clickstream/clickstream-enwiki-2021-11.tsv.gz,Elon_Musk,193831,1891719,17402,2102952,1278677
hdfs://spark-nn.eemcs.utwente.nl/user/s1934538/clickstream/clickstream-enwiki-2021-11.tsv.gz,Kelly_Preston,90617,173177,789,264583,74782
hdfs://spark-nn.eemcs.utwente.nl/user/s1934538/clickstream/clickstream-enwiki-2021-11.tsv.gz,IPv4,10026,39916,140,50082,9067
hdfs://spark-nn.eemcs.utwente.nl/user/s1934538/clickstream/clickstream-enwiki-2021-11.tsv.gz,Russo-Ukrainian_War,33786,78297,625,112708,67669
hdfs://spark-nn.eemcs.utwente.nl/user/s1934538/clickstream/clickstream-enwiki-2021-11.tsv.gz,Kobe_Bryant,52689,294844,3233,350766,96504
hdfs://spark-nn.eemcs.utwente.nl/user/s1934538/clickstream/clickstream-enwiki-2021-11.tsv.gz,YouTube,124473,2099593,10432,2234498,136350
hdfs://spark-nn.eemcs.utwente.nl/user/s1934538/clickstream/clickstream-enwiki-2021-11.tsv.gz,2018_Asian_Games,7222,7709,58,14989,13308
hdfs://spark-nn.eemcs.utwente.nl/user/s1934538/clickstream/clickstream-enwiki-2021-11.tsv.gz,2020_United_States_presidential_election,160586,235503,6753,402842,388824
hdfs://spark-nn.eemcs.utwente.nl/user/s1934538/clickstream/clickstream-enwiki-2021-11.tsv.gz,Aquaman_(film),24456,67457,1145,93058,54786
hdfs://spark-nn.eemcs.utwente.nl/user/s1934538/clickstream/clickstream-enwiki-2021-11.tsv.gz,Brie_Larson,66051,162576,1445,230072,96670
hdfs://spark-nn.eemcs.utwente.nl/user/s1934538/clickstream/clickstream-enwiki-2021-11.tsv.gz,Sridevi,31663,71811,198,103672,46997
hdfs://spark-nn.eemcs.utwente.nl/user/s1934538/clickstream/clickstream-enwiki-2021-11.tsv.gz,Main_Page,55337,149000147,4516499,153571983,31979963
hdfs://spark-nn.eemcs.utwente.nl/user/s1934538/clickstream/clickstream-enwiki-2021-11.tsv.gz,Ted_Bundy,41835,349195,4584,395614,95383
hdfs://spark-nn.eemcs.utwente.nl/user/s1934538/clickstream/clickstream-enwiki-2021-11.tsv.gz,Mortal_Kombat_(2021_film),28963,119948,2653,151564,162588
hdfs://spark-nn.eemcs.utwente.nl/user/s1934538/clickstream/clickstream-enwiki-2021-11.tsv.gz,Elizabeth_II,448754,787365,1557,1237676,852419
hdfs://spark-nn.eemcs.utwente.nl/user/s1934538/clickstream/clickstream-enwiki-2021-11.tsv.gz,Tunnel,3578,8426,108,12112,3410
hdfs://spark-nn.eemcs.utwente.nl/user/s1934538/clickstream/clickstream-enwiki-2021-11.tsv.gz,Atal_Bihari_Vajpayee,25126,45661,54,70841,22491
hdfs://spark-nn.eemcs.utwente.nl/user/s1934538/clickstream/clickstream-enwiki-2021-11.tsv.gz,Pelé,34780,122369,6138,163287,57495
hdfs://spark-nn.eemcs.utwente.nl/user/s1934538/clickstream/clickstream-enwiki-2021-11.tsv.gz,Jimmy_Buffett,6715,33718,425,40858,14950
hdfs://spark-nn.eemcs.utwente.nl/user/s1934538/clickstream/clickstream-enwiki-2021-11.tsv.gz,Hamilton_(musical),35663,194896,1552,232111,134082
hdfs://spark-nn.eemcs.utwente.nl/user/s1934538/clickstream/clickstream-enwiki-2021-11.tsv.gz,Greta_Thunberg,20983,517647,5196,543826,151910
hdfs://spark-nn.eemcs.utwente.nl/user/s1934538/clickstream/clickstream-enwiki-2021-11.tsv.gz,Antifa_(United_States),10708,66468,648,77824,15388
hdfs://spark-nn.eemcs.utwente.nl/user/s1934538/clickstream/clickstream-enwiki-2021-11.tsv.gz,XXX:_Return_of_Xander_Cage,63961,718769,1077,783807,83032
hdfs://spark-nn.eemcs.utwente.nl/user/s1934538/clickstream/clickstream-enwiki-2021-11.tsv.gz,Richard_Jewell,20111,123794,650,144555,47877
hdfs://spark-nn.eemcs.utwente.nl/user/s1934538/clickstream/clickstream-enwiki-2021-11.tsv.gz,Dennis_Nilsen,9237,67527,404,77168,18304
hdfs://spark-nn.eemcs.utwente.nl/user/s1934538/clickstream/clickstream-enwiki-2021-11.tsv.gz,Cricket_World_Cup,43629,318903,1110,363642,157486
hdfs://spark-nn.eemcs.utwente.nl/user/s1934538/clickstream/clickstream-enwiki-2021-11.tsv.gz,Notre-Dame_de_Paris,12281,79950,1078,93309,21989
hdfs://spark-nn.eemcs.utwente.nl/user/s1934538/clickstream/clickstream-enwiki-2021-11.tsv.gz,Naomi_Osaka,20886,49928,344,71158,18838
hdfs://spark-nn.eemcs.utwente.nl/user/s1934538/clickstream/clickstream-enwiki-2021-11.tsv.gz,Avengers:_Infinity_War,52692,70764,1177,124633,67436
hdfs://spark-nn.eemcs.utwente.nl/user/s1934538/clickstream/clickstream-enwiki-2021-11.tsv.gz,Johnny_Depp,130749,307652,2536,440937,286239
hdfs://spark-nn.eemcs.utwente.nl/user/s1934538/clickstream/clickstream-enwiki-2021-11.tsv.gz,Sylvester_Stallone,80477,211531,1915,293923,207133
hdfs://spark-nn.eemcs.utwente.nl/user/s1934538/clickstream/clickstream-enwiki-2021-11.tsv.gz,Lance_Reddick,28352,32292,219,60863,12205
hdfs://spark-nn.eemcs.utwente.nl/user/s1934538/clickstream/clickstream-enwiki-2021-11.tsv.gz,Bipin_Rawat,10842,21837,26,32705,15392
hdfs://spark-nn.eemcs.utwente.nl/user/s1934538/clickstream/clickstream-enwiki-2021-11.tsv.gz,It_Chapter_Two,38693,104855,1117,144665,96113
hdfs://spark-nn.eemcs.utwente.nl/user/s1934538/clickstream/clickstream-enwiki-2021-11.tsv.gz,Hyphen-minus,746,7588108,15971,7604825,838
hdfs://spark-nn.eemcs.utwente.nl/user/s1934538/clickstream/clickstream-enwiki-2021-11.tsv.gz,The_Flash_(film),50996,30451,394,81841,52334
hdfs://spark-nn.eemcs.utwente.nl/user/s1934538/clickstream/clickstream-enwiki-2021-11.tsv.gz,Roe_v._Wade,10846,94662,720,106228,29300
hdfs://spark-nn.eemcs.utwente.nl/user/s1934538/clickstream/clickstream-enwiki-2021-11.tsv.gz,Cristiano_Ronaldo,155571,1071319,7198,1234088,264439
hdfs://spark-nn.eemcs.utwente.nl/user/s1934538/clickstream/clickstream-enwiki-2021-11.tsv.gz,The_Suicide_Squad_(film),94925,179970,4325,279220,186752
hdfs://spark-nn.eemcs.utwente.nl/user/s1934538/clickstream/clickstream-enwiki-2021-11.tsv.gz,Tina_Turner,28606,260091,2613,291310,92055
hdfs://spark-nn.eemcs.utwente.nl/user/s1934538/clickstream/clickstream-enwiki-2021-12.tsv.gz,Kelly_Preston,101743,239266,940,341949,93782
hdfs://spark-nn.eemcs.utwente.nl/user/s1934538/clickstream/clickstream-enwiki-2021-12.tsv.gz,Jurassic_World_Dominion,85327,91909,2062,179298,52576
hdfs://spark-nn.eemcs.utwente.nl/user/s1934538/clickstream/clickstream-enwiki-2021-12.tsv.gz,Mac_Miller,35230,170919,1560,207709,61172
hdfs://spark-nn.eemcs.utwente.nl/user/s1934538/clickstream/clickstream-enwiki-2021-12.tsv.gz,Alexander_Hamilton,66638,206542,1767,274947,140275
hdfs://spark-nn.eemcs.utwente.nl/user/s1934538/clickstream/clickstream-enwiki-2021-12.tsv.gz,2020_Summer_Olympics,56706,85942,2099,144747,113907
hdfs://spark-nn.eemcs.utwente.nl/user/s1934538/clickstream/clickstream-enwiki-2021-12.tsv.gz,The_Mandalorian,106289,253178,5187,364654,253453
hdfs://spark-nn.eemcs.utwente.nl/user/s1934538/clickstream/clickstream-enwiki-2021-12.tsv.gz,The_Haunting_of_Bly_Manor,24130,50198,583,74911,36386
hdfs://spark-nn.eemcs.utwente.nl/user/s1934538/clickstream/clickstream-enwiki-2021-12.tsv.gz,QAnon,41679,320688,2187,364554,79128
hdfs://spark-nn.eemcs.utwente.nl/user/s1934538/clickstream/clickstream-enwiki-2021-12.tsv.gz,Sushant_Singh_Rajput,34797,94726,368,129891,56001
hdfs://spark-nn.eemcs.utwente.nl/user/s1934538/clickstream/clickstream-enwiki-2021-12.tsv.gz,Deaths_in_2021,167107,2483653,1169496,3820256,2315439
hdfs://spark-nn.eemcs.utwente.nl/user/s1934538/clickstream/clickstream-enwiki-2021-12.tsv.gz,The_Last_of_Us_(TV_series),29430,51391,645,81466,66420
hdfs://spark-nn.eemcs.utwente.nl/user/s1934538/clickstream/clickstream-enwiki-2021-12.tsv.gz,United_States_Senate,46662,53852,571,101085,46769
hdfs://spark-nn.eemcs.utwente.nl/user/s1934538/clickstream/clickstream-enwiki-2021-12.tsv.gz,Mortal_Kombat_(2021_film),27053,95416,2068,124537,110724
hdfs://spark-nn.eemcs.utwente.nl/user/s1934538/clickstream/clickstream-enwiki-2021-12.tsv.gz,2018_FIFA_World_Cup,62098,65598,638,128334,79549
hdfs://spark-nn.eemcs.utwente.nl/user/s1934538/clickstream/clickstream-enwiki-2021-12.tsv.gz,1917_(2019_film),27101,115664,2161,144926,84713
hdfs://spark-nn.eemcs.utwente.nl/user/s1934538/clickstream/clickstream-enwiki-2021-12.tsv.gz,Elon_Musk,168564,1792859,15891,1977314,1099720
hdfs://spark-nn.eemcs.utwente.nl/user/s1934538/clickstream/clickstream-enwiki-2021-12.tsv.gz,Roe_v._Wade,23477,386976,3058,413511,118775
hdfs://spark-nn.eemcs.utwente.nl/user/s1934538/clickstream/clickstream-enwiki-2021-12.tsv.gz,Doctor_Strange_in_the_Multiverse_of_Madness,388009,466309,10341,864659,542530
hdfs://spark-nn.eemcs.utwente.nl/user/s1934538/clickstream/clickstream-enwiki-2021-12.tsv.gz,Anna_Sorokin,8334,104090,264,112688,31649
hdfs://spark-nn.eemcs.utwente.nl/user/s1934538/clickstream/clickstream-enwiki-2021-12.tsv.gz,K.G.F:_Chapter_2,37352,130879,1495,169726,64697
hdfs://spark-nn.eemcs.utwente.nl/user/s1934538/clickstream/clickstream-enwiki-2021-12.tsv.gz,Stranger_Things_(season_4),21649,192990,852,215491,97343
hdfs://spark-nn.eemcs.utwente.nl/user/s1934538/clickstream/clickstream-enwiki-2021-12.tsv.gz,Dune_(2021_film),179373,845776,38972,1064121,691144
hdfs://spark-nn.eemcs.utwente.nl/user/s1934538/clickstream/clickstream-enwiki-2021-12.tsv.gz,Greta_Thunberg,10635,135397,1663,147695,33092
hdfs://spark-nn.eemcs.utwente.nl/user/s1934538/clickstream/clickstream-enwiki-2021-12.tsv.gz,Kate_Spade,22517,64063,326,86906,31201
hdfs://spark-nn.eemcs.utwente.nl/user/s1934538/clickstream/clickstream-enwiki-2021-12.tsv.gz,Top_Gun:_Maverick,56432,71398,1934,129764,71608
hdfs://spark-nn.eemcs.utwente.nl/user/s1934538/clickstream/clickstream-enwiki-2021-12.tsv.gz,The_Falcon_and_the_Winter_Soldier,52719,106584,1841,161144,98752
hdfs://spark-nn.eemcs.utwente.nl/user/s1934538/clickstream/clickstream-enwiki-2021-12.tsv.gz,The_Witcher_(TV_series),265277,2953874,75763,3294914,2072353
hdfs://spark-nn.eemcs.utwente.nl/user/s1934538/clickstream/clickstream-enwiki-2021-12.tsv.gz,Atal_Bihari_Vajpayee,27408,111980,79,139467,31917
hdfs://spark-nn.eemcs.utwente.nl/user/s1934538/clickstream/clickstream-enwiki-2021-12.tsv.gz,State_of_Palestine,41345,98298,1086,140729,56570
hdfs://spark-nn.eemcs.utwente.nl/user/s1934538/clickstream/clickstream-enwiki-2021-12.tsv.gz,Shang-Chi_and_the_Legend_of_the_Ten_Rings,239019,693797,12374,945190,685543
hdfs://spark-nn.eemcs.utwente.nl/user/s1934538/clickstream/clickstream-enwiki-2021-12.tsv.gz,The_Nun_(2018_film),13122,32104,248,45474,23352
hdfs://spark-nn.eemcs.utwente.nl/user/s1934538/clickstream/clickstream-enwiki-2021-12.tsv.gz,Pornhub,53426,509736,12824,575986,95220
hdfs://spark-nn.eemcs.utwente.nl/user/s1934538/clickstream/clickstream-enwiki-2021-12.tsv.gz,Adipurush,73730,39192,120,113042,84155
hdfs://spark-nn.eemcs.utwente.nl/user/s1934538/clickstream/clickstream-enwiki-2021-12.tsv.gz,2022_FIFA_World_Cup,87400,238266,4329,329995,172631
hdfs://spark-nn.eemcs.utwente.nl/user/s1934538/clickstream/clickstream-enwiki-2021-12.tsv.gz,Bible,15605,3982282,2001,3999888,34490
hdfs://spark-nn.eemcs.utwente.nl/user/s1934538/clickstream/clickstream-enwiki-2021-12.tsv.gz,Amber_Heard,114771,182873,1095,298739,114822
hdfs://spark-nn.eemcs.utwente.nl/user/s1934538/clickstream/clickstream-enwiki-2021-12.tsv.gz,Israel,79037,230553,5047,314637,152370
hdfs://spark-nn.eemcs.utwente.nl/user/s1934538/clickstream/clickstream-enwiki-2021-12.tsv.gz,Charles_Sobhraj,15286,71949,295,87530,15766
hdfs://spark-nn.eemcs.utwente.nl/user/s1934538/clickstream/clickstream-enwiki-2021-12.tsv.gz,Johnny_Depp,144975,385203,3317,533495,307447
hdfs://spark-nn.eemcs.utwente.nl/user/s1934538/clickstream/clickstream-enwiki-2021-12.tsv.gz,"Citizenship_(Amendment)_Act,_2019",3345,22975,35,26355,3035
hdfs://spark-nn.eemcs.utwente.nl/user/s1934538/clickstream/clickstream-enwiki-2021-12.tsv.gz,The_Suicide_Squad_(film),100624,243239,4958,348821,263426
hdfs://spark-nn.eemcs.utwente.nl/user/s1934538/clickstream/clickstream-enwiki-2021-12.tsv.gz,Captain_Marvel_(film),53131,122447,1478,177056,91369
hdfs://spark-nn.eemcs.utwente.nl/user/s1934538/clickstream/clickstream-enwiki-2021-12.tsv.gz,The_Irishman,50153,85825,1724,137702,114165
hdfs://spark-nn.eemcs.utwente.nl/user/s1934538/clickstream/clickstream-enwiki-2021-12.tsv.gz,Once_Upon_a_Time_in_Hollywood,86836,132605,3000,222441,205987
hdfs://spark-nn.eemcs.utwente.nl/user/s1934538/clickstream/clickstream-enwiki-2021-12.tsv.gz,Stan_Lee,115835,472953,1980,590768,135012
hdfs://spark-nn.eemcs.utwente.nl/user/s1934538/clickstream/clickstream-enwiki-2021-12.tsv.gz,Black_Panther_(film),55618,111019,2014,168651,102090
hdfs://spark-nn.eemcs.utwente.nl/user/s1934538/clickstream/clickstream-enwiki-2021-12.tsv.gz,Deion_Sanders,26980,317402,2527,346909,113785
hdfs://spark-nn.eemcs.utwente.nl/user/s1934538/clickstream/clickstream-enwiki-2021-12.tsv.gz,Avengers:_Infinity_War,100704,124088,1457,226249,118361
hdfs://spark-nn.eemcs.utwente.nl/user/s1934538/clickstream/clickstream-enwiki-2021-12.tsv.gz,Kamala_Harris,75552,197362,2021,274935,115572
hdfs://spark-nn.eemcs.utwente.nl/user/s1934538/clickstream/clickstream-enwiki-2021-12.tsv.gz,Donald_Trump,191480,400643,7766,599889,344470
hdfs://spark-nn.eemcs.utwente.nl/user/s1934538/clickstream/clickstream-enwiki-2021-12.tsv.gz,Lionel_Messi,105812,637950,7817,751579,161349
hdfs://spark-nn.eemcs.utwente.nl/user/s1934538/clickstream/clickstream-enwiki-2021-12.tsv.gz,Betty_White,160996,4179221,39378,4379595,900218
hdfs://spark-nn.eemcs.utwente.nl/user/s1934538/clickstream/clickstream-enwiki-2021-12.tsv.gz,Salman_Rushdie,27775,69603,385,97763,38882
hdfs://spark-nn.eemcs.utwente.nl/user/s1934538/clickstream/clickstream-enwiki-2021-12.tsv.gz,ICC_Men's_T20_World_Cup,14216,78814,353,93383,34935
hdfs://spark-nn.eemcs.utwente.nl/user/s1934538/clickstream/clickstream-enwiki-2021-12.tsv.gz,United_States_Electoral_College,10076,29522,68,39666,6406
hdfs://spark-nn.eemcs.utwente.nl/user/s1934538/clickstream/clickstream-enwiki-2021-12.tsv.gz,Thor:_Love_and_Thunder,221526,130922,1384,353832,242158
hdfs://spark-nn.eemcs.utwente.nl/user/s1934538/clickstream/clickstream-enwiki-2021-12.tsv.gz,Michael_Bloomberg,30415,28637,139,59191,26205
hdfs://spark-nn.eemcs.utwente.nl/user/s1934538/clickstream/clickstream-enwiki-2021-12.tsv.gz,List_of_Marvel_Cinematic_Universe_films,494118,1190639,3509,1688266,1028671
hdfs://spark-nn.eemcs.utwente.nl/user/s1934538/clickstream/clickstream-enwiki-2021-12.tsv.gz,House_of_the_Dragon,32730,99782,1189,133701,87971
hdfs://spark-nn.eemcs.utwente.nl/user/s1934538/clickstream/clickstream-enwiki-2021-12.tsv.gz,Glass_(2019_film),29761,36388,222,66371,21992
hdfs://spark-nn.eemcs.utwente.nl/user/s1934538/clickstream/clickstream-enwiki-2021-12.tsv.gz,Irrfan_Khan,44794,69536,123,114453,46106
hdfs://spark-nn.eemcs.utwente.nl/user/s1934538/clickstream/clickstream-enwiki-2021-12.tsv.gz,Matthew_Perry,61671,134177,855,196703,94733
hdfs://spark-nn.eemcs.utwente.nl/user/s1934538/clickstream/clickstream-enwiki-2021-12.tsv.gz,Wikipedia,229204,811066,1245,1041515,266641
hdfs://spark-nn.eemcs.utwente.nl/user/s1934538/clickstream/clickstream-enwiki-2021-12.tsv.gz,J._Robert_Oppenheimer,32453,134226,416,167095,59810
hdfs://spark-nn.eemcs.utwente.nl/user/s1934538/clickstream/clickstream-enwiki-2021-12.tsv.gz,Queen_(band),65152,217732,3457,286341,261272
hdfs://spark-nn.eemcs.utwente.nl/user/s1934538/clickstream/clickstream-enwiki-2021-12.tsv.gz,Star_Wars:_The_Rise_of_Skywalker,93794,91395,2500,187689,103355
hdfs://spark-nn.eemcs.utwente.nl/user/s1934538/clickstream/clickstream-enwiki-2021-12.tsv.gz,Ant-Man_and_the_Wasp:_Quantumania,113225,41271,460,154956,100090
hdfs://spark-nn.eemcs.utwente.nl/user/s1934538/clickstream/clickstream-enwiki-2021-12.tsv.gz,Joe_Biden,179871,441457,8204,629532,296056
hdfs://spark-nn.eemcs.utwente.nl/user/s1934538/clickstream/clickstream-enwiki-2021-12.tsv.gz,Freddie_Mercury,90990,570869,5394,667253,255608
hdfs://spark-nn.eemcs.utwente.nl/user/s1934538/clickstream/clickstream-enwiki-2021-12.tsv.gz,Bipin_Rawat,146385,3444294,44708,3635387,1044422
hdfs://spark-nn.eemcs.utwente.nl/user/s1934538/clickstream/clickstream-enwiki-2021-12.tsv.gz,Hamas,19497,31588,262,51347,21631
hdfs://spark-nn.eemcs.utwente.nl/user/s1934538/clickstream/clickstream-enwiki-2021-12.tsv.gz,Meat_Loaf,23412,77168,837,101417,36199
hdfs://spark-nn.eemcs.utwente.nl/user/s1934538/clickstream/clickstream-enwiki-2021-12.tsv.gz,The_Batman_(film),131516,267140,7283,405939,314212
hdfs://spark-nn.eemcs.utwente.nl/user/s1934538/clickstream/clickstream-enwiki-2021-12.tsv.gz,Lisa_Marie_Presley,113868,74015,293,188176,106040
hdfs://spark-nn.eemcs.utwente.nl/user/s1934538/clickstream/clickstream-enwiki-2021-12.tsv.gz,Simple_Mail_Transfer_Protocol,2738,34158,107,37003,3109
hdfs://spark-nn.eemcs.utwente.nl/user/s1934538/clickstream/clickstream-enwiki-2021-12.tsv.gz,Khabib_Nurmagomedov,68042,218742,1991,288775,147654
hdfs://spark-nn.eemcs.utwente.nl/user/s1934538/clickstream/clickstream-enwiki-2021-12.tsv.gz,Squid_Game,57015,721043,15453,793511,369079
hdfs://spark-nn.eemcs.utwente.nl/user/s1934538/clickstream/clickstream-enwiki-2021-12.tsv.gz,Eddie_Van_Halen,35356,68204,714,104274,40282
hdfs://spark-nn.eemcs.utwente.nl/user/s1934538/clickstream/clickstream-enwiki-2021-12.tsv.gz,Olivia_Newton-John,25088,79558,946,105592,42723
hdfs://spark-nn.eemcs.utwente.nl/user/s1934538/clickstream/clickstream-enwiki-2021-12.tsv.gz,Grover,1313,4265,48,5626,1275
hdfs://spark-nn.eemcs.utwente.nl/user/s1934538/clickstream/clickstream-enwiki-2021-12.tsv.gz,"Meghan,_Duchess_of_Sussex",71589,207890,1461,280940,147278
hdfs://spark-nn.eemcs.utwente.nl/user/s1934538/clickstream/clickstream-enwiki-2021-12.tsv.gz,The_Queen's_Gambit_(miniseries),32288,146276,1474,180038,95857
hdfs://spark-nn.eemcs.utwente.nl/user/s1934538/clickstream/clickstream-enwiki-2021-12.tsv.gz,Juice_Wrld,60373,688657,5843,754873,287957
hdfs://spark-nn.eemcs.utwente.nl/user/s1934538/clickstream/clickstream-enwiki-2021-12.tsv.gz,Jeffrey_Epstein,222408,1146853,10214,1379475,675848
hdfs://spark-nn.eemcs.utwente.nl/user/s1934538/clickstream/clickstream-enwiki-2021-12.tsv.gz,Asia_Cup,2080,25539,50,27669,13756
hdfs://spark-nn.eemcs.utwente.nl/user/s1934538/clickstream/clickstream-enwiki-2021-12.tsv.gz,Ukraine,78058,446617,10951,535626,249353
hdfs://spark-nn.eemcs.utwente.nl/user/s1934538/clickstream/clickstream-enwiki-2021-12.tsv.gz,Critical_race_theory,11399,342830,2008,356237,37423
hdfs://spark-nn.eemcs.utwente.nl/user/s1934538/clickstream/clickstream-enwiki-2021-12.tsv.gz,William_Murdoch,555,1327,27,1909,324
hdfs://spark-nn.eemcs.utwente.nl/user/s1934538/clickstream/clickstream-enwiki-2021-12.tsv.gz,Keanu_Reeves,263025,1779005,14766,2056796,1232966
hdfs://spark-nn.eemcs.utwente.nl/user/s1934538/clickstream/clickstream-enwiki-2021-12.tsv.gz,Royal_Rumble_(2018),6973,4481,157,11611,8143
hdfs://spark-nn.eemcs.utwente.nl/user/s1934538/clickstream/clickstream-enwiki-2021-12.tsv.gz,Chadwick_Boseman,65514,244331,1259,311104,84368
hdfs://spark-nn.eemcs.utwente.nl/user/s1934538/clickstream/clickstream-enwiki-2021-12.tsv.gz,George_H._W._Bush,118926,96034,725,215685,127495
hdfs://spark-nn.eemcs.utwente.nl/user/s1934538/clickstream/clickstream-enwiki-2021-12.tsv.gz,Pelé,32206,141268,1423,174897,60733
hdfs://spark-nn.eemcs.utwente.nl/user/s1934538/clickstream/clickstream-enwiki-2021-12.tsv.gz,Jeffrey_Dahmer,25472,221065,2870,249407,109566
hdfs://spark-nn.eemcs.utwente.nl/user/s1934538/clickstream/clickstream-enwiki-2021-12.tsv.gz,Tom_Brady,112771,595868,6323,714962,278562
hdfs://spark-nn.eemcs.utwente.nl/user/s1934538/clickstream/clickstream-enwiki-2021-12.tsv.gz,Sushma_Swaraj,5303,17474,95,22872,5751
hdfs://spark-nn.eemcs.utwente.nl/user/s1934538/clickstream/clickstream-enwiki-2021-12.tsv.gz,Darth_Vader,25413,57530,528,83471,49117
hdfs://spark-nn.eemcs.utwente.nl/user/s1934538/clickstream/clickstream-enwiki-2021-12.tsv.gz,Black_Panther:_Wakanda_Forever,193213,96182,1112,290507,219096
hdfs://spark-nn.eemcs.utwente.nl/user/s1934538/clickstream/clickstream-enwiki-2021-12.tsv.gz,HTTP_cookie,2679,233775,85,236539,16277
hdfs://spark-nn.eemcs.utwente.nl/user/s1934538/clickstream/clickstream-enwiki-2021-12.tsv.gz,Indian_Premier_League,22246,104409,162,126817,77120
hdfs://spark-nn.eemcs.utwente.nl/user/s1934538/clickstream/clickstream-enwiki-2021-12.tsv.gz,Central_Park_jogger_case,20227,49702,152,70081,9183
hdfs://spark-nn.eemcs.utwente.nl/user/s1934538/clickstream/clickstream-enwiki-2021-12.tsv.gz,Mötley_Crüe,29519,94870,1070,125459,141661
hdfs://spark-nn.eemcs.utwente.nl/user/s1934538/clickstream/clickstream-enwiki-2021-12.tsv.gz,Rami_Malek,90855,278362,1228,370445,152398
hdfs://spark-nn.eemcs.utwente.nl/user/s1934538/clickstream/clickstream-enwiki-2021-12.tsv.gz,COVID-19_pandemic_by_country_and_territory,69376,184268,3482,257126,168095
hdfs://spark-nn.eemcs.utwente.nl/user/s1934538/clickstream/clickstream-enwiki-2021-12.tsv.gz,Lance_Reddick,30881,27521,213,58615,11670
hdfs://spark-nn.eemcs.utwente.nl/user/s1934538/clickstream/clickstream-enwiki-2021-12.tsv.gz,Vivek_Ramaswamy,714,6499,14,7227,1130
hdfs://spark-nn.eemcs.utwente.nl/user/s1934538/clickstream/clickstream-enwiki-2021-12.tsv.gz,Croatia,40108,115734,1645,157487,56621
hdfs://spark-nn.eemcs.utwente.nl/user/s1934538/clickstream/clickstream-enwiki-2021-12.tsv.gz,Hyphen-minus,776,6782017,15727,6798520,698
hdfs://spark-nn.eemcs.utwente.nl/user/s1934538/clickstream/clickstream-enwiki-2021-12.tsv.gz,Shakira,22145,174784,1695,198624,87592
hdfs://spark-nn.eemcs.utwente.nl/user/s1934538/clickstream/clickstream-enwiki-2022-03.tsv.gz,Afghanistan,186419,287802,14054,488275,326582
hdfs://spark-nn.eemcs.utwente.nl/user/s1934538/clickstream/clickstream-enwiki-2022-03.tsv.gz,John_Wick:_Chapter_4,50857,55798,508,107163,59075
hdfs://spark-nn.eemcs.utwente.nl/user/s1934538/clickstream/clickstream-enwiki-2022-03.tsv.gz,Coronavirus,9451,77583,1697,88731,23716
hdfs://spark-nn.eemcs.utwente.nl/user/s1934538/clickstream/clickstream-enwiki-2022-03.tsv.gz,Kate_Spade,49738,57043,290,107071,38093
hdfs://spark-nn.eemcs.utwente.nl/user/s1934538/clickstream/clickstream-enwiki-2022-03.tsv.gz,Media,62,3793,478,4333,1630
hdfs://spark-nn.eemcs.utwente.nl/user/s1934538/clickstream/clickstream-enwiki-2022-03.tsv.gz,Charles_III,110,176,59,345,264
hdfs://spark-nn.eemcs.utwente.nl/user/s1934538/clickstream/clickstream-enwiki-2022-03.tsv.gz,George_H._W._Bush,168439,120103,921,289463,173467
hdfs://spark-nn.eemcs.utwente.nl/user/s1934538/clickstream/clickstream-enwiki-2022-03.tsv.gz,Jenna_Ortega,152079,159227,1698,313004,113276
hdfs://spark-nn.eemcs.utwente.nl/user/s1934538/clickstream/clickstream-enwiki-2022-03.tsv.gz,Top_Gun:_Maverick,100851,158933,5472,265256,198012
hdfs://spark-nn.eemcs.utwente.nl/user/s1934538/clickstream/clickstream-enwiki-2022-03.tsv.gz,Volodymyr_Zelenskyy,935368,4049359,33175,5017902,2182659
hdfs://spark-nn.eemcs.utwente.nl/user/s1934538/clickstream/clickstream-enwiki-2022-03.tsv.gz,Rihanna,83223,436139,5471,524833,298096
hdfs://spark-nn.eemcs.utwente.nl/user/s1934538/clickstream/clickstream-enwiki-2022-03.tsv.gz,FIFA_World_Cup,83453,303231,10727,397411,233641
hdfs://spark-nn.eemcs.utwente.nl/user/s1934538/clickstream/clickstream-enwiki-2022-03.tsv.gz,War_(2019_film),29283,48915,78,78276,20431
hdfs://spark-nn.eemcs.utwente.nl/user/s1934538/clickstream/clickstream-enwiki-2022-03.tsv.gz,Critical_race_theory,17239,380675,2863,400777,37273
hdfs://spark-nn.eemcs.utwente.nl/user/s1934538/clickstream/clickstream-enwiki-2022-03.tsv.gz,Lionel_Messi,101046,538976,6337,646359,136105
hdfs://spark-nn.eemcs.utwente.nl/user/s1934538/clickstream/clickstream-enwiki-2022-03.tsv.gz,Army_of_the_Dead,64688,90633,2117,157438,69824
hdfs://spark-nn.eemcs.utwente.nl/user/s1934538/clickstream/clickstream-enwiki-2022-03.tsv.gz,Pornhub,54815,432516,14266,501597,96500
hdfs://spark-nn.eemcs.utwente.nl/user/s1934538/clickstream/clickstream-enwiki-2022-03.tsv.gz,Murder_of_Dee_Dee_Blanchard,14616,105958,414,120988,28315
hdfs://spark-nn.eemcs.utwente.nl/user/s1934538/clickstream/clickstream-enwiki-2022-03.tsv.gz,Black_Widow_(2021_film),61141,113075,2046,176262,100938
hdfs://spark-nn.eemcs.utwente.nl/user/s1934538/clickstream/clickstream-enwiki-2022-03.tsv.gz,Puneeth_Rajkumar,39214,142748,1251,183213,83583
hdfs://spark-nn.eemcs.utwente.nl/user/s1934538/clickstream/clickstream-enwiki-2022-03.tsv.gz,Watts_family_murders,12448,159412,568,172428,50658
hdfs://spark-nn.eemcs.utwente.nl/user/s1934538/clickstream/clickstream-enwiki-2022-03.tsv.gz,A_Star_Is_Born_(2018_film),27398,72569,662,100629,47099
hdfs://spark-nn.eemcs.utwente.nl/user/s1934538/clickstream/clickstream-enwiki-2022-03.tsv.gz,J._Robert_Oppenheimer,91200,229219,760,321179,123199
hdfs://spark-nn.eemcs.utwente.nl/user/s1934538/clickstream/clickstream-enwiki-2022-03.tsv.gz,Aquaman_(film),29489,69121,1016,99626,55913
hdfs://spark-nn.eemcs.utwente.nl/user/s1934538/clickstream/clickstream-enwiki-2022-03.tsv.gz,Alexander_Hamilton,68849,230914,2169,301932,154618
hdfs://spark-nn.eemcs.utwente.nl/user/s1934538/clickstream/clickstream-enwiki-2022-03.tsv.gz,Irrfan_Khan,33887,49975,79,83941,35713
hdfs://spark-nn.eemcs.utwente.nl/user/s1934538/clickstream/clickstream-enwiki-2022-03.tsv.gz,Amber_Heard,107614,143631,911,252156,83636
hdfs://spark-nn.eemcs.utwente.nl/user/s1934538/clickstream/clickstream-enwiki-2022-03.tsv.gz,The_Queen's_Gambit_(miniseries),23534,79402,942,103878,53150
hdfs://spark-nn.eemcs.utwente.nl/user/s1934538/clickstream/clickstream-enwiki-2022-03.tsv.gz,JSON_Web_Token,786,28899,35,29720,1956
hdfs://spark-nn.eemcs.utwente.nl/user/s1934538/clickstream/clickstream-enwiki-2022-03.tsv.gz,UEFA_Euro_2020,58690,101014,1775,161479,83509
hdfs://spark-nn.eemcs.utwente.nl/user/s1934538/clickstream/clickstream-enwiki-2022-03.tsv.gz,Roe_v._Wade,11488,82191,651,94330,28159
hdfs://spark-nn.eemcs.utwente.nl/user/s1934538/clickstream/clickstream-enwiki-2022-03.tsv.gz,Johnny_Depp,124350,274086,2755,401191,248177
hdfs://spark-nn.eemcs.utwente.nl/user/s1934538/clickstream/clickstream-enwiki-2022-03.tsv.gz,R._Kelly,26729,184548,1874,213151,115268
hdfs://spark-nn.eemcs.utwente.nl/user/s1934538/clickstream/clickstream-enwiki-2022-03.tsv.gz,XHamster,6829,436172,5988,448989,48397
hdfs://spark-nn.eemcs.utwente.nl/user/s1934538/clickstream/clickstream-enwiki-2022-03.tsv.gz,Spanish_flu,24564,127163,1469,153196,39154
hdfs://spark-nn.eemcs.utwente.nl/user/s1934538/clickstream/clickstream-enwiki-2022-03.tsv.gz,Mac_Miller,33189,206087,1532,240808,74412
hdfs://spark-nn.eemcs.utwente.nl/user/s1934538/clickstream/clickstream-enwiki-2022-03.tsv.gz,Guardians_of_the_Galaxy_Vol._3,77423,32223,310,109956,68272
hdfs://spark-nn.eemcs.utwente.nl/user/s1934538/clickstream/clickstream-enwiki-2022-03.tsv.gz,Aaron_Carter,22030,77833,689,100552,47940
hdfs://spark-nn.eemcs.utwente.nl/user/s1934538/clickstream/clickstream-enwiki-2022-03.tsv.gz,Eternals_(film),109086,343860,7832,460778,436590
hdfs://spark-nn.eemcs.utwente.nl/user/s1934538/clickstream/clickstream-enwiki-2022-03.tsv.gz,Bible,16880,2399766,1856,2418502,30926
hdfs://spark-nn.eemcs.utwente.nl/user/s1934538/clickstream/clickstream-enwiki-2022-03.tsv.gz,When_They_See_Us,18097,26313,3322,47732,19780
hdfs://spark-nn.eemcs.utwente.nl/user/s1934538/clickstream/clickstream-enwiki-2022-03.tsv.gz,The_Mandalorian,66876,143877,3165,213918,150529
hdfs://spark-nn.eemcs.utwente.nl/user/s1934538/clickstream/clickstream-enwiki-2022-03.tsv.gz,Stranger_Things_(season_3),17066,30187,416,47669,26383
hdfs://spark-nn.eemcs.utwente.nl/user/s1934538/clickstream/clickstream-enwiki-2022-03.tsv.gz,Spider-Man:_Far_From_Home,86469,112589,1975,201033,96300
hdfs://spark-nn.eemcs.utwente.nl/user/s1934538/clickstream/clickstream-enwiki-2022-03.tsv.gz,Godzilla_vs._Kong,43255,76991,1661,121907,65006
hdfs://spark-nn.eemcs.utwente.nl/user/s1934538/clickstream/clickstream-enwiki-2022-03.tsv.gz,It_Chapter_Two,29048,57778,682,87508,56711
hdfs://spark-nn.eemcs.utwente.nl/user/s1934538/clickstream/clickstream-enwiki-2022-03.tsv.gz,List_of_awards_and_nominations_received_by_Meryl_Streep,12419,14082,185,26686,10797
hdfs://spark-nn.eemcs.utwente.nl/user/s1934538/clickstream/clickstream-enwiki-2022-03.tsv.gz,The_Irishman,48388,73884,1525,123797,106453
hdfs://spark-nn.eemcs.utwente.nl/user/s1934538/clickstream/clickstream-enwiki-2022-03.tsv.gz,Star_Wars:_The_Rise_of_Skywalker,74411,60630,1747,136788,76025
hdfs://spark-nn.eemcs.utwente.nl/user/s1934538/clickstream/clickstream-enwiki-2022-03.tsv.gz,The_Lion_King_(2019_film),37802,43429,661,81892,39506
hdfs://spark-nn.eemcs.utwente.nl/user/s1934538/clickstream/clickstream-enwiki-2022-03.tsv.gz,Elliot_Page,85611,498384,2430,586425,233503
hdfs://spark-nn.eemcs.utwente.nl/user/s1934538/clickstream/clickstream-enwiki-2022-03.tsv.gz,United_States_Senate,56175,59018,1540,116733,53074
hdfs://spark-nn.eemcs.utwente.nl/user/s1934538/clickstream/clickstream-enwiki-2022-03.tsv.gz,2.0_(film),45743,48501,175,94419,27642
hdfs://spark-nn.eemcs.utwente.nl/user/s1934538/clickstream/clickstream-enwiki-2022-03.tsv.gz,ICC_Men's_T20_World_Cup,12955,63165,431,76551,41447
hdfs://spark-nn.eemcs.utwente.nl/user/s1934538/clickstream/clickstream-enwiki-2022-03.tsv.gz,The_Idol_(TV_series),17272,8008,14,25294,16941
hdfs://spark-nn.eemcs.utwente.nl/user/s1934538/clickstream/clickstream-enwiki-2022-03.tsv.gz,Olivia_Newton-John,23852,71767,1108,96727,44487
hdfs://spark-nn.eemcs.utwente.nl/user/s1934538/clickstream/clickstream-enwiki-2022-03.tsv.gz,Freddie_Mercury,72825,398719,3804,475348,184940
hdfs://spark-nn.eemcs.utwente.nl/user/s1934538/clickstream/clickstream-enwiki-2022-03.tsv.gz,Dark_Phoenix_(film),46213,42881,541,89635,52752
hdfs://spark-nn.eemcs.utwente.nl/user/s1934538/clickstream/clickstream-enwiki-2022-03.tsv.gz,Mötley_Crüe,80470,217293,2252,300015,333564
hdfs://spark-nn.eemcs.utwente.nl/user/s1934538/clickstream/clickstream-enwiki-2022-03.tsv.gz,State_of_Palestine,57068,144611,229,201908,94699
hdfs://spark-nn.eemcs.utwente.nl/user/s1934538/clickstream/clickstream-enwiki-2022-03.tsv.gz,Game_of_Thrones,70900,241395,7304,319599,216679
hdfs://spark-nn.eemcs.utwente.nl/user/s1934538/clickstream/clickstream-enwiki-2022-03.tsv.gz,Joe_Exotic,51927,230068,1450,283445,132349
hdfs://spark-nn.eemcs.utwente.nl/user/s1934538/clickstream/clickstream-enwiki-2022-03.tsv.gz,Bipin_Rawat,9821,52227,72,62120,18884
hdfs://spark-nn.eemcs.utwente.nl/user/s1934538/clickstream/clickstream-enwiki-2022-03.tsv.gz,Jimmy_Buffett,10069,54642,702,65413,23863
hdfs://spark-nn.eemcs.utwente.nl/user/s1934538/clickstream/clickstream-enwiki-2022-03.tsv.gz,Indian_Premier_League,41256,352092,670,394018,242190
hdfs://spark-nn.eemcs.utwente.nl/user/s1934538/clickstream/clickstream-enwiki-2022-03.tsv.gz,Doctor_Strange_in_the_Multiverse_of_Madness,166572,338457,13388,518417,272155
hdfs://spark-nn.eemcs.utwente.nl/user/s1934538/clickstream/clickstream-enwiki-2022-03.tsv.gz,Rami_Malek,94878,195481,1053,291412,119069
hdfs://spark-nn.eemcs.utwente.nl/user/s1934538/clickstream/clickstream-enwiki-2022-03.tsv.gz,Vikram_(2022_film),34636,56056,3763,94455,55328
hdfs://spark-nn.eemcs.utwente.nl/user/s1934538/clickstream/clickstream-enwiki-2022-03.tsv.gz,Vivek_Ramaswamy,387,7809,54,8250,1320
hdfs://spark-nn.eemcs.utwente.nl/user/s1934538/clickstream/clickstream-enwiki-2022-03.tsv.gz,Croatia,79586,238200,4342,322128,100833
hdfs://spark-nn.eemcs.utwente.nl/user/s1934538/clickstream/clickstream-enwiki-2022-03.tsv.gz,Notre-Dame_de_Paris,12147,90837,950,103934,20199
hdfs://spark-nn.eemcs.utwente.nl/user/s1934538/clickstream/clickstream-enwiki-2022-03.tsv.gz,The_Kashmir_Files,185842,4551910,21741,4759493,1822010
hdfs://spark-nn.eemcs.utwente.nl/user/s1934538/clickstream/clickstream-enwiki-2022-03.tsv.gz,Glass_(2019_film),49288,89403,1062,139753,50732
hdfs://spark-nn.eemcs.utwente.nl/user/s1934538/clickstream/clickstream-enwiki-2022-03.tsv.gz,"Meghan,_Duchess_of_Sussex",68998,176051,1016,246065,134835
hdfs://spark-nn.eemcs.utwente.nl/user/s1934538/clickstream/clickstream-enwiki-2022-03.tsv.gz,The_Weeknd,70213,203967,2681,276861,131884
hdfs://spark-nn.eemcs.utwente.nl/user/s1934538/clickstream/clickstream-enwiki-2022-03.tsv.gz,Jeffrey_Dahmer,24241,254630,3135,282006,120608
hdfs://spark-nn.eemcs.utwente.nl/user/s1934538/clickstream/clickstream-enwiki-2022-03.tsv.gz,Naya_Rivera,54902,85476,461,140839,56540
hdfs://spark-nn.eemcs.utwente.nl/user/s1934538/clickstream/clickstream-enwiki-2022-03.tsv.gz,Rishi_Sunak,16019,192998,2917,211934,114684
hdfs://spark-nn.eemcs.utwente.nl/user/s1934538/clickstream/clickstream-enwiki-2022-03.tsv.gz,The_Umbrella_Academy_(TV_series),44085,134869,3369,182323,107264
hdfs://spark-nn.eemcs.utwente.nl/user/s1934538/clickstream/clickstream-enwiki-2022-03.tsv.gz,The_Batman_(film),777123,6005034,171472,6953629,4457757
hdfs://spark-nn.eemcs.utwente.nl/user/s1934538/clickstream/clickstream-enwiki-2022-03.tsv.gz,Antifa_(United_States),8673,51771,120,60564,10649
hdfs://spark-nn.eemcs.utwente.nl/user/s1934538/clickstream/clickstream-enwiki-2022-03.tsv.gz,1234,41,1386,29,1456,199
hdfs://spark-nn.eemcs.utwente.nl/user/s1934538/clickstream/clickstream-enwiki-2022-03.tsv.gz,Simple_Mail_Transfer_Protocol,3236,37988,153,41377,3754
hdfs://spark-nn.eemcs.utwente.nl/user/s1934538/clickstream/clickstream-enwiki-2022-03.tsv.gz,Ray_Liotta,29236,45564,439,75239,28527
hdfs://spark-nn.eemcs.utwente.nl/user/s1934538/clickstream/clickstream-enwiki-2022-03.tsv.gz,Adipurush,98379,55665,212,154256,125499
hdfs://spark-nn.eemcs.utwente.nl/user/s1934538/clickstream/clickstream-enwiki-2022-03.tsv.gz,Jeffrey_Epstein,36204,204515,1698,242417,108338
hdfs://spark-nn.eemcs.utwente.nl/user/s1934538/clickstream/clickstream-enwiki-2022-03.tsv.gz,Deadpool_2,86173,63115,1918,151206,98624
hdfs://spark-nn.eemcs.utwente.nl/user/s1934538/clickstream/clickstream-enwiki-2022-03.tsv.gz,IPv4,10832,40652,168,51652,9860
hdfs://spark-nn.eemcs.utwente.nl/user/s1934538/clickstream/clickstream-enwiki-2022-03.tsv.gz,Stan_Lee,46031,158782,1151,205964,49379
hdfs://spark-nn.eemcs.utwente.nl/user/s1934538/clickstream/clickstream-enwiki-2022-03.tsv.gz,Stephen_Hawking,27013,309964,3054,340031,124122
hdfs://spark-nn.eemcs.utwente.nl/user/s1934538/clickstream/clickstream-enwiki-2022-03.tsv.gz,Article_370_of_the_Constitution_of_India,31415,539107,494,571016,22993
hdfs://spark-nn.eemcs.utwente.nl/user/s1934538/clickstream/clickstream-enwiki-2022-03.tsv.gz,Tom_Brady,67532,625003,8520,701055,213638
hdfs://spark-nn.eemcs.utwente.nl/user/s1934538/clickstream/clickstream-enwiki-2022-03.tsv.gz,Once_Upon_a_Time_in_Hollywood,103019,245227,5774,354020,397900
hdfs://spark-nn.eemcs.utwente.nl/user/s1934538/clickstream/clickstream-enwiki-2022-03.tsv.gz,The_Shape_of_Water,29735,60752,778,91265,40049
hdfs://spark-nn.eemcs.utwente.nl/user/s1934538/clickstream/clickstream-enwiki-2022-03.tsv.gz,2023_Cricket_World_Cup,32627,61455,107,94189,28496
hdfs://spark-nn.eemcs.utwente.nl/user/s1934538/clickstream/clickstream-enwiki-2022-03.tsv.gz,Eddie_Van_Halen,39794,77770,1026,118590,48014
hdfs://spark-nn.eemcs.utwente.nl/user/s1934538/clickstream/clickstream-enwiki-2022-03.tsv.gz,Gaza_Strip,21303,32479,327,54109,21075
hdfs://spark-nn.eemcs.utwente.nl/user/s1934538/clickstream/clickstream-enwiki-2022-03.tsv.gz,2018_Winter_Olympics,15056,14467,163,29686,18720
hdfs://spark-nn.eemcs.utwente.nl/user/s1934538/clickstream/clickstream-enwiki-2022-03.tsv.gz,COVID-19_pandemic,223191,283159,2363,508713,199288
hdfs://spark-nn.eemcs.utwente.nl/user/s1934538/clickstream/clickstream-enwiki-2022-03.tsv.gz,Manti_Te'o,3647,24485,174,28306,3518
hdfs://spark-nn.eemcs.utwente.nl/user/s1934538/clickstream/clickstream-enwiki-2022-03.tsv.gz,Atal_Bihari_Vajpayee,46644,75039,138,121821,43465
hdfs://spark-nn.eemcs.utwente.nl/user/s1934538/clickstream/clickstream-enwiki-2022-03.tsv.gz,Royal_Rumble_(2018),7258,4680,113,12051,8907
hdfs://spark-nn.eemcs.utwente.nl/user/s1934538/clickstream/clickstream-enwiki-2022-03.tsv.gz,Naomi_Osaka,24137,150476,1158,175771,46289
hdfs://spark-nn.eemcs.utwente.nl/user/s1934538/clickstream/clickstream-enwiki-2022-03.tsv.gz,Sushant_Singh_Rajput,18914,85080,249,104243,46827
hdfs://spark-nn.eemcs.utwente.nl/user/s1934538/clickstream/clickstream-enwiki-2022-03.tsv.gz,Cecil_Hotel_(Los_Angeles),7238,83784,192,91214,21577
hdfs://spark-nn.eemcs.utwente.nl/user/s1934538/clickstream/clickstream-enwiki-2022-03.tsv.gz,Vladimir_Putin,954634,9508903,93897,10557434,4143161
hdfs://spark-nn.eemcs.utwente.nl/user/s1934538/clickstream/clickstream-enwiki-2022-03.tsv.gz,Chernobyl_disaster,139904,1212466,14692,1367062,482950
hdfs://spark-nn.eemcs.utwente.nl/user/s1934538/clickstream/clickstream-enwiki-2022-03.tsv.gz,Tonya_Harding,21607,84993,527,107127,28595
hdfs://spark-nn.eemcs.utwente.nl/user/s1934538/clickstream/clickstream-enwiki-2022-03.tsv.gz,Index_(statistics),139,1528,23,1690,160
hdfs://spark-nn.eemcs.utwente.nl/user/s1934538/clickstream/clickstream-enwiki-2022-03.tsv.gz,Key_frame,595,5319,15,5929,375
hdfs://spark-nn.eemcs.utwente.nl/user/s1934538/clickstream/clickstream-enwiki-2022-03.tsv.gz,Valentine's_Day,5462,46461,363,52286,5047
hdfs://spark-nn.eemcs.utwente.nl/user/s1934538/clickstream/clickstream-enwiki-2022-03.tsv.gz,Dennis_Nilsen,7503,56475,322,64300,16863
hdfs://spark-nn.eemcs.utwente.nl/user/s1934538/clickstream/clickstream-enwiki-2022-03.tsv.gz,2022_Russian_invasion_of_Ukraine,5233086,8561004,48552,13842642,7483291
hdfs://spark-nn.eemcs.utwente.nl/user/s1934538/clickstream/clickstream-enwiki-2022-03.tsv.gz,Qasem_Soleimani,20795,36293,179,57267,30133
hdfs://spark-nn.eemcs.utwente.nl/user/s1934538/clickstream/clickstream-enwiki-2022-03.tsv.gz,The_Nun_(2018_film),14048,38269,311,52628,30147
hdfs://spark-nn.eemcs.utwente.nl/user/s1934538/clickstream/clickstream-enwiki-2022-03.tsv.gz,NATO,346174,2180268,44930,2571372,833672
hdfs://spark-nn.eemcs.utwente.nl/user/s1934538/clickstream/clickstream-enwiki-2022-03.tsv.gz,Donald_Trump,237455,491748,8410,737613,428166
hdfs://spark-nn.eemcs.utwente.nl/user/s1934538/clickstream/clickstream-enwiki-2022-03.tsv.gz,QAnon,36635,212411,1336,250382,62148
hdfs://spark-nn.eemcs.utwente.nl/user/s1934538/clickstream/clickstream-enwiki-2022-03.tsv.gz,Juice_Wrld,40589,233971,3074,277634,116437
hdfs://spark-nn.eemcs.utwente.nl/user/s1934538/clickstream/clickstream-enwiki-2022-03.tsv.gz,Shakira,21877,162482,1879,186238,86830
hdfs://spark-nn.eemcs.utwente.nl/user/s1934538/clickstream/clickstream-enwiki-2022-03.tsv.gz,The_Witcher_(TV_series),30270,230606,5203,266079,152072
hdfs://spark-nn.eemcs.utwente.nl/user/s1934538/clickstream/clickstream-enwiki-2022-03.tsv.gz,Darth_Vader,35011,76234,1030,112275,66556
hdfs://spark-nn.eemcs.utwente.nl/user/s1934538/clickstream/clickstream-enwiki-2022-03.tsv.gz,Stranger_Things,69883,208203,5369,283455,220376
hdfs://spark-nn.eemcs.utwente.nl/user/s1934538/clickstream/clickstream-enwiki-2022-03.tsv.gz,Hamilton_(musical),40287,188336,1842,230465,146854
hdfs://spark-nn.eemcs.utwente.nl/user/s1934538/clickstream/clickstream-enwiki-2022-03.tsv.gz,List_of_James_Bond_films,69882,402218,1425,473525,284445
hdfs://spark-nn.eemcs.utwente.nl/user/s1934538/clickstream/clickstream-enwiki-2022-03.tsv.gz,United_States_Electoral_College,10854,33394,89,44337,6825
hdfs://spark-nn.eemcs.utwente.nl/user/s1934538/clickstream/clickstream-enwiki-2022-03.tsv.gz,Brie_Larson,52838,104654,960,158452,63984
hdfs://spark-nn.eemcs.utwente.nl/user/s1934538/clickstream/clickstream-enwiki-2022-03.tsv.gz,XXXTentacion,88941,654315,7026,750282,137200
hdfs://spark-nn.eemcs.utwente.nl/user/s1934538/clickstream/clickstream-enwiki-2023-09.tsv.gz,Antifa_(United_States),25764,56639,273,82676,15111
hdfs://spark-nn.eemcs.utwente.nl/user/s1934538/clickstream/clickstream-enwiki-2023-09.tsv.gz,Elon_Musk,165578,1423233,14393,1603204,950636
hdfs://spark-nn.eemcs.utwente.nl/user/s1934538/clickstream/clickstream-enwiki-2023-09.tsv.gz,War_(2019_film),78458,54471,489,133418,33286
hdfs://spark-nn.eemcs.utwente.nl/user/s1934538/clickstream/clickstream-enwiki-2023-09.tsv.gz,Top_Gun:_Maverick,64755,137297,2173,204225,135611
hdfs://spark-nn.eemcs.utwente.nl/user/s1934538/clickstream/clickstream-enwiki-2023-09.tsv.gz,Avengers:_Infinity_War,32651,55911,611,89173,38898
hdfs://spark-nn.eemcs.utwente.nl/user/s1934538/clickstream/clickstream-enwiki-2023-09.tsv.gz,Gadar_2,258317,1672425,9778,1940520,610320
hdfs://spark-nn.eemcs.utwente.nl/user/s1934538/clickstream/clickstream-enwiki-2023-09.tsv.gz,Sushant_Singh_Rajput,17166,92463,96,109725,48637
hdfs://spark-nn.eemcs.utwente.nl/user/s1934538/clickstream/clickstream-enwiki-2023-09.tsv.gz,The_Umbrella_Academy_(TV_series),19656,64429,1231,85316,50714
hdfs://spark-nn.eemcs.utwente.nl/user/s1934538/clickstream/clickstream-enwiki-2023-09.tsv.gz,Michael_Bloomberg,34470,50852,289,85611,41107
hdfs://spark-nn.eemcs.utwente.nl/user/s1934538/clickstream/clickstream-enwiki-2023-09.tsv.gz,Tunnel,3668,8388,88,12144,3067
hdfs://spark-nn.eemcs.utwente.nl/user/s1934538/clickstream/clickstream-enwiki-2023-09.tsv.gz,Ruth_Bader_Ginsburg,16616,109830,513,126959,39043
hdfs://spark-nn.eemcs.utwente.nl/user/s1934538/clickstream/clickstream-enwiki-2023-09.tsv.gz,George_VI,234188,81157,541,315886,226787
hdfs://spark-nn.eemcs.utwente.nl/user/s1934538/clickstream/clickstream-enwiki-2023-09.tsv.gz,Spider-Man:_Across_the_Spider-Verse,134279,390523,7570,532372,311288
hdfs://spark-nn.eemcs.utwente.nl/user/s1934538/clickstream/clickstream-enwiki-2023-09.tsv.gz,Asia_Cup,31426,6825351,1863,6858640,323645
hdfs://spark-nn.eemcs.utwente.nl/user/s1934538/clickstream/clickstream-enwiki-2023-09.tsv.gz,Adele,32036,243622,2008,277666,101857
hdfs://spark-nn.eemcs.utwente.nl/user/s1934538/clickstream/clickstream-enwiki-2023-09.tsv.gz,Us_(2019_film),23153,71427,343,94923,30427
hdfs://spark-nn.eemcs.utwente.nl/user/s1934538/clickstream/clickstream-enwiki-2023-09.tsv.gz,Media,22,1890,195,2107,846
hdfs://spark-nn.eemcs.utwente.nl/user/s1934538/clickstream/clickstream-enwiki-2023-09.tsv.gz,Aaron_Hernandez,23020,186721,2213,211954,79484
hdfs://spark-nn.eemcs.utwente.nl/user/s1934538/clickstream/clickstream-enwiki-2023-09.tsv.gz,United_States_Senate,76395,79775,2549,158719,73499
hdfs://spark-nn.eemcs.utwente.nl/user/s1934538/clickstream/clickstream-enwiki-2023-09.tsv.gz,Ray_Liotta,58637,226326,1682,286645,107696
hdfs://spark-nn.eemcs.utwente.nl/user/s1934538/clickstream/clickstream-enwiki-2023-09.tsv.gz,2023_Indian_Premier_League,6016,52587,36,58639,8752
hdfs://spark-nn.eemcs.utwente.nl/user/s1934538/clickstream/clickstream-enwiki-2023-09.tsv.gz,Amber_Heard,99390,338891,2188,440469,203216
hdfs://spark-nn.eemcs.utwente.nl/user/s1934538/clickstream/clickstream-enwiki-2023-09.tsv.gz,Chernobyl_(miniseries),18200,53907,1057,73164,83170
hdfs://spark-nn.eemcs.utwente.nl/user/s1934538/clickstream/clickstream-enwiki-2023-09.tsv.gz,Afghanistan,114971,241070,4046,360087,266045
hdfs://spark-nn.eemcs.utwente.nl/user/s1934538/clickstream/clickstream-enwiki-2023-09.tsv.gz,Tom_Brady,94581,618993,5318,718892,301261
hdfs://spark-nn.eemcs.utwente.nl/user/s1934538/clickstream/clickstream-enwiki-2023-09.tsv.gz,The_Shape_of_Water,19271,44068,353,63692,27327
hdfs://spark-nn.eemcs.utwente.nl/user/s1934538/clickstream/clickstream-enwiki-2023-09.tsv.gz,Everything_Everywhere_All_at_Once,58542,160008,1877,220427,94215
hdfs://spark-nn.eemcs.utwente.nl/user/s1934538/clickstream/clickstream-enwiki-2023-09.tsv.gz,List_of_awards_and_nominations_received_by_Meryl_Streep,7464,8257,167,15888,6974
hdfs://spark-nn.eemcs.utwente.nl/user/s1934538/clickstream/clickstream-enwiki-2023-09.tsv.gz,Donald_Trump,217420,639944,8267,865631,447001
hdfs://spark-nn.eemcs.utwente.nl/user/s1934538/clickstream/clickstream-enwiki-2023-09.tsv.gz,1917_(2019_film),15229,43082,671,58982,28176
hdfs://spark-nn.eemcs.utwente.nl/user/s1934538/clickstream/clickstream-enwiki-2023-09.tsv.gz,The_Matrix_Resurrections,48964,99568,1379,149911,74446
hdfs://spark-nn.eemcs.utwente.nl/user/s1934538/clickstream/clickstream-enwiki-2023-09.tsv.gz,Bipin_Rawat,6603,18373,12,24988,9249
hdfs://spark-nn.eemcs.utwente.nl/user/s1934538/clickstream/clickstream-enwiki-2023-09.tsv.gz,Ponniyin_Selvan:_I,40274,57179,135,97588,43491
hdfs://spark-nn.eemcs.utwente.nl/user/s1934538/clickstream/clickstream-enwiki-2023-09.tsv.gz,Shang-Chi_and_the_Legend_of_the_Ten_Rings,30873,68259,766,99898,50474
hdfs://spark-nn.eemcs.utwente.nl/user/s1934538/clickstream/clickstream-enwiki-2023-09.tsv.gz,Deaths_in_2023,1381055,2514292,15343,3910690,2383040
hdfs://spark-nn.eemcs.utwente.nl/user/s1934538/clickstream/clickstream-enwiki-2023-09.tsv.gz,Stan_Lee,29024,73351,2016,104391,34299
hdfs://spark-nn.eemcs.utwente.nl/user/s1934538/clickstream/clickstream-enwiki-2023-09.tsv.gz,Tiger_3,188024,354957,3716,546697,289132
hdfs://spark-nn.eemcs.utwente.nl/user/s1934538/clickstream/clickstream-enwiki-2023-09.tsv.gz,Cameron_Boyce,21715,147188,377,169280,43086
hdfs://spark-nn.eemcs.utwente.nl/user/s1934538/clickstream/clickstream-enwiki-2023-09.tsv.gz,Godzilla_vs._Kong,44348,83383,881,128612,75017
hdfs://spark-nn.eemcs.utwente.nl/user/s1934538/clickstream/clickstream-enwiki-2023-09.tsv.gz,Article_370_of_the_Constitution_of_India,3633,71948,47,75628,3677
hdfs://spark-nn.eemcs.utwente.nl/user/s1934538/clickstream/clickstream-enwiki-2023-09.tsv.gz,Jimmy_Buffett,129361,3488344,38936,3656641,1328751
hdfs://spark-nn.eemcs.utwente.nl/user/s1934538/clickstream/clickstream-enwiki-2023-09.tsv.gz,The_Witcher_(TV_series),28307,261621,4702,294630,134215
hdfs://spark-nn.eemcs.utwente.nl/user/s1934538/clickstream/clickstream-enwiki-2023-09.tsv.gz,Donald_Glover,44044,130839,1058,175941,75462
hdfs://spark-nn.eemcs.utwente.nl/user/s1934538/clickstream/clickstream-enwiki-2023-09.tsv.gz,Luke_Perry,58622,159989,849,219460,88486
hdfs://spark-nn.eemcs.utwente.nl/user/s1934538/clickstream/clickstream-enwiki-2023-09.tsv.gz,Sylvester_Stallone,102091,488332,3606,594029,450165
hdfs://spark-nn.eemcs.utwente.nl/user/s1934538/clickstream/clickstream-enwiki-2023-09.tsv.gz,Vivek_Ramaswamy,35057,1114194,4738,1153989,320081
hdfs://spark-nn.eemcs.utwente.nl/user/s1934538/clickstream/clickstream-enwiki-2023-09.tsv.gz,Richard_Jewell,8622,26444,199,35265,13781
hdfs://spark-nn.eemcs.utwente.nl/user/s1934538/clickstream/clickstream-enwiki-2023-09.tsv.gz,Richard_Ramirez,15476,150475,1090,167041,50217
hdfs://spark-nn.eemcs.utwente.nl/user/s1934538/clickstream/clickstream-enwiki-2023-09.tsv.gz,September_11_attacks,318749,1642843,49915,2011507,1401498
hdfs://spark-nn.eemcs.utwente.nl/user/s1934538/clickstream/clickstream-enwiki-2023-09.tsv.gz,Bonnie_and_Clyde,19855,182777,1032,203664,49014
hdfs://spark-nn.eemcs.utwente.nl/user/s1934538/clickstream/clickstream-enwiki-2023-09.tsv.gz,Stranger_Things_(season_3),8838,19360,92,28290,14344
hdfs://spark-nn.eemcs.utwente.nl/user/s1934538/clickstream/clickstream-enwiki-2023-09.tsv.gz,Ghislaine_Maxwell,54952,87027,424,142403,64007
hdfs://spark-nn.eemcs.utwente.nl/user/s1934538/clickstream/clickstream-enwiki-2023-09.tsv.gz,Roe_v._Wade,12348,79809,450,92607,30084
hdfs://spark-nn.eemcs.utwente.nl/user/s1934538/clickstream/clickstream-enwiki-2023-09.tsv.gz,QAnon,63077,112746,723,176546,57574
hdfs://spark-nn.eemcs.utwente.nl/user/s1934538/clickstream/clickstream-enwiki-2023-09.tsv.gz,Laal_Singh_Chaddha,36140,54462,184,90786,29075
hdfs://spark-nn.eemcs.utwente.nl/user/s1934538/clickstream/clickstream-enwiki-2023-09.tsv.gz,Star_Wars:_The_Rise_of_Skywalker,71912,49510,899,122321,66333
hdfs://spark-nn.eemcs.utwente.nl/user/s1934538/clickstream/clickstream-enwiki-2023-09.tsv.gz,Manti_Te'o,6044,88868,357,95269,11959
hdfs://spark-nn.eemcs.utwente.nl/user/s1934538/clickstream/clickstream-enwiki-2023-09.tsv.gz,Spanish_flu,16926,51025,401,68352,17303
hdfs://spark-nn.eemcs.utwente.nl/user/s1934538/clickstream/clickstream-enwiki-2023-09.tsv.gz,Anne_Heche,41702,128172,817,170691,64639
hdfs://spark-nn.eemcs.utwente.nl/user/s1934538/clickstream/clickstream-enwiki-2023-09.tsv.gz,Rishi_Sunak,159589,632512,2439,794540,358148
hdfs://spark-nn.eemcs.utwente.nl/user/s1934538/clickstream/clickstream-enwiki-2023-09.tsv.gz,Kelly_Preston,89189,93462,275,182926,55119
hdfs://spark-nn.eemcs.utwente.nl/user/s1934538/clickstream/clickstream-enwiki-2023-09.tsv.gz,List_of_Marvel_Cinematic_Universe_films,99023,371898,1058,471979,289009
hdfs://spark-nn.eemcs.utwente.nl/user/s1934538/clickstream/clickstream-enwiki-2023-09.tsv.gz,List_of_FIFA_World_Cup_finals,3062,62043,50,65155,16318
hdfs://spark-nn.eemcs.utwente.nl/user/s1934538/clickstream/clickstream-enwiki-2023-09.tsv.gz,Murder_of_Dee_Dee_Blanchard,14778,217915,826,233519,53815
hdfs://spark-nn.eemcs.utwente.nl/user/s1934538/clickstream/clickstream-enwiki-2023-09.tsv.gz,Rami_Malek,66839,215254,1238,283331,115856
hdfs://spark-nn.eemcs.utwente.nl/user/s1934538/clickstream/clickstream-enwiki-2023-09.tsv.gz,Mission:_Impossible_–_Dead_Reckoning_Part_One,147370,428410,10660,586440,218061
hdfs://spark-nn.eemcs.utwente.nl/user/s1934538/clickstream/clickstream-enwiki-2023-09.tsv.gz,Brahmāstra:_Part_One_–_Shiva,56259,101097,536,157892,37947
hdfs://spark-nn.eemcs.utwente.nl/user/s1934538/clickstream/clickstream-enwiki-2023-09.tsv.gz,A_Star_Is_Born_(2018_film),20402,59841,381,80624,36950
hdfs://spark-nn.eemcs.utwente.nl/user/s1934538/clickstream/clickstream-enwiki-2023-09.tsv.gz,Adipurush,78092,278042,961,357095,86792
hdfs://spark-nn.eemcs.utwente.nl/user/s1934538/clickstream/clickstream-enwiki-2023-09.tsv.gz,Betty_White,41889,99431,849,142169,37410
hdfs://spark-nn.eemcs.utwente.nl/user/s1934538/clickstream/clickstream-enwiki-2023-09.tsv.gz,"Meghan,_Duchess_of_Sussex",80317,382603,4001,466921,233441
hdfs://spark-nn.eemcs.utwente.nl/user/s1934538/clickstream/clickstream-enwiki-2023-09.tsv.gz,Central_Park_jogger_case,10481,46758,181,57420,17095
hdfs://spark-nn.eemcs.utwente.nl/user/s1934538/clickstream/clickstream-enwiki-2023-09.tsv.gz,HTTP_cookie,2054,422147,161,424362,15652
hdfs://spark-nn.eemcs.utwente.nl/user/s1934538/clickstream/clickstream-enwiki-2023-09.tsv.gz,The_Queen's_Gambit_(miniseries),14143,106002,673,120818,55913
hdfs://spark-nn.eemcs.utwente.nl/user/s1934538/clickstream/clickstream-enwiki-2023-09.tsv.gz,Kylian_Mbappé,51531,348966,2446,402943,69749
hdfs://spark-nn.eemcs.utwente.nl/user/s1934538/clickstream/clickstream-enwiki-2023-09.tsv.gz,Glass_(2019_film),36991,45159,269,82419,27390
hdfs://spark-nn.eemcs.utwente.nl/user/s1934538/clickstream/clickstream-enwiki-2023-09.tsv.gz,Kobe_Bryant,54404,381049,2951,438404,117602
hdfs://spark-nn.eemcs.utwente.nl/user/s1934538/clickstream/clickstream-enwiki-2023-09.tsv.gz,Kantara_(film),24449,96034,479,120962,42011
hdfs://spark-nn.eemcs.utwente.nl/user/s1934538/clickstream/clickstream-enwiki-2023-09.tsv.gz,2020_United_States_presidential_election,143518,171225,3760,318503,319339
hdfs://spark-nn.eemcs.utwente.nl/user/s1934538/clickstream/clickstream-enwiki-2023-09.tsv.gz,The_Last_of_Us_(TV_series),44578,257713,3694,305985,112219
hdfs://spark-nn.eemcs.utwente.nl/user/s1934538/clickstream/clickstream-enwiki-2023-09.tsv.gz,WandaVision,15348,34504,537,50389,23094
hdfs://spark-nn.eemcs.utwente.nl/user/s1934538/clickstream/clickstream-enwiki-2023-09.tsv.gz,Fantastic_Beasts:_The_Crimes_of_Grindelwald,33494,33344,288,67126,35365
hdfs://spark-nn.eemcs.utwente.nl/user/s1934538/clickstream/clickstream-enwiki-2023-09.tsv.gz,Joe_Biden,216755,666191,10250,893196,413961
hdfs://spark-nn.eemcs.utwente.nl/user/s1934538/clickstream/clickstream-enwiki-2023-09.tsv.gz,Bird_Box_(film),13030,55321,447,68798,28384
hdfs://spark-nn.eemcs.utwente.nl/user/s1934538/clickstream/clickstream-enwiki-2023-09.tsv.gz,Game_of_Thrones_(season_8),12384,50245,779,63408,18426
hdfs://spark-nn.eemcs.utwente.nl/user/s1934538/clickstream/clickstream-enwiki-2023-09.tsv.gz,Microsoft_Office,5241,376165,453,381859,16557
hdfs://spark-nn.eemcs.utwente.nl/user/s1934538/clickstream/clickstream-enwiki-2023-09.tsv.gz,Christopher_Scarver,61571,38562,23,100156,35725
hdfs://spark-nn.eemcs.utwente.nl/user/s1934538/clickstream/clickstream-enwiki-2023-09.tsv.gz,ICC_Men's_T20_World_Cup,34861,195073,1625,231559,73983
hdfs://spark-nn.eemcs.utwente.nl/user/s1934538/clickstream/clickstream-enwiki-2023-09.tsv.gz,Carlos_Alcaraz,89943,587030,8721,685694,164987
hdfs://spark-nn.eemcs.utwente.nl/user/s1934538/clickstream/clickstream-enwiki-2023-09.tsv.gz,Coronavirus,5493,31125,454,37072,10095
hdfs://spark-nn.eemcs.utwente.nl/user/s1934538/clickstream/clickstream-enwiki-2023-09.tsv.gz,Animal_(2023_film),76218,234989,291,311498,204572
hdfs://spark-nn.eemcs.utwente.nl/user/s1934538/clickstream/clickstream-enwiki-2023-09.tsv.gz,Cricket_World_Cup,66200,457552,1547,525299,169298
hdfs://spark-nn.eemcs.utwente.nl/user/s1934538/clickstream/clickstream-enwiki-2023-09.tsv.gz,Mortal_Kombat_(2021_film),37208,102684,1087,140979,135902
hdfs://spark-nn.eemcs.utwente.nl/user/s1934538/clickstream/clickstream-enwiki-2023-09.tsv.gz,Freddie_Mercury,83083,512016,4061,599160,227120
hdfs://spark-nn.eemcs.utwente.nl/user/s1934538/clickstream/clickstream-enwiki-2023-09.tsv.gz,1234,50,3391,20,3461,239
hdfs://spark-nn.eemcs.utwente.nl/user/s1934538/clickstream/clickstream-enwiki-2023-09.tsv.gz,Chernobyl_disaster,34905,219915,2128,256948,112901
hdfs://spark-nn.eemcs.utwente.nl/user/s1934538/clickstream/clickstream-enwiki-2023-09.tsv.gz,Brie_Larson,54842,141803,1015,197660,79877
hdfs://spark-nn.eemcs.utwente.nl/user/s1934538/clickstream/clickstream-enwiki-2023-09.tsv.gz,Darth_Vader,53887,86776,911,141574,97999
hdfs://spark-nn.eemcs.utwente.nl/user/s1934538/clickstream/clickstream-enwiki-2023-09.tsv.gz,Gaza_Strip,17297,29128,836,47261,21103
hdfs://spark-nn.eemcs.utwente.nl/user/s1934538/clickstream/clickstream-enwiki-2023-09.tsv.gz,The_Irishman,48465,77297,1023,126785,102348
hdfs://spark-nn.eemcs.utwente.nl/user/s1934538/clickstream/clickstream-enwiki-2023-09.tsv.gz,Michael_Jordan,74222,392615,3402,470239,145319
hdfs://spark-nn.eemcs.utwente.nl/user/s1934538/clickstream/clickstream-enwiki-2023-09.tsv.gz,Mulan_(2020_film),16774,46823,455,64052,34026
hdfs://spark-nn.eemcs.utwente.nl/user/s1934538/clickstream/clickstream-enwiki-2023-09.tsv.gz,Greta_Thunberg,10387,119900,855,131142,30325
hdfs://spark-nn.eemcs.utwente.nl/user/s1934538/clickstream/clickstream-enwiki-2023-09.tsv.gz,House_of_the_Dragon,47113,219355,4026,270494,149304
hdfs://spark-nn.eemcs.utwente.nl/user/s1934538/clickstream/clickstream-enwiki-2023-09.tsv.gz,WrestleMania_34,15008,7988,52,23048,15959
hdfs://spark-nn.eemcs.utwente.nl/user/s1934538/clickstream/clickstream-enwiki-2023-09.tsv.gz,J._Robert_Oppenheimer,201803,903504,7491,1112798,632514
hdfs://spark-nn.eemcs.utwente.nl/user/s1934538/clickstream/clickstream-enwiki-2023-09.tsv.gz,Chadwick_Boseman,27745,112552,530,140827,40051
hdfs://spark-nn.eemcs.utwente.nl/user/s1934538/clickstream/clickstream-enwiki-2023-09.tsv.gz,UEFA_Euro_2020,53870,44104,488,98462,61930
hdfs://spark-nn.eemcs.utwente.nl/user/s1934538/clickstream/clickstream-enwiki-2023-09.tsv.gz,2018_FIFA_World_Cup,61179,45551,511,107241,75858
hdfs://spark-nn.eemcs.utwente.nl/user/s1934538/clickstream/clickstream-enwiki-2023-09.tsv.gz,Kenosha_unrest_shooting,8270,19190,62,27522,7473
hdfs://spark-nn.eemcs.utwente.nl/user/s1934538/clickstream/clickstream-enwiki-2023-09.tsv.gz,Thor:_Love_and_Thunder,43343,74545,1017,118905,49486
hdfs://spark-nn.eemcs.utwente.nl/user/s1934538/clickstream/clickstream-enwiki-2023-09.tsv.gz,Ant-Man_and_the_Wasp:_Quantumania,43156,78537,1734,123427,68848
hdfs://spark-nn.eemcs.utwente.nl/user/s1934538/clickstream/clickstream-enwiki-2023-09.tsv.gz,Anna_Sorokin,11902,113078,374,125354,44313
hdfs://spark-nn.eemcs.utwente.nl/user/s1934538/clickstream/clickstream-enwiki-2023-09.tsv.gz,Avatar:_The_Way_of_Water,68301,191813,2981,263095,124544
hdfs://spark-nn.eemcs.utwente.nl/user/s1934538/clickstream/clickstream-enwiki-2023-09.tsv.gz,Stranger_Things_(season_4),18958,64753,556,84267,43665
hdfs://spark-nn.eemcs.utwente.nl/user/s1934538/clickstream/clickstream-enwiki-2023-09.tsv.gz,George_H._W._Bush,186305,138445,1032,325782,204302
hdfs://spark-nn.eemcs.utwente.nl/user/s1934538/clickstream/clickstream-enwiki-2023-09.tsv.gz,Dune_(2021_film),48548,158899,3012,210459,135269
hdfs://spark-nn.eemcs.utwente.nl/user/s1934538/clickstream/clickstream-enwiki-2023-09.tsv.gz,Brett_Kavanaugh,15104,22858,142,38104,15322
hdfs://spark-nn.eemcs.utwente.nl/user/s1934538/clickstream/clickstream-enwiki-2023-09.tsv.gz,List_of_highest-grossing_films,181358,479666,6608,667632,309662
hdfs://spark-nn.eemcs.utwente.nl/user/s1934538/clickstream/clickstream-enwiki-2023-09.tsv.gz,Tina_Turner,21901,204467,1875,228243,72751
hdfs://spark-nn.eemcs.utwente.nl/user/s1934538/clickstream/clickstream-enwiki-2023-09.tsv.gz,Jailer_(2023_Tamil_film),223144,1995544,9137,2227825,973544
hdfs://spark-nn.eemcs.utwente.nl/user/s1934538/clickstream/clickstream-enwiki-2023-09.tsv.gz,Eddie_Van_Halen,43063,86920,749,130732,55965
hdfs://spark-nn.eemcs.utwente.nl/user/s1934538/clickstream/clickstream-enwiki-2023-09.tsv.gz,State_of_Palestine,55013,101397,172,156582,72920
hdfs://spark-nn.eemcs.utwente.nl/user/s1934538/clickstream/clickstream-enwiki-2023-09.tsv.gz,The_Suicide_Squad_(film),50515,76871,748,128134,67604
hdfs://spark-nn.eemcs.utwente.nl/user/s1934538/clickstream/clickstream-enwiki-2023-09.tsv.gz,Royal_Rumble_(2018),6043,3803,32,9878,7600
hdfs://spark-nn.eemcs.utwente.nl/user/s1934538/clickstream/clickstream-enwiki-2023-09.tsv.gz,Black_Panther:_Wakanda_Forever,37459,74292,1350,113101,69594
hdfs://spark-nn.eemcs.utwente.nl/user/s1934538/clickstream/clickstream-enwiki-2023-09.tsv.gz,Game_of_Thrones,70660,320595,4925,396180,209182
hdfs://spark-nn.eemcs.utwente.nl/user/s1934538/clickstream/clickstream-enwiki-2023-09.tsv.gz,Lisa_Marie_Presley,214924,179497,754,395175,226887
hdfs://spark-nn.eemcs.utwente.nl/user/s1934538/clickstream/clickstream-enwiki-2023-09.tsv.gz,Khabib_Nurmagomedov,45554,188357,1383,235294,125087
hdfs://spark-nn.eemcs.utwente.nl/user/s1934538/clickstream/clickstream-enwiki-2023-09.tsv.gz,2018_Asian_Games,115962,68699,410,185071,168124
hdfs://spark-nn.eemcs.utwente.nl/user/s1934538/clickstream/clickstream-enwiki-2023-12.tsv.gz,John_Wick:_Chapter_4,69932,170714,3829,244475,160081
hdfs://spark-nn.eemcs.utwente.nl/user/s1934538/clickstream/clickstream-enwiki-2023-12.tsv.gz,Royal_Rumble_(2018),9835,5741,80,15656,12636
hdfs://spark-nn.eemcs.utwente.nl/user/s1934538/clickstream/clickstream-enwiki-2023-12.tsv.gz,2020_Summer_Olympics,38360,47389,654,86403,63885
hdfs://spark-nn.eemcs.utwente.nl/user/s1934538/clickstream/clickstream-enwiki-2023-12.tsv.gz,Bob_Saget,32554,104513,726,137793,26621
hdfs://spark-nn.eemcs.utwente.nl/user/s1934538/clickstream/clickstream-enwiki-2023-12.tsv.gz,Puneeth_Rajkumar,24970,55217,27,80214,27487
hdfs://spark-nn.eemcs.utwente.nl/user/s1934538/clickstream/clickstream-enwiki-2023-12.tsv.gz,Sridevi,43643,126695,204,170542,81233
hdfs://spark-nn.eemcs.utwente.nl/user/s1934538/clickstream/clickstream-enwiki-2023-12.tsv.gz,Dune_(2021_film),80844,299369,4773,384986,265308
hdfs://spark-nn.eemcs.utwente.nl/user/s1934538/clickstream/clickstream-enwiki-2023-12.tsv.gz,The_Falcon_and_the_Winter_Soldier,15184,20635,267,36086,19054
hdfs://spark-nn.eemcs.utwente.nl/user/s1934538/clickstream/clickstream-enwiki-2023-12.tsv.gz,Elizabeth_II,679536,1120411,5358,1805305,1323691
hdfs://spark-nn.eemcs.utwente.nl/user/s1934538/clickstream/clickstream-enwiki-2023-12.tsv.gz,Rami_Malek,65406,162059,967,228432,88514
hdfs://spark-nn.eemcs.utwente.nl/user/s1934538/clickstream/clickstream-enwiki-2023-12.tsv.gz,It_Chapter_Two,20985,33006,256,54247,32644
hdfs://spark-nn.eemcs.utwente.nl/user/s1934538/clickstream/clickstream-enwiki-2023-12.tsv.gz,Microsoft_Office,4154,408785,471,413410,14023
hdfs://spark-nn.eemcs.utwente.nl/user/s1934538/clickstream/clickstream-enwiki-2023-12.tsv.gz,Vivek_Ramaswamy,37267,723292,3439,763998,234376
hdfs://spark-nn.eemcs.utwente.nl/user/s1934538/clickstream/clickstream-enwiki-2023-12.tsv.gz,The_Batman_(film),95961,260847,3938,360746,205911
hdfs://spark-nn.eemcs.utwente.nl/user/s1934538/clickstream/clickstream-enwiki-2023-12.tsv.gz,Cristiano_Ronaldo,132148,1112100,5663,1249911,272922
hdfs://spark-nn.eemcs.utwente.nl/user/s1934538/clickstream/clickstream-enwiki-2023-12.tsv.gz,Rishi_Sunak,125320,276208,2293,403821,199069
hdfs://spark-nn.eemcs.utwente.nl/user/s1934538/clickstream/clickstream-enwiki-2023-12.tsv.gz,Godzilla_vs._Kong,163016,250170,2219,415405,213029
hdfs://spark-nn.eemcs.utwente.nl/user/s1934538/clickstream/clickstream-enwiki-2023-12.tsv.gz,Queen_(band),46478,147871,2099,196448,186182
hdfs://spark-nn.eemcs.utwente.nl/user/s1934538/clickstream/clickstream-enwiki-2023-12.tsv.gz,Chernobyl_(miniseries),27487,68873,1024,97384,102334
hdfs://spark-nn.eemcs.utwente.nl/user/s1934538/clickstream/clickstream-enwiki-2023-12.tsv.gz,Cook's_Country,386,2922,31,3339,471
hdfs://spark-nn.eemcs.utwente.nl/user/s1934538/clickstream/clickstream-enwiki-2023-12.tsv.gz,Joaquin_Phoenix,169900,272903,2801,445604,285088
hdfs://spark-nn.eemcs.utwente.nl/user/s1934538/clickstream/clickstream-enwiki-2023-12.tsv.gz,Kate_Spade,28673,87035,433,116141,42392
hdfs://spark-nn.eemcs.utwente.nl/user/s1934538/clickstream/clickstream-enwiki-2023-12.tsv.gz,Bonnie_and_Clyde,36450,338275,1744,376469,110940
hdfs://spark-nn.eemcs.utwente.nl/user/s1934538/clickstream/clickstream-enwiki-2023-12.tsv.gz,Spanish_flu,21333,53190,586,75109,20640
hdfs://spark-nn.eemcs.utwente.nl/user/s1934538/clickstream/clickstream-enwiki-2023-12.tsv.gz,Luke_Perry,36085,113871,661,150617,56616
hdfs://spark-nn.eemcs.utwente.nl/user/s1934538/clickstream/clickstream-enwiki-2023-12.tsv.gz,Joker_(2019_film),54708,162906,1256,218870,96385
hdfs://spark-nn.eemcs.utwente.nl/user/s1934538/clickstream/clickstream-enwiki-2023-12.tsv.gz,Sidharth_Shukla,7725,51100,256,59081,11401
hdfs://spark-nn.eemcs.utwente.nl/user/s1934538/clickstream/clickstream-enwiki-2023-12.tsv.gz,Tenet_(film),64646,99487,942,165075,72644
hdfs://spark-nn.eemcs.utwente.nl/user/s1934538/clickstream/clickstream-enwiki-2023-12.tsv.gz,Meat_Loaf,26802,98457,889,126148,44790
hdfs://spark-nn.eemcs.utwente.nl/user/s1934538/clickstream/clickstream-enwiki-2023-12.tsv.gz,Olivia_Newton-John,33059,122331,1122,156512,63941
hdfs://spark-nn.eemcs.utwente.nl/user/s1934538/clickstream/clickstream-enwiki-2023-12.tsv.gz,Ukraine,73397,243417,6347,323161,149325
hdfs://spark-nn.eemcs.utwente.nl/user/s1934538/clickstream/clickstream-enwiki-2023-12.tsv.gz,Ponniyin_Selvan:_I,33678,44224,41,77943,35387
hdfs://spark-nn.eemcs.utwente.nl/user/s1934538/clickstream/clickstream-enwiki-2023-12.tsv.gz,No_Time_to_Die,106931,192277,2205,301413,164589
hdfs://spark-nn.eemcs.utwente.nl/user/s1934538/clickstream/clickstream-enwiki-2023-12.tsv.gz,Burt_Reynolds,59459,159629,1092,220180,115462
hdfs://spark-nn.eemcs.utwente.nl/user/s1934538/clickstream/clickstream-enwiki-2023-12.tsv.gz,List_of_highest-grossing_films,119988,365369,1514,486871,253744
hdfs://spark-nn.eemcs.utwente.nl/user/s1934538/clickstream/clickstream-enwiki-2023-12.tsv.gz,Israel,173175,575751,12063,760989,354262
hdfs://spark-nn.eemcs.utwente.nl/user/s1934538/clickstream/clickstream-enwiki-2023-12.tsv.gz,Asia_Cup,6939,45029,80,52048,10828
hdfs://spark-nn.eemcs.utwente.nl/user/s1934538/clickstream/clickstream-enwiki-2023-12.tsv.gz,Irrfan_Khan,29191,97043,256,126490,65802
hdfs://spark-nn.eemcs.utwente.nl/user/s1934538/clickstream/clickstream-enwiki-2023-12.tsv.gz,Pornhub,64043,5389807,12409,5466259,102421
hdfs://spark-nn.eemcs.utwente.nl/user/s1934538/clickstream/clickstream-enwiki-2023-12.tsv.gz,Chernobyl_disaster,43628,280559,2260,326447,137420
hdfs://spark-nn.eemcs.utwente.nl/user/s1934538/clickstream/clickstream-enwiki-2023-12.tsv.gz,The_Last_of_Us_(TV_series),53975,326680,3937,384592,132164
hdfs://spark-nn.eemcs.utwente.nl/user/s1934538/clickstream/clickstream-enwiki-2023-12.tsv.gz,Avicii,18629,188721,1092,208442,61264
hdfs://spark-nn.eemcs.utwente.nl/user/s1934538/clickstream/clickstream-enwiki-2023-12.tsv.gz,Joe_Biden,204163,633016,7614,844793,361229
hdfs://spark-nn.eemcs.utwente.nl/user/s1934538/clickstream/clickstream-enwiki-2023-12.tsv.gz,Death_of_Elisa_Lam,16539,52740,139,69418,21978
hdfs://spark-nn.eemcs.utwente.nl/user/s1934538/clickstream/clickstream-enwiki-2023-12.tsv.gz,Key_frame,751,6073047,29,6073827,416
hdfs://spark-nn.eemcs.utwente.nl/user/s1934538/clickstream/clickstream-enwiki-2023-12.tsv.gz,Black_Adam_(film),46306,116176,1218,163700,76940
hdfs://spark-nn.eemcs.utwente.nl/user/s1934538/clickstream/clickstream-enwiki-2023-12.tsv.gz,The_Shape_of_Water,22840,47227,385,70452,29179
hdfs://spark-nn.eemcs.utwente.nl/user/s1934538/clickstream/clickstream-enwiki-2023-12.tsv.gz,The_Flash_(film),70657,188763,4038,263458,124800
hdfs://spark-nn.eemcs.utwente.nl/user/s1934538/clickstream/clickstream-enwiki-2023-12.tsv.gz,Nipsey_Hussle,24191,65128,382,89701,28821
hdfs://spark-nn.eemcs.utwente.nl/user/s1934538/clickstream/clickstream-enwiki-2023-12.tsv.gz,Eternals_(film),55308,88533,803,144644,91750
hdfs://spark-nn.eemcs.utwente.nl/user/s1934538/clickstream/clickstream-enwiki-2023-12.tsv.gz,Critical_race_theory,11133,53651,323,65107,9410
hdfs://spark-nn.eemcs.utwente.nl/user/s1934538/clickstream/clickstream-enwiki-2023-12.tsv.gz,UEFA_Euro_2020,50030,48813,412,99255,62134
hdfs://spark-nn.eemcs.utwente.nl/user/s1934538/clickstream/clickstream-enwiki-2023-12.tsv.gz,The_Umbrella_Academy_(TV_series),20473,65840,1137,87450,54025
hdfs://spark-nn.eemcs.utwente.nl/user/s1934538/clickstream/clickstream-enwiki-2023-12.tsv.gz,Aaron_Carter,108495,247559,1952,358006,228074
hdfs://spark-nn.eemcs.utwente.nl/user/s1934538/clickstream/clickstream-enwiki-2023-12.tsv.gz,List_of_awards_and_nominations_received_by_Meryl_Streep,9400,8179,35,17614,8789
hdfs://spark-nn.eemcs.utwente.nl/user/s1934538/clickstream/clickstream-enwiki-2023-12.tsv.gz,2023_Cricket_World_Cup,34678,307837,350,342865,58682
hdfs://spark-nn.eemcs.utwente.nl/user/s1934538/clickstream/clickstream-enwiki-2023-12.tsv.gz,Sushma_Swaraj,11150,22637,23,33810,10009
hdfs://spark-nn.eemcs.utwente.nl/user/s1934538/clickstream/clickstream-enwiki-2023-12.tsv.gz,Shinzo_Abe,45342,69313,963,115618,82465
hdfs://spark-nn.eemcs.utwente.nl/user/s1934538/clickstream/clickstream-enwiki-2023-12.tsv.gz,Jenna_Ortega,100119,335484,3413,439016,182988
hdfs://spark-nn.eemcs.utwente.nl/user/s1934538/clickstream/clickstream-enwiki-2023-12.tsv.gz,George_VI,514976,201788,917,717681,538872
hdfs://spark-nn.eemcs.utwente.nl/user/s1934538/clickstream/clickstream-enwiki-2023-12.tsv.gz,Lists_of_deaths_by_year,121753,3016886,1211435,4350074,60718
hdfs://spark-nn.eemcs.utwente.nl/user/s1934538/clickstream/clickstream-enwiki-2023-12.tsv.gz,Jurassic_World_Dominion,51180,72066,819,124065,81858
hdfs://spark-nn.eemcs.utwente.nl/user/s1934538/clickstream/clickstream-enwiki-2023-12.tsv.gz,Gadar_2,74994,225514,1677,302185,90390
hdfs://spark-nn.eemcs.utwente.nl/user/s1934538/clickstream/clickstream-enwiki-2023-12.tsv.gz,21_Savage,14819,74896,416,90131,29840
hdfs://spark-nn.eemcs.utwente.nl/user/s1934538/clickstream/clickstream-enwiki-2023-12.tsv.gz,Mortal_Kombat_(2021_film),25566,60856,778,87200,74112
hdfs://spark-nn.eemcs.utwente.nl/user/s1934538/clickstream/clickstream-enwiki-2023-12.tsv.gz,Jimmy_Buffett,12719,99248,1315,113282,42514
hdfs://spark-nn.eemcs.utwente.nl/user/s1934538/clickstream/clickstream-enwiki-2023-12.tsv.gz,Fantastic_Beasts:_The_Crimes_of_Grindelwald,47972,56247,548,104767,60194
hdfs://spark-nn.eemcs.utwente.nl/user/s1934538/clickstream/clickstream-enwiki-2023-12.tsv.gz,WandaVision,17068,34148,584,51800,24826
hdfs://spark-nn.eemcs.utwente.nl/user/s1934538/clickstream/clickstream-enwiki-2023-12.tsv.gz,Grover,1425,7309,30,8764,1648
hdfs://spark-nn.eemcs.utwente.nl/user/s1934538/clickstream/clickstream-enwiki-2023-12.tsv.gz,Crazy_Rich_Asians_(film),25084,87346,740,113170,88710
hdfs://spark-nn.eemcs.utwente.nl/user/s1934538/clickstream/clickstream-enwiki-2023-12.tsv.gz,Murder_of_Dee_Dee_Blanchard,90229,3270285,9927,3370441,661378
hdfs://spark-nn.eemcs.utwente.nl/user/s1934538/clickstream/clickstream-enwiki-2023-12.tsv.gz,WrestleMania_34,16259,8617,59,24935,16729
hdfs://spark-nn.eemcs.utwente.nl/user/s1934538/clickstream/clickstream-enwiki-2023-12.tsv.gz,Shakira,19130,212526,1860,233516,94685
hdfs://spark-nn.eemcs.utwente.nl/user/s1934538/clickstream/clickstream-enwiki-2023-12.tsv.gz,Kylian_Mbappé,48062,281907,1747,331716,64356
hdfs://spark-nn.eemcs.utwente.nl/user/s1934538/clickstream/clickstream-enwiki-2023-12.tsv.gz,Aretha_Franklin,32232,247229,1164,280625,119375
hdfs://spark-nn.eemcs.utwente.nl/user/s1934538/clickstream/clickstream-enwiki-2023-12.tsv.gz,List_of_highest-grossing_Indian_films,388731,2104718,17219,2510668,1100684
hdfs://spark-nn.eemcs.utwente.nl/user/s1934538/clickstream/clickstream-enwiki-2023-12.tsv.gz,Gaza_Strip,90704,389878,3115,483697,154987
hdfs://spark-nn.eemcs.utwente.nl/user/s1934538/clickstream/clickstream-enwiki-2023-12.tsv.gz,Jimmy_Hoffa,33931,119440,729,154100,62432
hdfs://spark-nn.eemcs.utwente.nl/user/s1934538/clickstream/clickstream-enwiki-2023-12.tsv.gz,Main_Page,56592,130930445,4665596,135652633,31043244
hdfs://spark-nn.eemcs.utwente.nl/user/s1934538/clickstream/clickstream-enwiki-2023-12.tsv.gz,COVID-19_pandemic_by_country_and_territory,4643,17505,353,22501,7398
hdfs://spark-nn.eemcs.utwente.nl/user/s1934538/clickstream/clickstream-enwiki-2023-12.tsv.gz,Dennis_Nilsen,7730,43644,325,51699,14640
hdfs://spark-nn.eemcs.utwente.nl/user/s1934538/clickstream/clickstream-enwiki-2023-12.tsv.gz,Qasem_Soleimani,17534,41880,423,59837,34645
hdfs://spark-nn.eemcs.utwente.nl/user/s1934538/clickstream/clickstream-enwiki-2023-12.tsv.gz,Aquaman_(film),79995,512762,3900,596657,244857
hdfs://spark-nn.eemcs.utwente.nl/user/s1934538/clickstream/clickstream-enwiki-2023-12.tsv.gz,Priyanka_Chopra,79391,248416,363,328170,109346
hdfs://spark-nn.eemcs.utwente.nl/user/s1934538/clickstream/clickstream-enwiki-2023-12.tsv.gz,Tina_Turner,27486,392393,4335,424214,105977
hdfs://spark-nn.eemcs.utwente.nl/user/s1934538/clickstream/clickstream-enwiki-2023-12.tsv.gz,Avengers:_Infinity_War,36566,54287,552,91405,41903
hdfs://spark-nn.eemcs.utwente.nl/user/s1934538/clickstream/clickstream-enwiki-2023-12.tsv.gz,Amy_Coney_Barrett,24806,25075,164,50045,16524
hdfs://spark-nn.eemcs.utwente.nl/user/s1934538/clickstream/clickstream-enwiki-2023-12.tsv.gz,COVID-19_pandemic,76376,171493,3440,251309,84505
hdfs://spark-nn.eemcs.utwente.nl/user/s1934538/clickstream/clickstream-enwiki-2023-12.tsv.gz,2022_FIFA_World_Cup,105334,200973,2233,308540,163135
hdfs://spark-nn.eemcs.utwente.nl/user/s1934538/clickstream/clickstream-enwiki-2023-12.tsv.gz,Donald_Trump,222526,689436,7272,919234,452138
hdfs://spark-nn.eemcs.utwente.nl/user/s1934538/clickstream/clickstream-enwiki-2023-12.tsv.gz,Naya_Rivera,40044,58346,280,98670,46356
hdfs://spark-nn.eemcs.utwente.nl/user/s1934538/clickstream/clickstream-enwiki-2023-12.tsv.gz,Army_of_the_Dead,68408,54115,616,123139,58193
hdfs://spark-nn.eemcs.utwente.nl/user/s1934538/clickstream/clickstream-enwiki-2023-12.tsv.gz,Tiger_3,196421,1068411,9993,1274825,248807
hdfs://spark-nn.eemcs.utwente.nl/user/s1934538/clickstream/clickstream-enwiki-2023-12.tsv.gz,Indian_Premier_League,32056,300145,682,332883,140103
hdfs://spark-nn.eemcs.utwente.nl/user/s1934538/clickstream/clickstream-enwiki-2023-12.tsv.gz,Wonder_Woman_1984,32706,53308,855,86869,42617
hdfs://spark-nn.eemcs.utwente.nl/user/s1934538/clickstream/clickstream-enwiki-2023-12.tsv.gz,Mötley_Crüe,27408,80452,1084,108944,127581
hdfs://spark-nn.eemcs.utwente.nl/user/s1934538/clickstream/clickstream-enwiki-2023-12.tsv.gz,Johnny_Depp,140195,363704,3197,507096,317376
hdfs://spark-nn.eemcs.utwente.nl/user/s1934538/clickstream/clickstream-enwiki-2023-12.tsv.gz,Amber_Heard,190113,253722,1355,445190,204488
hdfs://spark-nn.eemcs.utwente.nl/user/s1934538/clickstream/clickstream-enwiki-2023-12.tsv.gz,Wikipedia,243580,997213,1327,1242120,444370
hdfs://spark-nn.eemcs.utwente.nl/user/s1934538/clickstream/clickstream-enwiki-2023-12.tsv.gz,FIFA_World_Cup,48817,269707,2937,321461,151388
hdfs://spark-nn.eemcs.utwente.nl/user/s1934538/clickstream/clickstream-enwiki-2023-12.tsv.gz,Notre-Dame_de_Paris,15834,91145,1664,108643,27859
hdfs://spark-nn.eemcs.utwente.nl/user/s1934538/clickstream/clickstream-enwiki-2023-12.tsv.gz,Guardians_of_the_Galaxy_Vol._3,82540,189712,2997,275249,126771
hdfs://spark-nn.eemcs.utwente.nl/user/s1934538/clickstream/clickstream-enwiki-2023-12.tsv.gz,Jason_Momoa,111094,567068,3081,681243,334756
hdfs://spark-nn.eemcs.utwente.nl/user/s1934538/clickstream/clickstream-enwiki-2023-12.tsv.gz,Juneteenth,7240,36668,128,44036,4733
hdfs://spark-nn.eemcs.utwente.nl/user/s1934538/clickstream/clickstream-enwiki-2023-12.tsv.gz,Charles_Sobhraj,13192,72337,82,85611,20726
hdfs://spark-nn.eemcs.utwente.nl/user/s1934538/clickstream/clickstream-enwiki-2023-12.tsv.gz,September_11_attacks,107904,286597,4396,398897,274945
hdfs://spark-nn.eemcs.utwente.nl/user/s1934538/clickstream/clickstream-enwiki-2023-12.tsv.gz,Anna_Sorokin,15637,133175,292,149104,55701
hdfs://spark-nn.eemcs.utwente.nl/user/s1934538/clickstream/clickstream-enwiki-2023-12.tsv.gz,Jawan_(film),186114,781338,3100,970552,291270
hdfs://spark-nn.eemcs.utwente.nl/user/s1934538/clickstream/clickstream-enwiki-2023-12.tsv.gz,List_of_Marvel_Cinematic_Universe_films,132659,463902,1456,598017,395083
hdfs://spark-nn.eemcs.utwente.nl/user/s1934538/clickstream/clickstream-enwiki-2023-12.tsv.gz,The_Queen's_Gambit_(miniseries),24606,113758,753,139117,64863
hdfs://spark-nn.eemcs.utwente.nl/user/s1934538/clickstream/clickstream-enwiki-2023-12.tsv.gz,Ted_Bundy,30493,319060,3424,352977,88735
hdfs://spark-nn.eemcs.utwente.nl/user/s1934538/clickstream/clickstream-enwiki-2023-12.tsv.gz,Parasite_(2019_film),146031,390737,7072,543840,317895
hdfs://spark-nn.eemcs.utwente.nl/user/s1934538/clickstream/clickstream-enwiki-2023-12.tsv.gz,Spider-Man:_Across_the_Spider-Verse,123322,381600,7372,512294,340240
hdfs://spark-nn.eemcs.utwente.nl/user/s1934538/clickstream/clickstream-enwiki-2023-12.tsv.gz,Cecil_Hotel_(Los_Angeles),7142,83712,136,90990,25287
hdfs://spark-nn.eemcs.utwente.nl/user/s1934538/clickstream/clickstream-enwiki-2023-12.tsv.gz,Henry_V_of_England,89582,96030,423,186035,127439
hdfs://spark-nn.eemcs.utwente.nl/user/s1934538/clickstream/clickstream-enwiki-2023-12.tsv.gz,Bible,23245,104880,1707,129832,39776
hdfs://spark-nn.eemcs.utwente.nl/user/s1934538/clickstream/clickstream-enwiki-2023-12.tsv.gz,Michael_Jordan,89932,453156,3515,546603,169353
hdfs://spark-nn.eemcs.utwente.nl/user/s1934538/clickstream/clickstream-enwiki-2023-12.tsv.gz,Ghislaine_Maxwell,116333,165352,596,282281,125169
hdfs://spark-nn.eemcs.utwente.nl/user/s1934538/clickstream/clickstream-enwiki-2023-12.tsv.gz,State_of_Palestine,153937,470515,667,625119,222956
hdfs://spark-nn.eemcs.utwente.nl/user/s1934538/clickstream/clickstream-enwiki-2023-12.tsv.gz,Cricket_World_Cup,29321,218137,459,247917,49994
hdfs://spark-nn.eemcs.utwente.nl/user/s1934538/clickstream/clickstream-enwiki-2023-12.tsv.gz,Adipurush,76758,153399,16720,246877,72495
hdfs://spark-nn.eemcs.utwente.nl/user/s1934538/clickstream/clickstream-enwiki-2023-12.tsv.gz,Adele,35658,222634,4818,263110,98441
hdfs://spark-nn.eemcs.utwente.nl/user/s1934538/clickstream/clickstream-enwiki-2023-12.tsv.gz,2.0_(film),47851,35211,83,83145,15041
hdfs://spark-nn.eemcs.utwente.nl/user/s1934538/clickstream/clickstream-enwiki-2023-12.tsv.gz,Jailer_(2023_Tamil_film),60514,187904,1505,249923,80280
hdfs://spark-nn.eemcs.utwente.nl/user/s1934538/clickstream/clickstream-enwiki-2023-12.tsv.gz,Simone_Biles,37895,329706,1838,369439,184071
hdfs://spark-nn.eemcs.utwente.nl/user/s1934538/clickstream/clickstream-enwiki-2023-12.tsv.gz,2020_United_States_presidential_election,152705,186556,3510,342771,331847
hdfs://spark-nn.eemcs.utwente.nl/user/s1934538/clickstream/clickstream-enwiki-2023-12.tsv.gz,Venom_(2018_film),14956,73406,666,89028,34664
hdfs://spark-nn.eemcs.utwente.nl/user/s1934538/clickstream/clickstream-enwiki-2023-12.tsv.gz,Freddie_Mercury,69601,431398,2916,503915,200651
hdfs://spark-nn.eemcs.utwente.nl/user/s1934538/clickstream/clickstream-enwiki-2023-12.tsv.gz,Thor:_Love_and_Thunder,54886,90691,990,146567,67671
hdfs://spark-nn.eemcs.utwente.nl/user/s1934538/clickstream/clickstream-enwiki-2023-12.tsv.gz,The_Sandman_(TV_series),27845,56281,799,84925,53054
hdfs://spark-nn.eemcs.utwente.nl/user/s1934538/clickstream/clickstream-enwiki-2023-12.tsv.gz,Laal_Singh_Chaddha,31687,56693,237,88617,30142
hdfs://spark-nn.eemcs.utwente.nl/user/s1934538/clickstream/clickstream-enwiki-2023-12.tsv.gz,Kobe_Bryant,58443,347559,2537,408539,126228
hdfs://spark-nn.eemcs.utwente.nl/user/s1934538/clickstream/clickstream-enwiki-2023-12.tsv.gz,Watts_family_murders,5373,147010,306,152689,38515
hdfs://spark-nn.eemcs.utwente.nl/user/s1934538/clickstream/clickstream-enwiki-2023-12.tsv.gz,Ant-Man_and_the_Wasp:_Quantumania,72408,77778,1954,152140,79445
hdfs://spark-nn.eemcs.utwente.nl/user/s1934538/clickstream/clickstream-enwiki-2023-12.tsv.gz,Stranger_Things_(season_4),17322,58908,534,76764,42434
hdfs://spark-nn.eemcs.utwente.nl/user/s1934538/clickstream/clickstream-enwiki-2023-12.tsv.gz,Lance_Reddick,104091,209788,1901,315780,61591
hdfs://spark-nn.eemcs.utwente.nl/user/s1934538/clickstream/clickstream-enwiki-2023-12.tsv.gz,Croatia,48097,137118,1718,186933,61308
hdfs://spark-nn.eemcs.utwente.nl/user/s1934538/clickstream/clickstream-enwiki-2018-01.tsv.gz,Stephen_Hawking,23742,529340,3164,556246,118385
hdfs://spark-nn.eemcs.utwente.nl/user/s1934538/clickstream/clickstream-enwiki-2018-01.tsv.gz,Chadwick_Boseman,73925,203190,575,277690,63067
hdfs://spark-nn.eemcs.utwente.nl/user/s1934538/clickstream/clickstream-enwiki-2018-01.tsv.gz,Deion_Sanders,9503,137939,393,147835,20239
hdfs://spark-nn.eemcs.utwente.nl/user/s1934538/clickstream/clickstream-enwiki-2018-01.tsv.gz,Atal_Bihari_Vajpayee,16667,57237,97,74001,14403
hdfs://spark-nn.eemcs.utwente.nl/user/s1934538/clickstream/clickstream-enwiki-2018-01.tsv.gz,Cameron_Boyce,10900,61192,119,72211,8508
hdfs://spark-nn.eemcs.utwente.nl/user/s1934538/clickstream/clickstream-enwiki-2018-01.tsv.gz,Bonnie_and_Clyde,11004,213739,863,225606,31883
hdfs://spark-nn.eemcs.utwente.nl/user/s1934538/clickstream/clickstream-enwiki-2018-01.tsv.gz,Naomi_Osaka,2633,134212,331,137176,16901
hdfs://spark-nn.eemcs.utwente.nl/user/s1934538/clickstream/clickstream-enwiki-2018-01.tsv.gz,List_of_Marvel_Cinematic_Universe_films,96425,695637,1163,793225,195962
hdfs://spark-nn.eemcs.utwente.nl/user/s1934538/clickstream/clickstream-enwiki-2018-01.tsv.gz,Shakira,12150,317106,2210,331466,91032
hdfs://spark-nn.eemcs.utwente.nl/user/s1934538/clickstream/clickstream-enwiki-2018-01.tsv.gz,Bob_Saget,15888,72418,248,88554,9594
hdfs://spark-nn.eemcs.utwente.nl/user/s1934538/clickstream/clickstream-enwiki-2018-01.tsv.gz,Hamas,11664,43982,331,55977,14481
hdfs://spark-nn.eemcs.utwente.nl/user/s1934538/clickstream/clickstream-enwiki-2018-01.tsv.gz,Simple_Mail_Transfer_Protocol,6661,41649,204,48514,7279
hdfs://spark-nn.eemcs.utwente.nl/user/s1934538/clickstream/clickstream-enwiki-2018-01.tsv.gz,2018_Winter_Olympics,120790,1049988,13888,1184666,607707
hdfs://spark-nn.eemcs.utwente.nl/user/s1934538/clickstream/clickstream-enwiki-2018-01.tsv.gz,Burt_Reynolds,27967,183066,1208,212241,55917
hdfs://spark-nn.eemcs.utwente.nl/user/s1934538/clickstream/clickstream-enwiki-2018-01.tsv.gz,Deaths_in_2018,1348006,2121418,6546,3475970,1784325
hdfs://spark-nn.eemcs.utwente.nl/user/s1934538/clickstream/clickstream-enwiki-2018-01.tsv.gz,Taliban,20792,118987,723,140502,47398
hdfs://spark-nn.eemcs.utwente.nl/user/s1934538/clickstream/clickstream-enwiki-2018-01.tsv.gz,Rami_Malek,34078,96574,357,131009,32457
hdfs://spark-nn.eemcs.utwente.nl/user/s1934538/clickstream/clickstream-enwiki-2018-01.tsv.gz,Black_Panther_(film),152716,896484,15549,1064749,530213
hdfs://spark-nn.eemcs.utwente.nl/user/s1934538/clickstream/clickstream-enwiki-2018-01.tsv.gz,Stan_Lee,41898,244564,2669,289131,67009
hdfs://spark-nn.eemcs.utwente.nl/user/s1934538/clickstream/clickstream-enwiki-2018-01.tsv.gz,Exo_(band),36754,883598,943,921295,217657
hdfs://spark-nn.eemcs.utwente.nl/user/s1934538/clickstream/clickstream-enwiki-2018-01.tsv.gz,Area_51,15369,303482,1503,320354,56285
hdfs://spark-nn.eemcs.utwente.nl/user/s1934538/clickstream/clickstream-enwiki-2018-01.tsv.gz,Indian_Premier_League,26849,143707,347,170903,91618
hdfs://spark-nn.eemcs.utwente.nl/user/s1934538/clickstream/clickstream-enwiki-2018-01.tsv.gz,George_VI,450487,1226026,2596,1679109,515056
hdfs://spark-nn.eemcs.utwente.nl/user/s1934538/clickstream/clickstream-enwiki-2018-01.tsv.gz,Venom_(2018_film),73580,242340,3494,319414,134905
hdfs://spark-nn.eemcs.utwente.nl/user/s1934538/clickstream/clickstream-enwiki-2018-01.tsv.gz,Joaquin_Phoenix,65781,180286,631,246698,96677
hdfs://spark-nn.eemcs.utwente.nl/user/s1934538/clickstream/clickstream-enwiki-2018-01.tsv.gz,Anne_Heche,54788,180951,647,236386,33627
hdfs://spark-nn.eemcs.utwente.nl/user/s1934538/clickstream/clickstream-enwiki-2018-01.tsv.gz,Sridevi,34669,108305,219,143193,43186
hdfs://spark-nn.eemcs.utwente.nl/user/s1934538/clickstream/clickstream-enwiki-2018-01.tsv.gz,George_H._W._Bush,90569,194073,789,285431,96893
hdfs://spark-nn.eemcs.utwente.nl/user/s1934538/clickstream/clickstream-enwiki-2018-01.tsv.gz,United_States_Senate,47392,143410,2161,192963,63776
hdfs://spark-nn.eemcs.utwente.nl/user/s1934538/clickstream/clickstream-enwiki-2018-01.tsv.gz,Vladimir_Putin,61805,310065,2859,374729,143431
hdfs://spark-nn.eemcs.utwente.nl/user/s1934538/clickstream/clickstream-enwiki-2018-01.tsv.gz,Sushma_Swaraj,4997,33458,76,38531,7167
hdfs://spark-nn.eemcs.utwente.nl/user/s1934538/clickstream/clickstream-enwiki-2018-01.tsv.gz,Cecil_Hotel_(Los_Angeles),3086,36086,46,39218,8381
hdfs://spark-nn.eemcs.utwente.nl/user/s1934538/clickstream/clickstream-enwiki-2018-01.tsv.gz,Naya_Rivera,24747,82847,140,107734,12637
hdfs://spark-nn.eemcs.utwente.nl/user/s1934538/clickstream/clickstream-enwiki-2018-01.tsv.gz,HTTP_cookie,7868,5233469,103,5241440,254939
hdfs://spark-nn.eemcs.utwente.nl/user/s1934538/clickstream/clickstream-enwiki-2018-01.tsv.gz,Hamilton_(musical),26734,436535,1747,465016,141985
hdfs://spark-nn.eemcs.utwente.nl/user/s1934538/clickstream/clickstream-enwiki-2018-01.tsv.gz,William_Murdoch,570,1825,10,2405,279
hdfs://spark-nn.eemcs.utwente.nl/user/s1934538/clickstream/clickstream-enwiki-2018-01.tsv.gz,Pornhub,41215,545096,7392,593703,69096
hdfs://spark-nn.eemcs.utwente.nl/user/s1934538/clickstream/clickstream-enwiki-2018-01.tsv.gz,Cleopatra,45418,271529,2765,319712,101390
hdfs://spark-nn.eemcs.utwente.nl/user/s1934538/clickstream/clickstream-enwiki-2018-01.tsv.gz,A_Star_Is_Born_(2018_film),24389,27498,80,51967,14996
hdfs://spark-nn.eemcs.utwente.nl/user/s1934538/clickstream/clickstream-enwiki-2018-01.tsv.gz,Coronavirus,1059,22818,35,23912,1724
hdfs://spark-nn.eemcs.utwente.nl/user/s1934538/clickstream/clickstream-enwiki-2018-01.tsv.gz,Meghan_Markle,59074,1021392,5333,1085799,171908
hdfs://spark-nn.eemcs.utwente.nl/user/s1934538/clickstream/clickstream-enwiki-2018-01.tsv.gz,Notre-Dame_de_Paris,7170,71552,1164,79886,11870
hdfs://spark-nn.eemcs.utwente.nl/user/s1934538/clickstream/clickstream-enwiki-2018-01.tsv.gz,Grover,944,6929,25,7898,970
hdfs://spark-nn.eemcs.utwente.nl/user/s1934538/clickstream/clickstream-enwiki-2018-01.tsv.gz,Aquaman_(film),71705,83701,836,156242,78987
hdfs://spark-nn.eemcs.utwente.nl/user/s1934538/clickstream/clickstream-enwiki-2018-01.tsv.gz,NATO,35031,151306,1663,188000,54124
hdfs://spark-nn.eemcs.utwente.nl/user/s1934538/clickstream/clickstream-enwiki-2018-01.tsv.gz,Cristiano_Ronaldo,63887,739264,3869,807020,116439
hdfs://spark-nn.eemcs.utwente.nl/user/s1934538/clickstream/clickstream-enwiki-2018-01.tsv.gz,Jenna_Ortega,5233,25576,62,30871,2475
hdfs://spark-nn.eemcs.utwente.nl/user/s1934538/clickstream/clickstream-enwiki-2018-01.tsv.gz,Keanu_Reeves,51969,615860,3427,671256,238113
hdfs://spark-nn.eemcs.utwente.nl/user/s1934538/clickstream/clickstream-enwiki-2018-01.tsv.gz,"Diana,_Princess_of_Wales",146387,521228,2303,669918,215272
hdfs://spark-nn.eemcs.utwente.nl/user/s1934538/clickstream/clickstream-enwiki-2018-01.tsv.gz,Queen_(band),30010,166587,2251,198848,130004
hdfs://spark-nn.eemcs.utwente.nl/user/s1934538/clickstream/clickstream-enwiki-2018-01.tsv.gz,The_Umbrella_Academy_(TV_series),5649,9461,20,15130,6982
hdfs://spark-nn.eemcs.utwente.nl/user/s1934538/clickstream/clickstream-enwiki-2018-01.tsv.gz,Michael_Bloomberg,18836,62213,171,81220,22963
hdfs://spark-nn.eemcs.utwente.nl/user/s1934538/clickstream/clickstream-enwiki-2018-01.tsv.gz,Joe_Biden,25141,132295,1226,158662,31255
hdfs://spark-nn.eemcs.utwente.nl/user/s1934538/clickstream/clickstream-enwiki-2018-01.tsv.gz,XXXTentacion,29392,327767,6381,363540,57375
hdfs://spark-nn.eemcs.utwente.nl/user/s1934538/clickstream/clickstream-enwiki-2018-01.tsv.gz,1234,55,1954,17,2026,157
hdfs://spark-nn.eemcs.utwente.nl/user/s1934538/clickstream/clickstream-enwiki-2018-01.tsv.gz,2018_Asian_Games,8664,48785,239,57688,12219
hdfs://spark-nn.eemcs.utwente.nl/user/s1934538/clickstream/clickstream-enwiki-2018-01.tsv.gz,IPv4,11942,59988,161,72091,11811
hdfs://spark-nn.eemcs.utwente.nl/user/s1934538/clickstream/clickstream-enwiki-2018-01.tsv.gz,A_Quiet_Place_(film),22639,152256,1049,175944,27120
hdfs://spark-nn.eemcs.utwente.nl/user/s1934538/clickstream/clickstream-enwiki-2018-01.tsv.gz,The_Lion_King_(2019_film),53520,131424,731,185675,127879
hdfs://spark-nn.eemcs.utwente.nl/user/s1934538/clickstream/clickstream-enwiki-2018-01.tsv.gz,Glass_(2019_film),68817,77151,97,146065,54382
hdfs://spark-nn.eemcs.utwente.nl/user/s1934538/clickstream/clickstream-enwiki-2018-01.tsv.gz,Freddie_Mercury,43361,408650,2803,454814,104871
hdfs://spark-nn.eemcs.utwente.nl/user/s1934538/clickstream/clickstream-enwiki-2018-01.tsv.gz,Anthony_Bourdain,9869,163522,742,174133,36607
hdfs://spark-nn.eemcs.utwente.nl/user/s1934538/clickstream/clickstream-enwiki-2018-01.tsv.gz,Cook's_Country,284,5819,26,6129,67
hdfs://spark-nn.eemcs.utwente.nl/user/s1934538/clickstream/clickstream-enwiki-2018-01.tsv.gz,Deadpool_2,75867,173553,2184,251604,148694
hdfs://spark-nn.eemcs.utwente.nl/user/s1934538/clickstream/clickstream-enwiki-2018-01.tsv.gz,Charles_Sobhraj,3709,25665,35,29409,3314
hdfs://spark-nn.eemcs.utwente.nl/user/s1934538/clickstream/clickstream-enwiki-2018-01.tsv.gz,Aaron_Hernandez,8974,246547,950,256471,36583
hdfs://spark-nn.eemcs.utwente.nl/user/s1934538/clickstream/clickstream-enwiki-2018-01.tsv.gz,YouTube,90987,712095,6233,809315,132645
hdfs://spark-nn.eemcs.utwente.nl/user/s1934538/clickstream/clickstream-enwiki-2018-01.tsv.gz,The_Weeknd,24621,179977,4769,209367,58122
hdfs://spark-nn.eemcs.utwente.nl/user/s1934538/clickstream/clickstream-enwiki-2018-01.tsv.gz,Matthew_Perry,58812,330959,841,390612,94773
hdfs://spark-nn.eemcs.utwente.nl/user/s1934538/clickstream/clickstream-enwiki-2018-01.tsv.gz,Simone_Biles,45280,194861,664,240805,29450
hdfs://spark-nn.eemcs.utwente.nl/user/s1934538/clickstream/clickstream-enwiki-2018-01.tsv.gz,Fantastic_Beasts:_The_Crimes_of_Grindelwald,71321,123823,646,195790,96339
hdfs://spark-nn.eemcs.utwente.nl/user/s1934538/clickstream/clickstream-enwiki-2018-01.tsv.gz,Prince_Harry,159903,394539,1757,556199,139818
hdfs://spark-nn.eemcs.utwente.nl/user/s1934538/clickstream/clickstream-enwiki-2018-01.tsv.gz,Tom_Brady,114184,1756346,9654,1880184,376751
hdfs://spark-nn.eemcs.utwente.nl/user/s1934538/clickstream/clickstream-enwiki-2018-01.tsv.gz,Jimmy_Hoffa,18847,78271,374,97492,20669
hdfs://spark-nn.eemcs.utwente.nl/user/s1934538/clickstream/clickstream-enwiki-2018-01.tsv.gz,Lisa_Marie_Presley,75209,143069,156,218434,62666
hdfs://spark-nn.eemcs.utwente.nl/user/s1934538/clickstream/clickstream-enwiki-2018-01.tsv.gz,Kim_Jong-un,50877,408810,2933,462620,137445
hdfs://spark-nn.eemcs.utwente.nl/user/s1934538/clickstream/clickstream-enwiki-2018-01.tsv.gz,Critical_race_theory,1420,13353,30,14803,2417
hdfs://spark-nn.eemcs.utwente.nl/user/s1934538/clickstream/clickstream-enwiki-2018-01.tsv.gz,2018_FIFA_World_Cup,71311,587368,6655,665334,241287
hdfs://spark-nn.eemcs.utwente.nl/user/s1934538/clickstream/clickstream-enwiki-2018-01.tsv.gz,The_Irishman,66,816,33,915,689
hdfs://spark-nn.eemcs.utwente.nl/user/s1934538/clickstream/clickstream-enwiki-2018-01.tsv.gz,Lance_Reddick,13601,28754,108,42463,6567
hdfs://spark-nn.eemcs.utwente.nl/user/s1934538/clickstream/clickstream-enwiki-2018-01.tsv.gz,Qasem_Soleimani,3091,13007,34,16132,6315
hdfs://spark-nn.eemcs.utwente.nl/user/s1934538/clickstream/clickstream-enwiki-2018-01.tsv.gz,Gaza_Strip,11176,41091,204,52471,13669
hdfs://spark-nn.eemcs.utwente.nl/user/s1934538/clickstream/clickstream-enwiki-2018-01.tsv.gz,Manti_Te'o,4097,150583,277,154957,2610
hdfs://spark-nn.eemcs.utwente.nl/user/s1934538/clickstream/clickstream-enwiki-2018-01.tsv.gz,Jason_Momoa,80591,705438,1815,787844,177002
hdfs://spark-nn.eemcs.utwente.nl/user/s1934538/clickstream/clickstream-enwiki-2018-01.tsv.gz,John_McCain,21154,112814,875,134843,31277
hdfs://spark-nn.eemcs.utwente.nl/user/s1934538/clickstream/clickstream-enwiki-2018-01.tsv.gz,List_of_highest-grossing_Indian_films,146008,903341,1223,1050572,362070
hdfs://spark-nn.eemcs.utwente.nl/user/s1934538/clickstream/clickstream-enwiki-2018-01.tsv.gz,Sylvester_Stallone,60380,479844,2097,542321,202398
hdfs://spark-nn.eemcs.utwente.nl/user/s1934538/clickstream/clickstream-enwiki-2018-01.tsv.gz,Meat_Loaf,14800,91556,673,107029,26261
hdfs://spark-nn.eemcs.utwente.nl/user/s1934538/clickstream/clickstream-enwiki-2018-01.tsv.gz,Tina_Turner,11513,247011,1485,260009,42062
hdfs://spark-nn.eemcs.utwente.nl/user/s1934538/clickstream/clickstream-enwiki-2018-01.tsv.gz,Fyre_Festival,1376,32661,113,34150,8604
hdfs://spark-nn.eemcs.utwente.nl/user/s1934538/clickstream/clickstream-enwiki-2018-01.tsv.gz,Donald_Glover,81553,667747,2690,751990,132076
hdfs://spark-nn.eemcs.utwente.nl/user/s1934538/clickstream/clickstream-enwiki-2018-01.tsv.gz,Antifa_(United_States),5475,102976,180,108631,15645
hdfs://spark-nn.eemcs.utwente.nl/user/s1934538/clickstream/clickstream-enwiki-2018-01.tsv.gz,Louis_Tomlinson,24374,72416,1012,97802,11777
hdfs://spark-nn.eemcs.utwente.nl/user/s1934538/clickstream/clickstream-enwiki-2018-01.tsv.gz,Johnny_Depp,77200,387884,2490,467574,208752
hdfs://spark-nn.eemcs.utwente.nl/user/s1934538/clickstream/clickstream-enwiki-2018-01.tsv.gz,List_of_awards_and_nominations_received_by_Meryl_Streep,30107,54382,366,84855,22319
hdfs://spark-nn.eemcs.utwente.nl/user/s1934538/clickstream/clickstream-enwiki-2018-01.tsv.gz,State_of_Palestine,35376,106979,203,142558,46945
hdfs://spark-nn.eemcs.utwente.nl/user/s1934538/clickstream/clickstream-enwiki-2018-01.tsv.gz,Kobe_Bryant_sexual_assault_case,2551,32065,23,34639,1883
hdfs://spark-nn.eemcs.utwente.nl/user/s1934538/clickstream/clickstream-enwiki-2018-01.tsv.gz,Dennis_Nilsen,3496,38933,271,42700,5503
hdfs://spark-nn.eemcs.utwente.nl/user/s1934538/clickstream/clickstream-enwiki-2018-01.tsv.gz,Article_370_of_the_Constitution_of_India,3247,28546,51,31844,2532
hdfs://spark-nn.eemcs.utwente.nl/user/s1934538/clickstream/clickstream-enwiki-2018-01.tsv.gz,Sushant_Singh_Rajput,18735,83979,724,103438,44786
hdfs://spark-nn.eemcs.utwente.nl/user/s1934538/clickstream/clickstream-enwiki-2018-01.tsv.gz,Rihanna,44801,450129,3677,498607,118230
hdfs://spark-nn.eemcs.utwente.nl/user/s1934538/clickstream/clickstream-enwiki-2018-01.tsv.gz,Kobe_Bryant,26730,266487,1556,294773,46349
hdfs://spark-nn.eemcs.utwente.nl/user/s1934538/clickstream/clickstream-enwiki-2018-01.tsv.gz,List_of_James_Bond_films,14348,263663,315,278326,76564
hdfs://spark-nn.eemcs.utwente.nl/user/s1934538/clickstream/clickstream-enwiki-2018-01.tsv.gz,Amber_Heard,72632,175777,783,249192,61713
hdfs://spark-nn.eemcs.utwente.nl/user/s1934538/clickstream/clickstream-enwiki-2018-01.tsv.gz,Adele,21671,202749,2541,226961,51498
hdfs://spark-nn.eemcs.utwente.nl/user/s1934538/clickstream/clickstream-enwiki-2018-01.tsv.gz,Chernobyl_disaster,19985,260020,1083,281088,55086
hdfs://spark-nn.eemcs.utwente.nl/user/s1934538/clickstream/clickstream-enwiki-2018-01.tsv.gz,Lionel_Messi,54995,657325,5617,717937,113297
hdfs://spark-nn.eemcs.utwente.nl/user/s1934538/clickstream/clickstream-enwiki-2018-01.tsv.gz,Priyanka_Chopra,50895,280005,797,331697,68696
hdfs://spark-nn.eemcs.utwente.nl/user/s1934538/clickstream/clickstream-enwiki-2018-01.tsv.gz,Microsoft_Office,9047,96832,829,106708,23077
hdfs://spark-nn.eemcs.utwente.nl/user/s1934538/clickstream/clickstream-enwiki-2018-01.tsv.gz,Israel,60148,436499,5202,501849,170843
hdfs://spark-nn.eemcs.utwente.nl/user/s1934538/clickstream/clickstream-enwiki-2018-01.tsv.gz,2.0_(film),54535,233945,1105,289585,78142
hdfs://spark-nn.eemcs.utwente.nl/user/s1934538/clickstream/clickstream-enwiki-2018-01.tsv.gz,Eddie_Van_Halen,23181,76140,446,99767,23822
hdfs://spark-nn.eemcs.utwente.nl/user/s1934538/clickstream/clickstream-enwiki-2018-01.tsv.gz,Elon_Musk,79764,1050810,6089,1136663,474565
hdfs://spark-nn.eemcs.utwente.nl/user/s1934538/clickstream/clickstream-enwiki-2018-01.tsv.gz,Stranger_Things,78422,1145211,17830,1241463,611502
hdfs://spark-nn.eemcs.utwente.nl/user/s1934538/clickstream/clickstream-enwiki-2018-02.tsv.gz,Black_Panther_(film),531919,7417328,126677,8075924,4266515
hdfs://spark-nn.eemcs.utwente.nl/user/s1934538/clickstream/clickstream-enwiki-2018-02.tsv.gz,Hamas,9724,35503,193,45420,10596
hdfs://spark-nn.eemcs.utwente.nl/user/s1934538/clickstream/clickstream-enwiki-2018-02.tsv.gz,List_of_most_popular_websites,24436,172942,145,197523,75095
hdfs://spark-nn.eemcs.utwente.nl/user/s1934538/clickstream/clickstream-enwiki-2018-02.tsv.gz,Asia_Cup,5385,17377,71,22833,7954
hdfs://spark-nn.eemcs.utwente.nl/user/s1934538/clickstream/clickstream-enwiki-2018-02.tsv.gz,Venom_(2018_film),71770,485905,7558,565233,227675
hdfs://spark-nn.eemcs.utwente.nl/user/s1934538/clickstream/clickstream-enwiki-2018-02.tsv.gz,Saaho,33180,48186,109,81475,38342
hdfs://spark-nn.eemcs.utwente.nl/user/s1934538/clickstream/clickstream-enwiki-2018-02.tsv.gz,Aquaman_(film),75683,92690,896,169269,89333
hdfs://spark-nn.eemcs.utwente.nl/user/s1934538/clickstream/clickstream-enwiki-2018-02.tsv.gz,Line_shaft,682,1544,10,2236,65
hdfs://spark-nn.eemcs.utwente.nl/user/s1934538/clickstream/clickstream-enwiki-2018-02.tsv.gz,Stranger_Things,45193,600934,9991,656118,305053
hdfs://spark-nn.eemcs.utwente.nl/user/s1934538/clickstream/clickstream-enwiki-2018-02.tsv.gz,Puneeth_Rajkumar,7945,23956,35,31936,13135
hdfs://spark-nn.eemcs.utwente.nl/user/s1934538/clickstream/clickstream-enwiki-2018-02.tsv.gz,The_Witcher_(TV_series),4142,28884,118,33144,6153
hdfs://spark-nn.eemcs.utwente.nl/user/s1934538/clickstream/clickstream-enwiki-2018-02.tsv.gz,Jason_Momoa,65242,531615,1095,597952,139618
hdfs://spark-nn.eemcs.utwente.nl/user/s1934538/clickstream/clickstream-enwiki-2018-02.tsv.gz,Main_Page,22214,486302547,2728347,489053108,28545582
hdfs://spark-nn.eemcs.utwente.nl/user/s1934538/clickstream/clickstream-enwiki-2018-02.tsv.gz,Roe_v._Wade,7260,74205,367,81832,14445
hdfs://spark-nn.eemcs.utwente.nl/user/s1934538/clickstream/clickstream-enwiki-2018-02.tsv.gz,Game_of_Thrones_(season_8),34640,194837,658,230135,66723
hdfs://spark-nn.eemcs.utwente.nl/user/s1934538/clickstream/clickstream-enwiki-2018-02.tsv.gz,The_Nun_(2018_film),33290,83240,238,116768,40782
hdfs://spark-nn.eemcs.utwente.nl/user/s1934538/clickstream/clickstream-enwiki-2018-02.tsv.gz,Sushant_Singh_Rajput,17558,60798,450,78806,37422
hdfs://spark-nn.eemcs.utwente.nl/user/s1934538/clickstream/clickstream-enwiki-2018-02.tsv.gz,Sushma_Swaraj,5047,25103,69,30219,5288
hdfs://spark-nn.eemcs.utwente.nl/user/s1934538/clickstream/clickstream-enwiki-2018-02.tsv.gz,21_Savage,24227,161568,2556,188351,46862
hdfs://spark-nn.eemcs.utwente.nl/user/s1934538/clickstream/clickstream-enwiki-2018-02.tsv.gz,Central_Park_jogger_case,3976,90506,332,94814,6491
hdfs://spark-nn.eemcs.utwente.nl/user/s1934538/clickstream/clickstream-enwiki-2018-02.tsv.gz,XHamster,7652,6956634,10607,6974893,26997
hdfs://spark-nn.eemcs.utwente.nl/user/s1934538/clickstream/clickstream-enwiki-2018-02.tsv.gz,Game_of_Thrones,51066,444534,9501,505101,251134
hdfs://spark-nn.eemcs.utwente.nl/user/s1934538/clickstream/clickstream-enwiki-2018-02.tsv.gz,Manti_Te'o,1863,15502,47,17412,93
hdfs://spark-nn.eemcs.utwente.nl/user/s1934538/clickstream/clickstream-enwiki-2018-02.tsv.gz,Indian_Premier_League,18041,100986,180,119207,61645
hdfs://spark-nn.eemcs.utwente.nl/user/s1934538/clickstream/clickstream-enwiki-2018-02.tsv.gz,NATO,31504,135642,1384,168530,48123
hdfs://spark-nn.eemcs.utwente.nl/user/s1934538/clickstream/clickstream-enwiki-2018-02.tsv.gz,Sylvester_Stallone,83836,3040120,13745,3137701,423522
hdfs://spark-nn.eemcs.utwente.nl/user/s1934538/clickstream/clickstream-enwiki-2018-02.tsv.gz,A_Quiet_Place_(film),31788,358899,2811,393498,71337
hdfs://spark-nn.eemcs.utwente.nl/user/s1934538/clickstream/clickstream-enwiki-2018-02.tsv.gz,2018_Winter_Olympics,544610,3966864,202871,4714345,3454936
hdfs://spark-nn.eemcs.utwente.nl/user/s1934538/clickstream/clickstream-enwiki-2018-02.tsv.gz,Dennis_Nilsen,3285,24222,65,27572,4079
hdfs://spark-nn.eemcs.utwente.nl/user/s1934538/clickstream/clickstream-enwiki-2018-02.tsv.gz,Salman_Rushdie,16162,100206,699,117067,33691
hdfs://spark-nn.eemcs.utwente.nl/user/s1934538/clickstream/clickstream-enwiki-2018-02.tsv.gz,List_of_Marvel_Cinematic_Universe_films,150432,1125881,1570,1277883,330220
hdfs://spark-nn.eemcs.utwente.nl/user/s1934538/clickstream/clickstream-enwiki-2018-02.tsv.gz,Tonya_Harding,133982,1509858,5913,1649753,243117
hdfs://spark-nn.eemcs.utwente.nl/user/s1934538/clickstream/clickstream-enwiki-2018-02.tsv.gz,Anne_Heche,54587,120234,366,175187,26571
hdfs://spark-nn.eemcs.utwente.nl/user/s1934538/clickstream/clickstream-enwiki-2018-02.tsv.gz,2018_Asian_Games,10235,48509,228,58972,14624
hdfs://spark-nn.eemcs.utwente.nl/user/s1934538/clickstream/clickstream-enwiki-2018-02.tsv.gz,Bonnie_and_Clyde,10390,200254,889,211533,29731
hdfs://spark-nn.eemcs.utwente.nl/user/s1934538/clickstream/clickstream-enwiki-2018-02.tsv.gz,Wikipedia,40486,483092,1038,524616,221889
hdfs://spark-nn.eemcs.utwente.nl/user/s1934538/clickstream/clickstream-enwiki-2018-02.tsv.gz,DMX_(rapper),9752,167961,379,178092,24430
hdfs://spark-nn.eemcs.utwente.nl/user/s1934538/clickstream/clickstream-enwiki-2018-02.tsv.gz,Key_frame,912,5766,19,6697,570
hdfs://spark-nn.eemcs.utwente.nl/user/s1934538/clickstream/clickstream-enwiki-2018-02.tsv.gz,Priyanka_Chopra,48602,253993,541,303136,57989
hdfs://spark-nn.eemcs.utwente.nl/user/s1934538/clickstream/clickstream-enwiki-2018-02.tsv.gz,List_of_highest-grossing_films,101910,581703,2439,686052,228919
hdfs://spark-nn.eemcs.utwente.nl/user/s1934538/clickstream/clickstream-enwiki-2018-02.tsv.gz,Freddie_Mercury,36065,302933,2131,341129,81960
hdfs://spark-nn.eemcs.utwente.nl/user/s1934538/clickstream/clickstream-enwiki-2018-02.tsv.gz,Donald_Trump,171498,928264,10268,1110030,426975
hdfs://spark-nn.eemcs.utwente.nl/user/s1934538/clickstream/clickstream-enwiki-2018-02.tsv.gz,Joe_Biden,21978,136357,1222,159557,30330
hdfs://spark-nn.eemcs.utwente.nl/user/s1934538/clickstream/clickstream-enwiki-2018-02.tsv.gz,Eddie_Van_Halen,20021,52121,263,72405,19613
hdfs://spark-nn.eemcs.utwente.nl/user/s1934538/clickstream/clickstream-enwiki-2018-02.tsv.gz,Jeffrey_Dahmer,29731,726619,3064,759414,156102
hdfs://spark-nn.eemcs.utwente.nl/user/s1934538/clickstream/clickstream-enwiki-2018-02.tsv.gz,J._Robert_Oppenheimer,12408,71393,197,83998,19467
hdfs://spark-nn.eemcs.utwente.nl/user/s1934538/clickstream/clickstream-enwiki-2018-02.tsv.gz,Cameron_Boyce,8533,47370,108,56011,6971
hdfs://spark-nn.eemcs.utwente.nl/user/s1934538/clickstream/clickstream-enwiki-2018-02.tsv.gz,Khabib_Nurmagomedov,17247,109060,812,127119,38865
hdfs://spark-nn.eemcs.utwente.nl/user/s1934538/clickstream/clickstream-enwiki-2018-02.tsv.gz,Matthew_Perry,42522,258750,929,302201,77231
hdfs://spark-nn.eemcs.utwente.nl/user/s1934538/clickstream/clickstream-enwiki-2018-02.tsv.gz,Naomi_Osaka,309,8262,32,8603,877
hdfs://spark-nn.eemcs.utwente.nl/user/s1934538/clickstream/clickstream-enwiki-2018-02.tsv.gz,George_H._W._Bush,79677,171972,557,252206,83375
hdfs://spark-nn.eemcs.utwente.nl/user/s1934538/clickstream/clickstream-enwiki-2018-02.tsv.gz,Ray_Liotta,28895,102531,343,131769,26497
hdfs://spark-nn.eemcs.utwente.nl/user/s1934538/clickstream/clickstream-enwiki-2018-02.tsv.gz,Olivia_Newton-John,11602,80931,670,93203,23648
hdfs://spark-nn.eemcs.utwente.nl/user/s1934538/clickstream/clickstream-enwiki-2018-02.tsv.gz,Captain_Marvel_(film),55084,35666,349,91099,38300
hdfs://spark-nn.eemcs.utwente.nl/user/s1934538/clickstream/clickstream-enwiki-2018-02.tsv.gz,Anthony_Bourdain,7083,85966,428,93477,20861
hdfs://spark-nn.eemcs.utwente.nl/user/s1934538/clickstream/clickstream-enwiki-2018-02.tsv.gz,Afghanistan,34119,149212,1847,185178,105305
hdfs://spark-nn.eemcs.utwente.nl/user/s1934538/clickstream/clickstream-enwiki-2018-02.tsv.gz,Hamilton_(musical),21616,370653,1371,393640,116659
hdfs://spark-nn.eemcs.utwente.nl/user/s1934538/clickstream/clickstream-enwiki-2018-02.tsv.gz,Richard_Ramirez,7567,114400,507,122474,15078
hdfs://spark-nn.eemcs.utwente.nl/user/s1934538/clickstream/clickstream-enwiki-2018-02.tsv.gz,Death_of_Elisa_Lam,5031,87288,194,92513,14019
hdfs://spark-nn.eemcs.utwente.nl/user/s1934538/clickstream/clickstream-enwiki-2018-02.tsv.gz,The_Weeknd,23983,180886,2073,206942,55648
hdfs://spark-nn.eemcs.utwente.nl/user/s1934538/clickstream/clickstream-enwiki-2018-02.tsv.gz,Rihanna,38987,467885,3757,510629,110083
hdfs://spark-nn.eemcs.utwente.nl/user/s1934538/clickstream/clickstream-enwiki-2018-02.tsv.gz,Gaza_Strip,8656,36224,154,45034,11205
hdfs://spark-nn.eemcs.utwente.nl/user/s1934538/clickstream/clickstream-enwiki-2018-02.tsv.gz,Kate_Spade,11034,38649,45,49728,7714
hdfs://spark-nn.eemcs.utwente.nl/user/s1934538/clickstream/clickstream-enwiki-2018-02.tsv.gz,Vladimir_Putin,57213,285232,2556,345001,126124
hdfs://spark-nn.eemcs.utwente.nl/user/s1934538/clickstream/clickstream-enwiki-2018-02.tsv.gz,Aaron_Hernandez,7311,161096,541,168948,26074
hdfs://spark-nn.eemcs.utwente.nl/user/s1934538/clickstream/clickstream-enwiki-2018-02.tsv.gz,United_States_Senate,30064,83212,561,113837,31323
hdfs://spark-nn.eemcs.utwente.nl/user/s1934538/clickstream/clickstream-enwiki-2018-02.tsv.gz,WrestleMania_34,207914,324087,6217,538218,212815
hdfs://spark-nn.eemcs.utwente.nl/user/s1934538/clickstream/clickstream-enwiki-2018-02.tsv.gz,Aaron_Carter,9336,62468,314,72118,14703
hdfs://spark-nn.eemcs.utwente.nl/user/s1934538/clickstream/clickstream-enwiki-2018-02.tsv.gz,Antifa_(United_States),11526,213901,140,225567,25039
hdfs://spark-nn.eemcs.utwente.nl/user/s1934538/clickstream/clickstream-enwiki-2018-02.tsv.gz,Jimmy_Hoffa,17381,70473,437,88291,18969
hdfs://spark-nn.eemcs.utwente.nl/user/s1934538/clickstream/clickstream-enwiki-2018-02.tsv.gz,Taliban,14170,87402,692,102264,31356
hdfs://spark-nn.eemcs.utwente.nl/user/s1934538/clickstream/clickstream-enwiki-2018-02.tsv.gz,Michael_Jordan,50666,739481,5878,796025,136497
hdfs://spark-nn.eemcs.utwente.nl/user/s1934538/clickstream/clickstream-enwiki-2018-02.tsv.gz,Croatia,26380,128629,1331,156340,48627
hdfs://spark-nn.eemcs.utwente.nl/user/s1934538/clickstream/clickstream-enwiki-2018-02.tsv.gz,Bob_Saget,11464,45411,187,57062,6717
hdfs://spark-nn.eemcs.utwente.nl/user/s1934538/clickstream/clickstream-enwiki-2018-02.tsv.gz,JSON_Web_Token,874,63467,16,64357,1743
hdfs://spark-nn.eemcs.utwente.nl/user/s1934538/clickstream/clickstream-enwiki-2018-02.tsv.gz,2022_FIFA_World_Cup,44903,81302,643,126848,51735
hdfs://spark-nn.eemcs.utwente.nl/user/s1934538/clickstream/clickstream-enwiki-2018-02.tsv.gz,Bird_Box_(film),8538,7917,24,16479,5386
hdfs://spark-nn.eemcs.utwente.nl/user/s1934538/clickstream/clickstream-enwiki-2018-02.tsv.gz,Deaths_in_2018,1078529,1990534,7252,3076315,1591117
hdfs://spark-nn.eemcs.utwente.nl/user/s1934538/clickstream/clickstream-enwiki-2018-02.tsv.gz,Simone_Biles,21051,323972,771,345794,48061
hdfs://spark-nn.eemcs.utwente.nl/user/s1934538/clickstream/clickstream-enwiki-2018-02.tsv.gz,Simple_Mail_Transfer_Protocol,5600,39586,462,45648,5932
hdfs://spark-nn.eemcs.utwente.nl/user/s1934538/clickstream/clickstream-enwiki-2018-02.tsv.gz,David_Beckham,23044,219145,1062,243251,43994
hdfs://spark-nn.eemcs.utwente.nl/user/s1934538/clickstream/clickstream-enwiki-2018-02.tsv.gz,Exo_(band),31270,3400216,2401,3433887,198189
hdfs://spark-nn.eemcs.utwente.nl/user/s1934538/clickstream/clickstream-enwiki-2018-02.tsv.gz,Prince_Harry,87331,208058,883,296272,79865
hdfs://spark-nn.eemcs.utwente.nl/user/s1934538/clickstream/clickstream-enwiki-2018-02.tsv.gz,Brie_Larson,71760,160494,918,233172,68718
hdfs://spark-nn.eemcs.utwente.nl/user/s1934538/clickstream/clickstream-enwiki-2018-02.tsv.gz,Naya_Rivera,32114,75800,110,108024,12914
hdfs://spark-nn.eemcs.utwente.nl/user/s1934538/clickstream/clickstream-enwiki-2018-02.tsv.gz,Crazy_Rich_Asians_(film),15572,25060,73,40705,33793
hdfs://spark-nn.eemcs.utwente.nl/user/s1934538/clickstream/clickstream-enwiki-2018-02.tsv.gz,Ukraine,31440,141954,2388,175782,63379
hdfs://spark-nn.eemcs.utwente.nl/user/s1934538/clickstream/clickstream-enwiki-2018-02.tsv.gz,UEFA_Euro_2020,11221,41063,543,52827,20229
hdfs://spark-nn.eemcs.utwente.nl/user/s1934538/clickstream/clickstream-enwiki-2018-02.tsv.gz,Bipin_Rawat,5108,22024,27,27159,6275
hdfs://spark-nn.eemcs.utwente.nl/user/s1934538/clickstream/clickstream-enwiki-2018-02.tsv.gz,State_of_Palestine,27457,93882,83,121422,36225
hdfs://spark-nn.eemcs.utwente.nl/user/s1934538/clickstream/clickstream-enwiki-2018-02.tsv.gz,Cleopatra,34020,260624,1906,296550,83773
hdfs://spark-nn.eemcs.utwente.nl/user/s1934538/clickstream/clickstream-enwiki-2018-02.tsv.gz,Sridevi,276962,6104685,53372,6435019,1860384
hdfs://spark-nn.eemcs.utwente.nl/user/s1934538/clickstream/clickstream-enwiki-2018-02.tsv.gz,Microsoft_Office,8778,91912,720,101410,22836
hdfs://spark-nn.eemcs.utwente.nl/user/s1934538/clickstream/clickstream-enwiki-2018-02.tsv.gz,Richard_Jewell,2718,10552,49,13319,2168
hdfs://spark-nn.eemcs.utwente.nl/user/s1934538/clickstream/clickstream-enwiki-2018-02.tsv.gz,Adele,16567,168540,1623,186730,40951
hdfs://spark-nn.eemcs.utwente.nl/user/s1934538/clickstream/clickstream-enwiki-2018-02.tsv.gz,List_of_highest-grossing_Indian_films,134771,692947,754,828472,322146
hdfs://spark-nn.eemcs.utwente.nl/user/s1934538/clickstream/clickstream-enwiki-2018-02.tsv.gz,Burt_Reynolds,24728,164493,1503,190724,54016
hdfs://spark-nn.eemcs.utwente.nl/user/s1934538/clickstream/clickstream-enwiki-2018-02.tsv.gz,Rami_Malek,25505,70613,286,96404,24029
hdfs://spark-nn.eemcs.utwente.nl/user/s1934538/clickstream/clickstream-enwiki-2018-02.tsv.gz,IPv4,11313,55217,219,66749,11142
hdfs://spark-nn.eemcs.utwente.nl/user/s1934538/clickstream/clickstream-enwiki-2018-02.tsv.gz,Critical_race_theory,1471,16515,30,18016,3089
hdfs://spark-nn.eemcs.utwente.nl/user/s1934538/clickstream/clickstream-enwiki-2018-02.tsv.gz,FIFA_World_Cup,29262,185355,2307,216924,107323
hdfs://spark-nn.eemcs.utwente.nl/user/s1934538/clickstream/clickstream-enwiki-2018-02.tsv.gz,Nipsey_Hussle,8747,173443,941,183131,50196
hdfs://spark-nn.eemcs.utwente.nl/user/s1934538/clickstream/clickstream-enwiki-2018-02.tsv.gz,Avicii,5542,35443,364,41349,12438
hdfs://spark-nn.eemcs.utwente.nl/user/s1934538/clickstream/clickstream-enwiki-2018-02.tsv.gz,Ghislaine_Maxwell,342,1101,34,1477,213
hdfs://spark-nn.eemcs.utwente.nl/user/s1934538/clickstream/clickstream-enwiki-2018-02.tsv.gz,September_11_attacks,44893,287825,1655,334373,92846
hdfs://spark-nn.eemcs.utwente.nl/user/s1934538/clickstream/clickstream-enwiki-2018-02.tsv.gz,Charles_III,63,628,39,730,396
hdfs://spark-nn.eemcs.utwente.nl/user/s1934538/clickstream/clickstream-enwiki-2018-02.tsv.gz,Article_370_of_the_Constitution_of_India,3043,29574,52,32669,2495
hdfs://spark-nn.eemcs.utwente.nl/user/s1934538/clickstream/clickstream-enwiki-2018-02.tsv.gz,Donald_Glover,76360,446446,2601,525407,124132
hdfs://spark-nn.eemcs.utwente.nl/user/s1934538/clickstream/clickstream-enwiki-2018-02.tsv.gz,Kim_Jong-un,65088,376180,2837,444105,146904
hdfs://spark-nn.eemcs.utwente.nl/user/s1934538/clickstream/clickstream-enwiki-2018-02.tsv.gz,Pornhub,37288,436457,6549,480294,57539
hdfs://spark-nn.eemcs.utwente.nl/user/s1934538/clickstream/clickstream-enwiki-2018-02.tsv.gz,Keanu_Reeves,44221,650581,2287,697089,179684
hdfs://spark-nn.eemcs.utwente.nl/user/s1934538/clickstream/clickstream-enwiki-2018-02.tsv.gz,Grimes_(musician),5768,35626,277,41671,14689
hdfs://spark-nn.eemcs.utwente.nl/user/s1934538/clickstream/clickstream-enwiki-2018-02.tsv.gz,Hyphen-minus,5289,42582873,7458356,50046518,741
hdfs://spark-nn.eemcs.utwente.nl/user/s1934538/clickstream/clickstream-enwiki-2018-02.tsv.gz,List_of_awards_and_nominations_received_by_Meryl_Streep,15087,35431,271,50789,12359
hdfs://spark-nn.eemcs.utwente.nl/user/s1934538/clickstream/clickstream-enwiki-2018-02.tsv.gz,Aretha_Franklin,10899,108385,701,119985,22241
hdfs://spark-nn.eemcs.utwente.nl/user/s1934538/clickstream/clickstream-enwiki-2018-02.tsv.gz,The_Irishman_(2019_film),44269,83099,466,127834,75718
hdfs://spark-nn.eemcs.utwente.nl/user/s1934538/clickstream/clickstream-enwiki-2018-02.tsv.gz,Tunnel,2584,12271,113,14968,3133
hdfs://spark-nn.eemcs.utwente.nl/user/s1934538/clickstream/clickstream-enwiki-2018-02.tsv.gz,Tina_Turner,9977,185486,1240,196703,32827
hdfs://spark-nn.eemcs.utwente.nl/user/s1934538/clickstream/clickstream-enwiki-2018-02.tsv.gz,Meghan_Markle,37595,534464,2731,574790,92410
hdfs://spark-nn.eemcs.utwente.nl/user/s1934538/clickstream/clickstream-enwiki-2018-02.tsv.gz,Henry_V_of_England,26127,47543,175,73845,31512
hdfs://spark-nn.eemcs.utwente.nl/user/s1934538/clickstream/clickstream-enwiki-2018-02.tsv.gz,Qasem_Soleimani,2071,7424,19,9514,3510
hdfs://spark-nn.eemcs.utwente.nl/user/s1934538/clickstream/clickstream-enwiki-2018-03.tsv.gz,Lionel_Messi,65674,865526,6844,938044,133234
hdfs://spark-nn.eemcs.utwente.nl/user/s1934538/clickstream/clickstream-enwiki-2018-03.tsv.gz,Eddie_Van_Halen,21873,58282,349,80504,21280
hdfs://spark-nn.eemcs.utwente.nl/user/s1934538/clickstream/clickstream-enwiki-2018-03.tsv.gz,Ukraine,37397,173545,2623,213565,73926
hdfs://spark-nn.eemcs.utwente.nl/user/s1934538/clickstream/clickstream-enwiki-2018-03.tsv.gz,Anne_Heche,38032,79074,575,117681,20064
hdfs://spark-nn.eemcs.utwente.nl/user/s1934538/clickstream/clickstream-enwiki-2018-03.tsv.gz,The_Irishman_(2019_film),52607,108999,447,162053,94546
hdfs://spark-nn.eemcs.utwente.nl/user/s1934538/clickstream/clickstream-enwiki-2018-03.tsv.gz,Jason_Momoa,75816,541235,1047,618098,134624
hdfs://spark-nn.eemcs.utwente.nl/user/s1934538/clickstream/clickstream-enwiki-2018-03.tsv.gz,YouTube,83063,756315,2742,842120,136030
hdfs://spark-nn.eemcs.utwente.nl/user/s1934538/clickstream/clickstream-enwiki-2018-03.tsv.gz,2022_FIFA_World_Cup,52306,76805,479,129590,57400
hdfs://spark-nn.eemcs.utwente.nl/user/s1934538/clickstream/clickstream-enwiki-2018-03.tsv.gz,Lisa_Marie_Presley,76783,146122,193,223098,62169
hdfs://spark-nn.eemcs.utwente.nl/user/s1934538/clickstream/clickstream-enwiki-2018-03.tsv.gz,Henry_V_of_England,26263,48891,144,75298,31930
hdfs://spark-nn.eemcs.utwente.nl/user/s1934538/clickstream/clickstream-enwiki-2018-03.tsv.gz,Rami_Malek,29570,74837,247,104654,25814
hdfs://spark-nn.eemcs.utwente.nl/user/s1934538/clickstream/clickstream-enwiki-2018-03.tsv.gz,Adele,16697,187338,1878,205913,42784
hdfs://spark-nn.eemcs.utwente.nl/user/s1934538/clickstream/clickstream-enwiki-2018-03.tsv.gz,Fantastic_Beasts:_The_Crimes_of_Grindelwald,90521,228024,2039,320584,192985
hdfs://spark-nn.eemcs.utwente.nl/user/s1934538/clickstream/clickstream-enwiki-2018-03.tsv.gz,Kobe_Bryant,41941,528890,4172,575003,93918
hdfs://spark-nn.eemcs.utwente.nl/user/s1934538/clickstream/clickstream-enwiki-2018-03.tsv.gz,The_Umbrella_Academy_(TV_series),5143,9465,21,14629,6360
hdfs://spark-nn.eemcs.utwente.nl/user/s1934538/clickstream/clickstream-enwiki-2018-03.tsv.gz,Kate_Spade,8541,42849,85,51475,8245
hdfs://spark-nn.eemcs.utwente.nl/user/s1934538/clickstream/clickstream-enwiki-2018-03.tsv.gz,State_of_Palestine,29398,75145,61,104604,33643
hdfs://spark-nn.eemcs.utwente.nl/user/s1934538/clickstream/clickstream-enwiki-2018-03.tsv.gz,Anthony_Bourdain,8858,96264,508,105630,23279
hdfs://spark-nn.eemcs.utwente.nl/user/s1934538/clickstream/clickstream-enwiki-2018-03.tsv.gz,Jenna_Ortega,5065,24972,68,30105,2750
hdfs://spark-nn.eemcs.utwente.nl/user/s1934538/clickstream/clickstream-enwiki-2018-03.tsv.gz,Cleopatra,40022,291195,2186,333403,91635
hdfs://spark-nn.eemcs.utwente.nl/user/s1934538/clickstream/clickstream-enwiki-2018-03.tsv.gz,Shakira,11663,227778,1552,240993,66234
hdfs://spark-nn.eemcs.utwente.nl/user/s1934538/clickstream/clickstream-enwiki-2018-03.tsv.gz,Ted_Bundy,29377,365388,3211,397976,61376
hdfs://spark-nn.eemcs.utwente.nl/user/s1934538/clickstream/clickstream-enwiki-2018-03.tsv.gz,Ghislaine_Maxwell,384,1398,29,1811,320
hdfs://spark-nn.eemcs.utwente.nl/user/s1934538/clickstream/clickstream-enwiki-2018-03.tsv.gz,Salman_Rushdie,21504,87652,340,109496,31337
hdfs://spark-nn.eemcs.utwente.nl/user/s1934538/clickstream/clickstream-enwiki-2018-03.tsv.gz,Murder_of_Dee_Dee_Blanchard,2477,53715,59,56251,7260
hdfs://spark-nn.eemcs.utwente.nl/user/s1934538/clickstream/clickstream-enwiki-2018-03.tsv.gz,Alexander_Hamilton,53998,447610,2084,503692,118184
hdfs://spark-nn.eemcs.utwente.nl/user/s1934538/clickstream/clickstream-enwiki-2018-03.tsv.gz,J._Robert_Oppenheimer,14473,85558,352,100383,24155
hdfs://spark-nn.eemcs.utwente.nl/user/s1934538/clickstream/clickstream-enwiki-2018-03.tsv.gz,Priyanka_Chopra,45309,247798,554,293661,62060
hdfs://spark-nn.eemcs.utwente.nl/user/s1934538/clickstream/clickstream-enwiki-2018-03.tsv.gz,United_States_Senate,34552,96094,1388,132034,36266
hdfs://spark-nn.eemcs.utwente.nl/user/s1934538/clickstream/clickstream-enwiki-2018-03.tsv.gz,Joaquin_Phoenix,71637,249465,1118,322220,128200
hdfs://spark-nn.eemcs.utwente.nl/user/s1934538/clickstream/clickstream-enwiki-2018-03.tsv.gz,XXXTentacion,31232,482787,7082,521101,117930
hdfs://spark-nn.eemcs.utwente.nl/user/s1934538/clickstream/clickstream-enwiki-2018-03.tsv.gz,Grimes_(musician),5611,34087,180,39878,12737
hdfs://spark-nn.eemcs.utwente.nl/user/s1934538/clickstream/clickstream-enwiki-2018-03.tsv.gz,DMX_(rapper),11376,132013,492,143881,33093
hdfs://spark-nn.eemcs.utwente.nl/user/s1934538/clickstream/clickstream-enwiki-2018-03.tsv.gz,David_Beckham,23366,254224,1145,278735,49384
hdfs://spark-nn.eemcs.utwente.nl/user/s1934538/clickstream/clickstream-enwiki-2018-03.tsv.gz,List_of_highest-grossing_films,236788,1126818,3374,1366980,398424
hdfs://spark-nn.eemcs.utwente.nl/user/s1934538/clickstream/clickstream-enwiki-2018-03.tsv.gz,Matthew_Perry,42504,246271,572,289347,72598
hdfs://spark-nn.eemcs.utwente.nl/user/s1934538/clickstream/clickstream-enwiki-2018-03.tsv.gz,Grover,836,7120,21,7977,882
hdfs://spark-nn.eemcs.utwente.nl/user/s1934538/clickstream/clickstream-enwiki-2018-03.tsv.gz,Juneteenth,2875,108141,73,111089,2867
hdfs://spark-nn.eemcs.utwente.nl/user/s1934538/clickstream/clickstream-enwiki-2018-03.tsv.gz,Roe_v._Wade,8965,97738,501,107204,17742
hdfs://spark-nn.eemcs.utwente.nl/user/s1934538/clickstream/clickstream-enwiki-2018-03.tsv.gz,List_of_Marvel_Cinematic_Universe_films,147876,1812149,2394,1962419,454572
hdfs://spark-nn.eemcs.utwente.nl/user/s1934538/clickstream/clickstream-enwiki-2018-03.tsv.gz,Ray_Liotta,24972,83634,384,108990,23243
hdfs://spark-nn.eemcs.utwente.nl/user/s1934538/clickstream/clickstream-enwiki-2018-03.tsv.gz,Coronavirus,801,12640,27,13468,1208
hdfs://spark-nn.eemcs.utwente.nl/user/s1934538/clickstream/clickstream-enwiki-2018-03.tsv.gz,Amber_Heard,78467,180212,559,259238,72382
hdfs://spark-nn.eemcs.utwente.nl/user/s1934538/clickstream/clickstream-enwiki-2018-03.tsv.gz,Rihanna,43359,341907,3189,388455,104140
hdfs://spark-nn.eemcs.utwente.nl/user/s1934538/clickstream/clickstream-enwiki-2018-03.tsv.gz,Gaza_Strip,9132,47069,366,56567,13844
hdfs://spark-nn.eemcs.utwente.nl/user/s1934538/clickstream/clickstream-enwiki-2018-03.tsv.gz,Asia_Cup,8650,27568,139,36357,13467
hdfs://spark-nn.eemcs.utwente.nl/user/s1934538/clickstream/clickstream-enwiki-2018-03.tsv.gz,"Diana,_Princess_of_Wales",92925,340481,3207,436613,154767
hdfs://spark-nn.eemcs.utwente.nl/user/s1934538/clickstream/clickstream-enwiki-2018-03.tsv.gz,Amy_Coney_Barrett,924,2702,899,4525,909
hdfs://spark-nn.eemcs.utwente.nl/user/s1934538/clickstream/clickstream-enwiki-2018-03.tsv.gz,Royal_Rumble_(2018),38902,99814,749,139465,73229
hdfs://spark-nn.eemcs.utwente.nl/user/s1934538/clickstream/clickstream-enwiki-2018-03.tsv.gz,Sylvester_Stallone,61689,583043,3509,648241,197773
hdfs://spark-nn.eemcs.utwente.nl/user/s1934538/clickstream/clickstream-enwiki-2018-03.tsv.gz,Brie_Larson,117723,213073,1146,331942,102649
hdfs://spark-nn.eemcs.utwente.nl/user/s1934538/clickstream/clickstream-enwiki-2018-03.tsv.gz,Fyre_Festival,2981,83390,349,86720,29101
hdfs://spark-nn.eemcs.utwente.nl/user/s1934538/clickstream/clickstream-enwiki-2018-03.tsv.gz,Deadpool_2,115959,459077,9838,584874,479669
hdfs://spark-nn.eemcs.utwente.nl/user/s1934538/clickstream/clickstream-enwiki-2018-03.tsv.gz,Antifa_(United_States),9146,111765,146,121057,18533
hdfs://spark-nn.eemcs.utwente.nl/user/s1934538/clickstream/clickstream-enwiki-2018-03.tsv.gz,Johnny_Depp,73656,370456,2071,446183,195146
hdfs://spark-nn.eemcs.utwente.nl/user/s1934538/clickstream/clickstream-enwiki-2018-03.tsv.gz,Freddie_Mercury,42713,445112,2636,490461,109737
hdfs://spark-nn.eemcs.utwente.nl/user/s1934538/clickstream/clickstream-enwiki-2018-03.tsv.gz,Cook's_Country,115,5887,30,6032,73
hdfs://spark-nn.eemcs.utwente.nl/user/s1934538/clickstream/clickstream-enwiki-2018-03.tsv.gz,Dennis_Nilsen,3224,40108,130,43462,5725
hdfs://spark-nn.eemcs.utwente.nl/user/s1934538/clickstream/clickstream-enwiki-2018-03.tsv.gz,Sushma_Swaraj,5312,34360,58,39730,7487
hdfs://spark-nn.eemcs.utwente.nl/user/s1934538/clickstream/clickstream-enwiki-2018-03.tsv.gz,Simple_Mail_Transfer_Protocol,5760,44166,188,50114,6625
hdfs://spark-nn.eemcs.utwente.nl/user/s1934538/clickstream/clickstream-enwiki-2018-03.tsv.gz,Louis_Tomlinson,21184,63093,203,84480,8614
hdfs://spark-nn.eemcs.utwente.nl/user/s1934538/clickstream/clickstream-enwiki-2018-03.tsv.gz,Indian_Premier_League,24553,160305,322,185180,98123
hdfs://spark-nn.eemcs.utwente.nl/user/s1934538/clickstream/clickstream-enwiki-2018-03.tsv.gz,George_H._W._Bush,91578,191052,722,283352,95010
hdfs://spark-nn.eemcs.utwente.nl/user/s1934538/clickstream/clickstream-enwiki-2018-03.tsv.gz,List_of_most_popular_websites,25539,158811,118,184468,75747
hdfs://spark-nn.eemcs.utwente.nl/user/s1934538/clickstream/clickstream-enwiki-2018-03.tsv.gz,2018_Winter_Olympics,65179,277415,3870,346464,169374
hdfs://spark-nn.eemcs.utwente.nl/user/s1934538/clickstream/clickstream-enwiki-2018-03.tsv.gz,Aaron_Carter,8781,54381,295,63457,12888
hdfs://spark-nn.eemcs.utwente.nl/user/s1934538/clickstream/clickstream-enwiki-2018-03.tsv.gz,Saaho,32797,63059,6697,102553,47834
hdfs://spark-nn.eemcs.utwente.nl/user/s1934538/clickstream/clickstream-enwiki-2018-03.tsv.gz,NATO,40064,197022,2175,239261,66151
hdfs://spark-nn.eemcs.utwente.nl/user/s1934538/clickstream/clickstream-enwiki-2018-03.tsv.gz,Game_of_Thrones,52815,468890,10217,531922,253140
hdfs://spark-nn.eemcs.utwente.nl/user/s1934538/clickstream/clickstream-enwiki-2018-03.tsv.gz,Jeffrey_Dahmer,21850,561255,2730,585835,120640
hdfs://spark-nn.eemcs.utwente.nl/user/s1934538/clickstream/clickstream-enwiki-2018-03.tsv.gz,Charles_Sobhraj,2466,22821,34,25321,2961
hdfs://spark-nn.eemcs.utwente.nl/user/s1934538/clickstream/clickstream-enwiki-2018-03.tsv.gz,UEFA_Euro_2020,17096,57399,650,75145,27858
hdfs://spark-nn.eemcs.utwente.nl/user/s1934538/clickstream/clickstream-enwiki-2018-03.tsv.gz,XHamster,7532,7326912,9332,7343776,30617
hdfs://spark-nn.eemcs.utwente.nl/user/s1934538/clickstream/clickstream-enwiki-2018-03.tsv.gz,2018_FIFA_World_Cup,108132,885192,11385,1004709,476970
hdfs://spark-nn.eemcs.utwente.nl/user/s1934538/clickstream/clickstream-enwiki-2018-03.tsv.gz,Michael_Bloomberg,17422,58195,293,75910,21171
hdfs://spark-nn.eemcs.utwente.nl/user/s1934538/clickstream/clickstream-enwiki-2018-03.tsv.gz,Wikipedia,43016,461173,1053,505242,183551
hdfs://spark-nn.eemcs.utwente.nl/user/s1934538/clickstream/clickstream-enwiki-2018-03.tsv.gz,HTTP_cookie,4911,236292,99,241302,17464
hdfs://spark-nn.eemcs.utwente.nl/user/s1934538/clickstream/clickstream-enwiki-2018-03.tsv.gz,FIFA_World_Cup,40591,238075,3338,282004,159690
hdfs://spark-nn.eemcs.utwente.nl/user/s1934538/clickstream/clickstream-enwiki-2018-03.tsv.gz,Aretha_Franklin,11472,130677,906,143055,24416
hdfs://spark-nn.eemcs.utwente.nl/user/s1934538/clickstream/clickstream-enwiki-2018-03.tsv.gz,Article_370_of_the_Constitution_of_India,4075,31680,24,35779,2443
hdfs://spark-nn.eemcs.utwente.nl/user/s1934538/clickstream/clickstream-enwiki-2018-03.tsv.gz,Queen_(band),29475,174117,2154,205746,128104
hdfs://spark-nn.eemcs.utwente.nl/user/s1934538/clickstream/clickstream-enwiki-2018-03.tsv.gz,Hamas,12172,40533,1280,53985,13242
hdfs://spark-nn.eemcs.utwente.nl/user/s1934538/clickstream/clickstream-enwiki-2018-03.tsv.gz,The_Irishman,62,684,45,791,670
hdfs://spark-nn.eemcs.utwente.nl/user/s1934538/clickstream/clickstream-enwiki-2018-03.tsv.gz,Crazy_Rich_Asians_(film),21756,33616,78,55450,48319
hdfs://spark-nn.eemcs.utwente.nl/user/s1934538/clickstream/clickstream-enwiki-2018-03.tsv.gz,Khabib_Nurmagomedov,31713,152693,1233,185639,59477
hdfs://spark-nn.eemcs.utwente.nl/user/s1934538/clickstream/clickstream-enwiki-2018-03.tsv.gz,Lists_of_deaths_by_year,7179,205142,321,212642,139912
hdfs://spark-nn.eemcs.utwente.nl/user/s1934538/clickstream/clickstream-enwiki-2018-03.tsv.gz,Stan_Lee,74903,408060,3477,486440,107938
hdfs://spark-nn.eemcs.utwente.nl/user/s1934538/clickstream/clickstream-enwiki-2018-03.tsv.gz,The_Weeknd,40609,282033,2239,324881,100781
hdfs://spark-nn.eemcs.utwente.nl/user/s1934538/clickstream/clickstream-enwiki-2018-03.tsv.gz,Main_Page,20704,488528002,3203222,491751928,31086188
hdfs://spark-nn.eemcs.utwente.nl/user/s1934538/clickstream/clickstream-enwiki-2018-03.tsv.gz,Bonnie_and_Clyde,12471,237901,1223,251595,36926
hdfs://spark-nn.eemcs.utwente.nl/user/s1934538/clickstream/clickstream-enwiki-2018-03.tsv.gz,Bipin_Rawat,4338,15860,19,20217,4474
hdfs://spark-nn.eemcs.utwente.nl/user/s1934538/clickstream/clickstream-enwiki-2018-03.tsv.gz,Critical_race_theory,1661,16752,30,18443,3285
hdfs://spark-nn.eemcs.utwente.nl/user/s1934538/clickstream/clickstream-enwiki-2018-03.tsv.gz,Sridevi,111936,1538581,31172,1681689,438174
hdfs://spark-nn.eemcs.utwente.nl/user/s1934538/clickstream/clickstream-enwiki-2018-03.tsv.gz,Tina_Turner,12031,238306,1569,251906,41406
hdfs://spark-nn.eemcs.utwente.nl/user/s1934538/clickstream/clickstream-enwiki-2018-03.tsv.gz,Richard_Ramirez,11126,129600,1323,142049,18175
hdfs://spark-nn.eemcs.utwente.nl/user/s1934538/clickstream/clickstream-enwiki-2018-03.tsv.gz,Lance_Reddick,13197,23780,73,37050,5787
hdfs://spark-nn.eemcs.utwente.nl/user/s1934538/clickstream/clickstream-enwiki-2018-03.tsv.gz,Atal_Bihari_Vajpayee,22688,125116,156,147960,23011
hdfs://spark-nn.eemcs.utwente.nl/user/s1934538/clickstream/clickstream-enwiki-2018-03.tsv.gz,Chernobyl_disaster,21983,302386,1187,325556,60773
hdfs://spark-nn.eemcs.utwente.nl/user/s1934538/clickstream/clickstream-enwiki-2018-03.tsv.gz,Qasem_Soleimani,2115,8503,27,10645,3925
hdfs://spark-nn.eemcs.utwente.nl/user/s1934538/clickstream/clickstream-enwiki-2018-03.tsv.gz,The_Nun_(2018_film),39587,93965,258,133810,45717
hdfs://spark-nn.eemcs.utwente.nl/user/s1934538/clickstream/clickstream-enwiki-2018-03.tsv.gz,September_11_attacks,51714,328547,2290,382551,113830
hdfs://spark-nn.eemcs.utwente.nl/user/s1934538/clickstream/clickstream-enwiki-2018-03.tsv.gz,Game_of_Thrones_(season_8),38586,296466,790,335842,89353
hdfs://spark-nn.eemcs.utwente.nl/user/s1934538/clickstream/clickstream-enwiki-2018-03.tsv.gz,Cardi_B,35695,826002,5308,867005,139808
hdfs://spark-nn.eemcs.utwente.nl/user/s1934538/clickstream/clickstream-enwiki-2018-03.tsv.gz,Area_51,10895,197808,1105,209808,38567
hdfs://spark-nn.eemcs.utwente.nl/user/s1934538/clickstream/clickstream-enwiki-2018-03.tsv.gz,Pornhub,40090,458253,7684,506027,59048
hdfs://spark-nn.eemcs.utwente.nl/user/s1934538/clickstream/clickstream-enwiki-2018-03.tsv.gz,Meat_Loaf,18935,99500,576,119011,26747
hdfs://spark-nn.eemcs.utwente.nl/user/s1934538/clickstream/clickstream-enwiki-2018-03.tsv.gz,The_Witcher_(TV_series),4763,29639,89,34491,9264
hdfs://spark-nn.eemcs.utwente.nl/user/s1934538/clickstream/clickstream-enwiki-2018-03.tsv.gz,Central_Park_jogger_case,3077,27207,80,30364,2799
hdfs://spark-nn.eemcs.utwente.nl/user/s1934538/clickstream/clickstream-enwiki-2018-03.tsv.gz,A_Quiet_Place_(film),56808,966380,7595,1030783,176779
hdfs://spark-nn.eemcs.utwente.nl/user/s1934538/clickstream/clickstream-enwiki-2018-03.tsv.gz,2020_Summer_Olympics,41356,110940,1056,153352,52894
hdfs://spark-nn.eemcs.utwente.nl/user/s1934538/clickstream/clickstream-enwiki-2018-03.tsv.gz,Vladimir_Putin,140113,1050860,73289,1264262,453347
hdfs://spark-nn.eemcs.utwente.nl/user/s1934538/clickstream/clickstream-enwiki-2018-03.tsv.gz,William_Murdoch,553,2199,16,2768,288
hdfs://spark-nn.eemcs.utwente.nl/user/s1934538/clickstream/clickstream-enwiki-2018-03.tsv.gz,Deion_Sanders,6355,84661,358,91374,12201
hdfs://spark-nn.eemcs.utwente.nl/user/s1934538/clickstream/clickstream-enwiki-2019-02.tsv.gz,Darth_Vader,18470,654753,565,673788,48176
hdfs://spark-nn.eemcs.utwente.nl/user/s1934538/clickstream/clickstream-enwiki-2019-02.tsv.gz,WrestleMania_34,60951,64186,3540,128677,91037
hdfs://spark-nn.eemcs.utwente.nl/user/s1934538/clickstream/clickstream-enwiki-2019-02.tsv.gz,The_Mandalorian,26707,31510,259,58476,43846
hdfs://spark-nn.eemcs.utwente.nl/user/s1934538/clickstream/clickstream-enwiki-2019-02.tsv.gz,Stranger_Things,41749,211959,5351,259059,185763
hdfs://spark-nn.eemcs.utwente.nl/user/s1934538/clickstream/clickstream-enwiki-2019-02.tsv.gz,Naya_Rivera,21840,35137,76,57053,12050
hdfs://spark-nn.eemcs.utwente.nl/user/s1934538/clickstream/clickstream-enwiki-2019-02.tsv.gz,Nipsey_Hussle,25514,84561,279,110354,50821
hdfs://spark-nn.eemcs.utwente.nl/user/s1934538/clickstream/clickstream-enwiki-2019-02.tsv.gz,List_of_awards_and_nominations_received_by_Meryl_Streep,21146,18479,111,39736,13316
hdfs://spark-nn.eemcs.utwente.nl/user/s1934538/clickstream/clickstream-enwiki-2019-02.tsv.gz,Microsoft_Office,8908,77222,673,86803,24272
hdfs://spark-nn.eemcs.utwente.nl/user/s1934538/clickstream/clickstream-enwiki-2019-02.tsv.gz,Central_Park_jogger_case,4550,44893,198,49641,4661
hdfs://spark-nn.eemcs.utwente.nl/user/s1934538/clickstream/clickstream-enwiki-2019-02.tsv.gz,Jimmy_Hoffa,38743,77378,613,116734,40681
hdfs://spark-nn.eemcs.utwente.nl/user/s1934538/clickstream/clickstream-enwiki-2019-02.tsv.gz,Simone_Biles,9936,61302,257,71495,14236
hdfs://spark-nn.eemcs.utwente.nl/user/s1934538/clickstream/clickstream-enwiki-2019-02.tsv.gz,List_of_FIFA_World_Cup_finals,1368,42238,51,43657,10170
hdfs://spark-nn.eemcs.utwente.nl/user/s1934538/clickstream/clickstream-enwiki-2019-02.tsv.gz,Critical_race_theory,1566,15479,34,17079,3409
hdfs://spark-nn.eemcs.utwente.nl/user/s1934538/clickstream/clickstream-enwiki-2019-02.tsv.gz,Article_370_of_the_Constitution_of_India,49456,585846,429,635731,34206
hdfs://spark-nn.eemcs.utwente.nl/user/s1934538/clickstream/clickstream-enwiki-2019-02.tsv.gz,Avengers:_Infinity_War,159252,299396,7631,466279,322912
hdfs://spark-nn.eemcs.utwente.nl/user/s1934538/clickstream/clickstream-enwiki-2019-02.tsv.gz,XHamster,7011,3257166,1927,3266104,29469
hdfs://spark-nn.eemcs.utwente.nl/user/s1934538/clickstream/clickstream-enwiki-2019-02.tsv.gz,Gaza_Strip,12456,31769,306,44531,16407
hdfs://spark-nn.eemcs.utwente.nl/user/s1934538/clickstream/clickstream-enwiki-2019-02.tsv.gz,Glass_(2019_film),165137,605500,13684,784321,270803
hdfs://spark-nn.eemcs.utwente.nl/user/s1934538/clickstream/clickstream-enwiki-2019-02.tsv.gz,Afghanistan,45097,156338,4061,205496,136093
hdfs://spark-nn.eemcs.utwente.nl/user/s1934538/clickstream/clickstream-enwiki-2019-02.tsv.gz,Salman_Rushdie,35617,104797,6441,146855,69839
hdfs://spark-nn.eemcs.utwente.nl/user/s1934538/clickstream/clickstream-enwiki-2019-02.tsv.gz,2020_United_States_presidential_election,109250,447694,9557,566501,445630
hdfs://spark-nn.eemcs.utwente.nl/user/s1934538/clickstream/clickstream-enwiki-2019-02.tsv.gz,Kate_Spade,32521,84379,642,117542,38141
hdfs://spark-nn.eemcs.utwente.nl/user/s1934538/clickstream/clickstream-enwiki-2019-02.tsv.gz,Ray_Liotta,26593,66797,402,93792,26877
hdfs://spark-nn.eemcs.utwente.nl/user/s1934538/clickstream/clickstream-enwiki-2019-02.tsv.gz,Rishi_Sunak,2603,2197,11,4811,877
hdfs://spark-nn.eemcs.utwente.nl/user/s1934538/clickstream/clickstream-enwiki-2019-02.tsv.gz,Cardi_B,112779,1553905,16037,1682721,600916
hdfs://spark-nn.eemcs.utwente.nl/user/s1934538/clickstream/clickstream-enwiki-2019-02.tsv.gz,List_of_highest-grossing_films,142426,339662,1767,483855,223589
hdfs://spark-nn.eemcs.utwente.nl/user/s1934538/clickstream/clickstream-enwiki-2019-02.tsv.gz,Manti_Te'o,3059,17751,86,20896,754
hdfs://spark-nn.eemcs.utwente.nl/user/s1934538/clickstream/clickstream-enwiki-2019-02.tsv.gz,Once_Upon_a_Time_in_Hollywood,163333,83302,1138,247773,237625
hdfs://spark-nn.eemcs.utwente.nl/user/s1934538/clickstream/clickstream-enwiki-2019-02.tsv.gz,Lists_of_deaths_by_year,14587,284154,525,299266,280899
hdfs://spark-nn.eemcs.utwente.nl/user/s1934538/clickstream/clickstream-enwiki-2019-02.tsv.gz,Juice_Wrld,15526,111020,2803,129349,43614
hdfs://spark-nn.eemcs.utwente.nl/user/s1934538/clickstream/clickstream-enwiki-2019-02.tsv.gz,Ruth_Bader_Ginsburg,63631,417058,2917,483606,166809
hdfs://spark-nn.eemcs.utwente.nl/user/s1934538/clickstream/clickstream-enwiki-2019-02.tsv.gz,David_Beckham,32483,195853,1290,229626,73152
hdfs://spark-nn.eemcs.utwente.nl/user/s1934538/clickstream/clickstream-enwiki-2019-02.tsv.gz,Kim_Jong-un,44557,228633,3163,276353,138484
hdfs://spark-nn.eemcs.utwente.nl/user/s1934538/clickstream/clickstream-enwiki-2019-02.tsv.gz,Pornhub,34727,324917,10496,370140,65510
hdfs://spark-nn.eemcs.utwente.nl/user/s1934538/clickstream/clickstream-enwiki-2019-02.tsv.gz,List_of_most_popular_websites,19157,78431,175,97763,44826
hdfs://spark-nn.eemcs.utwente.nl/user/s1934538/clickstream/clickstream-enwiki-2019-02.tsv.gz,Brett_Kavanaugh,32771,88799,1127,122697,37995
hdfs://spark-nn.eemcs.utwente.nl/user/s1934538/clickstream/clickstream-enwiki-2019-02.tsv.gz,Irrfan_Khan,22326,43222,129,65677,29636
hdfs://spark-nn.eemcs.utwente.nl/user/s1934538/clickstream/clickstream-enwiki-2019-02.tsv.gz,United_States_Senate,60538,75881,1074,137493,57736
hdfs://spark-nn.eemcs.utwente.nl/user/s1934538/clickstream/clickstream-enwiki-2019-02.tsv.gz,Cleopatra,36638,173783,2184,212605,83829
hdfs://spark-nn.eemcs.utwente.nl/user/s1934538/clickstream/clickstream-enwiki-2019-02.tsv.gz,Mulan_(2020_film),32233,37773,375,70381,80871
hdfs://spark-nn.eemcs.utwente.nl/user/s1934538/clickstream/clickstream-enwiki-2019-02.tsv.gz,Coronavirus,900,15804,80,16784,1766
hdfs://spark-nn.eemcs.utwente.nl/user/s1934538/clickstream/clickstream-enwiki-2019-02.tsv.gz,2018_Asian_Games,7702,29188,131,37021,18365
hdfs://spark-nn.eemcs.utwente.nl/user/s1934538/clickstream/clickstream-enwiki-2019-02.tsv.gz,Stranger_Things_(season_3),7310,2655,249,10214,8528
hdfs://spark-nn.eemcs.utwente.nl/user/s1934538/clickstream/clickstream-enwiki-2019-02.tsv.gz,Rami_Malek,472607,2990041,71685,3534333,1255420
hdfs://spark-nn.eemcs.utwente.nl/user/s1934538/clickstream/clickstream-enwiki-2019-02.tsv.gz,Lionel_Messi,60880,563690,5835,630405,125790
hdfs://spark-nn.eemcs.utwente.nl/user/s1934538/clickstream/clickstream-enwiki-2019-02.tsv.gz,XXX:_Return_of_Xander_Cage,29198,86145,638,115981,35421
hdfs://spark-nn.eemcs.utwente.nl/user/s1934538/clickstream/clickstream-enwiki-2019-02.tsv.gz,2018_Winter_Olympics,30249,44113,733,75095,45238
hdfs://spark-nn.eemcs.utwente.nl/user/s1934538/clickstream/clickstream-enwiki-2019-02.tsv.gz,Godzilla_vs._Kong,46632,17993,130,64755,49079
hdfs://spark-nn.eemcs.utwente.nl/user/s1934538/clickstream/clickstream-enwiki-2019-02.tsv.gz,Lance_Reddick,15337,18254,94,33685,8317
hdfs://spark-nn.eemcs.utwente.nl/user/s1934538/clickstream/clickstream-enwiki-2019-02.tsv.gz,Richard_Jewell,6054,37788,219,44061,9451
hdfs://spark-nn.eemcs.utwente.nl/user/s1934538/clickstream/clickstream-enwiki-2019-02.tsv.gz,R._Kelly,61966,878394,8968,949328,400464
hdfs://spark-nn.eemcs.utwente.nl/user/s1934538/clickstream/clickstream-enwiki-2019-02.tsv.gz,2016_United_States_presidential_election,102419,208201,2862,313482,221324
hdfs://spark-nn.eemcs.utwente.nl/user/s1934538/clickstream/clickstream-enwiki-2019-02.tsv.gz,Rihanna,65067,324182,3870,393119,155792
hdfs://spark-nn.eemcs.utwente.nl/user/s1934538/clickstream/clickstream-enwiki-2019-02.tsv.gz,Captain_Marvel_(film),166219,707266,22352,895837,465276
hdfs://spark-nn.eemcs.utwente.nl/user/s1934538/clickstream/clickstream-enwiki-2019-02.tsv.gz,"Princess_Margaret,_Countess_of_Snowdon",117520,498283,3791,619594,365127
hdfs://spark-nn.eemcs.utwente.nl/user/s1934538/clickstream/clickstream-enwiki-2019-02.tsv.gz,Top_Gun:_Maverick,70557,49623,377,120557,90657
hdfs://spark-nn.eemcs.utwente.nl/user/s1934538/clickstream/clickstream-enwiki-2019-02.tsv.gz,Bible,15052,78157,1441,94650,31165
hdfs://spark-nn.eemcs.utwente.nl/user/s1934538/clickstream/clickstream-enwiki-2019-02.tsv.gz,Game_of_Thrones,117824,630874,16623,765321,588087
hdfs://spark-nn.eemcs.utwente.nl/user/s1934538/clickstream/clickstream-enwiki-2019-02.tsv.gz,Hamas,16105,33873,649,50627,18252
hdfs://spark-nn.eemcs.utwente.nl/user/s1934538/clickstream/clickstream-enwiki-2019-02.tsv.gz,Puneeth_Rajkumar,12366,28953,36,41355,22706
hdfs://spark-nn.eemcs.utwente.nl/user/s1934538/clickstream/clickstream-enwiki-2019-02.tsv.gz,Sylvester_Stallone,86202,359192,2077,447471,298540
hdfs://spark-nn.eemcs.utwente.nl/user/s1934538/clickstream/clickstream-enwiki-2019-02.tsv.gz,September_11_attacks,77385,326869,9096,413350,171344
hdfs://spark-nn.eemcs.utwente.nl/user/s1934538/clickstream/clickstream-enwiki-2019-02.tsv.gz,Eddie_Van_Halen,32697,42371,334,75402,35753
hdfs://spark-nn.eemcs.utwente.nl/user/s1934538/clickstream/clickstream-enwiki-2019-02.tsv.gz,"Meghan,_Duchess_of_Sussex",93346,440301,3091,536738,261185
hdfs://spark-nn.eemcs.utwente.nl/user/s1934538/clickstream/clickstream-enwiki-2019-02.tsv.gz,Christopher_Scarver,105871,33916,12,139799,45617
hdfs://spark-nn.eemcs.utwente.nl/user/s1934538/clickstream/clickstream-enwiki-2019-02.tsv.gz,Cricket_World_Cup,9785,111924,778,122487,70370
hdfs://spark-nn.eemcs.utwente.nl/user/s1934538/clickstream/clickstream-enwiki-2019-02.tsv.gz,Jeffrey_Epstein,10610,201898,1156,213664,65039
hdfs://spark-nn.eemcs.utwente.nl/user/s1934538/clickstream/clickstream-enwiki-2019-02.tsv.gz,Bob_Saget,17756,32514,183,50453,9256
hdfs://spark-nn.eemcs.utwente.nl/user/s1934538/clickstream/clickstream-enwiki-2019-02.tsv.gz,Louis_Tomlinson,26025,53316,318,79659,11829
hdfs://spark-nn.eemcs.utwente.nl/user/s1934538/clickstream/clickstream-enwiki-2019-02.tsv.gz,Aaron_Hernandez,18985,215980,1919,236884,73181
hdfs://spark-nn.eemcs.utwente.nl/user/s1934538/clickstream/clickstream-enwiki-2019-02.tsv.gz,NATO,41486,144140,4512,190138,65547
hdfs://spark-nn.eemcs.utwente.nl/user/s1934538/clickstream/clickstream-enwiki-2019-02.tsv.gz,2.0_(film),49476,294293,1571,345340,66911
hdfs://spark-nn.eemcs.utwente.nl/user/s1934538/clickstream/clickstream-enwiki-2019-02.tsv.gz,Elon_Musk,106546,675198,5104,786848,497927
hdfs://spark-nn.eemcs.utwente.nl/user/s1934538/clickstream/clickstream-enwiki-2019-02.tsv.gz,Olivia_Newton-John,33106,481467,2307,516880,248725
hdfs://spark-nn.eemcs.utwente.nl/user/s1934538/clickstream/clickstream-enwiki-2019-02.tsv.gz,Hamilton_(musical),30235,242149,1544,273928,144660
hdfs://spark-nn.eemcs.utwente.nl/user/s1934538/clickstream/clickstream-enwiki-2019-02.tsv.gz,Greta_Thunberg,3419,86499,694,90612,32905
hdfs://spark-nn.eemcs.utwente.nl/user/s1934538/clickstream/clickstream-enwiki-2019-02.tsv.gz,Royal_Rumble_(2018),17126,16242,343,33711,22610
hdfs://spark-nn.eemcs.utwente.nl/user/s1934538/clickstream/clickstream-enwiki-2019-02.tsv.gz,Bipin_Rawat,19977,48137,184,68298,25519
hdfs://spark-nn.eemcs.utwente.nl/user/s1934538/clickstream/clickstream-enwiki-2019-02.tsv.gz,Ted_Bundy,90973,4530888,32375,4654236,1041602
hdfs://spark-nn.eemcs.utwente.nl/user/s1934538/clickstream/clickstream-enwiki-2019-02.tsv.gz,Notre-Dame_de_Paris,8313,58325,363,67001,11568
hdfs://spark-nn.eemcs.utwente.nl/user/s1934538/clickstream/clickstream-enwiki-2019-02.tsv.gz,Wikipedia,44845,488374,1147,534366,193970
hdfs://spark-nn.eemcs.utwente.nl/user/s1934538/clickstream/clickstream-enwiki-2019-02.tsv.gz,Juneteenth,2264,31693,67,34024,3669
hdfs://spark-nn.eemcs.utwente.nl/user/s1934538/clickstream/clickstream-enwiki-2019-02.tsv.gz,Joe_Biden,52452,224774,4103,281329,83462
hdfs://spark-nn.eemcs.utwente.nl/user/s1934538/clickstream/clickstream-enwiki-2019-02.tsv.gz,Bonnie_and_Clyde,25273,226657,1985,253915,71553
hdfs://spark-nn.eemcs.utwente.nl/user/s1934538/clickstream/clickstream-enwiki-2019-02.tsv.gz,Keanu_Reeves,69604,559578,3276,632458,278253
hdfs://spark-nn.eemcs.utwente.nl/user/s1934538/clickstream/clickstream-enwiki-2019-02.tsv.gz,Hyphen-minus,5364,34759460,6869376,41634200,1062
hdfs://spark-nn.eemcs.utwente.nl/user/s1934538/clickstream/clickstream-enwiki-2019-02.tsv.gz,A_Quiet_Place_(film),33559,266816,3113,303488,85679
hdfs://spark-nn.eemcs.utwente.nl/user/s1934538/clickstream/clickstream-enwiki-2019-02.tsv.gz,Antifa_(United_States),8574,95633,204,104411,15172
hdfs://spark-nn.eemcs.utwente.nl/user/s1934538/clickstream/clickstream-enwiki-2019-02.tsv.gz,George_VI,342691,181630,5688,530009,368211
hdfs://spark-nn.eemcs.utwente.nl/user/s1934538/clickstream/clickstream-enwiki-2019-02.tsv.gz,Jimmy_Buffett,7101,43514,465,51080,15331
hdfs://spark-nn.eemcs.utwente.nl/user/s1934538/clickstream/clickstream-enwiki-2019-02.tsv.gz,Joker_(2019_film),98773,103832,593,203198,123862
hdfs://spark-nn.eemcs.utwente.nl/user/s1934538/clickstream/clickstream-enwiki-2019-02.tsv.gz,Meat_Loaf,15155,63240,724,79119,28763
hdfs://spark-nn.eemcs.utwente.nl/user/s1934538/clickstream/clickstream-enwiki-2019-02.tsv.gz,"Prince_Philip,_Duke_of_Edinburgh",185717,258727,6434,450878,268011
hdfs://spark-nn.eemcs.utwente.nl/user/s1934538/clickstream/clickstream-enwiki-2019-02.tsv.gz,A_Star_Is_Born_(2018_film),247421,1680835,16644,1944900,1014057
hdfs://spark-nn.eemcs.utwente.nl/user/s1934538/clickstream/clickstream-enwiki-2019-02.tsv.gz,Joaquin_Phoenix,124326,134109,885,259320,183265
hdfs://spark-nn.eemcs.utwente.nl/user/s1934538/clickstream/clickstream-enwiki-2019-02.tsv.gz,Us_(2019_film),69198,279408,1383,349989,177348
hdfs://spark-nn.eemcs.utwente.nl/user/s1934538/clickstream/clickstream-enwiki-2019-02.tsv.gz,Jeffrey_Dahmer,42128,581104,7363,630595,256194
hdfs://spark-nn.eemcs.utwente.nl/user/s1934538/clickstream/clickstream-enwiki-2019-02.tsv.gz,Jason_Momoa,272067,1016215,4395,1292677,566841
hdfs://spark-nn.eemcs.utwente.nl/user/s1934538/clickstream/clickstream-enwiki-2019-02.tsv.gz,Spider-Man:_Far_From_Home,111322,111528,2168,225018,152051
hdfs://spark-nn.eemcs.utwente.nl/user/s1934538/clickstream/clickstream-enwiki-2019-02.tsv.gz,Cameron_Boyce,11007,28742,83,39832,8532
hdfs://spark-nn.eemcs.utwente.nl/user/s1934538/clickstream/clickstream-enwiki-2019-02.tsv.gz,Amy_Coney_Barrett,1763,10088,120,11971,2828
hdfs://spark-nn.eemcs.utwente.nl/user/s1934538/clickstream/clickstream-enwiki-2019-02.tsv.gz,Key_frame,605,5845,17,6467,659
hdfs://spark-nn.eemcs.utwente.nl/user/s1934538/clickstream/clickstream-enwiki-2019-02.tsv.gz,Stan_Lee,56704,223469,2268,282441,78123
hdfs://spark-nn.eemcs.utwente.nl/user/s1934538/clickstream/clickstream-enwiki-2019-02.tsv.gz,Charles_Sobhraj,3177,33041,117,36335,7580
hdfs://spark-nn.eemcs.utwente.nl/user/s1934538/clickstream/clickstream-enwiki-2019-02.tsv.gz,Tom_Brady,264807,2496252,23427,2784486,1059413
hdfs://spark-nn.eemcs.utwente.nl/user/s1934538/clickstream/clickstream-enwiki-2019-02.tsv.gz,Adele,28781,176480,2367,207628,64945
hdfs://spark-nn.eemcs.utwente.nl/user/s1934538/clickstream/clickstream-enwiki-2019-02.tsv.gz,Game_of_Thrones_(season_8),66696,357739,2323,426758,155761
hdfs://spark-nn.eemcs.utwente.nl/user/s1934538/clickstream/clickstream-enwiki-2019-02.tsv.gz,JSON_Web_Token,1122,20840,33,21995,2010
hdfs://spark-nn.eemcs.utwente.nl/user/s1934538/clickstream/clickstream-enwiki-2019-02.tsv.gz,Kelly_Preston,69837,44736,126,114699,31184
hdfs://spark-nn.eemcs.utwente.nl/user/s1934538/clickstream/clickstream-enwiki-2019-02.tsv.gz,Luke_Perry,28871,284043,2607,315521,45124
hdfs://spark-nn.eemcs.utwente.nl/user/s1934538/clickstream/clickstream-enwiki-2019-02.tsv.gz,Kamala_Harris,73679,996144,10385,1080208,363642
hdfs://spark-nn.eemcs.utwente.nl/user/s1934538/clickstream/clickstream-enwiki-2019-02.tsv.gz,FIFA_World_Cup,29839,92905,1492,124236,99782
hdfs://spark-nn.eemcs.utwente.nl/user/s1934538/clickstream/clickstream-enwiki-2019-02.tsv.gz,Khabib_Nurmagomedov,45622,132716,1486,179824,83520
hdfs://spark-nn.eemcs.utwente.nl/user/s1934538/clickstream/clickstream-enwiki-2019-02.tsv.gz,RRR_(film),39392,30075,47,69514,23778
hdfs://spark-nn.eemcs.utwente.nl/user/s1934538/clickstream/clickstream-enwiki-2019-02.tsv.gz,The_Witcher_(TV_series),14100,37938,260,52298,26314
hdfs://spark-nn.eemcs.utwente.nl/user/s1934538/clickstream/clickstream-enwiki-2019-02.tsv.gz,Elizabeth_II,410500,602827,9374,1022701,783145
hdfs://spark-nn.eemcs.utwente.nl/user/s1934538/clickstream/clickstream-enwiki-2019-02.tsv.gz,Cecil_Hotel_(Los_Angeles),4273,17118,12,21403,7499
hdfs://spark-nn.eemcs.utwente.nl/user/s1934538/clickstream/clickstream-enwiki-2019-02.tsv.gz,J._Robert_Oppenheimer,15996,84908,289,101193,32151
hdfs://spark-nn.eemcs.utwente.nl/user/s1934538/clickstream/clickstream-enwiki-2019-02.tsv.gz,George_H._W._Bush,124866,157280,1278,283424,140737
hdfs://spark-nn.eemcs.utwente.nl/user/s1934538/clickstream/clickstream-enwiki-2019-02.tsv.gz,UEFA_Euro_2020,21093,83441,1190,105724,38882
hdfs://spark-nn.eemcs.utwente.nl/user/s1934538/clickstream/clickstream-enwiki-2019-02.tsv.gz,Betty_White,50408,217536,2181,270125,64328
hdfs://spark-nn.eemcs.utwente.nl/user/s1934538/clickstream/clickstream-enwiki-2019-02.tsv.gz,Aquaman_(film),114412,679760,16302,810474,440600
hdfs://spark-nn.eemcs.utwente.nl/user/s1934538/clickstream/clickstream-enwiki-2019-02.tsv.gz,Alexander_Hamilton,69848,285454,2071,357373,157315
hdfs://spark-nn.eemcs.utwente.nl/user/s1934538/clickstream/clickstream-enwiki-2019-02.tsv.gz,Stephen_Hawking,31376,410694,2919,444989,172919
hdfs://spark-nn.eemcs.utwente.nl/user/s1934538/clickstream/clickstream-enwiki-2019-02.tsv.gz,Chernobyl_(miniseries),3013,12580,60,15653,5821
hdfs://spark-nn.eemcs.utwente.nl/user/s1934538/clickstream/clickstream-enwiki-2020-07.tsv.gz,Cameron_Boyce,41531,509434,2641,553606,132844
hdfs://spark-nn.eemcs.utwente.nl/user/s1934538/clickstream/clickstream-enwiki-2020-07.tsv.gz,Venom_(2018_film),25080,115798,1621,142499,64182
hdfs://spark-nn.eemcs.utwente.nl/user/s1934538/clickstream/clickstream-enwiki-2020-07.tsv.gz,Michael_Bloomberg,48922,58304,717,107943,45323
hdfs://spark-nn.eemcs.utwente.nl/user/s1934538/clickstream/clickstream-enwiki-2020-07.tsv.gz,Tunnel,2974,8611,82,11667,3398
hdfs://spark-nn.eemcs.utwente.nl/user/s1934538/clickstream/clickstream-enwiki-2020-07.tsv.gz,2022_FIFA_World_Cup,58725,114629,2036,175390,96640
hdfs://spark-nn.eemcs.utwente.nl/user/s1934538/clickstream/clickstream-enwiki-2020-07.tsv.gz,Laal_Singh_Chaddha,34055,26748,19,60822,33710
hdfs://spark-nn.eemcs.utwente.nl/user/s1934538/clickstream/clickstream-enwiki-2020-07.tsv.gz,The_Queen's_Gambit_(miniseries),1956,897,28,2881,724
hdfs://spark-nn.eemcs.utwente.nl/user/s1934538/clickstream/clickstream-enwiki-2020-07.tsv.gz,JSON_Web_Token,888,28139,41,29068,1975
hdfs://spark-nn.eemcs.utwente.nl/user/s1934538/clickstream/clickstream-enwiki-2020-07.tsv.gz,Mortal_Kombat_(2021_film),27627,51228,233,79088,130928
hdfs://spark-nn.eemcs.utwente.nl/user/s1934538/clickstream/clickstream-enwiki-2020-07.tsv.gz,Deion_Sanders,8972,95083,549,104604,28659
hdfs://spark-nn.eemcs.utwente.nl/user/s1934538/clickstream/clickstream-enwiki-2020-07.tsv.gz,Tina_Turner,23858,235986,2198,262042,79597
hdfs://spark-nn.eemcs.utwente.nl/user/s1934538/clickstream/clickstream-enwiki-2020-07.tsv.gz,Luke_Perry,47735,155711,639,204085,59170
hdfs://spark-nn.eemcs.utwente.nl/user/s1934538/clickstream/clickstream-enwiki-2020-07.tsv.gz,Grover,1396,5857,493,7746,1634
hdfs://spark-nn.eemcs.utwente.nl/user/s1934538/clickstream/clickstream-enwiki-2020-07.tsv.gz,Stranger_Things,67039,352474,6924,426437,326565
hdfs://spark-nn.eemcs.utwente.nl/user/s1934538/clickstream/clickstream-enwiki-2020-07.tsv.gz,Microsoft_Office,9326,966701,634,976661,22162
hdfs://spark-nn.eemcs.utwente.nl/user/s1934538/clickstream/clickstream-enwiki-2020-07.tsv.gz,Cardi_B,44124,252252,4772,301148,97097
hdfs://spark-nn.eemcs.utwente.nl/user/s1934538/clickstream/clickstream-enwiki-2020-07.tsv.gz,Joker_(2019_film),69437,373526,3750,446713,183433
hdfs://spark-nn.eemcs.utwente.nl/user/s1934538/clickstream/clickstream-enwiki-2020-07.tsv.gz,Rihanna,74535,273295,3508,351338,170828
hdfs://spark-nn.eemcs.utwente.nl/user/s1934538/clickstream/clickstream-enwiki-2020-07.tsv.gz,List_of_James_Bond_films,62790,411605,326,474721,283089
hdfs://spark-nn.eemcs.utwente.nl/user/s1934538/clickstream/clickstream-enwiki-2020-07.tsv.gz,Aquaman_(film),51085,158665,1695,211445,103920
hdfs://spark-nn.eemcs.utwente.nl/user/s1934538/clickstream/clickstream-enwiki-2020-07.tsv.gz,Irrfan_Khan,46276,117746,322,164344,57034
hdfs://spark-nn.eemcs.utwente.nl/user/s1934538/clickstream/clickstream-enwiki-2020-07.tsv.gz,Roe_v._Wade,18124,74854,457,93435,31629
hdfs://spark-nn.eemcs.utwente.nl/user/s1934538/clickstream/clickstream-enwiki-2020-07.tsv.gz,List_of_FIFA_World_Cup_finals,3005,54433,72,57510,19819
hdfs://spark-nn.eemcs.utwente.nl/user/s1934538/clickstream/clickstream-enwiki-2020-07.tsv.gz,Spanish_flu,76968,903439,9382,989789,200315
hdfs://spark-nn.eemcs.utwente.nl/user/s1934538/clickstream/clickstream-enwiki-2020-07.tsv.gz,Salman_Rushdie,61194,93246,616,155056,57803
hdfs://spark-nn.eemcs.utwente.nl/user/s1934538/clickstream/clickstream-enwiki-2020-07.tsv.gz,XXX:_Return_of_Xander_Cage,36894,289293,1063,327250,61209
hdfs://spark-nn.eemcs.utwente.nl/user/s1934538/clickstream/clickstream-enwiki-2020-07.tsv.gz,Rishi_Sunak,20785,267948,1582,290315,125734
hdfs://spark-nn.eemcs.utwente.nl/user/s1934538/clickstream/clickstream-enwiki-2020-07.tsv.gz,List_of_highest-grossing_Indian_films,60719,207066,109,267894,155618
hdfs://spark-nn.eemcs.utwente.nl/user/s1934538/clickstream/clickstream-enwiki-2020-07.tsv.gz,Jenna_Ortega,16530,27091,1755,45376,9259
hdfs://spark-nn.eemcs.utwente.nl/user/s1934538/clickstream/clickstream-enwiki-2020-07.tsv.gz,Killing_of_George_Floyd,90795,324832,1229,416856,161369
hdfs://spark-nn.eemcs.utwente.nl/user/s1934538/clickstream/clickstream-enwiki-2020-07.tsv.gz,Murder_of_Dee_Dee_Blanchard,18879,136929,593,156401,28091
hdfs://spark-nn.eemcs.utwente.nl/user/s1934538/clickstream/clickstream-enwiki-2020-07.tsv.gz,Betty_White,77913,297290,3543,378746,116754
hdfs://spark-nn.eemcs.utwente.nl/user/s1934538/clickstream/clickstream-enwiki-2020-07.tsv.gz,Manti_Te'o,3443,15932,131,19506,2399
hdfs://spark-nn.eemcs.utwente.nl/user/s1934538/clickstream/clickstream-enwiki-2020-07.tsv.gz,Khabib_Nurmagomedov,91200,371037,3252,465489,219783
hdfs://spark-nn.eemcs.utwente.nl/user/s1934538/clickstream/clickstream-enwiki-2020-07.tsv.gz,Shinzo_Abe,38645,33329,360,72334,41783
hdfs://spark-nn.eemcs.utwente.nl/user/s1934538/clickstream/clickstream-enwiki-2020-07.tsv.gz,Cristiano_Ronaldo,155217,999836,7364,1162417,284380
hdfs://spark-nn.eemcs.utwente.nl/user/s1934538/clickstream/clickstream-enwiki-2020-07.tsv.gz,The_Irishman,66858,166082,2685,235625,207455
hdfs://spark-nn.eemcs.utwente.nl/user/s1934538/clickstream/clickstream-enwiki-2020-07.tsv.gz,Asia_Cup,1089,16676,105,17870,10610
hdfs://spark-nn.eemcs.utwente.nl/user/s1934538/clickstream/clickstream-enwiki-2020-07.tsv.gz,Cecil_Hotel_(Los_Angeles),5350,18497,40,23887,9411
hdfs://spark-nn.eemcs.utwente.nl/user/s1934538/clickstream/clickstream-enwiki-2020-07.tsv.gz,Joe_Exotic,32746,180653,780,214179,56284
hdfs://spark-nn.eemcs.utwente.nl/user/s1934538/clickstream/clickstream-enwiki-2020-07.tsv.gz,Sushma_Swaraj,6357,22365,122,28844,7800
hdfs://spark-nn.eemcs.utwente.nl/user/s1934538/clickstream/clickstream-enwiki-2020-07.tsv.gz,Saaho,29402,81489,307,111198,36186
hdfs://spark-nn.eemcs.utwente.nl/user/s1934538/clickstream/clickstream-enwiki-2020-07.tsv.gz,The_Haunting_of_Bly_Manor,29874,23410,80,53364,42205
hdfs://spark-nn.eemcs.utwente.nl/user/s1934538/clickstream/clickstream-enwiki-2020-07.tsv.gz,Area_51,23143,168940,1421,193504,49327
hdfs://spark-nn.eemcs.utwente.nl/user/s1934538/clickstream/clickstream-enwiki-2020-07.tsv.gz,Once_Upon_a_Time_in_Hollywood,117592,311088,4311,432991,457035
hdfs://spark-nn.eemcs.utwente.nl/user/s1934538/clickstream/clickstream-enwiki-2020-07.tsv.gz,Black_Panther_(film),50252,148537,2264,201053,122728
hdfs://spark-nn.eemcs.utwente.nl/user/s1934538/clickstream/clickstream-enwiki-2020-07.tsv.gz,Croatia,45721,145997,2259,193977,72796
hdfs://spark-nn.eemcs.utwente.nl/user/s1934538/clickstream/clickstream-enwiki-2020-07.tsv.gz,Chernobyl_disaster,56507,413944,3373,473824,181078
hdfs://spark-nn.eemcs.utwente.nl/user/s1934538/clickstream/clickstream-enwiki-2020-07.tsv.gz,Anthony_Bourdain,20660,281943,2098,304701,98533
hdfs://spark-nn.eemcs.utwente.nl/user/s1934538/clickstream/clickstream-enwiki-2020-07.tsv.gz,Tom_Brady,54520,158669,1414,214603,82978
hdfs://spark-nn.eemcs.utwente.nl/user/s1934538/clickstream/clickstream-enwiki-2020-07.tsv.gz,Meat_Loaf,24037,80527,697,105261,35866
hdfs://spark-nn.eemcs.utwente.nl/user/s1934538/clickstream/clickstream-enwiki-2020-07.tsv.gz,Darth_Vader,30769,84594,768,116131,72630
hdfs://spark-nn.eemcs.utwente.nl/user/s1934538/clickstream/clickstream-enwiki-2020-07.tsv.gz,Zack_Snyder's_Justice_League,138251,93732,4051,236034,98488
hdfs://spark-nn.eemcs.utwente.nl/user/s1934538/clickstream/clickstream-enwiki-2020-07.tsv.gz,Ruth_Bader_Ginsburg,54256,567109,4478,625843,213655
hdfs://spark-nn.eemcs.utwente.nl/user/s1934538/clickstream/clickstream-enwiki-2020-07.tsv.gz,Army_of_the_Dead,32488,10373,138,42999,28378
hdfs://spark-nn.eemcs.utwente.nl/user/s1934538/clickstream/clickstream-enwiki-2020-07.tsv.gz,2018_FIFA_World_Cup,98667,163411,1806,263884,150969
hdfs://spark-nn.eemcs.utwente.nl/user/s1934538/clickstream/clickstream-enwiki-2020-07.tsv.gz,Richard_Jewell,24086,135780,574,160440,55364
hdfs://spark-nn.eemcs.utwente.nl/user/s1934538/clickstream/clickstream-enwiki-2020-07.tsv.gz,Keanu_Reeves,115392,550663,3150,669205,388510
hdfs://spark-nn.eemcs.utwente.nl/user/s1934538/clickstream/clickstream-enwiki-2020-07.tsv.gz,Critical_race_theory,6693,69740,388,76821,26944
hdfs://spark-nn.eemcs.utwente.nl/user/s1934538/clickstream/clickstream-enwiki-2020-07.tsv.gz,A_Quiet_Place_(film),28591,114505,794,143890,45920
hdfs://spark-nn.eemcs.utwente.nl/user/s1934538/clickstream/clickstream-enwiki-2020-07.tsv.gz,Mulan_(2020_film),36526,253467,17420,307413,127910
hdfs://spark-nn.eemcs.utwente.nl/user/s1934538/clickstream/clickstream-enwiki-2020-07.tsv.gz,A_Star_Is_Born_(2018_film),44078,165108,764,209950,91431
hdfs://spark-nn.eemcs.utwente.nl/user/s1934538/clickstream/clickstream-enwiki-2020-07.tsv.gz,Russo-Ukrainian_War,17486,27091,70,44647,26620
hdfs://spark-nn.eemcs.utwente.nl/user/s1934538/clickstream/clickstream-enwiki-2020-07.tsv.gz,Article_370_of_the_Constitution_of_India,4042,54901,34,58977,4965
hdfs://spark-nn.eemcs.utwente.nl/user/s1934538/clickstream/clickstream-enwiki-2020-07.tsv.gz,Jeffrey_Epstein,327163,2910557,18906,3256626,1412138
hdfs://spark-nn.eemcs.utwente.nl/user/s1934538/clickstream/clickstream-enwiki-2020-07.tsv.gz,Hamas,23499,28652,504,52655,21556
hdfs://spark-nn.eemcs.utwente.nl/user/s1934538/clickstream/clickstream-enwiki-2020-07.tsv.gz,Sridevi,36221,100504,330,137055,57200
hdfs://spark-nn.eemcs.utwente.nl/user/s1934538/clickstream/clickstream-enwiki-2020-07.tsv.gz,Lists_of_deaths_by_year,5238,214710,332,220280,209375
hdfs://spark-nn.eemcs.utwente.nl/user/s1934538/clickstream/clickstream-enwiki-2020-07.tsv.gz,George_H._W._Bush,219841,167651,1236,388728,237821
hdfs://spark-nn.eemcs.utwente.nl/user/s1934538/clickstream/clickstream-enwiki-2020-07.tsv.gz,Bible,17652,5072005,1696,5091353,34986
hdfs://spark-nn.eemcs.utwente.nl/user/s1934538/clickstream/clickstream-enwiki-2020-07.tsv.gz,Lance_Reddick,36071,43576,1332,80979,17117
hdfs://spark-nn.eemcs.utwente.nl/user/s1934538/clickstream/clickstream-enwiki-2020-07.tsv.gz,Jimmy_Hoffa,45358,191513,1556,238427,85832
hdfs://spark-nn.eemcs.utwente.nl/user/s1934538/clickstream/clickstream-enwiki-2020-07.tsv.gz,United_States_Senate,87965,83286,1179,172430,77508
hdfs://spark-nn.eemcs.utwente.nl/user/s1934538/clickstream/clickstream-enwiki-2020-07.tsv.gz,Donald_Glover,73574,296969,1821,372364,144080
hdfs://spark-nn.eemcs.utwente.nl/user/s1934538/clickstream/clickstream-enwiki-2020-07.tsv.gz,Avicii,21163,227877,1858,250898,84788
hdfs://spark-nn.eemcs.utwente.nl/user/s1934538/clickstream/clickstream-enwiki-2020-07.tsv.gz,Bipin_Rawat,15041,35616,58,50715,27862
hdfs://spark-nn.eemcs.utwente.nl/user/s1934538/clickstream/clickstream-enwiki-2020-07.tsv.gz,Ray_Liotta,37944,53017,343,91304,31168
hdfs://spark-nn.eemcs.utwente.nl/user/s1934538/clickstream/clickstream-enwiki-2020-07.tsv.gz,Valentine's_Day,4052,18876,160,23088,2595
hdfs://spark-nn.eemcs.utwente.nl/user/s1934538/clickstream/clickstream-enwiki-2020-07.tsv.gz,RRR_(film),39073,48804,156,88033,50200
hdfs://spark-nn.eemcs.utwente.nl/user/s1934538/clickstream/clickstream-enwiki-2020-07.tsv.gz,Aaron_Hernandez,7734,141009,653,149396,42746
hdfs://spark-nn.eemcs.utwente.nl/user/s1934538/clickstream/clickstream-enwiki-2020-07.tsv.gz,Anna_Sorokin,8402,21070,84,29556,7076
hdfs://spark-nn.eemcs.utwente.nl/user/s1934538/clickstream/clickstream-enwiki-2020-07.tsv.gz,Henry_V_of_England,76712,90867,408,167987,116215
hdfs://spark-nn.eemcs.utwente.nl/user/s1934538/clickstream/clickstream-enwiki-2020-07.tsv.gz,It_Chapter_Two,47979,177457,1979,227415,163640
hdfs://spark-nn.eemcs.utwente.nl/user/s1934538/clickstream/clickstream-enwiki-2020-07.tsv.gz,Qasem_Soleimani,13039,38012,195,51246,25273
hdfs://spark-nn.eemcs.utwente.nl/user/s1934538/clickstream/clickstream-enwiki-2020-07.tsv.gz,Shakira,21441,191763,1626,214830,106017
hdfs://spark-nn.eemcs.utwente.nl/user/s1934538/clickstream/clickstream-enwiki-2020-07.tsv.gz,Gaza_Strip,21353,42633,948,64934,25332
hdfs://spark-nn.eemcs.utwente.nl/user/s1934538/clickstream/clickstream-enwiki-2020-07.tsv.gz,2016_United_States_presidential_election,238551,490665,5881,735097,543972
hdfs://spark-nn.eemcs.utwente.nl/user/s1934538/clickstream/clickstream-enwiki-2020-07.tsv.gz,When_They_See_Us,24469,86447,459,111375,60916
hdfs://spark-nn.eemcs.utwente.nl/user/s1934538/clickstream/clickstream-enwiki-2020-07.tsv.gz,Burt_Reynolds,54875,165973,1246,222094,94457
hdfs://spark-nn.eemcs.utwente.nl/user/s1934538/clickstream/clickstream-enwiki-2020-07.tsv.gz,Olivia_Newton-John,40829,162600,1362,204791,88446
hdfs://spark-nn.eemcs.utwente.nl/user/s1934538/clickstream/clickstream-enwiki-2020-07.tsv.gz,Bob_Saget,23226,80574,1003,104803,24454
hdfs://spark-nn.eemcs.utwente.nl/user/s1934538/clickstream/clickstream-enwiki-2020-07.tsv.gz,Tonya_Harding,24235,111228,383,135846,34243
hdfs://spark-nn.eemcs.utwente.nl/user/s1934538/clickstream/clickstream-enwiki-2020-07.tsv.gz,Dennis_Nilsen,6143,31940,654,38737,8991
hdfs://spark-nn.eemcs.utwente.nl/user/s1934538/clickstream/clickstream-enwiki-2020-07.tsv.gz,FIFA_World_Cup,43192,158959,2143,204294,160091
hdfs://spark-nn.eemcs.utwente.nl/user/s1934538/clickstream/clickstream-enwiki-2020-07.tsv.gz,Sylvester_Stallone,107049,391303,2624,500976,337415
hdfs://spark-nn.eemcs.utwente.nl/user/s1934538/clickstream/clickstream-enwiki-2020-07.tsv.gz,Avengers:_Infinity_War,61230,122340,1587,185157,111700
hdfs://spark-nn.eemcs.utwente.nl/user/s1934538/clickstream/clickstream-enwiki-2020-07.tsv.gz,Joaquin_Phoenix,157207,248563,1642,407412,255105
hdfs://spark-nn.eemcs.utwente.nl/user/s1934538/clickstream/clickstream-enwiki-2020-07.tsv.gz,The_Witcher_(TV_series),38711,237571,3944,280226,174163
hdfs://spark-nn.eemcs.utwente.nl/user/s1934538/clickstream/clickstream-enwiki-2020-07.tsv.gz,Us_(2019_film),31390,167520,664,199574,55009
hdfs://spark-nn.eemcs.utwente.nl/user/s1934538/clickstream/clickstream-enwiki-2020-07.tsv.gz,COVID-19_pandemic_by_country_and_territory,511045,884792,634,1396471,1053651
hdfs://spark-nn.eemcs.utwente.nl/user/s1934538/clickstream/clickstream-enwiki-2020-07.tsv.gz,"Princess_Margaret,_Countess_of_Snowdon",127832,348740,2446,479018,298024
hdfs://spark-nn.eemcs.utwente.nl/user/s1934538/clickstream/clickstream-enwiki-2020-07.tsv.gz,Adele,22688,126831,1931,151450,57038
hdfs://spark-nn.eemcs.utwente.nl/user/s1934538/clickstream/clickstream-enwiki-2020-07.tsv.gz,Eddie_Van_Halen,38233,55764,466,94463,42857
hdfs://spark-nn.eemcs.utwente.nl/user/s1934538/clickstream/clickstream-enwiki-2020-07.tsv.gz,The_Suicide_Squad_(film),104386,45960,693,151039,127610
hdfs://spark-nn.eemcs.utwente.nl/user/s1934538/clickstream/clickstream-enwiki-2020-07.tsv.gz,Chernobyl_(miniseries),20227,126556,1860,148643,133537
hdfs://spark-nn.eemcs.utwente.nl/user/s1934538/clickstream/clickstream-enwiki-2020-07.tsv.gz,Jason_Momoa,86733,283484,1218,371435,165000
hdfs://spark-nn.eemcs.utwente.nl/user/s1934538/clickstream/clickstream-enwiki-2020-07.tsv.gz,Captain_Marvel_(film),46560,138863,1609,187032,98441
hdfs://spark-nn.eemcs.utwente.nl/user/s1934538/clickstream/clickstream-enwiki-2020-07.tsv.gz,Naya_Rivera,343677,7660446,72954,8077077,2422383
hdfs://spark-nn.eemcs.utwente.nl/user/s1934538/clickstream/clickstream-enwiki-2020-07.tsv.gz,"Citizenship_(Amendment)_Act,_2019",4961,46353,66,51380,6434
hdfs://spark-nn.eemcs.utwente.nl/user/s1934538/clickstream/clickstream-enwiki-2020-07.tsv.gz,Spider-Man:_Far_From_Home,89723,147341,1990,239054,120999
hdfs://spark-nn.eemcs.utwente.nl/user/s1934538/clickstream/clickstream-enwiki-2020-07.tsv.gz,K.G.F:_Chapter_2,33062,143005,153,176220,86403
hdfs://spark-nn.eemcs.utwente.nl/user/s1934538/clickstream/clickstream-enwiki-2020-07.tsv.gz,Afghanistan,51573,124847,1921,178341,100512
hdfs://spark-nn.eemcs.utwente.nl/user/s1934538/clickstream/clickstream-enwiki-2020-07.tsv.gz,Exo_(band),26390,113514,507,140411,154969
hdfs://spark-nn.eemcs.utwente.nl/user/s1934538/clickstream/clickstream-enwiki-2020-07.tsv.gz,War_(2019_film),24528,98413,158,123099,30738
hdfs://spark-nn.eemcs.utwente.nl/user/s1934538/clickstream/clickstream-enwiki-2020-07.tsv.gz,George_VI,383598,154317,618,538533,391830
hdfs://spark-nn.eemcs.utwente.nl/user/s1934538/clickstream/clickstream-enwiki-2020-07.tsv.gz,Naomi_Osaka,8862,53908,420,63190,20327
hdfs://spark-nn.eemcs.utwente.nl/user/s1934538/clickstream/clickstream-enwiki-2020-07.tsv.gz,Hamilton_(musical),746752,4729616,37625,5513993,5435764
hdfs://spark-nn.eemcs.utwente.nl/user/s1934538/clickstream/clickstream-enwiki-2020-07.tsv.gz,Mac_Miller,36555,208392,1861,246808,82705
hdfs://spark-nn.eemcs.utwente.nl/user/s1934538/clickstream/clickstream-enwiki-2020-07.tsv.gz,Kylian_Mbappé,35558,161425,1997,198980,43382
hdfs://spark-nn.eemcs.utwente.nl/user/s1934538/clickstream/clickstream-enwiki-2020-07.tsv.gz,Game_of_Thrones_(season_8),16333,62044,877,79254,28669
hdfs://spark-nn.eemcs.utwente.nl/user/s1934538/clickstream/clickstream-enwiki-2020-07.tsv.gz,Alexander_Hamilton,1494411,7455338,39377,8989126,5170232
hdfs://spark-nn.eemcs.utwente.nl/user/s1934538/clickstream/clickstream-enwiki-2020-07.tsv.gz,Avengers:_Endgame,138686,293888,3857,436431,273064
hdfs://spark-nn.eemcs.utwente.nl/user/s1934538/clickstream/clickstream-enwiki-2020-07.tsv.gz,List_of_awards_and_nominations_received_by_Meryl_Streep,20756,13287,256,34299,12774
hdfs://spark-nn.eemcs.utwente.nl/user/s1934538/clickstream/clickstream-enwiki-2020-07.tsv.gz,Johnny_Depp,257404,1045610,8696,1311710,949555
hdfs://spark-nn.eemcs.utwente.nl/user/s1934538/clickstream/clickstream-enwiki-2020-07.tsv.gz,NATO,48727,118977,1970,169674,63458
hdfs://spark-nn.eemcs.utwente.nl/user/s1934538/clickstream/clickstream-enwiki-2020-07.tsv.gz,Sidharth_Shukla,17175,34048,179,51402,11832
hdfs://spark-nn.eemcs.utwente.nl/user/s1934538/clickstream/clickstream-enwiki-2020-07.tsv.gz,September_11_attacks,85491,251265,2082,338838,166120
hdfs://spark-nn.eemcs.utwente.nl/user/s1934538/clickstream/clickstream-enwiki-2020-07.tsv.gz,Fantastic_Beasts:_The_Crimes_of_Grindelwald,66143,109023,1095,176261,93136
hdfs://spark-nn.eemcs.utwente.nl/user/s1934538/clickstream/clickstream-enwiki-2020-07.tsv.gz,Puneeth_Rajkumar,14922,29287,39,44248,26333
hdfs://spark-nn.eemcs.utwente.nl/user/s1934538/clickstream/clickstream-enwiki-2020-07.tsv.gz,Kim_Jong-un,50236,202855,1618,254709,102344
hdfs://spark-nn.eemcs.utwente.nl/user/s1934538/clickstream/clickstream-enwiki-2020-07.tsv.gz,COVID-19_pandemic,1150977,2246069,14565,3411611,2309971
hdfs://spark-nn.eemcs.utwente.nl/user/s1934538/clickstream/clickstream-enwiki-2020-07.tsv.gz,Media,46,2676,330,3052,1392
hdfs://spark-nn.eemcs.utwente.nl/user/s1934538/clickstream/clickstream-enwiki-2020-07.tsv.gz,Donald_Trump,492467,1299031,16752,1808250,1353081
hdfs://spark-nn.eemcs.utwente.nl/user/s1934538/clickstream/clickstream-enwiki-2020-07.tsv.gz,Shang-Chi_and_the_Legend_of_the_Ten_Rings,75173,28720,164,104057,69166
hdfs://spark-nn.eemcs.utwente.nl/user/s1934538/clickstream/clickstream-enwiki-2020-07.tsv.gz,Jeffrey_Dahmer,31830,344967,3206,380003,169133
hdfs://spark-nn.eemcs.utwente.nl/user/s1934538/clickstream/clickstream-enwiki-2020-07.tsv.gz,Anne_Heche,36132,86142,478,122752,35891
hdfs://spark-nn.eemcs.utwente.nl/user/s1934538/clickstream/clickstream-enwiki-2020-07.tsv.gz,XHamster,13843,76669,3036,93548,17295
hdfs://spark-nn.eemcs.utwente.nl/user/s1934538/clickstream/clickstream-enwiki-2020-07.tsv.gz,ICC_Men's_T20_World_Cup,5820,76598,185,82603,37493
hdfs://spark-nn.eemcs.utwente.nl/user/s1934538/clickstream/clickstream-enwiki-2020-07.tsv.gz,Bonnie_and_Clyde,24482,225148,1497,251127,58677
hdfs://spark-nn.eemcs.utwente.nl/user/s1934538/clickstream/clickstream-enwiki-2020-07.tsv.gz,Godzilla_vs._Kong,66771,70166,1430,138367,84321
hdfs://spark-nn.eemcs.utwente.nl/user/s1934538/clickstream/clickstream-enwiki-2020-07.tsv.gz,Tasuku_Honjo,2206,2224723,229,2227158,68801
hdfs://spark-nn.eemcs.utwente.nl/user/s1934538/clickstream/clickstream-enwiki-2020-07.tsv.gz,Kamala_Harris,69325,643734,7628,720687,211497
hdfs://spark-nn.eemcs.utwente.nl/user/s1934538/clickstream/clickstream-enwiki-2020-07.tsv.gz,Kobe_Bryant,69161,391860,4783,465804,142142
hdfs://spark-nn.eemcs.utwente.nl/user/s1934538/clickstream/clickstream-enwiki-2020-07.tsv.gz,Amber_Heard,209576,1405938,10409,1625923,781451
hdfs://spark-nn.eemcs.utwente.nl/user/s1934538/clickstream/clickstream-enwiki-2020-07.tsv.gz,2.0_(film),22821,62852,373,86046,23084
hdfs://spark-nn.eemcs.utwente.nl/user/s1934538/clickstream/clickstream-enwiki-2020-07.tsv.gz,Michael_Jordan,155915,1156543,7454,1319912,551908
hdfs://spark-nn.eemcs.utwente.nl/user/s1934538/clickstream/clickstream-enwiki-2020-07.tsv.gz,Aaron_Carter,19715,79529,1302,100546,54830
hdfs://spark-nn.eemcs.utwente.nl/user/s1934538/clickstream/clickstream-enwiki-2020-07.tsv.gz,2018_Asian_Games,4799,8856,33,13688,12591
hdfs://spark-nn.eemcs.utwente.nl/user/s1934538/clickstream/clickstream-enwiki-2020-07.tsv.gz,Jimmy_Buffett,12376,97848,833,111057,37920
hdfs://spark-nn.eemcs.utwente.nl/user/s1934538/clickstream/clickstream-enwiki-2020-07.tsv.gz,R._Kelly,33766,198397,1613,233776,92622
hdfs://spark-nn.eemcs.utwente.nl/user/s1934538/clickstream/clickstream-enwiki-2020-07.tsv.gz,Bird_Box_(film),20448,104058,1245,125751,39969
hdfs://spark-nn.eemcs.utwente.nl/user/s1934538/clickstream/clickstream-enwiki-2020-07.tsv.gz,Brie_Larson,83716,319924,3321,406961,156440
hdfs://spark-nn.eemcs.utwente.nl/user/s1934538/clickstream/clickstream-enwiki-2020-07.tsv.gz,No_Time_to_Die,129011,110963,2427,242401,159041
hdfs://spark-nn.eemcs.utwente.nl/user/s1934538/clickstream/clickstream-enwiki-2020-07.tsv.gz,Game_of_Thrones,81392,286592,7717,375701,245406
hdfs://spark-nn.eemcs.utwente.nl/user/s1934538/clickstream/clickstream-enwiki-2020-07.tsv.gz,United_States_Electoral_College,61766,377588,529,439883,64016
hdfs://spark-nn.eemcs.utwente.nl/user/s1934538/clickstream/clickstream-enwiki-2020-07.tsv.gz,Key_frame,623,5227,18,5868,416
hdfs://spark-nn.eemcs.utwente.nl/user/s1934538/clickstream/clickstream-enwiki-2020-07.tsv.gz,Priyanka_Chopra,157037,372438,3697,533172,193294
hdfs://spark-nn.eemcs.utwente.nl/user/s1934538/clickstream/clickstream-enwiki-2020-07.tsv.gz,Elon_Musk,192842,1629252,11685,1833779,1091586
hdfs://spark-nn.eemcs.utwente.nl/user/s1934538/clickstream/clickstream-enwiki-2020-08.tsv.gz,Microsoft_Office,9204,1657435,710,1667349,21744
hdfs://spark-nn.eemcs.utwente.nl/user/s1934538/clickstream/clickstream-enwiki-2020-08.tsv.gz,Donald_Glover,61050,232075,1665,294790,110426
hdfs://spark-nn.eemcs.utwente.nl/user/s1934538/clickstream/clickstream-enwiki-2020-08.tsv.gz,Dennis_Nilsen,12335,116826,1374,130535,35829
hdfs://spark-nn.eemcs.utwente.nl/user/s1934538/clickstream/clickstream-enwiki-2020-08.tsv.gz,Cameron_Boyce,34441,231046,1044,266531,75076
hdfs://spark-nn.eemcs.utwente.nl/user/s1934538/clickstream/clickstream-enwiki-2020-08.tsv.gz,Loki_(TV_series),29844,15305,80,45229,17034
hdfs://spark-nn.eemcs.utwente.nl/user/s1934538/clickstream/clickstream-enwiki-2020-08.tsv.gz,"Meghan,_Duchess_of_Sussex",106085,292789,2311,401185,206311
hdfs://spark-nn.eemcs.utwente.nl/user/s1934538/clickstream/clickstream-enwiki-2020-08.tsv.gz,"Prince_Philip,_Duke_of_Edinburgh",257371,342944,7362,607677,406216
hdfs://spark-nn.eemcs.utwente.nl/user/s1934538/clickstream/clickstream-enwiki-2020-08.tsv.gz,Wonder_Woman_1984,104281,355086,8264,467631,275319
hdfs://spark-nn.eemcs.utwente.nl/user/s1934538/clickstream/clickstream-enwiki-2020-08.tsv.gz,Sidharth_Shukla,12322,36170,356,48848,12349
hdfs://spark-nn.eemcs.utwente.nl/user/s1934538/clickstream/clickstream-enwiki-2020-08.tsv.gz,The_Lion_King_(2019_film),51900,122171,1043,175114,95568
hdfs://spark-nn.eemcs.utwente.nl/user/s1934538/clickstream/clickstream-enwiki-2020-08.tsv.gz,ICC_Men's_T20_World_Cup,6021,83558,162,89741,38204
hdfs://spark-nn.eemcs.utwente.nl/user/s1934538/clickstream/clickstream-enwiki-2020-08.tsv.gz,Priyanka_Chopra,121296,263055,731,385082,127377
hdfs://spark-nn.eemcs.utwente.nl/user/s1934538/clickstream/clickstream-enwiki-2020-08.tsv.gz,Chadwick_Boseman,572115,12098723,14920,12685758,3492415
hdfs://spark-nn.eemcs.utwente.nl/user/s1934538/clickstream/clickstream-enwiki-2020-08.tsv.gz,Sridevi,47237,130159,372,177768,69317
hdfs://spark-nn.eemcs.utwente.nl/user/s1934538/clickstream/clickstream-enwiki-2020-08.tsv.gz,2022_FIFA_World_Cup,51696,77189,1390,130275,72591
hdfs://spark-nn.eemcs.utwente.nl/user/s1934538/clickstream/clickstream-enwiki-2020-08.tsv.gz,RRR_(film),40629,53872,97,94598,53952
hdfs://spark-nn.eemcs.utwente.nl/user/s1934538/clickstream/clickstream-enwiki-2020-08.tsv.gz,Cricket_World_Cup,7203,57670,363,65236,33432
hdfs://spark-nn.eemcs.utwente.nl/user/s1934538/clickstream/clickstream-enwiki-2020-08.tsv.gz,Laal_Singh_Chaddha,29476,63840,1404,94720,48612
hdfs://spark-nn.eemcs.utwente.nl/user/s1934538/clickstream/clickstream-enwiki-2020-08.tsv.gz,Sinéad_O'Connor,13095,79166,611,92872,25790
hdfs://spark-nn.eemcs.utwente.nl/user/s1934538/clickstream/clickstream-enwiki-2020-08.tsv.gz,Kobe_Bryant_sexual_assault_case,7589,49615,54,57258,3903
hdfs://spark-nn.eemcs.utwente.nl/user/s1934538/clickstream/clickstream-enwiki-2020-08.tsv.gz,Wikipedia,241271,816381,1073,1058725,311936
hdfs://spark-nn.eemcs.utwente.nl/user/s1934538/clickstream/clickstream-enwiki-2020-08.tsv.gz,HTTP_cookie,3707,610953,120,614780,26848
hdfs://spark-nn.eemcs.utwente.nl/user/s1934538/clickstream/clickstream-enwiki-2020-08.tsv.gz,Tasuku_Honjo,1116,518189,74,519379,19175
hdfs://spark-nn.eemcs.utwente.nl/user/s1934538/clickstream/clickstream-enwiki-2020-08.tsv.gz,Nipsey_Hussle,30409,224215,1293,255917,75333
hdfs://spark-nn.eemcs.utwente.nl/user/s1934538/clickstream/clickstream-enwiki-2020-08.tsv.gz,Aretha_Franklin,24269,98705,850,123824,46878
hdfs://spark-nn.eemcs.utwente.nl/user/s1934538/clickstream/clickstream-enwiki-2020-08.tsv.gz,The_Batman_(film),280905,948655,18954,1248514,1461946
hdfs://spark-nn.eemcs.utwente.nl/user/s1934538/clickstream/clickstream-enwiki-2020-08.tsv.gz,Joker_(2019_film),82055,438776,4768,525599,232820
hdfs://spark-nn.eemcs.utwente.nl/user/s1934538/clickstream/clickstream-enwiki-2020-08.tsv.gz,Richard_Ramirez,45759,194312,1376,241447,75345
hdfs://spark-nn.eemcs.utwente.nl/user/s1934538/clickstream/clickstream-enwiki-2020-08.tsv.gz,Star_Wars:_The_Rise_of_Skywalker,96006,146563,3080,245649,137099
hdfs://spark-nn.eemcs.utwente.nl/user/s1934538/clickstream/clickstream-enwiki-2020-08.tsv.gz,"Princess_Margaret,_Countess_of_Snowdon",153431,436543,2821,592795,372797
hdfs://spark-nn.eemcs.utwente.nl/user/s1934538/clickstream/clickstream-enwiki-2020-08.tsv.gz,United_States_Electoral_College,69913,483834,627,554374,76616
hdfs://spark-nn.eemcs.utwente.nl/user/s1934538/clickstream/clickstream-enwiki-2020-08.tsv.gz,The_Queen's_Gambit_(miniseries),4871,6930,91,11892,5428
hdfs://spark-nn.eemcs.utwente.nl/user/s1934538/clickstream/clickstream-enwiki-2020-08.tsv.gz,Juneteenth,3677,56654,394,60725,6107
hdfs://spark-nn.eemcs.utwente.nl/user/s1934538/clickstream/clickstream-enwiki-2020-08.tsv.gz,Keanu_Reeves,152151,724193,4965,881309,532265
hdfs://spark-nn.eemcs.utwente.nl/user/s1934538/clickstream/clickstream-enwiki-2020-08.tsv.gz,Ted_Bundy,41700,430047,4149,475896,109850
hdfs://spark-nn.eemcs.utwente.nl/user/s1934538/clickstream/clickstream-enwiki-2020-08.tsv.gz,Charles_Sobhraj,3354,21664,40,25058,5555
hdfs://spark-nn.eemcs.utwente.nl/user/s1934538/clickstream/clickstream-enwiki-2020-08.tsv.gz,Donald_Trump,644853,1957244,22634,2624731,1952238
hdfs://spark-nn.eemcs.utwente.nl/user/s1934538/clickstream/clickstream-enwiki-2020-08.tsv.gz,Google_logo,1202,13744,15,14961,1267
hdfs://spark-nn.eemcs.utwente.nl/user/s1934538/clickstream/clickstream-enwiki-2020-08.tsv.gz,The_Haunting_of_Bly_Manor,40045,107748,507,148300,115883
hdfs://spark-nn.eemcs.utwente.nl/user/s1934538/clickstream/clickstream-enwiki-2020-08.tsv.gz,JSON_Web_Token,793,27597,35,28425,1812
hdfs://spark-nn.eemcs.utwente.nl/user/s1934538/clickstream/clickstream-enwiki-2020-08.tsv.gz,The_Mandalorian,61092,270423,4887,336402,217518
hdfs://spark-nn.eemcs.utwente.nl/user/s1934538/clickstream/clickstream-enwiki-2020-08.tsv.gz,Grover,1631,6261,82,7974,1784
hdfs://spark-nn.eemcs.utwente.nl/user/s1934538/clickstream/clickstream-enwiki-2020-08.tsv.gz,Joe_Exotic,34640,157332,786,192758,51169
hdfs://spark-nn.eemcs.utwente.nl/user/s1934538/clickstream/clickstream-enwiki-2020-08.tsv.gz,1917_(2019_film),37179,200047,2880,240106,113812
hdfs://spark-nn.eemcs.utwente.nl/user/s1934538/clickstream/clickstream-enwiki-2020-08.tsv.gz,Aquaman_(film),50468,140885,2034,193387,112438
hdfs://spark-nn.eemcs.utwente.nl/user/s1934538/clickstream/clickstream-enwiki-2020-08.tsv.gz,Kate_Spade,30870,58281,305,89456,30711
hdfs://spark-nn.eemcs.utwente.nl/user/s1934538/clickstream/clickstream-enwiki-2020-08.tsv.gz,Stephen_Hawking,35802,402296,2126,440224,179907
hdfs://spark-nn.eemcs.utwente.nl/user/s1934538/clickstream/clickstream-enwiki-2020-08.tsv.gz,Coronavirus_disease_2019,244697,478876,8131,731704,241123
hdfs://spark-nn.eemcs.utwente.nl/user/s1934538/clickstream/clickstream-enwiki-2020-08.tsv.gz,Ruth_Bader_Ginsburg,32421,182197,1118,215736,77335
hdfs://spark-nn.eemcs.utwente.nl/user/s1934538/clickstream/clickstream-enwiki-2020-08.tsv.gz,Hamas,32397,41392,1507,75296,32172
hdfs://spark-nn.eemcs.utwente.nl/user/s1934538/clickstream/clickstream-enwiki-2020-08.tsv.gz,Elizabeth_II,517863,737232,3262,1258357,1034496
hdfs://spark-nn.eemcs.utwente.nl/user/s1934538/clickstream/clickstream-enwiki-2020-08.tsv.gz,Eternals_(film),124385,81846,607,206838,58311
hdfs://spark-nn.eemcs.utwente.nl/user/s1934538/clickstream/clickstream-enwiki-2020-08.tsv.gz,"Citizenship_(Amendment)_Act,_2019",5861,58270,104,64235,7151
hdfs://spark-nn.eemcs.utwente.nl/user/s1934538/clickstream/clickstream-enwiki-2020-08.tsv.gz,Stranger_Things_(season_3),21339,61468,518,83325,45693
hdfs://spark-nn.eemcs.utwente.nl/user/s1934538/clickstream/clickstream-enwiki-2020-08.tsv.gz,Valentine's_Day,3475,23358,217,27050,2726
hdfs://spark-nn.eemcs.utwente.nl/user/s1934538/clickstream/clickstream-enwiki-2020-08.tsv.gz,Matthew_Perry,65430,175448,791,241669,137968
hdfs://spark-nn.eemcs.utwente.nl/user/s1934538/clickstream/clickstream-enwiki-2020-08.tsv.gz,Queen_(band),51655,174552,2417,228624,223044
hdfs://spark-nn.eemcs.utwente.nl/user/s1934538/clickstream/clickstream-enwiki-2020-08.tsv.gz,Brett_Kavanaugh,33150,78112,387,111649,33960
hdfs://spark-nn.eemcs.utwente.nl/user/s1934538/clickstream/clickstream-enwiki-2020-08.tsv.gz,Fantastic_Beasts:_The_Crimes_of_Grindelwald,60742,99064,998,160804,81566
hdfs://spark-nn.eemcs.utwente.nl/user/s1934538/clickstream/clickstream-enwiki-2020-08.tsv.gz,IPv4,9512,39228,117,48857,8331
hdfs://spark-nn.eemcs.utwente.nl/user/s1934538/clickstream/clickstream-enwiki-2020-08.tsv.gz,Killing_of_George_Floyd,87429,365047,1350,453826,142664
hdfs://spark-nn.eemcs.utwente.nl/user/s1934538/clickstream/clickstream-enwiki-2020-08.tsv.gz,Lists_of_deaths_by_year,4515,180061,308,184884,173301
hdfs://spark-nn.eemcs.utwente.nl/user/s1934538/clickstream/clickstream-enwiki-2020-08.tsv.gz,Michael_Jordan,139505,958969,7423,1105897,449119
hdfs://spark-nn.eemcs.utwente.nl/user/s1934538/clickstream/clickstream-enwiki-2020-08.tsv.gz,Israel,107645,322320,5430,435395,217650
hdfs://spark-nn.eemcs.utwente.nl/user/s1934538/clickstream/clickstream-enwiki-2020-08.tsv.gz,Eddie_Van_Halen,38462,51197,401,90060,38195
hdfs://spark-nn.eemcs.utwente.nl/user/s1934538/clickstream/clickstream-enwiki-2020-08.tsv.gz,Olivia_Newton-John,31240,143590,1192,176022,77445
hdfs://spark-nn.eemcs.utwente.nl/user/s1934538/clickstream/clickstream-enwiki-2020-08.tsv.gz,Simone_Biles,13496,78008,740,92244,30578
hdfs://spark-nn.eemcs.utwente.nl/user/s1934538/clickstream/clickstream-enwiki-2020-08.tsv.gz,Jenna_Ortega,26501,27355,1608,55464,13543
hdfs://spark-nn.eemcs.utwente.nl/user/s1934538/clickstream/clickstream-enwiki-2020-08.tsv.gz,Pornhub,52855,508113,14346,575314,117794
hdfs://spark-nn.eemcs.utwente.nl/user/s1934538/clickstream/clickstream-enwiki-2020-08.tsv.gz,Hyphen-minus,4594,6491336,7780074,14276004,715
hdfs://spark-nn.eemcs.utwente.nl/user/s1934538/clickstream/clickstream-enwiki-2020-08.tsv.gz,2018_FIFA_World_Cup,91141,121746,1379,214266,125976
hdfs://spark-nn.eemcs.utwente.nl/user/s1934538/clickstream/clickstream-enwiki-2020-08.tsv.gz,Shang-Chi_and_the_Legend_of_the_Ten_Rings,87058,40830,1073,128961,88207
hdfs://spark-nn.eemcs.utwente.nl/user/s1934538/clickstream/clickstream-enwiki-2020-08.tsv.gz,State_of_Palestine,56186,165777,88,222051,95132
hdfs://spark-nn.eemcs.utwente.nl/user/s1934538/clickstream/clickstream-enwiki-2020-08.tsv.gz,Vladimir_Putin,135132,524437,5387,664956,420841
hdfs://spark-nn.eemcs.utwente.nl/user/s1934538/clickstream/clickstream-enwiki-2020-08.tsv.gz,The_Falcon_and_the_Winter_Soldier,54156,74966,444,129566,55659
hdfs://spark-nn.eemcs.utwente.nl/user/s1934538/clickstream/clickstream-enwiki-2020-08.tsv.gz,Tunnel,3418,9411,131,12960,3810
hdfs://spark-nn.eemcs.utwente.nl/user/s1934538/clickstream/clickstream-enwiki-2020-08.tsv.gz,QAnon,107448,4141910,22070,4271428,556988
hdfs://spark-nn.eemcs.utwente.nl/user/s1934538/clickstream/clickstream-enwiki-2020-08.tsv.gz,Burt_Reynolds,57652,211684,1434,270770,115370
hdfs://spark-nn.eemcs.utwente.nl/user/s1934538/clickstream/clickstream-enwiki-2020-08.tsv.gz,Fyre_Festival,10966,87278,632,98876,55437
hdfs://spark-nn.eemcs.utwente.nl/user/s1934538/clickstream/clickstream-enwiki-2020-08.tsv.gz,Cristiano_Ronaldo,156365,876374,5663,1038402,253927
hdfs://spark-nn.eemcs.utwente.nl/user/s1934538/clickstream/clickstream-enwiki-2020-08.tsv.gz,Lisa_Marie_Presley,142696,98033,694,241423,128378
hdfs://spark-nn.eemcs.utwente.nl/user/s1934538/clickstream/clickstream-enwiki-2020-08.tsv.gz,Sushant_Singh_Rajput,185205,1435234,9545,1629984,566969
hdfs://spark-nn.eemcs.utwente.nl/user/s1934538/clickstream/clickstream-enwiki-2020-08.tsv.gz,Afghanistan,52612,132887,3856,189355,106723
hdfs://spark-nn.eemcs.utwente.nl/user/s1934538/clickstream/clickstream-enwiki-2020-08.tsv.gz,Cook's_Country,407,3387,23,3817,1066
hdfs://spark-nn.eemcs.utwente.nl/user/s1934538/clickstream/clickstream-enwiki-2020-08.tsv.gz,Deion_Sanders,8857,124569,518,133944,39284
hdfs://spark-nn.eemcs.utwente.nl/user/s1934538/clickstream/clickstream-enwiki-2020-08.tsv.gz,Qasem_Soleimani,15908,39438,183,55529,27037
hdfs://spark-nn.eemcs.utwente.nl/user/s1934538/clickstream/clickstream-enwiki-2020-08.tsv.gz,List_of_most_popular_websites,13546,62897,79,76522,31127
hdfs://spark-nn.eemcs.utwente.nl/user/s1934538/clickstream/clickstream-enwiki-2020-08.tsv.gz,Kobe_Bryant,93548,765571,7896,867015,216886
hdfs://spark-nn.eemcs.utwente.nl/user/s1934538/clickstream/clickstream-enwiki-2020-08.tsv.gz,Luke_Perry,40647,150420,603,191670,56603
hdfs://spark-nn.eemcs.utwente.nl/user/s1934538/clickstream/clickstream-enwiki-2020-08.tsv.gz,Tom_Brady,50149,179788,1379,231316,78871
hdfs://spark-nn.eemcs.utwente.nl/user/s1934538/clickstream/clickstream-enwiki-2020-08.tsv.gz,Avengers:_Infinity_War,82336,144957,1420,228713,109860
hdfs://spark-nn.eemcs.utwente.nl/user/s1934538/clickstream/clickstream-enwiki-2020-08.tsv.gz,Darth_Vader,27229,76069,762,104060,65014
hdfs://spark-nn.eemcs.utwente.nl/user/s1934538/clickstream/clickstream-enwiki-2020-08.tsv.gz,Manti_Te'o,3545,20801,168,24514,2737
hdfs://spark-nn.eemcs.utwente.nl/user/s1934538/clickstream/clickstream-enwiki-2020-08.tsv.gz,Alexander_Hamilton,260228,1156046,6243,1422517,807781
hdfs://spark-nn.eemcs.utwente.nl/user/s1934538/clickstream/clickstream-enwiki-2020-08.tsv.gz,2018_Asian_Games,4711,7867,65,12643,11544
hdfs://spark-nn.eemcs.utwente.nl/user/s1934538/clickstream/clickstream-enwiki-2020-08.tsv.gz,The_Shape_of_Water,26917,65463,608,92988,38948
hdfs://spark-nn.eemcs.utwente.nl/user/s1934538/clickstream/clickstream-enwiki-2020-08.tsv.gz,The_Weeknd,70617,275406,3630,349653,144069
hdfs://spark-nn.eemcs.utwente.nl/user/s1934538/clickstream/clickstream-enwiki-2020-08.tsv.gz,Tonya_Harding,25526,139032,491,165049,40353
hdfs://spark-nn.eemcs.utwente.nl/user/s1934538/clickstream/clickstream-enwiki-2020-08.tsv.gz,Zack_Snyder's_Justice_League,161425,282025,30016,473466,227556
hdfs://spark-nn.eemcs.utwente.nl/user/s1934538/clickstream/clickstream-enwiki-2020-08.tsv.gz,List_of_highest-grossing_films,121766,311131,1448,434345,193457
hdfs://spark-nn.eemcs.utwente.nl/user/s1934538/clickstream/clickstream-enwiki-2020-08.tsv.gz,David_Beckham,46813,200835,1914,249562,93045
hdfs://spark-nn.eemcs.utwente.nl/user/s1934538/clickstream/clickstream-enwiki-2020-08.tsv.gz,Deaths_in_2020,1313266,2344675,12384,3670325,2138959
hdfs://spark-nn.eemcs.utwente.nl/user/s1934538/clickstream/clickstream-enwiki-2020-08.tsv.gz,WandaVision,45208,30513,198,75919,39036
hdfs://spark-nn.eemcs.utwente.nl/user/s1934538/clickstream/clickstream-enwiki-2020-08.tsv.gz,Kylian_Mbappé,64874,344049,3479,412402,84569
hdfs://spark-nn.eemcs.utwente.nl/user/s1934538/clickstream/clickstream-enwiki-2020-08.tsv.gz,Royal_Rumble_(2018),9087,5356,90,14533,10362
hdfs://spark-nn.eemcs.utwente.nl/user/s1934538/clickstream/clickstream-enwiki-2020-08.tsv.gz,Stan_Lee,58565,160087,1429,220081,63325
hdfs://spark-nn.eemcs.utwente.nl/user/s1934538/clickstream/clickstream-enwiki-2020-08.tsv.gz,Bob_Saget,21318,44180,353,65851,12922
hdfs://spark-nn.eemcs.utwente.nl/user/s1934538/clickstream/clickstream-enwiki-2020-08.tsv.gz,Shooting_of_Breonna_Taylor,27141,1001066,2585,1030792,78119
hdfs://spark-nn.eemcs.utwente.nl/user/s1934538/clickstream/clickstream-enwiki-2020-08.tsv.gz,Pelé,36210,129968,922,167100,58516
hdfs://spark-nn.eemcs.utwente.nl/user/s1934538/clickstream/clickstream-enwiki-2020-08.tsv.gz,R._Kelly,36456,216156,1999,254611,106047
hdfs://spark-nn.eemcs.utwente.nl/user/s1934538/clickstream/clickstream-enwiki-2020-08.tsv.gz,Spider-Man:_Far_From_Home,87535,141837,1758,231130,111094
hdfs://spark-nn.eemcs.utwente.nl/user/s1934538/clickstream/clickstream-enwiki-2020-08.tsv.gz,Asia_Cup,1490,29701,91,31282,15206
hdfs://spark-nn.eemcs.utwente.nl/user/s1934538/clickstream/clickstream-enwiki-2020-08.tsv.gz,Central_Park_jogger_case,22322,148227,1153,171702,28991
hdfs://spark-nn.eemcs.utwente.nl/user/s1934538/clickstream/clickstream-enwiki-2020-08.tsv.gz,Stranger_Things_(season_4),34435,192419,675,227529,115584
hdfs://spark-nn.eemcs.utwente.nl/user/s1934538/clickstream/clickstream-enwiki-2020-08.tsv.gz,2018_Winter_Olympics,16720,13677,229,30626,22328
hdfs://spark-nn.eemcs.utwente.nl/user/s1934538/clickstream/clickstream-enwiki-2020-08.tsv.gz,Tenet_(film),272302,2496567,29016,2797885,1136993
hdfs://spark-nn.eemcs.utwente.nl/user/s1934538/clickstream/clickstream-enwiki-2020-08.tsv.gz,1234,64,1715,19,1798,259
hdfs://spark-nn.eemcs.utwente.nl/user/s1934538/clickstream/clickstream-enwiki-2020-08.tsv.gz,2023_Cricket_World_Cup,9941,18810,299,29050,9291
hdfs://spark-nn.eemcs.utwente.nl/user/s1934538/clickstream/clickstream-enwiki-2020-08.tsv.gz,Chernobyl_(miniseries),23779,134173,2146,160098,154911
hdfs://spark-nn.eemcs.utwente.nl/user/s1934538/clickstream/clickstream-enwiki-2020-08.tsv.gz,List_of_FIFA_World_Cup_finals,2895,62674,87,65656,20798
hdfs://spark-nn.eemcs.utwente.nl/user/s1934538/clickstream/clickstream-enwiki-2020-08.tsv.gz,XXXTentacion,73607,472970,4409,550986,96533
hdfs://spark-nn.eemcs.utwente.nl/user/s1934538/clickstream/clickstream-enwiki-2020-08.tsv.gz,George_H._W._Bush,238134,186265,1339,425738,252832
hdfs://spark-nn.eemcs.utwente.nl/user/s1934538/clickstream/clickstream-enwiki-2020-08.tsv.gz,Lance_Reddick,33841,47000,1020,81861,18368
hdfs://spark-nn.eemcs.utwente.nl/user/s1934538/clickstream/clickstream-enwiki-2020-08.tsv.gz,Mortal_Kombat_(2021_film),30152,53572,413,84137,127507
hdfs://spark-nn.eemcs.utwente.nl/user/s1934538/clickstream/clickstream-enwiki-2020-08.tsv.gz,Henry_V_of_England,78196,102944,480,181620,123819
hdfs://spark-nn.eemcs.utwente.nl/user/s1934538/clickstream/clickstream-enwiki-2020-08.tsv.gz,Jason_Momoa,162352,462586,2281,627219,270680
hdfs://spark-nn.eemcs.utwente.nl/user/s1934538/clickstream/clickstream-enwiki-2020-08.tsv.gz,When_They_See_Us,20250,52795,356,73401,37736
hdfs://spark-nn.eemcs.utwente.nl/user/s1934538/clickstream/clickstream-enwiki-2020-08.tsv.gz,Kim_Jong-un,71841,343233,3130,418204,191451
hdfs://spark-nn.eemcs.utwente.nl/user/s1934538/clickstream/clickstream-enwiki-2020-08.tsv.gz,Gaza_Strip,24284,59669,614,84567,33498
hdfs://spark-nn.eemcs.utwente.nl/user/s1934538/clickstream/clickstream-enwiki-2020-08.tsv.gz,Amy_Coney_Barrett,1434,8139,30,9603,968
hdfs://spark-nn.eemcs.utwente.nl/user/s1934538/clickstream/clickstream-enwiki-2020-08.tsv.gz,Bird_Box_(film),22399,90129,869,113397,36003
hdfs://spark-nn.eemcs.utwente.nl/user/s1934538/clickstream/clickstream-enwiki-2020-08.tsv.gz,List_of_James_Bond_films,65800,424456,294,490550,311559
hdfs://spark-nn.eemcs.utwente.nl/user/s1934538/clickstream/clickstream-enwiki-2020-08.tsv.gz,Glass_(2019_film),47807,83600,528,131935,42307
hdfs://spark-nn.eemcs.utwente.nl/user/s1934538/clickstream/clickstream-enwiki-2020-08.tsv.gz,Khabib_Nurmagomedov,71750,222705,2707,297162,160846
hdfs://spark-nn.eemcs.utwente.nl/user/s1934538/clickstream/clickstream-enwiki-2020-08.tsv.gz,George_VI,408524,205479,972,614975,451145
hdfs://spark-nn.eemcs.utwente.nl/user/s1934538/clickstream/clickstream-enwiki-2020-08.tsv.gz,Jeffrey_Dahmer,32694,369242,3492,405428,180455
hdfs://spark-nn.eemcs.utwente.nl/user/s1934538/clickstream/clickstream-enwiki-2020-09.tsv.gz,No_Time_to_Die,186206,324963,7846,519015,409601
hdfs://spark-nn.eemcs.utwente.nl/user/s1934538/clickstream/clickstream-enwiki-2020-09.tsv.gz,Avengers:_Infinity_War,64747,129567,1327,195641,102533
hdfs://spark-nn.eemcs.utwente.nl/user/s1934538/clickstream/clickstream-enwiki-2020-09.tsv.gz,Roe_v._Wade,73311,645938,3363,722612,223142
hdfs://spark-nn.eemcs.utwente.nl/user/s1934538/clickstream/clickstream-enwiki-2020-09.tsv.gz,Fyre_Festival,7718,47789,312,55819,30646
hdfs://spark-nn.eemcs.utwente.nl/user/s1934538/clickstream/clickstream-enwiki-2020-09.tsv.gz,Juneteenth,3607,56710,315,60632,5759
hdfs://spark-nn.eemcs.utwente.nl/user/s1934538/clickstream/clickstream-enwiki-2020-09.tsv.gz,Spider-Man:_Far_From_Home,88617,109231,1533,199381,101559
hdfs://spark-nn.eemcs.utwente.nl/user/s1934538/clickstream/clickstream-enwiki-2020-09.tsv.gz,Simple_Mail_Transfer_Protocol,3948,32663,117,36728,3591
hdfs://spark-nn.eemcs.utwente.nl/user/s1934538/clickstream/clickstream-enwiki-2020-09.tsv.gz,Aretha_Franklin,25668,108171,1882,135721,48668
hdfs://spark-nn.eemcs.utwente.nl/user/s1934538/clickstream/clickstream-enwiki-2020-09.tsv.gz,Once_Upon_a_Time_in_Hollywood,97120,201067,3083,301270,299827
hdfs://spark-nn.eemcs.utwente.nl/user/s1934538/clickstream/clickstream-enwiki-2020-09.tsv.gz,Pelé,30226,118422,993,149641,48494
hdfs://spark-nn.eemcs.utwente.nl/user/s1934538/clickstream/clickstream-enwiki-2020-09.tsv.gz,Kobe_Bryant,99747,532489,5279,637515,177210
hdfs://spark-nn.eemcs.utwente.nl/user/s1934538/clickstream/clickstream-enwiki-2020-09.tsv.gz,NATO,45318,114028,1846,161192,60242
hdfs://spark-nn.eemcs.utwente.nl/user/s1934538/clickstream/clickstream-enwiki-2020-09.tsv.gz,The_Falcon_and_the_Winter_Soldier,67446,85629,801,153876,78929
hdfs://spark-nn.eemcs.utwente.nl/user/s1934538/clickstream/clickstream-enwiki-2020-09.tsv.gz,YouTube,125714,1147200,10145,1283059,121896
hdfs://spark-nn.eemcs.utwente.nl/user/s1934538/clickstream/clickstream-enwiki-2020-09.tsv.gz,Tonya_Harding,35049,200429,828,236306,58086
hdfs://spark-nn.eemcs.utwente.nl/user/s1934538/clickstream/clickstream-enwiki-2020-09.tsv.gz,DMX_(rapper),17286,89321,560,107167,44677
hdfs://spark-nn.eemcs.utwente.nl/user/s1934538/clickstream/clickstream-enwiki-2020-09.tsv.gz,Top_Gun:_Maverick,47282,75024,1572,123878,78583
hdfs://spark-nn.eemcs.utwente.nl/user/s1934538/clickstream/clickstream-enwiki-2020-09.tsv.gz,2016_United_States_presidential_election,310319,754436,9135,1073890,770935
hdfs://spark-nn.eemcs.utwente.nl/user/s1934538/clickstream/clickstream-enwiki-2020-09.tsv.gz,ICC_Men's_T20_World_Cup,4944,69636,131,74711,30104
hdfs://spark-nn.eemcs.utwente.nl/user/s1934538/clickstream/clickstream-enwiki-2020-09.tsv.gz,"Citizenship_(Amendment)_Act,_2019",5351,54675,14,60040,6353
hdfs://spark-nn.eemcs.utwente.nl/user/s1934538/clickstream/clickstream-enwiki-2020-09.tsv.gz,Rami_Malek,72966,183541,845,257352,101737
hdfs://spark-nn.eemcs.utwente.nl/user/s1934538/clickstream/clickstream-enwiki-2020-09.tsv.gz,List_of_highest-grossing_Indian_films,38873,126292,291,165456,98628
hdfs://spark-nn.eemcs.utwente.nl/user/s1934538/clickstream/clickstream-enwiki-2020-09.tsv.gz,2018_FIFA_World_Cup,68335,93347,1170,162852,94324
hdfs://spark-nn.eemcs.utwente.nl/user/s1934538/clickstream/clickstream-enwiki-2020-09.tsv.gz,Coronavirus,23134,364227,10085,397446,103129
hdfs://spark-nn.eemcs.utwente.nl/user/s1934538/clickstream/clickstream-enwiki-2020-09.tsv.gz,Sridevi,29140,81832,216,111188,44186
hdfs://spark-nn.eemcs.utwente.nl/user/s1934538/clickstream/clickstream-enwiki-2020-09.tsv.gz,Mötley_Crüe,28155,91546,1148,120849,150503
hdfs://spark-nn.eemcs.utwente.nl/user/s1934538/clickstream/clickstream-enwiki-2020-09.tsv.gz,The_Witcher_(TV_series),46389,224524,4148,275061,166548
hdfs://spark-nn.eemcs.utwente.nl/user/s1934538/clickstream/clickstream-enwiki-2020-09.tsv.gz,Juice_Wrld,36727,455162,5045,496934,149924
hdfs://spark-nn.eemcs.utwente.nl/user/s1934538/clickstream/clickstream-enwiki-2020-09.tsv.gz,Article_370_of_the_Constitution_of_India,3184,53630,37,56851,3966
hdfs://spark-nn.eemcs.utwente.nl/user/s1934538/clickstream/clickstream-enwiki-2020-09.tsv.gz,Bonnie_and_Clyde,21141,206311,1290,228742,52363
hdfs://spark-nn.eemcs.utwente.nl/user/s1934538/clickstream/clickstream-enwiki-2020-09.tsv.gz,Jeffrey_Dahmer,38348,404633,7819,450800,196709
hdfs://spark-nn.eemcs.utwente.nl/user/s1934538/clickstream/clickstream-enwiki-2020-09.tsv.gz,Naomi_Osaka,98722,1394924,29351,1522997,456510
hdfs://spark-nn.eemcs.utwente.nl/user/s1934538/clickstream/clickstream-enwiki-2020-09.tsv.gz,Stephen_Hawking,56454,641702,3184,701340,331049
hdfs://spark-nn.eemcs.utwente.nl/user/s1934538/clickstream/clickstream-enwiki-2020-09.tsv.gz,2022_FIFA_World_Cup,45058,69800,1018,115876,63897
hdfs://spark-nn.eemcs.utwente.nl/user/s1934538/clickstream/clickstream-enwiki-2020-09.tsv.gz,Star_Wars:_The_Rise_of_Skywalker,90124,118417,2832,211373,115041
hdfs://spark-nn.eemcs.utwente.nl/user/s1934538/clickstream/clickstream-enwiki-2020-09.tsv.gz,Jenna_Ortega,140047,128783,1607,270437,60816
hdfs://spark-nn.eemcs.utwente.nl/user/s1934538/clickstream/clickstream-enwiki-2020-09.tsv.gz,The_Batman_(film),136151,239058,6085,381294,349353
hdfs://spark-nn.eemcs.utwente.nl/user/s1934538/clickstream/clickstream-enwiki-2020-09.tsv.gz,Nipsey_Hussle,28359,125292,1026,154677,48153
hdfs://spark-nn.eemcs.utwente.nl/user/s1934538/clickstream/clickstream-enwiki-2020-09.tsv.gz,Spanish_flu,48539,501977,5653,556169,116811
hdfs://spark-nn.eemcs.utwente.nl/user/s1934538/clickstream/clickstream-enwiki-2020-09.tsv.gz,Sylvester_Stallone,118126,338007,2603,458736,333658
hdfs://spark-nn.eemcs.utwente.nl/user/s1934538/clickstream/clickstream-enwiki-2020-09.tsv.gz,Deaths_in_2020,1211272,2161319,11188,3383779,1873241
hdfs://spark-nn.eemcs.utwente.nl/user/s1934538/clickstream/clickstream-enwiki-2020-09.tsv.gz,Joaquin_Phoenix,221079,485874,2367,709320,455569
hdfs://spark-nn.eemcs.utwente.nl/user/s1934538/clickstream/clickstream-enwiki-2020-09.tsv.gz,Parasite_(2019_film),48558,202461,1495,252514,86376
hdfs://spark-nn.eemcs.utwente.nl/user/s1934538/clickstream/clickstream-enwiki-2020-09.tsv.gz,A_Star_Is_Born_(2018_film),35747,179054,814,215615,99855
hdfs://spark-nn.eemcs.utwente.nl/user/s1934538/clickstream/clickstream-enwiki-2020-09.tsv.gz,David_Beckham,40660,175583,1097,217340,79828
hdfs://spark-nn.eemcs.utwente.nl/user/s1934538/clickstream/clickstream-enwiki-2020-09.tsv.gz,Captain_Marvel_(film),45552,128707,1466,175725,88357
hdfs://spark-nn.eemcs.utwente.nl/user/s1934538/clickstream/clickstream-enwiki-2020-09.tsv.gz,"Meghan,_Duchess_of_Sussex",87674,243798,1674,333146,164690
hdfs://spark-nn.eemcs.utwente.nl/user/s1934538/clickstream/clickstream-enwiki-2020-09.tsv.gz,Cricket_World_Cup,6155,56951,189,63295,29588
hdfs://spark-nn.eemcs.utwente.nl/user/s1934538/clickstream/clickstream-enwiki-2020-09.tsv.gz,Richard_Ramirez,23226,153501,1113,177840,54589
hdfs://spark-nn.eemcs.utwente.nl/user/s1934538/clickstream/clickstream-enwiki-2020-09.tsv.gz,Ray_Liotta,38344,58226,350,96920,32422
hdfs://spark-nn.eemcs.utwente.nl/user/s1934538/clickstream/clickstream-enwiki-2020-09.tsv.gz,Croatia,39774,117727,1434,158935,57162
hdfs://spark-nn.eemcs.utwente.nl/user/s1934538/clickstream/clickstream-enwiki-2020-09.tsv.gz,Notre-Dame_de_Paris,12273,95480,853,108606,26641
hdfs://spark-nn.eemcs.utwente.nl/user/s1934538/clickstream/clickstream-enwiki-2020-09.tsv.gz,QAnon,85568,1581147,16747,1683462,289333
hdfs://spark-nn.eemcs.utwente.nl/user/s1934538/clickstream/clickstream-enwiki-2020-09.tsv.gz,United_States_Electoral_College,76417,713413,922,790752,105552
hdfs://spark-nn.eemcs.utwente.nl/user/s1934538/clickstream/clickstream-enwiki-2020-09.tsv.gz,Aaron_Hernandez,8847,92458,353,101658,32218
hdfs://spark-nn.eemcs.utwente.nl/user/s1934538/clickstream/clickstream-enwiki-2020-09.tsv.gz,Freddie_Mercury,73433,549704,4000,627137,217593
hdfs://spark-nn.eemcs.utwente.nl/user/s1934538/clickstream/clickstream-enwiki-2020-09.tsv.gz,Meat_Loaf,23548,83267,784,107599,40782
hdfs://spark-nn.eemcs.utwente.nl/user/s1934538/clickstream/clickstream-enwiki-2020-09.tsv.gz,R._Kelly,27686,157839,1397,186922,78699
hdfs://spark-nn.eemcs.utwente.nl/user/s1934538/clickstream/clickstream-enwiki-2020-09.tsv.gz,Puneeth_Rajkumar,8872,19306,15,28193,14483
hdfs://spark-nn.eemcs.utwente.nl/user/s1934538/clickstream/clickstream-enwiki-2020-09.tsv.gz,Russo-Ukrainian_War,16930,25186,48,42164,23891
hdfs://spark-nn.eemcs.utwente.nl/user/s1934538/clickstream/clickstream-enwiki-2020-09.tsv.gz,The_Haunting_of_Bly_Manor,57440,226595,1245,285280,192249
hdfs://spark-nn.eemcs.utwente.nl/user/s1934538/clickstream/clickstream-enwiki-2020-09.tsv.gz,Lisa_Marie_Presley,118601,70298,261,189160,100599
hdfs://spark-nn.eemcs.utwente.nl/user/s1934538/clickstream/clickstream-enwiki-2020-09.tsv.gz,The_Shape_of_Water,25356,65197,658,91211,38448
hdfs://spark-nn.eemcs.utwente.nl/user/s1934538/clickstream/clickstream-enwiki-2020-09.tsv.gz,COVID-19_pandemic_by_country_and_territory,554089,724517,2989,1281595,1108044
hdfs://spark-nn.eemcs.utwente.nl/user/s1934538/clickstream/clickstream-enwiki-2020-09.tsv.gz,Hamas,19922,31450,242,51614,21706
hdfs://spark-nn.eemcs.utwente.nl/user/s1934538/clickstream/clickstream-enwiki-2020-09.tsv.gz,Shang-Chi_and_the_Legend_of_the_Ten_Rings,89162,38295,258,127715,86826
hdfs://spark-nn.eemcs.utwente.nl/user/s1934538/clickstream/clickstream-enwiki-2020-09.tsv.gz,21_Savage,14632,60371,643,75646,28715
hdfs://spark-nn.eemcs.utwente.nl/user/s1934538/clickstream/clickstream-enwiki-2020-09.tsv.gz,Aquaman_(film),36200,111721,1527,149448,85088
hdfs://spark-nn.eemcs.utwente.nl/user/s1934538/clickstream/clickstream-enwiki-2020-09.tsv.gz,2018_Asian_Games,4781,7739,37,12557,9638
hdfs://spark-nn.eemcs.utwente.nl/user/s1934538/clickstream/clickstream-enwiki-2020-09.tsv.gz,Death_of_Elisa_Lam,6969,125190,517,132676,25577
hdfs://spark-nn.eemcs.utwente.nl/user/s1934538/clickstream/clickstream-enwiki-2020-09.tsv.gz,Tunnel,2855,10624,115,13594,3528
hdfs://spark-nn.eemcs.utwente.nl/user/s1934538/clickstream/clickstream-enwiki-2020-09.tsv.gz,Greta_Thunberg,12306,167267,1149,180722,39781
hdfs://spark-nn.eemcs.utwente.nl/user/s1934538/clickstream/clickstream-enwiki-2020-09.tsv.gz,List_of_highest-grossing_films,110834,268508,980,380322,177517
hdfs://spark-nn.eemcs.utwente.nl/user/s1934538/clickstream/clickstream-enwiki-2020-09.tsv.gz,1917_(2019_film),34407,132830,2359,169596,85563
hdfs://spark-nn.eemcs.utwente.nl/user/s1934538/clickstream/clickstream-enwiki-2020-09.tsv.gz,List_of_Queen_of_the_South_episodes,17258,14193,114,31565,760
hdfs://spark-nn.eemcs.utwente.nl/user/s1934538/clickstream/clickstream-enwiki-2020-09.tsv.gz,Brie_Larson,92418,219314,1839,313571,122257
hdfs://spark-nn.eemcs.utwente.nl/user/s1934538/clickstream/clickstream-enwiki-2020-09.tsv.gz,Eternals_(film),135995,113610,822,250427,299265
hdfs://spark-nn.eemcs.utwente.nl/user/s1934538/clickstream/clickstream-enwiki-2020-09.tsv.gz,Stan_Lee,49769,160886,1200,211855,58732
hdfs://spark-nn.eemcs.utwente.nl/user/s1934538/clickstream/clickstream-enwiki-2020-09.tsv.gz,Deadpool_2,52694,95678,1606,149978,116163
hdfs://spark-nn.eemcs.utwente.nl/user/s1934538/clickstream/clickstream-enwiki-2020-09.tsv.gz,Donald_Trump,442664,1369098,18071,1829833,1132984
hdfs://spark-nn.eemcs.utwente.nl/user/s1934538/clickstream/clickstream-enwiki-2020-09.tsv.gz,Anthony_Bourdain,17345,204176,1496,223017,66761
hdfs://spark-nn.eemcs.utwente.nl/user/s1934538/clickstream/clickstream-enwiki-2020-09.tsv.gz,Grimes_(musician),120864,126062,378,247304,62019
hdfs://spark-nn.eemcs.utwente.nl/user/s1934538/clickstream/clickstream-enwiki-2020-09.tsv.gz,Pornhub,42798,568482,14189,625469,113116
hdfs://spark-nn.eemcs.utwente.nl/user/s1934538/clickstream/clickstream-enwiki-2020-09.tsv.gz,Bob_Saget,20249,41298,293,61840,12470
hdfs://spark-nn.eemcs.utwente.nl/user/s1934538/clickstream/clickstream-enwiki-2020-09.tsv.gz,XXXTentacion,65202,454595,5445,525242,90155
hdfs://spark-nn.eemcs.utwente.nl/user/s1934538/clickstream/clickstream-enwiki-2020-09.tsv.gz,Henry_V_of_England,82542,109005,596,192143,132269
hdfs://spark-nn.eemcs.utwente.nl/user/s1934538/clickstream/clickstream-enwiki-2020-09.tsv.gz,The_Umbrella_Academy_(TV_series),87439,762340,12370,862149,565788
hdfs://spark-nn.eemcs.utwente.nl/user/s1934538/clickstream/clickstream-enwiki-2020-09.tsv.gz,Kelly_Preston,108294,245801,1386,355481,103516
hdfs://spark-nn.eemcs.utwente.nl/user/s1934538/clickstream/clickstream-enwiki-2020-09.tsv.gz,JSON_Web_Token,885,27835,42,28762,1828
hdfs://spark-nn.eemcs.utwente.nl/user/s1934538/clickstream/clickstream-enwiki-2020-09.tsv.gz,Richard_Jewell,48605,350311,1572,400488,120080
hdfs://spark-nn.eemcs.utwente.nl/user/s1934538/clickstream/clickstream-enwiki-2020-09.tsv.gz,George_VI,338247,145936,635,484818,360874
hdfs://spark-nn.eemcs.utwente.nl/user/s1934538/clickstream/clickstream-enwiki-2020-09.tsv.gz,Key_frame,598,5083,13,5694,418
hdfs://spark-nn.eemcs.utwente.nl/user/s1934538/clickstream/clickstream-enwiki-2020-09.tsv.gz,K.G.F:_Chapter_2,18270,100844,193,119307,43177
hdfs://spark-nn.eemcs.utwente.nl/user/s1934538/clickstream/clickstream-enwiki-2020-09.tsv.gz,HTTP_cookie,3574,659303,143,663020,26087
hdfs://spark-nn.eemcs.utwente.nl/user/s1934538/clickstream/clickstream-enwiki-2020-09.tsv.gz,Tom_Brady,81961,467502,3727,553190,177858
hdfs://spark-nn.eemcs.utwente.nl/user/s1934538/clickstream/clickstream-enwiki-2020-09.tsv.gz,Us_(2019_film),31373,119942,983,152298,47002
hdfs://spark-nn.eemcs.utwente.nl/user/s1934538/clickstream/clickstream-enwiki-2020-09.tsv.gz,Indian_Premier_League,54176,611299,596,666071,310190
hdfs://spark-nn.eemcs.utwente.nl/user/s1934538/clickstream/clickstream-enwiki-2020-09.tsv.gz,Anne_Heche,53311,438690,2139,494140,112866
hdfs://spark-nn.eemcs.utwente.nl/user/s1934538/clickstream/clickstream-enwiki-2020-09.tsv.gz,Anna_Sorokin,6892,28047,78,35017,8460
hdfs://spark-nn.eemcs.utwente.nl/user/s1934538/clickstream/clickstream-enwiki-2020-09.tsv.gz,Lists_of_deaths_by_year,5021,151352,255,156628,148947
hdfs://spark-nn.eemcs.utwente.nl/user/s1934538/clickstream/clickstream-enwiki-2020-09.tsv.gz,"Prince_Philip,_Duke_of_Edinburgh",231322,326145,7425,564892,371373
hdfs://spark-nn.eemcs.utwente.nl/user/s1934538/clickstream/clickstream-enwiki-2020-09.tsv.gz,Keanu_Reeves,132638,760389,4807,897834,512671
hdfs://spark-nn.eemcs.utwente.nl/user/s1934538/clickstream/clickstream-enwiki-2020-09.tsv.gz,Chernobyl_(miniseries),26410,99329,1712,127451,115723
hdfs://spark-nn.eemcs.utwente.nl/user/s1934538/clickstream/clickstream-enwiki-2020-09.tsv.gz,Avicii,18444,226700,1621,246765,111919
hdfs://spark-nn.eemcs.utwente.nl/user/s1934538/clickstream/clickstream-enwiki-2020-09.tsv.gz,Critical_race_theory,8182,677424,3183,688789,119093
hdfs://spark-nn.eemcs.utwente.nl/user/s1934538/clickstream/clickstream-enwiki-2020-09.tsv.gz,Kylian_Mbappé,25610,133181,1847,160638,31973
hdfs://spark-nn.eemcs.utwente.nl/user/s1934538/clickstream/clickstream-enwiki-2020-09.tsv.gz,Zack_Snyder's_Justice_League,103112,97457,1181,201750,97297
hdfs://spark-nn.eemcs.utwente.nl/user/s1934538/clickstream/clickstream-enwiki-2020-09.tsv.gz,Louis_Tomlinson,38155,83155,475,121785,19385
hdfs://spark-nn.eemcs.utwente.nl/user/s1934538/clickstream/clickstream-enwiki-2020-09.tsv.gz,Sushant_Singh_Rajput,94887,612870,2937,710694,269549
hdfs://spark-nn.eemcs.utwente.nl/user/s1934538/clickstream/clickstream-enwiki-2020-09.tsv.gz,Alexander_Hamilton,141649,580901,3199,725749,386286
hdfs://spark-nn.eemcs.utwente.nl/user/s1934538/clickstream/clickstream-enwiki-2020-09.tsv.gz,Valentine's_Day,2959,25465,144,28568,2741
hdfs://spark-nn.eemcs.utwente.nl/user/s1934538/clickstream/clickstream-enwiki-2020-09.tsv.gz,Watts_family_murders,30754,634419,1017,666190,165991
hdfs://spark-nn.eemcs.utwente.nl/user/s1934538/clickstream/clickstream-enwiki-2020-09.tsv.gz,Hyphen-minus,5105,6982168,7775845,14763118,712
hdfs://spark-nn.eemcs.utwente.nl/user/s1934538/clickstream/clickstream-enwiki-2020-09.tsv.gz,Manti_Te'o,5104,45379,287,50770,5077
hdfs://spark-nn.eemcs.utwente.nl/user/s1934538/clickstream/clickstream-enwiki-2020-09.tsv.gz,John_McCain,69698,271346,2443,343487,153316
hdfs://spark-nn.eemcs.utwente.nl/user/s1934538/clickstream/clickstream-enwiki-2020-09.tsv.gz,Stranger_Things,89645,285729,6768,382142,311172
hdfs://spark-nn.eemcs.utwente.nl/user/s1934538/clickstream/clickstream-enwiki-2020-09.tsv.gz,WrestleMania_34,15786,9147,164,25097,17086
hdfs://spark-nn.eemcs.utwente.nl/user/s1934538/clickstream/clickstream-enwiki-2020-09.tsv.gz,COVID-19_pandemic,599544,878916,4353,1482813,812755
hdfs://spark-nn.eemcs.utwente.nl/user/s1934538/clickstream/clickstream-enwiki-2020-09.tsv.gz,Cristiano_Ronaldo,129918,789383,5451,924752,225624
hdfs://spark-nn.eemcs.utwente.nl/user/s1934538/clickstream/clickstream-enwiki-2020-09.tsv.gz,Killing_of_George_Floyd,59298,235942,865,296105,90854
hdfs://spark-nn.eemcs.utwente.nl/user/s1934538/clickstream/clickstream-enwiki-2020-09.tsv.gz,Atal_Bihari_Vajpayee,27255,48156,123,75534,21378
hdfs://spark-nn.eemcs.utwente.nl/user/s1934538/clickstream/clickstream-enwiki-2020-09.tsv.gz,J._Robert_Oppenheimer,22771,116974,393,140138,47513
hdfs://spark-nn.eemcs.utwente.nl/user/s1934538/clickstream/clickstream-enwiki-2020-09.tsv.gz,Sidharth_Shukla,11798,42442,312,54552,14120
hdfs://spark-nn.eemcs.utwente.nl/user/s1934538/clickstream/clickstream-enwiki-2020-09.tsv.gz,Royal_Rumble_(2018),8638,6463,204,15305,10637
hdfs://spark-nn.eemcs.utwente.nl/user/s1934538/clickstream/clickstream-enwiki-2020-09.tsv.gz,Loki_(TV_series),42551,22534,130,65215,24929
hdfs://spark-nn.eemcs.utwente.nl/user/s1934538/clickstream/clickstream-enwiki-2020-09.tsv.gz,Johnny_Depp,120526,357785,2823,481134,333691
hdfs://spark-nn.eemcs.utwente.nl/user/s1934538/clickstream/clickstream-enwiki-2020-09.tsv.gz,The_Lion_King_(2019_film),49146,114222,1025,164393,82371
hdfs://spark-nn.eemcs.utwente.nl/user/s1934538/clickstream/clickstream-enwiki-2020-09.tsv.gz,Avengers:_Endgame,139407,280226,3455,423088,252140
hdfs://spark-nn.eemcs.utwente.nl/user/s1934538/clickstream/clickstream-enwiki-2020-09.tsv.gz,Olivia_Newton-John,35880,126676,1149,163705,66579
hdfs://spark-nn.eemcs.utwente.nl/user/s1934538/clickstream/clickstream-enwiki-2020-09.tsv.gz,Chadwick_Boseman,188758,2135463,26774,2350995,741767
hdfs://spark-nn.eemcs.utwente.nl/user/s1934538/clickstream/clickstream-enwiki-2020-09.tsv.gz,Tasuku_Honjo,1068,275839,29,276936,10161
hdfs://spark-nn.eemcs.utwente.nl/user/s1934538/clickstream/clickstream-enwiki-2020-09.tsv.gz,Kim_Jong-un,51129,182497,1761,235387,108249
hdfs://spark-nn.eemcs.utwente.nl/user/s1934538/clickstream/clickstream-enwiki-2020-09.tsv.gz,Michael_Jordan,125696,692482,5938,824116,291868
hdfs://spark-nn.eemcs.utwente.nl/user/s1934538/clickstream/clickstream-enwiki-2020-09.tsv.gz,Cecil_Hotel_(Los_Angeles),6026,18253,30,24309,9538
hdfs://spark-nn.eemcs.utwente.nl/user/s1934538/clickstream/clickstream-enwiki-2020-09.tsv.gz,Coronavirus_disease_2019,210595,493117,6960,710672,210728
hdfs://spark-nn.eemcs.utwente.nl/user/s1934538/clickstream/clickstream-enwiki-2020-09.tsv.gz,The_Suicide_Squad_(film),109647,88681,1184,199512,237281
hdfs://spark-nn.eemcs.utwente.nl/user/s1934538/clickstream/clickstream-enwiki-2020-09.tsv.gz,Cook's_Country,410,3127,31,3568,1012
hdfs://spark-nn.eemcs.utwente.nl/user/s1934538/clickstream/clickstream-enwiki-2020-09.tsv.gz,Army_of_the_Dead,30790,17447,233,48470,31090
hdfs://spark-nn.eemcs.utwente.nl/user/s1934538/clickstream/clickstream-enwiki-2020-09.tsv.gz,1234,46,1687,23,1756,176
hdfs://spark-nn.eemcs.utwente.nl/user/s1934538/clickstream/clickstream-enwiki-2020-09.tsv.gz,Ruth_Bader_Ginsburg,337457,7096465,136627,7570549,2565567
hdfs://spark-nn.eemcs.utwente.nl/user/s1934538/clickstream/clickstream-enwiki-2020-09.tsv.gz,Mortal_Kombat_(2021_film),25549,40544,430,66523,96214
hdfs://spark-nn.eemcs.utwente.nl/user/s1934538/clickstream/clickstream-enwiki-2020-09.tsv.gz,Stranger_Things_(season_4),36421,214447,716,251584,119539
hdfs://spark-nn.eemcs.utwente.nl/user/s1934538/clickstream/clickstream-enwiki-2020-09.tsv.gz,Cardi_B,84478,736351,10249,831078,255716
hdfs://spark-nn.eemcs.utwente.nl/user/s1934538/clickstream/clickstream-enwiki-2020-09.tsv.gz,Khabib_Nurmagomedov,67430,207419,1914,276763,139247
hdfs://spark-nn.eemcs.utwente.nl/user/s1934538/clickstream/clickstream-enwiki-2020-09.tsv.gz,Elizabeth_II,450469,725907,5070,1181446,929436
hdfs://spark-nn.eemcs.utwente.nl/user/s1934538/clickstream/clickstream-enwiki-2020-09.tsv.gz,Joe_Biden,324294,2419732,27778,2771804,1161362
hdfs://spark-nn.eemcs.utwente.nl/user/s1934538/clickstream/clickstream-enwiki-2020-09.tsv.gz,Kamala_Harris,149007,974954,11352,1135313,467159
hdfs://spark-nn.eemcs.utwente.nl/user/s1934538/clickstream/clickstream-enwiki-2020-09.tsv.gz,Shinzo_Abe,97166,156002,83354,336522,202862
hdfs://spark-nn.eemcs.utwente.nl/user/s1934538/clickstream/clickstream-enwiki-2020-09.tsv.gz,2018_Winter_Olympics,15106,13410,154,28670,19812
hdfs://spark-nn.eemcs.utwente.nl/user/s1934538/clickstream/clickstream-enwiki-2020-09.tsv.gz,Queen_(band),50144,171354,2138,223636,213713
hdfs://spark-nn.eemcs.utwente.nl/user/s1934538/clickstream/clickstream-enwiki-2020-09.tsv.gz,Black_Panther_(film),135444,497530,9377,642351,404067
hdfs://spark-nn.eemcs.utwente.nl/user/s1934538/clickstream/clickstream-enwiki-2020-09.tsv.gz,Tenet_(film),299762,3499849,38554,3838165,1425815
hdfs://spark-nn.eemcs.utwente.nl/user/s1934538/clickstream/clickstream-enwiki-2020-09.tsv.gz,Microsoft_Office,10390,2122750,694,2133834,23697
hdfs://spark-nn.eemcs.utwente.nl/user/s1934538/clickstream/clickstream-enwiki-2020-09.tsv.gz,Adele,21215,180911,2110,204236,63154
hdfs://spark-nn.eemcs.utwente.nl/user/s1934538/clickstream/clickstream-enwiki-2020-10.tsv.gz,Naomi_Osaka,25419,81056,507,106982,29606
hdfs://spark-nn.eemcs.utwente.nl/user/s1934538/clickstream/clickstream-enwiki-2020-10.tsv.gz,IPv4,11907,50094,188,62189,10344
hdfs://spark-nn.eemcs.utwente.nl/user/s1934538/clickstream/clickstream-enwiki-2020-10.tsv.gz,List_of_highest-grossing_films,92632,230432,905,323969,153058
hdfs://spark-nn.eemcs.utwente.nl/user/s1934538/clickstream/clickstream-enwiki-2020-10.tsv.gz,Stranger_Things,88043,363237,7641,458921,351411
hdfs://spark-nn.eemcs.utwente.nl/user/s1934538/clickstream/clickstream-enwiki-2020-10.tsv.gz,Tonya_Harding,24857,126760,541,152158,38282
hdfs://spark-nn.eemcs.utwente.nl/user/s1934538/clickstream/clickstream-enwiki-2020-10.tsv.gz,Avengers:_Infinity_War,47120,86955,938,135013,73875
hdfs://spark-nn.eemcs.utwente.nl/user/s1934538/clickstream/clickstream-enwiki-2020-10.tsv.gz,John_McCain,129486,339215,3262,471963,225232
hdfs://spark-nn.eemcs.utwente.nl/user/s1934538/clickstream/clickstream-enwiki-2020-10.tsv.gz,Coronavirus_disease_2019,230046,522639,7016,759701,243448
hdfs://spark-nn.eemcs.utwente.nl/user/s1934538/clickstream/clickstream-enwiki-2020-10.tsv.gz,Top_Gun:_Maverick,44429,81613,1682,127724,75545
hdfs://spark-nn.eemcs.utwente.nl/user/s1934538/clickstream/clickstream-enwiki-2020-10.tsv.gz,Elon_Musk,83290,787499,6088,876877,466910
hdfs://spark-nn.eemcs.utwente.nl/user/s1934538/clickstream/clickstream-enwiki-2020-10.tsv.gz,When_They_See_Us,17405,51724,490,69619,33003
hdfs://spark-nn.eemcs.utwente.nl/user/s1934538/clickstream/clickstream-enwiki-2020-10.tsv.gz,The_Queen's_Gambit_(miniseries),143289,2045658,12541,2201488,1014352
hdfs://spark-nn.eemcs.utwente.nl/user/s1934538/clickstream/clickstream-enwiki-2020-10.tsv.gz,Article_370_of_the_Constitution_of_India,3221,64980,38,68239,4640
hdfs://spark-nn.eemcs.utwente.nl/user/s1934538/clickstream/clickstream-enwiki-2020-10.tsv.gz,No_Time_to_Die,131163,204936,5585,341684,220548
hdfs://spark-nn.eemcs.utwente.nl/user/s1934538/clickstream/clickstream-enwiki-2020-10.tsv.gz,Bird_Box_(film),25219,90654,872,116745,32722
hdfs://spark-nn.eemcs.utwente.nl/user/s1934538/clickstream/clickstream-enwiki-2020-10.tsv.gz,Rami_Malek,60590,159430,750,220770,86100
hdfs://spark-nn.eemcs.utwente.nl/user/s1934538/clickstream/clickstream-enwiki-2020-10.tsv.gz,Ruth_Bader_Ginsburg,176765,853957,6858,1037580,338082
hdfs://spark-nn.eemcs.utwente.nl/user/s1934538/clickstream/clickstream-enwiki-2020-10.tsv.gz,NATO,46732,135001,1854,183587,66241
hdfs://spark-nn.eemcs.utwente.nl/user/s1934538/clickstream/clickstream-enwiki-2020-10.tsv.gz,Crazy_Rich_Asians_(film),38552,248001,1968,288521,320145
hdfs://spark-nn.eemcs.utwente.nl/user/s1934538/clickstream/clickstream-enwiki-2020-10.tsv.gz,XHamster,9480,144253,3103,156836,20669
hdfs://spark-nn.eemcs.utwente.nl/user/s1934538/clickstream/clickstream-enwiki-2020-10.tsv.gz,Jeffrey_Dahmer,32354,329455,4161,365970,151113
hdfs://spark-nn.eemcs.utwente.nl/user/s1934538/clickstream/clickstream-enwiki-2020-10.tsv.gz,WandaVision,53310,94811,1186,149307,72327
hdfs://spark-nn.eemcs.utwente.nl/user/s1934538/clickstream/clickstream-enwiki-2020-10.tsv.gz,George_H._W._Bush,335051,242484,1892,579427,328674
hdfs://spark-nn.eemcs.utwente.nl/user/s1934538/clickstream/clickstream-enwiki-2020-10.tsv.gz,Cameron_Boyce,124854,1016577,2614,1144045,249877
hdfs://spark-nn.eemcs.utwente.nl/user/s1934538/clickstream/clickstream-enwiki-2020-10.tsv.gz,Deadpool_2,43651,150967,1285,195903,86472
hdfs://spark-nn.eemcs.utwente.nl/user/s1934538/clickstream/clickstream-enwiki-2020-10.tsv.gz,Alexander_Hamilton,134375,481627,2866,618868,309518
hdfs://spark-nn.eemcs.utwente.nl/user/s1934538/clickstream/clickstream-enwiki-2020-10.tsv.gz,"Meghan,_Duchess_of_Sussex",130073,230278,1824,362175,167522
hdfs://spark-nn.eemcs.utwente.nl/user/s1934538/clickstream/clickstream-enwiki-2020-10.tsv.gz,XXX:_Return_of_Xander_Cage,33357,457787,857,492001,66794
hdfs://spark-nn.eemcs.utwente.nl/user/s1934538/clickstream/clickstream-enwiki-2020-10.tsv.gz,Naya_Rivera,61672,144218,562,206452,70945
hdfs://spark-nn.eemcs.utwente.nl/user/s1934538/clickstream/clickstream-enwiki-2020-10.tsv.gz,Richard_Ramirez,23903,149320,1048,174271,51020
hdfs://spark-nn.eemcs.utwente.nl/user/s1934538/clickstream/clickstream-enwiki-2020-10.tsv.gz,Keanu_Reeves,89883,481207,2854,573944,283835
hdfs://spark-nn.eemcs.utwente.nl/user/s1934538/clickstream/clickstream-enwiki-2020-10.tsv.gz,J._Robert_Oppenheimer,20776,91635,398,112809,35827
hdfs://spark-nn.eemcs.utwente.nl/user/s1934538/clickstream/clickstream-enwiki-2020-10.tsv.gz,Henry_V_of_England,82858,110864,547,194269,132095
hdfs://spark-nn.eemcs.utwente.nl/user/s1934538/clickstream/clickstream-enwiki-2020-10.tsv.gz,JSON_Web_Token,914,31259,35,32208,1832
hdfs://spark-nn.eemcs.utwente.nl/user/s1934538/clickstream/clickstream-enwiki-2020-10.tsv.gz,"Prince_Philip,_Duke_of_Edinburgh",259567,392211,8476,660254,421780
hdfs://spark-nn.eemcs.utwente.nl/user/s1934538/clickstream/clickstream-enwiki-2020-10.tsv.gz,Aretha_Franklin,24299,82284,701,107284,44935
hdfs://spark-nn.eemcs.utwente.nl/user/s1934538/clickstream/clickstream-enwiki-2020-10.tsv.gz,Jason_Momoa,95454,293586,1518,390558,155595
hdfs://spark-nn.eemcs.utwente.nl/user/s1934538/clickstream/clickstream-enwiki-2020-10.tsv.gz,Lists_of_deaths_by_year,5442,148624,414,154480,141646
hdfs://spark-nn.eemcs.utwente.nl/user/s1934538/clickstream/clickstream-enwiki-2020-10.tsv.gz,Deion_Sanders,14156,190590,911,205657,69912
hdfs://spark-nn.eemcs.utwente.nl/user/s1934538/clickstream/clickstream-enwiki-2020-10.tsv.gz,Grover,1311,6731,71,8113,1604
hdfs://spark-nn.eemcs.utwente.nl/user/s1934538/clickstream/clickstream-enwiki-2020-10.tsv.gz,Lance_Reddick,24962,31753,167,56882,11338
hdfs://spark-nn.eemcs.utwente.nl/user/s1934538/clickstream/clickstream-enwiki-2020-10.tsv.gz,2016_United_States_presidential_election,686318,2076416,20406,2783140,1748852
hdfs://spark-nn.eemcs.utwente.nl/user/s1934538/clickstream/clickstream-enwiki-2020-10.tsv.gz,Vladimir_Putin,94161,316049,3466,413676,244534
hdfs://spark-nn.eemcs.utwente.nl/user/s1934538/clickstream/clickstream-enwiki-2020-10.tsv.gz,Valentine's_Day,3934,28935,215,33084,3142
hdfs://spark-nn.eemcs.utwente.nl/user/s1934538/clickstream/clickstream-enwiki-2020-10.tsv.gz,2018_FIFA_World_Cup,68883,98579,1172,168634,96803
hdfs://spark-nn.eemcs.utwente.nl/user/s1934538/clickstream/clickstream-enwiki-2020-10.tsv.gz,Rihanna,70350,273003,3348,346701,162527
hdfs://spark-nn.eemcs.utwente.nl/user/s1934538/clickstream/clickstream-enwiki-2020-10.tsv.gz,Black_Panther_(film),60086,211878,2696,274660,122190
hdfs://spark-nn.eemcs.utwente.nl/user/s1934538/clickstream/clickstream-enwiki-2020-10.tsv.gz,Kate_Spade,25608,57459,272,83339,26563
hdfs://spark-nn.eemcs.utwente.nl/user/s1934538/clickstream/clickstream-enwiki-2020-10.tsv.gz,Dennis_Nilsen,43026,423843,1936,468805,92696
hdfs://spark-nn.eemcs.utwente.nl/user/s1934538/clickstream/clickstream-enwiki-2020-10.tsv.gz,Ted_Bundy,46708,504951,4708,556367,135288
hdfs://spark-nn.eemcs.utwente.nl/user/s1934538/clickstream/clickstream-enwiki-2020-10.tsv.gz,Sushant_Singh_Rajput,37956,330256,1348,369560,115398
hdfs://spark-nn.eemcs.utwente.nl/user/s1934538/clickstream/clickstream-enwiki-2020-10.tsv.gz,Richard_Jewell,42538,321053,1134,364725,111029
hdfs://spark-nn.eemcs.utwente.nl/user/s1934538/clickstream/clickstream-enwiki-2020-10.tsv.gz,Wikipedia,241803,703209,1064,946076,275421
hdfs://spark-nn.eemcs.utwente.nl/user/s1934538/clickstream/clickstream-enwiki-2020-10.tsv.gz,Bob_Saget,18913,35189,189,54291,10195
hdfs://spark-nn.eemcs.utwente.nl/user/s1934538/clickstream/clickstream-enwiki-2020-10.tsv.gz,Charles_III,82,239,44,365,255
hdfs://spark-nn.eemcs.utwente.nl/user/s1934538/clickstream/clickstream-enwiki-2020-10.tsv.gz,Manti_Te'o,5671,76298,319,82288,8916
hdfs://spark-nn.eemcs.utwente.nl/user/s1934538/clickstream/clickstream-enwiki-2020-10.tsv.gz,Star_Wars:_The_Rise_of_Skywalker,79794,99719,2017,181530,95518
hdfs://spark-nn.eemcs.utwente.nl/user/s1934538/clickstream/clickstream-enwiki-2020-10.tsv.gz,List_of_James_Bond_films,77653,566996,510,645159,397461
hdfs://spark-nn.eemcs.utwente.nl/user/s1934538/clickstream/clickstream-enwiki-2020-10.tsv.gz,Kelly_Preston,106391,275909,1298,383598,107174
hdfs://spark-nn.eemcs.utwente.nl/user/s1934538/clickstream/clickstream-enwiki-2020-10.tsv.gz,Critical_race_theory,7164,356401,1783,365348,59817
hdfs://spark-nn.eemcs.utwente.nl/user/s1934538/clickstream/clickstream-enwiki-2020-10.tsv.gz,Shang-Chi_and_the_Legend_of_the_Ten_Rings,77065,42905,275,120245,80448
hdfs://spark-nn.eemcs.utwente.nl/user/s1934538/clickstream/clickstream-enwiki-2020-10.tsv.gz,Gaza_Strip,14812,30405,183,45400,16909
hdfs://spark-nn.eemcs.utwente.nl/user/s1934538/clickstream/clickstream-enwiki-2020-10.tsv.gz,Fyre_Festival,8407,61810,362,70579,37574
hdfs://spark-nn.eemcs.utwente.nl/user/s1934538/clickstream/clickstream-enwiki-2020-10.tsv.gz,Google_logo,1228,23559,14,24801,1788
hdfs://spark-nn.eemcs.utwente.nl/user/s1934538/clickstream/clickstream-enwiki-2020-10.tsv.gz,Rishi_Sunak,23925,491225,1333,516483,146706
hdfs://spark-nn.eemcs.utwente.nl/user/s1934538/clickstream/clickstream-enwiki-2020-10.tsv.gz,Tina_Turner,20279,227911,2130,250320,62555
hdfs://spark-nn.eemcs.utwente.nl/user/s1934538/clickstream/clickstream-enwiki-2020-10.tsv.gz,Tenet_(film),136035,986770,10617,1133422,374878
hdfs://spark-nn.eemcs.utwente.nl/user/s1934538/clickstream/clickstream-enwiki-2020-10.tsv.gz,Cleopatra,61745,1430635,5797,1498177,286536
hdfs://spark-nn.eemcs.utwente.nl/user/s1934538/clickstream/clickstream-enwiki-2020-10.tsv.gz,The_Batman_(film),89448,161824,4990,256262,212641
hdfs://spark-nn.eemcs.utwente.nl/user/s1934538/clickstream/clickstream-enwiki-2020-10.tsv.gz,Taliban,27075,79196,642,106913,63284
hdfs://spark-nn.eemcs.utwente.nl/user/s1934538/clickstream/clickstream-enwiki-2020-10.tsv.gz,Antifa_(United_States),62856,719085,4853,786794,113384
hdfs://spark-nn.eemcs.utwente.nl/user/s1934538/clickstream/clickstream-enwiki-2020-10.tsv.gz,Sinéad_O'Connor,15797,170918,1206,187921,51301
hdfs://spark-nn.eemcs.utwente.nl/user/s1934538/clickstream/clickstream-enwiki-2020-10.tsv.gz,United_States_Electoral_College,169521,1689659,2269,1861449,241164
hdfs://spark-nn.eemcs.utwente.nl/user/s1934538/clickstream/clickstream-enwiki-2020-10.tsv.gz,Donald_Trump,778983,2669752,32470,3481205,2447101
hdfs://spark-nn.eemcs.utwente.nl/user/s1934538/clickstream/clickstream-enwiki-2020-10.tsv.gz,Jimmy_Buffett,8575,45915,414,54904,21994
hdfs://spark-nn.eemcs.utwente.nl/user/s1934538/clickstream/clickstream-enwiki-2020-10.tsv.gz,"Diana,_Princess_of_Wales",147833,341756,3247,492836,311755
hdfs://spark-nn.eemcs.utwente.nl/user/s1934538/clickstream/clickstream-enwiki-2020-10.tsv.gz,The_Weeknd,63631,226174,2380,292185,121205
hdfs://spark-nn.eemcs.utwente.nl/user/s1934538/clickstream/clickstream-enwiki-2020-10.tsv.gz,Stan_Lee,43932,169064,1226,214222,47850
hdfs://spark-nn.eemcs.utwente.nl/user/s1934538/clickstream/clickstream-enwiki-2020-10.tsv.gz,Queen_(band),51893,177531,2731,232155,215067
hdfs://spark-nn.eemcs.utwente.nl/user/s1934538/clickstream/clickstream-enwiki-2020-10.tsv.gz,Once_Upon_a_Time_in_Hollywood,113548,205550,2293,321391,282685
hdfs://spark-nn.eemcs.utwente.nl/user/s1934538/clickstream/clickstream-enwiki-2020-10.tsv.gz,Cecil_Hotel_(Los_Angeles),7516,51753,146,59415,28890
hdfs://spark-nn.eemcs.utwente.nl/user/s1934538/clickstream/clickstream-enwiki-2020-10.tsv.gz,Game_of_Thrones_(season_8),14249,51859,774,66882,22507
hdfs://spark-nn.eemcs.utwente.nl/user/s1934538/clickstream/clickstream-enwiki-2020-10.tsv.gz,Ukraine,48943,130118,2759,181820,83815
hdfs://spark-nn.eemcs.utwente.nl/user/s1934538/clickstream/clickstream-enwiki-2020-10.tsv.gz,Kylian_Mbappé,32475,193261,2381,228117,44282
hdfs://spark-nn.eemcs.utwente.nl/user/s1934538/clickstream/clickstream-enwiki-2020-10.tsv.gz,1234,65,1889,28,1982,276
hdfs://spark-nn.eemcs.utwente.nl/user/s1934538/clickstream/clickstream-enwiki-2020-10.tsv.gz,The_Haunting_of_Bly_Manor,394988,5452783,32152,5879923,3240548
hdfs://spark-nn.eemcs.utwente.nl/user/s1934538/clickstream/clickstream-enwiki-2020-10.tsv.gz,Venom_(2018_film),27335,217663,1739,246737,98650
hdfs://spark-nn.eemcs.utwente.nl/user/s1934538/clickstream/clickstream-enwiki-2020-10.tsv.gz,Matthew_Perry,75300,196505,858,272663,153384
hdfs://spark-nn.eemcs.utwente.nl/user/s1934538/clickstream/clickstream-enwiki-2020-10.tsv.gz,Parasite_(2019_film),45146,312471,2701,360318,136849
hdfs://spark-nn.eemcs.utwente.nl/user/s1934538/clickstream/clickstream-enwiki-2020-10.tsv.gz,Burt_Reynolds,50034,161056,1133,212223,87738
hdfs://spark-nn.eemcs.utwente.nl/user/s1934538/clickstream/clickstream-enwiki-2020-10.tsv.gz,Roe_v._Wade,61551,765367,3879,830797,253674
hdfs://spark-nn.eemcs.utwente.nl/user/s1934538/clickstream/clickstream-enwiki-2020-10.tsv.gz,Game_of_Thrones,76243,258407,6674,341324,213232
hdfs://spark-nn.eemcs.utwente.nl/user/s1934538/clickstream/clickstream-enwiki-2020-10.tsv.gz,ICC_Men's_T20_World_Cup,7253,96321,121,103695,42449
hdfs://spark-nn.eemcs.utwente.nl/user/s1934538/clickstream/clickstream-enwiki-2020-10.tsv.gz,Royal_Rumble_(2018),6953,4872,99,11924,8378
hdfs://spark-nn.eemcs.utwente.nl/user/s1934538/clickstream/clickstream-enwiki-2020-10.tsv.gz,Mac_Miller,35684,203814,1609,241107,75471
hdfs://spark-nn.eemcs.utwente.nl/user/s1934538/clickstream/clickstream-enwiki-2020-10.tsv.gz,2018_Asian_Games,4992,7399,42,12433,9642
hdfs://spark-nn.eemcs.utwente.nl/user/s1934538/clickstream/clickstream-enwiki-2020-10.tsv.gz,Chernobyl_disaster,53297,364012,2617,419926,158821
hdfs://spark-nn.eemcs.utwente.nl/user/s1934538/clickstream/clickstream-enwiki-2020-10.tsv.gz,The_Suicide_Squad_(film),97585,91656,929,190170,223659
hdfs://spark-nn.eemcs.utwente.nl/user/s1934538/clickstream/clickstream-enwiki-2020-10.tsv.gz,Shinzo_Abe,33929,43928,694,78551,44391
hdfs://spark-nn.eemcs.utwente.nl/user/s1934538/clickstream/clickstream-enwiki-2020-10.tsv.gz,Simone_Biles,11480,64710,375,76565,26167
hdfs://spark-nn.eemcs.utwente.nl/user/s1934538/clickstream/clickstream-enwiki-2020-10.tsv.gz,Ghislaine_Maxwell,64230,153160,1010,218400,85661
hdfs://spark-nn.eemcs.utwente.nl/user/s1934538/clickstream/clickstream-enwiki-2020-10.tsv.gz,DMX_(rapper),14977,66142,442,81561,33554
hdfs://spark-nn.eemcs.utwente.nl/user/s1934538/clickstream/clickstream-enwiki-2020-10.tsv.gz,Tom_Brady,85855,506227,4550,596632,200550
hdfs://spark-nn.eemcs.utwente.nl/user/s1934538/clickstream/clickstream-enwiki-2020-10.tsv.gz,Cristiano_Ronaldo,100427,694603,4971,800001,175843
hdfs://spark-nn.eemcs.utwente.nl/user/s1934538/clickstream/clickstream-enwiki-2020-10.tsv.gz,Anne_Heche,44089,289667,1355,335111,96525
hdfs://spark-nn.eemcs.utwente.nl/user/s1934538/clickstream/clickstream-enwiki-2020-10.tsv.gz,Bipin_Rawat,6567,15678,37,22282,9876
hdfs://spark-nn.eemcs.utwente.nl/user/s1934538/clickstream/clickstream-enwiki-2020-10.tsv.gz,The_Irishman,49809,122337,1660,173806,149381
hdfs://spark-nn.eemcs.utwente.nl/user/s1934538/clickstream/clickstream-enwiki-2020-10.tsv.gz,XXXTentacion,64156,501307,5599,571062,92151
hdfs://spark-nn.eemcs.utwente.nl/user/s1934538/clickstream/clickstream-enwiki-2020-10.tsv.gz,UEFA_Euro_2020,56437,167933,3619,227989,132173
hdfs://spark-nn.eemcs.utwente.nl/user/s1934538/clickstream/clickstream-enwiki-2020-10.tsv.gz,Pelé,32327,203369,2042,237738,78324
hdfs://spark-nn.eemcs.utwente.nl/user/s1934538/clickstream/clickstream-enwiki-2020-10.tsv.gz,Don't_Look_Up_(2021_film),2381,408,13,2802,1648
hdfs://spark-nn.eemcs.utwente.nl/user/s1934538/clickstream/clickstream-enwiki-2020-10.tsv.gz,Hamilton_(musical),54866,318651,2450,375967,262606
hdfs://spark-nn.eemcs.utwente.nl/user/s1934538/clickstream/clickstream-enwiki-2020-10.tsv.gz,Death_of_Elisa_Lam,12775,136113,768,149656,32569
hdfs://spark-nn.eemcs.utwente.nl/user/s1934538/clickstream/clickstream-enwiki-2020-10.tsv.gz,The_Lion_King_(2019_film),41793,121785,788,164366,64311
hdfs://spark-nn.eemcs.utwente.nl/user/s1934538/clickstream/clickstream-enwiki-2020-10.tsv.gz,Qasem_Soleimani,15312,52284,328,67924,29491
hdfs://spark-nn.eemcs.utwente.nl/user/s1934538/clickstream/clickstream-enwiki-2020-10.tsv.gz,List_of_Marvel_Cinematic_Universe_films,84707,596970,1370,683047,259957
hdfs://spark-nn.eemcs.utwente.nl/user/s1934538/clickstream/clickstream-enwiki-2020-10.tsv.gz,Microsoft_Office,10035,2066221,789,2077045,23356
hdfs://spark-nn.eemcs.utwente.nl/user/s1934538/clickstream/clickstream-enwiki-2020-10.tsv.gz,Louis_Tomlinson,34472,80714,342,115528,23245
hdfs://spark-nn.eemcs.utwente.nl/user/s1934538/clickstream/clickstream-enwiki-2020-10.tsv.gz,Media,60,3579,294,3933,1685
hdfs://spark-nn.eemcs.utwente.nl/user/s1934538/clickstream/clickstream-enwiki-2020-10.tsv.gz,Aaron_Hernandez,11057,167380,692,179129,53633
hdfs://spark-nn.eemcs.utwente.nl/user/s1934538/clickstream/clickstream-enwiki-2020-10.tsv.gz,COVID-19_pandemic,597119,796885,6483,1400487,772044
hdfs://spark-nn.eemcs.utwente.nl/user/s1934538/clickstream/clickstream-enwiki-2020-10.tsv.gz,2020_Summer_Olympics,39435,82471,1601,123507,78408
hdfs://spark-nn.eemcs.utwente.nl/user/s1934538/clickstream/clickstream-enwiki-2020-10.tsv.gz,Mulan_(2020_film),41341,1015866,7081,1064288,194830
hdfs://spark-nn.eemcs.utwente.nl/user/s1934538/clickstream/clickstream-enwiki-2020-10.tsv.gz,The_Shape_of_Water,30244,82074,585,112903,44527
hdfs://spark-nn.eemcs.utwente.nl/user/s1934538/clickstream/clickstream-enwiki-2020-10.tsv.gz,Brett_Kavanaugh,149272,205809,1343,356424,129062
hdfs://spark-nn.eemcs.utwente.nl/user/s1934538/clickstream/clickstream-enwiki-2020-10.tsv.gz,Cricket_World_Cup,8813,85253,182,94248,44958
hdfs://spark-nn.eemcs.utwente.nl/user/s1934538/clickstream/clickstream-enwiki-2020-10.tsv.gz,Hyphen-minus,5619,6691369,8206359,14903347,731
hdfs://spark-nn.eemcs.utwente.nl/user/s1934538/clickstream/clickstream-enwiki-2020-10.tsv.gz,"Citizenship_(Amendment)_Act,_2019",4696,49872,30,54598,5563
hdfs://spark-nn.eemcs.utwente.nl/user/s1934538/clickstream/clickstream-enwiki-2020-10.tsv.gz,Jimmy_Hoffa,31858,136083,1012,168953,61205
hdfs://spark-nn.eemcs.utwente.nl/user/s1934538/clickstream/clickstream-enwiki-2020-10.tsv.gz,Freddie_Mercury,73540,462258,3972,539770,184994
hdfs://spark-nn.eemcs.utwente.nl/user/s1934538/clickstream/clickstream-enwiki-2020-10.tsv.gz,"Princess_Margaret,_Countess_of_Snowdon",155903,457929,2689,616521,386652
hdfs://spark-nn.eemcs.utwente.nl/user/s1934538/clickstream/clickstream-enwiki-2020-10.tsv.gz,Aaron_Carter,20772,53557,317,74646,29033
hdfs://spark-nn.eemcs.utwente.nl/user/s1934538/clickstream/clickstream-enwiki-2020-10.tsv.gz,Bible,17330,5424498,1615,5443443,35746
hdfs://spark-nn.eemcs.utwente.nl/user/s1934538/clickstream/clickstream-enwiki-2020-10.tsv.gz,Joker_(2019_film),53662,329236,2576,385474,124666
hdfs://spark-nn.eemcs.utwente.nl/user/s1934538/clickstream/clickstream-enwiki-2020-10.tsv.gz,David_Beckham,37302,170508,1417,209227,75455
hdfs://spark-nn.eemcs.utwente.nl/user/s1934538/clickstream/clickstream-enwiki-2020-10.tsv.gz,RRR_(film),47480,213436,412,261328,207842
hdfs://spark-nn.eemcs.utwente.nl/user/s1934538/clickstream/clickstream-enwiki-2020-10.tsv.gz,Godzilla_vs._Kong,66879,67164,1028,135071,75168
hdfs://spark-nn.eemcs.utwente.nl/user/s1934538/clickstream/clickstream-enwiki-2020-10.tsv.gz,Avengers:_Endgame,104120,205070,2608,311798,184042
hdfs://spark-nn.eemcs.utwente.nl/user/s1934538/clickstream/clickstream-enwiki-2020-10.tsv.gz,Brie_Larson,68498,171268,1713,241479,85988
hdfs://spark-nn.eemcs.utwente.nl/user/s1934538/clickstream/clickstream-enwiki-2020-10.tsv.gz,Cook's_Country,335,3073,30,3438,864
hdfs://spark-nn.eemcs.utwente.nl/user/s1934538/clickstream/clickstream-enwiki-2020-10.tsv.gz,Tunnel,3334,12833,151,16318,3859
hdfs://spark-nn.eemcs.utwente.nl/user/s1934538/clickstream/clickstream-enwiki-2020-10.tsv.gz,Black_Widow_(2021_film),74814,131819,3089,209722,87623
hdfs://spark-nn.eemcs.utwente.nl/user/s1934538/clickstream/clickstream-enwiki-2020-10.tsv.gz,Hamas,17582,30951,277,48810,17784
hdfs://spark-nn.eemcs.utwente.nl/user/s1934538/clickstream/clickstream-enwiki-2020-10.tsv.gz,Aquaman_(film),34466,155280,1421,191167,75440
hdfs://spark-nn.eemcs.utwente.nl/user/s1934538/clickstream/clickstream-enwiki-2020-10.tsv.gz,Eddie_Van_Halen,580816,3877128,87466,4545410,1778246
hdfs://spark-nn.eemcs.utwente.nl/user/s1934538/clickstream/clickstream-enwiki-2020-10.tsv.gz,WrestleMania_34,14964,8386,117,23467,15932
hdfs://spark-nn.eemcs.utwente.nl/user/s1934538/clickstream/clickstream-enwiki-2020-10.tsv.gz,Loki_(TV_series),31254,16376,102,47732,18685
hdfs://spark-nn.eemcs.utwente.nl/user/s1934538/clickstream/clickstream-enwiki-2020-10.tsv.gz,Captain_Marvel_(film),34847,119767,1273,155887,61748
hdfs://spark-nn.eemcs.utwente.nl/user/s1934538/clickstream/clickstream-enwiki-2020-10.tsv.gz,Lisa_Marie_Presley,117824,108859,803,227486,124343
hdfs://spark-nn.eemcs.utwente.nl/user/s1934538/clickstream/clickstream-enwiki-2020-10.tsv.gz,Kim_Jong-un,58740,188773,1769,249282,120095
hdfs://spark-nn.eemcs.utwente.nl/user/s1934538/clickstream/clickstream-enwiki-2020-10.tsv.gz,Russo-Ukrainian_War,20731,29087,115,49933,28615
hdfs://spark-nn.eemcs.utwente.nl/user/s1934538/clickstream/clickstream-enwiki-2020-10.tsv.gz,Spider-Man:_Far_From_Home,86205,132669,9950,228824,137427
hdfs://spark-nn.eemcs.utwente.nl/user/s1934538/clickstream/clickstream-enwiki-2020-10.tsv.gz,The_Mandalorian,109573,903514,17657,1030744,634043
hdfs://spark-nn.eemcs.utwente.nl/user/s1934538/clickstream/clickstream-enwiki-2020-10.tsv.gz,Spanish_flu,59610,588947,6347,654904,143307
hdfs://spark-nn.eemcs.utwente.nl/user/s1934538/clickstream/clickstream-enwiki-2020-11.tsv.gz,United_States_Senate,373473,658798,7290,1039561,403708
hdfs://spark-nn.eemcs.utwente.nl/user/s1934538/clickstream/clickstream-enwiki-2020-11.tsv.gz,Johnny_Depp,243792,1078879,7714,1330385,899298
hdfs://spark-nn.eemcs.utwente.nl/user/s1934538/clickstream/clickstream-enwiki-2020-11.tsv.gz,Shakira,20655,167395,1524,189574,81872
hdfs://spark-nn.eemcs.utwente.nl/user/s1934538/clickstream/clickstream-enwiki-2020-11.tsv.gz,The_Batman_(film),72376,112456,1836,186668,141349
hdfs://spark-nn.eemcs.utwente.nl/user/s1934538/clickstream/clickstream-enwiki-2020-11.tsv.gz,When_They_See_Us,18962,57246,305,76513,34617
hdfs://spark-nn.eemcs.utwente.nl/user/s1934538/clickstream/clickstream-enwiki-2020-11.tsv.gz,Bonnie_and_Clyde,25278,264197,1441,290916,64563
hdfs://spark-nn.eemcs.utwente.nl/user/s1934538/clickstream/clickstream-enwiki-2020-11.tsv.gz,The_Weeknd,77509,459663,4499,541671,212808
hdfs://spark-nn.eemcs.utwente.nl/user/s1934538/clickstream/clickstream-enwiki-2020-11.tsv.gz,Black_Widow_(2021_film),73735,142936,2559,219230,86959
hdfs://spark-nn.eemcs.utwente.nl/user/s1934538/clickstream/clickstream-enwiki-2020-11.tsv.gz,Olivia_Newton-John,28956,120018,973,149947,60716
hdfs://spark-nn.eemcs.utwente.nl/user/s1934538/clickstream/clickstream-enwiki-2020-11.tsv.gz,Matthew_Perry,70201,240211,1176,311588,176629
hdfs://spark-nn.eemcs.utwente.nl/user/s1934538/clickstream/clickstream-enwiki-2020-11.tsv.gz,Jenna_Ortega,32142,41592,1494,75228,16702
hdfs://spark-nn.eemcs.utwente.nl/user/s1934538/clickstream/clickstream-enwiki-2020-11.tsv.gz,Hamilton_(musical),54210,328339,2549,385098,278718
hdfs://spark-nn.eemcs.utwente.nl/user/s1934538/clickstream/clickstream-enwiki-2020-11.tsv.gz,The_Mandalorian,302506,2316536,36822,2655864,1899218
hdfs://spark-nn.eemcs.utwente.nl/user/s1934538/clickstream/clickstream-enwiki-2020-11.tsv.gz,Anna_Sorokin,7317,30970,50,38337,10844
hdfs://spark-nn.eemcs.utwente.nl/user/s1934538/clickstream/clickstream-enwiki-2020-11.tsv.gz,Lisa_Marie_Presley,122429,72977,237,195643,103832
hdfs://spark-nn.eemcs.utwente.nl/user/s1934538/clickstream/clickstream-enwiki-2020-11.tsv.gz,Keanu_Reeves,113333,772098,4055,889486,483388
hdfs://spark-nn.eemcs.utwente.nl/user/s1934538/clickstream/clickstream-enwiki-2020-11.tsv.gz,Naya_Rivera,74114,195381,895,270390,82931
hdfs://spark-nn.eemcs.utwente.nl/user/s1934538/clickstream/clickstream-enwiki-2020-11.tsv.gz,Joe_Exotic,26039,193674,957,220670,56673
hdfs://spark-nn.eemcs.utwente.nl/user/s1934538/clickstream/clickstream-enwiki-2020-11.tsv.gz,Eddie_Van_Halen,56992,186335,2437,245764,86574
hdfs://spark-nn.eemcs.utwente.nl/user/s1934538/clickstream/clickstream-enwiki-2020-11.tsv.gz,Hamas,20499,30492,223,51214,20181
hdfs://spark-nn.eemcs.utwente.nl/user/s1934538/clickstream/clickstream-enwiki-2020-11.tsv.gz,Anthony_Bourdain,18252,196780,1291,216323,65129
hdfs://spark-nn.eemcs.utwente.nl/user/s1934538/clickstream/clickstream-enwiki-2020-11.tsv.gz,Bird_Box_(film),22706,94212,858,117776,34776
hdfs://spark-nn.eemcs.utwente.nl/user/s1934538/clickstream/clickstream-enwiki-2020-11.tsv.gz,Lance_Reddick,29617,36975,311,66903,13765
hdfs://spark-nn.eemcs.utwente.nl/user/s1934538/clickstream/clickstream-enwiki-2020-11.tsv.gz,Joaquin_Phoenix,146382,232137,1041,379560,226716
hdfs://spark-nn.eemcs.utwente.nl/user/s1934538/clickstream/clickstream-enwiki-2020-11.tsv.gz,COVID-19_pandemic_by_country_and_territory,422076,735124,3250,1160450,965679
hdfs://spark-nn.eemcs.utwente.nl/user/s1934538/clickstream/clickstream-enwiki-2020-11.tsv.gz,JSON_Web_Token,809,30309,63,31181,1789
hdfs://spark-nn.eemcs.utwente.nl/user/s1934538/clickstream/clickstream-enwiki-2020-11.tsv.gz,List_of_highest-grossing_films,98047,218431,1605,318083,152727
hdfs://spark-nn.eemcs.utwente.nl/user/s1934538/clickstream/clickstream-enwiki-2020-11.tsv.gz,It_Chapter_Two,41604,113044,919,155567,103125
hdfs://spark-nn.eemcs.utwente.nl/user/s1934538/clickstream/clickstream-enwiki-2020-11.tsv.gz,September_11_attacks,83689,294488,2360,380537,164429
hdfs://spark-nn.eemcs.utwente.nl/user/s1934538/clickstream/clickstream-enwiki-2020-11.tsv.gz,Loki_(TV_series),32854,28817,181,61852,22170
hdfs://spark-nn.eemcs.utwente.nl/user/s1934538/clickstream/clickstream-enwiki-2020-11.tsv.gz,Star_Wars:_The_Rise_of_Skywalker,109625,138333,2530,250488,134555
hdfs://spark-nn.eemcs.utwente.nl/user/s1934538/clickstream/clickstream-enwiki-2020-11.tsv.gz,Stranger_Things,63279,291223,5818,360320,275181
hdfs://spark-nn.eemcs.utwente.nl/user/s1934538/clickstream/clickstream-enwiki-2020-11.tsv.gz,Brie_Larson,59216,168478,1139,228833,80118
hdfs://spark-nn.eemcs.utwente.nl/user/s1934538/clickstream/clickstream-enwiki-2020-11.tsv.gz,Ruth_Bader_Ginsburg,109484,367304,2806,479594,175648
hdfs://spark-nn.eemcs.utwente.nl/user/s1934538/clickstream/clickstream-enwiki-2020-11.tsv.gz,Mulan_(2020_film),35738,437207,3758,476703,148408
hdfs://spark-nn.eemcs.utwente.nl/user/s1934538/clickstream/clickstream-enwiki-2020-11.tsv.gz,Avicii,19260,184519,1441,205220,92865
hdfs://spark-nn.eemcs.utwente.nl/user/s1934538/clickstream/clickstream-enwiki-2020-11.tsv.gz,Tonya_Harding,23199,102649,517,126365,32404
hdfs://spark-nn.eemcs.utwente.nl/user/s1934538/clickstream/clickstream-enwiki-2020-11.tsv.gz,Bipin_Rawat,8480,76156,89,84725,17340
hdfs://spark-nn.eemcs.utwente.nl/user/s1934538/clickstream/clickstream-enwiki-2020-11.tsv.gz,The_Shape_of_Water,26592,58348,467,85407,32295
hdfs://spark-nn.eemcs.utwente.nl/user/s1934538/clickstream/clickstream-enwiki-2020-11.tsv.gz,Jason_Momoa,103582,423438,2208,529228,237803
hdfs://spark-nn.eemcs.utwente.nl/user/s1934538/clickstream/clickstream-enwiki-2020-11.tsv.gz,2020_United_States_presidential_election,2672981,9397034,428702,12498717,6893238
hdfs://spark-nn.eemcs.utwente.nl/user/s1934538/clickstream/clickstream-enwiki-2020-11.tsv.gz,Murder_of_Dee_Dee_Blanchard,22402,190218,487,213107,39164
hdfs://spark-nn.eemcs.utwente.nl/user/s1934538/clickstream/clickstream-enwiki-2020-11.tsv.gz,The_Umbrella_Academy_(TV_series),35184,275309,4128,314621,181898
hdfs://spark-nn.eemcs.utwente.nl/user/s1934538/clickstream/clickstream-enwiki-2020-11.tsv.gz,War_(2019_film),16215,84376,104,100695,20892
hdfs://spark-nn.eemcs.utwente.nl/user/s1934538/clickstream/clickstream-enwiki-2020-11.tsv.gz,Ukraine,46537,120325,2476,169338,78643
hdfs://spark-nn.eemcs.utwente.nl/user/s1934538/clickstream/clickstream-enwiki-2020-11.tsv.gz,Christopher_Scarver,54647,22517,20,77184,28367
hdfs://spark-nn.eemcs.utwente.nl/user/s1934538/clickstream/clickstream-enwiki-2020-11.tsv.gz,Venom_(2018_film),22749,185824,1173,209746,69664
hdfs://spark-nn.eemcs.utwente.nl/user/s1934538/clickstream/clickstream-enwiki-2020-11.tsv.gz,Shooting_of_Breonna_Taylor,6992,228629,475,236096,16248
hdfs://spark-nn.eemcs.utwente.nl/user/s1934538/clickstream/clickstream-enwiki-2020-11.tsv.gz,Cristiano_Ronaldo,121448,768845,5526,895819,201508
hdfs://spark-nn.eemcs.utwente.nl/user/s1934538/clickstream/clickstream-enwiki-2020-11.tsv.gz,Aaron_Carter,16413,41076,225,57714,24472
hdfs://spark-nn.eemcs.utwente.nl/user/s1934538/clickstream/clickstream-enwiki-2020-11.tsv.gz,Tunnel,2832,10789,93,13714,3198
hdfs://spark-nn.eemcs.utwente.nl/user/s1934538/clickstream/clickstream-enwiki-2020-11.tsv.gz,Chernobyl_(miniseries),19482,103100,1607,124189,111270
hdfs://spark-nn.eemcs.utwente.nl/user/s1934538/clickstream/clickstream-enwiki-2020-11.tsv.gz,Watts_family_murders,31102,343278,496,374876,83674
hdfs://spark-nn.eemcs.utwente.nl/user/s1934538/clickstream/clickstream-enwiki-2020-11.tsv.gz,Glass_(2019_film),97062,132952,748,230762,64464
hdfs://spark-nn.eemcs.utwente.nl/user/s1934538/clickstream/clickstream-enwiki-2020-11.tsv.gz,Charles_III,126,320,97,543,449
hdfs://spark-nn.eemcs.utwente.nl/user/s1934538/clickstream/clickstream-enwiki-2020-11.tsv.gz,Grover,1690,7409,82,9181,2167
hdfs://spark-nn.eemcs.utwente.nl/user/s1934538/clickstream/clickstream-enwiki-2020-11.tsv.gz,Cecil_Hotel_(Los_Angeles),7523,31993,71,39587,15332
hdfs://spark-nn.eemcs.utwente.nl/user/s1934538/clickstream/clickstream-enwiki-2020-11.tsv.gz,QAnon,121440,1435198,12430,1569068,336841
hdfs://spark-nn.eemcs.utwente.nl/user/s1934538/clickstream/clickstream-enwiki-2020-11.tsv.gz,The_Witcher_(TV_series),31492,200269,3769,235530,129100
hdfs://spark-nn.eemcs.utwente.nl/user/s1934538/clickstream/clickstream-enwiki-2020-11.tsv.gz,Mötley_Crüe,30235,107376,1116,138727,170594
hdfs://spark-nn.eemcs.utwente.nl/user/s1934538/clickstream/clickstream-enwiki-2020-11.tsv.gz,Brett_Kavanaugh,112656,115225,1300,229181,71451
hdfs://spark-nn.eemcs.utwente.nl/user/s1934538/clickstream/clickstream-enwiki-2020-11.tsv.gz,Parasite_(2019_film),45401,346775,2820,394996,147274
hdfs://spark-nn.eemcs.utwente.nl/user/s1934538/clickstream/clickstream-enwiki-2020-11.tsv.gz,FIFA_World_Cup,54007,232639,2946,289592,197451
hdfs://spark-nn.eemcs.utwente.nl/user/s1934538/clickstream/clickstream-enwiki-2020-11.tsv.gz,Meat_Loaf,31309,98736,879,130924,46664
hdfs://spark-nn.eemcs.utwente.nl/user/s1934538/clickstream/clickstream-enwiki-2020-11.tsv.gz,2023_Cricket_World_Cup,13941,26447,54,40442,12785
hdfs://spark-nn.eemcs.utwente.nl/user/s1934538/clickstream/clickstream-enwiki-2020-11.tsv.gz,Kamala_Harris,1660596,14108670,111587,15880853,9341491
hdfs://spark-nn.eemcs.utwente.nl/user/s1934538/clickstream/clickstream-enwiki-2020-11.tsv.gz,XXXTentacion,68553,461923,5670,536146,94130
hdfs://spark-nn.eemcs.utwente.nl/user/s1934538/clickstream/clickstream-enwiki-2020-11.tsv.gz,Israel,86149,234488,4002,324639,161642
hdfs://spark-nn.eemcs.utwente.nl/user/s1934538/clickstream/clickstream-enwiki-2020-11.tsv.gz,Shang-Chi_and_the_Legend_of_the_Ten_Rings,72251,29221,88,101560,64358
hdfs://spark-nn.eemcs.utwente.nl/user/s1934538/clickstream/clickstream-enwiki-2020-11.tsv.gz,Alexander_Hamilton,150151,476869,2880,629900,334961
hdfs://spark-nn.eemcs.utwente.nl/user/s1934538/clickstream/clickstream-enwiki-2020-11.tsv.gz,Black_Panther_(film),63195,191020,2692,256907,131169
hdfs://spark-nn.eemcs.utwente.nl/user/s1934538/clickstream/clickstream-enwiki-2020-11.tsv.gz,Coronavirus,30448,439851,6863,477162,110093
hdfs://spark-nn.eemcs.utwente.nl/user/s1934538/clickstream/clickstream-enwiki-2020-11.tsv.gz,Game_of_Thrones_(season_8),14439,53859,557,68855,21726
hdfs://spark-nn.eemcs.utwente.nl/user/s1934538/clickstream/clickstream-enwiki-2020-11.tsv.gz,Jimmy_Buffett,7060,37478,471,45009,18138
hdfs://spark-nn.eemcs.utwente.nl/user/s1934538/clickstream/clickstream-enwiki-2020-11.tsv.gz,Donald_Glover,54917,216142,1103,272162,99723
hdfs://spark-nn.eemcs.utwente.nl/user/s1934538/clickstream/clickstream-enwiki-2020-11.tsv.gz,Henry_V_of_England,105877,133430,524,239831,167720
hdfs://spark-nn.eemcs.utwente.nl/user/s1934538/clickstream/clickstream-enwiki-2020-11.tsv.gz,Aretha_Franklin,25700,88792,708,115200,44217
hdfs://spark-nn.eemcs.utwente.nl/user/s1934538/clickstream/clickstream-enwiki-2020-11.tsv.gz,2018_Asian_Games,4449,6678,43,11170,9151
hdfs://spark-nn.eemcs.utwente.nl/user/s1934538/clickstream/clickstream-enwiki-2020-11.tsv.gz,K.G.F:_Chapter_2,18114,162324,191,180629,47558
hdfs://spark-nn.eemcs.utwente.nl/user/s1934538/clickstream/clickstream-enwiki-2020-11.tsv.gz,Vladimir_Putin,127435,525990,6413,659838,378089
hdfs://spark-nn.eemcs.utwente.nl/user/s1934538/clickstream/clickstream-enwiki-2020-11.tsv.gz,Michael_Bloomberg,119666,94452,599,214717,114445
hdfs://spark-nn.eemcs.utwente.nl/user/s1934538/clickstream/clickstream-enwiki-2020-11.tsv.gz,No_Time_to_Die,172341,185916,3187,361444,238955
hdfs://spark-nn.eemcs.utwente.nl/user/s1934538/clickstream/clickstream-enwiki-2020-11.tsv.gz,YouTube,131589,1433098,10817,1575504,136472
hdfs://spark-nn.eemcs.utwente.nl/user/s1934538/clickstream/clickstream-enwiki-2020-11.tsv.gz,Game_of_Thrones,77934,263818,6305,348057,215689
hdfs://spark-nn.eemcs.utwente.nl/user/s1934538/clickstream/clickstream-enwiki-2020-11.tsv.gz,"Meghan,_Duchess_of_Sussex",287166,406327,2834,696327,364315
hdfs://spark-nn.eemcs.utwente.nl/user/s1934538/clickstream/clickstream-enwiki-2020-11.tsv.gz,Stranger_Things_(season_4),33745,167043,812,201600,113549
hdfs://spark-nn.eemcs.utwente.nl/user/s1934538/clickstream/clickstream-enwiki-2020-11.tsv.gz,Microsoft_Office,9544,2010508,792,2020844,21638
hdfs://spark-nn.eemcs.utwente.nl/user/s1934538/clickstream/clickstream-enwiki-2020-11.tsv.gz,Sinéad_O'Connor,16771,123963,1083,141817,43645
hdfs://spark-nn.eemcs.utwente.nl/user/s1934538/clickstream/clickstream-enwiki-2020-11.tsv.gz,The_Haunting_of_Bly_Manor,80535,765865,5853,852253,440612
hdfs://spark-nn.eemcs.utwente.nl/user/s1934538/clickstream/clickstream-enwiki-2020-11.tsv.gz,21_Savage,14850,111983,955,127788,45434
hdfs://spark-nn.eemcs.utwente.nl/user/s1934538/clickstream/clickstream-enwiki-2020-11.tsv.gz,ICC_Men's_T20_World_Cup,8079,112416,214,120709,53331
hdfs://spark-nn.eemcs.utwente.nl/user/s1934538/clickstream/clickstream-enwiki-2020-11.tsv.gz,Kelly_Preston,133479,326418,1584,461481,131829
hdfs://spark-nn.eemcs.utwente.nl/user/s1934538/clickstream/clickstream-enwiki-2020-11.tsv.gz,Ghislaine_Maxwell,70559,120693,441,191693,69612
hdfs://spark-nn.eemcs.utwente.nl/user/s1934538/clickstream/clickstream-enwiki-2020-11.tsv.gz,Killing_of_George_Floyd,63639,100607,864,165110,60433
hdfs://spark-nn.eemcs.utwente.nl/user/s1934538/clickstream/clickstream-enwiki-2020-11.tsv.gz,Simone_Biles,10443,64973,406,75822,23918
hdfs://spark-nn.eemcs.utwente.nl/user/s1934538/clickstream/clickstream-enwiki-2020-11.tsv.gz,The_Sandman_(TV_series),2555,3618,15,6188,1095
hdfs://spark-nn.eemcs.utwente.nl/user/s1934538/clickstream/clickstream-enwiki-2020-11.tsv.gz,Army_of_the_Dead,27897,17891,264,46052,29786
hdfs://spark-nn.eemcs.utwente.nl/user/s1934538/clickstream/clickstream-enwiki-2020-11.tsv.gz,1917_(2019_film),33018,275025,3454,311497,153846
hdfs://spark-nn.eemcs.utwente.nl/user/s1934538/clickstream/clickstream-enwiki-2020-11.tsv.gz,Avengers:_Endgame,105967,219258,2749,327974,196510
hdfs://spark-nn.eemcs.utwente.nl/user/s1934538/clickstream/clickstream-enwiki-2020-11.tsv.gz,Irrfan_Khan,31606,71437,165,103208,34160
hdfs://spark-nn.eemcs.utwente.nl/user/s1934538/clickstream/clickstream-enwiki-2020-11.tsv.gz,Juneteenth,3699,43397,368,47464,3978
hdfs://spark-nn.eemcs.utwente.nl/user/s1934538/clickstream/clickstream-enwiki-2020-11.tsv.gz,Khabib_Nurmagomedov,80432,340577,3580,424589,204231
hdfs://spark-nn.eemcs.utwente.nl/user/s1934538/clickstream/clickstream-enwiki-2020-11.tsv.gz,List_of_awards_and_nominations_received_by_Meryl_Streep,17391,13477,165,31033,11092
hdfs://spark-nn.eemcs.utwente.nl/user/s1934538/clickstream/clickstream-enwiki-2020-11.tsv.gz,Wonder_Woman_1984,82662,240932,7186,330780,137868
hdfs://spark-nn.eemcs.utwente.nl/user/s1934538/clickstream/clickstream-enwiki-2020-11.tsv.gz,"Citizenship_(Amendment)_Act,_2019",5056,43419,161,48636,5287
hdfs://spark-nn.eemcs.utwente.nl/user/s1934538/clickstream/clickstream-enwiki-2020-11.tsv.gz,Zack_Snyder's_Justice_League,89483,120349,1462,211294,100961
hdfs://spark-nn.eemcs.utwente.nl/user/s1934538/clickstream/clickstream-enwiki-2020-11.tsv.gz,Kim_Jong-un,60313,168097,1726,230136,115241
hdfs://spark-nn.eemcs.utwente.nl/user/s1934538/clickstream/clickstream-enwiki-2020-11.tsv.gz,Royal_Rumble_(2018),7828,5493,89,13410,9607
hdfs://spark-nn.eemcs.utwente.nl/user/s1934538/clickstream/clickstream-enwiki-2020-11.tsv.gz,Sylvester_Stallone,101027,316895,2285,420207,308905
hdfs://spark-nn.eemcs.utwente.nl/user/s1934538/clickstream/clickstream-enwiki-2020-11.tsv.gz,2018_Winter_Olympics,15914,14494,208,30616,22075
hdfs://spark-nn.eemcs.utwente.nl/user/s1934538/clickstream/clickstream-enwiki-2020-11.tsv.gz,Critical_race_theory,7132,176603,741,184476,31181
hdfs://spark-nn.eemcs.utwente.nl/user/s1934538/clickstream/clickstream-enwiki-2020-11.tsv.gz,Stan_Lee,47139,190363,1331,238833,52048
hdfs://spark-nn.eemcs.utwente.nl/user/s1934538/clickstream/clickstream-enwiki-2020-11.tsv.gz,Deion_Sanders,14118,178133,790,193041,58796
hdfs://spark-nn.eemcs.utwente.nl/user/s1934538/clickstream/clickstream-enwiki-2020-11.tsv.gz,Bible,16669,5305782,1444,5323895,34066
hdfs://spark-nn.eemcs.utwente.nl/user/s1934538/clickstream/clickstream-enwiki-2020-11.tsv.gz,Michael_Jordan,75052,436321,3815,515188,173886
hdfs://spark-nn.eemcs.utwente.nl/user/s1934538/clickstream/clickstream-enwiki-2020-11.tsv.gz,The_Lion_King_(2019_film),45763,84937,705,131405,68772
hdfs://spark-nn.eemcs.utwente.nl/user/s1934538/clickstream/clickstream-enwiki-2020-11.tsv.gz,J._Robert_Oppenheimer,21225,113631,419,135275,45840
hdfs://spark-nn.eemcs.utwente.nl/user/s1934538/clickstream/clickstream-enwiki-2020-11.tsv.gz,Sushant_Singh_Rajput,30800,167743,689,199232,74767
hdfs://spark-nn.eemcs.utwente.nl/user/s1934538/clickstream/clickstream-enwiki-2020-11.tsv.gz,Chernobyl_disaster,54376,344833,2617,401826,162531
hdfs://spark-nn.eemcs.utwente.nl/user/s1934538/clickstream/clickstream-enwiki-2020-11.tsv.gz,Main_Page,10225,187734131,4912047,192656403,37236245
hdfs://spark-nn.eemcs.utwente.nl/user/s1934538/clickstream/clickstream-enwiki-2020-11.tsv.gz,Google_logo,1087,22904,13,24004,1510
hdfs://spark-nn.eemcs.utwente.nl/user/s1934538/clickstream/clickstream-enwiki-2020-11.tsv.gz,Ted_Bundy,39282,449960,4532,493774,117387
hdfs://spark-nn.eemcs.utwente.nl/user/s1934538/clickstream/clickstream-enwiki-2020-11.tsv.gz,Stephen_Hawking,40112,467019,2463,509594,213062
hdfs://spark-nn.eemcs.utwente.nl/user/s1934538/clickstream/clickstream-enwiki-2020-11.tsv.gz,Donald_Trump,2047905,25931893,46617,28026415,5956231
hdfs://spark-nn.eemcs.utwente.nl/user/s1934538/clickstream/clickstream-enwiki-2020-11.tsv.gz,Louis_Tomlinson,36121,74975,339,111435,23561
hdfs://spark-nn.eemcs.utwente.nl/user/s1934538/clickstream/clickstream-enwiki-2020-11.tsv.gz,Amber_Heard,223511,1100487,5878,1329876,574756
hdfs://spark-nn.eemcs.utwente.nl/user/s1934538/clickstream/clickstream-enwiki-2020-11.tsv.gz,Richard_Jewell,40099,271110,1020,312229,99410
hdfs://spark-nn.eemcs.utwente.nl/user/s1934538/clickstream/clickstream-enwiki-2020-11.tsv.gz,Shinzo_Abe,38232,42245,618,81095,48154
hdfs://spark-nn.eemcs.utwente.nl/user/s1934538/clickstream/clickstream-enwiki-2020-11.tsv.gz,The_Irishman,53937,135299,2086,191322,161359
hdfs://spark-nn.eemcs.utwente.nl/user/s1934538/clickstream/clickstream-enwiki-2020-11.tsv.gz,List_of_most_popular_websites,8320,66844,73,75237,27947
hdfs://spark-nn.eemcs.utwente.nl/user/s1934538/clickstream/clickstream-enwiki-2020-11.tsv.gz,Amy_Coney_Barrett,186236,408394,6164,600794,197221
hdfs://spark-nn.eemcs.utwente.nl/user/s1934538/clickstream/clickstream-enwiki-2020-11.tsv.gz,Spanish_flu,61035,539874,6338,607247,133529
hdfs://spark-nn.eemcs.utwente.nl/user/s1934538/clickstream/clickstream-enwiki-2020-11.tsv.gz,Lionel_Messi,120497,508433,5393,634323,138104
hdfs://spark-nn.eemcs.utwente.nl/user/s1934538/clickstream/clickstream-enwiki-2020-11.tsv.gz,Captain_Marvel_(film),35903,128931,1098,165932,65900
hdfs://spark-nn.eemcs.utwente.nl/user/s1934538/clickstream/clickstream-enwiki-2020-11.tsv.gz,Cook's_Country,464,2888,31,3383,877
hdfs://spark-nn.eemcs.utwente.nl/user/s1934538/clickstream/clickstream-enwiki-2020-11.tsv.gz,Jeffrey_Dahmer,28289,333593,3462,365344,145643
hdfs://spark-nn.eemcs.utwente.nl/user/s1934538/clickstream/clickstream-enwiki-2020-11.tsv.gz,Aquaman_(film),53540,228407,2748,284695,143731
hdfs://spark-nn.eemcs.utwente.nl/user/s1934538/clickstream/clickstream-enwiki-2020-11.tsv.gz,William_Murdoch,525,1651,15,2191,288
hdfs://spark-nn.eemcs.utwente.nl/user/s1934538/clickstream/clickstream-enwiki-2020-11.tsv.gz,Jimmy_Hoffa,35031,142602,1112,178745,66040
hdfs://spark-nn.eemcs.utwente.nl/user/s1934538/clickstream/clickstream-enwiki-2020-11.tsv.gz,Pornhub,46018,493744,13741,553503,109822
hdfs://spark-nn.eemcs.utwente.nl/user/s1934538/clickstream/clickstream-enwiki-2020-11.tsv.gz,Deadpool_2,55365,194624,2036,252025,125878
hdfs://spark-nn.eemcs.utwente.nl/user/s1934538/clickstream/clickstream-enwiki-2020-11.tsv.gz,Grimes_(musician),192179,170984,741,363904,86316
hdfs://spark-nn.eemcs.utwente.nl/user/s1934538/clickstream/clickstream-enwiki-2020-11.tsv.gz,The_Nun_(2018_film),22103,122834,639,145576,98091
hdfs://spark-nn.eemcs.utwente.nl/user/s1934538/clickstream/clickstream-enwiki-2020-11.tsv.gz,COVID-19_pandemic,532769,712903,6292,1251964,645405
hdfs://spark-nn.eemcs.utwente.nl/user/s1934538/clickstream/clickstream-enwiki-2021-07.tsv.gz,Stranger_Things_(season_4),52985,200825,1242,255052,130303
hdfs://spark-nn.eemcs.utwente.nl/user/s1934538/clickstream/clickstream-enwiki-2021-07.tsv.gz,Pornhub,47883,261822,14326,324031,89036
hdfs://spark-nn.eemcs.utwente.nl/user/s1934538/clickstream/clickstream-enwiki-2021-07.tsv.gz,Fantastic_Beasts:_The_Crimes_of_Grindelwald,46894,58831,555,106280,58844
hdfs://spark-nn.eemcs.utwente.nl/user/s1934538/clickstream/clickstream-enwiki-2021-07.tsv.gz,Elliot_Page,76242,250201,15674,342117,133313
hdfs://spark-nn.eemcs.utwente.nl/user/s1934538/clickstream/clickstream-enwiki-2021-07.tsv.gz,Fyre_Festival,11225,64826,658,76709,47596
hdfs://spark-nn.eemcs.utwente.nl/user/s1934538/clickstream/clickstream-enwiki-2021-07.tsv.gz,John_Wick:_Chapter_4,82905,103234,779,186918,130039
hdfs://spark-nn.eemcs.utwente.nl/user/s1934538/clickstream/clickstream-enwiki-2021-07.tsv.gz,Charles_III,89,145,67,301,286
hdfs://spark-nn.eemcs.utwente.nl/user/s1934538/clickstream/clickstream-enwiki-2021-07.tsv.gz,Captain_Marvel_(film),53878,138078,1677,193633,104349
hdfs://spark-nn.eemcs.utwente.nl/user/s1934538/clickstream/clickstream-enwiki-2021-07.tsv.gz,WandaVision,94651,373579,6421,474651,265019
hdfs://spark-nn.eemcs.utwente.nl/user/s1934538/clickstream/clickstream-enwiki-2021-07.tsv.gz,House_of_the_Dragon,29313,54378,499,84190,71740
hdfs://spark-nn.eemcs.utwente.nl/user/s1934538/clickstream/clickstream-enwiki-2021-07.tsv.gz,Godzilla_vs._Kong,93447,256409,9137,358993,172634
hdfs://spark-nn.eemcs.utwente.nl/user/s1934538/clickstream/clickstream-enwiki-2021-07.tsv.gz,Cricket_World_Cup,14993,102667,567,118227,64872
hdfs://spark-nn.eemcs.utwente.nl/user/s1934538/clickstream/clickstream-enwiki-2021-07.tsv.gz,Valentine's_Day,3437,24776,177,28390,3005
hdfs://spark-nn.eemcs.utwente.nl/user/s1934538/clickstream/clickstream-enwiki-2021-07.tsv.gz,Rihanna,79168,246921,4145,330234,165059
hdfs://spark-nn.eemcs.utwente.nl/user/s1934538/clickstream/clickstream-enwiki-2021-07.tsv.gz,Ruth_Bader_Ginsburg,17347,77906,483,95736,35088
hdfs://spark-nn.eemcs.utwente.nl/user/s1934538/clickstream/clickstream-enwiki-2021-07.tsv.gz,Game_of_Thrones_(season_8),17878,49877,709,68464,23668
hdfs://spark-nn.eemcs.utwente.nl/user/s1934538/clickstream/clickstream-enwiki-2021-07.tsv.gz,Joe_Exotic,20714,124185,823,145722,59725
hdfs://spark-nn.eemcs.utwente.nl/user/s1934538/clickstream/clickstream-enwiki-2021-07.tsv.gz,Antifa_(United_States),13315,74889,426,88630,21192
hdfs://spark-nn.eemcs.utwente.nl/user/s1934538/clickstream/clickstream-enwiki-2021-07.tsv.gz,IPv4,9937,35972,151,46060,8445
hdfs://spark-nn.eemcs.utwente.nl/user/s1934538/clickstream/clickstream-enwiki-2021-07.tsv.gz,List_of_James_Bond_films,62784,345212,675,408671,259136
hdfs://spark-nn.eemcs.utwente.nl/user/s1934538/clickstream/clickstream-enwiki-2021-07.tsv.gz,"Diana,_Princess_of_Wales",167796,551325,15530,734651,435820
hdfs://spark-nn.eemcs.utwente.nl/user/s1934538/clickstream/clickstream-enwiki-2021-07.tsv.gz,David_Beckham,73318,419565,3055,495938,196439
hdfs://spark-nn.eemcs.utwente.nl/user/s1934538/clickstream/clickstream-enwiki-2021-07.tsv.gz,Irrfan_Khan,38454,72940,201,111595,40384
hdfs://spark-nn.eemcs.utwente.nl/user/s1934538/clickstream/clickstream-enwiki-2021-07.tsv.gz,Kate_Spade,25752,100601,868,127221,46784
hdfs://spark-nn.eemcs.utwente.nl/user/s1934538/clickstream/clickstream-enwiki-2021-07.tsv.gz,J._Robert_Oppenheimer,19366,73029,312,92707,32400
hdfs://spark-nn.eemcs.utwente.nl/user/s1934538/clickstream/clickstream-enwiki-2021-07.tsv.gz,Taliban,94015,610930,6899,711844,494156
hdfs://spark-nn.eemcs.utwente.nl/user/s1934538/clickstream/clickstream-enwiki-2021-07.tsv.gz,Croatia,58285,195061,2498,255844,82480
hdfs://spark-nn.eemcs.utwente.nl/user/s1934538/clickstream/clickstream-enwiki-2021-07.tsv.gz,Vladimir_Putin,89288,209107,3118,301513,188532
hdfs://spark-nn.eemcs.utwente.nl/user/s1934538/clickstream/clickstream-enwiki-2021-07.tsv.gz,Stranger_Things_(season_3),23681,47599,538,71818,39985
hdfs://spark-nn.eemcs.utwente.nl/user/s1934538/clickstream/clickstream-enwiki-2021-07.tsv.gz,Manti_Te'o,2592,11063,88,13743,1610
hdfs://spark-nn.eemcs.utwente.nl/user/s1934538/clickstream/clickstream-enwiki-2021-07.tsv.gz,Lists_of_deaths_by_year,3254,174204,615,178073,194100
hdfs://spark-nn.eemcs.utwente.nl/user/s1934538/clickstream/clickstream-enwiki-2021-07.tsv.gz,State_of_Palestine,39503,114778,737,155018,58335
hdfs://spark-nn.eemcs.utwente.nl/user/s1934538/clickstream/clickstream-enwiki-2021-07.tsv.gz,JSON_Web_Token,776,29344,42,30162,2034
hdfs://spark-nn.eemcs.utwente.nl/user/s1934538/clickstream/clickstream-enwiki-2021-07.tsv.gz,Venom_(2018_film),23537,94825,1083,119445,58516
hdfs://spark-nn.eemcs.utwente.nl/user/s1934538/clickstream/clickstream-enwiki-2021-07.tsv.gz,The_Haunting_of_Bly_Manor,23842,64401,496,88739,43349
hdfs://spark-nn.eemcs.utwente.nl/user/s1934538/clickstream/clickstream-enwiki-2021-07.tsv.gz,John_McCain,36445,72723,897,110065,56717
hdfs://spark-nn.eemcs.utwente.nl/user/s1934538/clickstream/clickstream-enwiki-2021-07.tsv.gz,Parasite_(2019_film),35805,170082,2130,208017,88585
hdfs://spark-nn.eemcs.utwente.nl/user/s1934538/clickstream/clickstream-enwiki-2021-07.tsv.gz,Adipurush,55339,22642,66,78047,54297
hdfs://spark-nn.eemcs.utwente.nl/user/s1934538/clickstream/clickstream-enwiki-2021-07.tsv.gz,Donald_Trump,213818,434285,8197,656300,396008
hdfs://spark-nn.eemcs.utwente.nl/user/s1934538/clickstream/clickstream-enwiki-2021-07.tsv.gz,Cecil_Hotel_(Los_Angeles),9069,95102,232,104403,25577
hdfs://spark-nn.eemcs.utwente.nl/user/s1934538/clickstream/clickstream-enwiki-2021-07.tsv.gz,Richard_Jewell,22745,96951,471,120167,44900
hdfs://spark-nn.eemcs.utwente.nl/user/s1934538/clickstream/clickstream-enwiki-2021-07.tsv.gz,Murder_of_Dee_Dee_Blanchard,14621,114229,428,129278,25404
hdfs://spark-nn.eemcs.utwente.nl/user/s1934538/clickstream/clickstream-enwiki-2021-07.tsv.gz,UEFA_Euro_2020,641505,3231921,105936,3979362,1839087
hdfs://spark-nn.eemcs.utwente.nl/user/s1934538/clickstream/clickstream-enwiki-2021-07.tsv.gz,List_of_most_popular_websites,8546,33022,123,41691,14462
hdfs://spark-nn.eemcs.utwente.nl/user/s1934538/clickstream/clickstream-enwiki-2021-07.tsv.gz,Anne_Heche,25681,48747,252,74680,25157
hdfs://spark-nn.eemcs.utwente.nl/user/s1934538/clickstream/clickstream-enwiki-2021-07.tsv.gz,Jason_Momoa,90394,280931,2157,373482,172600
hdfs://spark-nn.eemcs.utwente.nl/user/s1934538/clickstream/clickstream-enwiki-2021-07.tsv.gz,Chernobyl_disaster,76126,691015,4627,771768,283269
hdfs://spark-nn.eemcs.utwente.nl/user/s1934538/clickstream/clickstream-enwiki-2021-07.tsv.gz,1234,62,1205,25,1292,243
hdfs://spark-nn.eemcs.utwente.nl/user/s1934538/clickstream/clickstream-enwiki-2021-07.tsv.gz,FIFA_World_Cup,245191,1040753,11669,1297613,855691
hdfs://spark-nn.eemcs.utwente.nl/user/s1934538/clickstream/clickstream-enwiki-2021-07.tsv.gz,Roe_v._Wade,8923,75414,506,84843,24881
hdfs://spark-nn.eemcs.utwente.nl/user/s1934538/clickstream/clickstream-enwiki-2021-07.tsv.gz,Top_Gun:_Maverick,83485,160976,2824,247285,135243
hdfs://spark-nn.eemcs.utwente.nl/user/s1934538/clickstream/clickstream-enwiki-2021-07.tsv.gz,Bible,15536,4055597,1845,4072978,32589
hdfs://spark-nn.eemcs.utwente.nl/user/s1934538/clickstream/clickstream-enwiki-2021-07.tsv.gz,XHamster,7489,226553,5721,239763,24610
hdfs://spark-nn.eemcs.utwente.nl/user/s1934538/clickstream/clickstream-enwiki-2021-07.tsv.gz,Stephen_Hawking,31669,369415,2531,403615,161393
hdfs://spark-nn.eemcs.utwente.nl/user/s1934538/clickstream/clickstream-enwiki-2021-07.tsv.gz,The_Umbrella_Academy_(TV_series),29686,140562,2231,172479,92607
hdfs://spark-nn.eemcs.utwente.nl/user/s1934538/clickstream/clickstream-enwiki-2021-07.tsv.gz,Black_Panther:_Wakanda_Forever,186046,74453,1253,261752,181163
hdfs://spark-nn.eemcs.utwente.nl/user/s1934538/clickstream/clickstream-enwiki-2021-07.tsv.gz,Nipsey_Hussle,24804,123598,933,149335,45565
hdfs://spark-nn.eemcs.utwente.nl/user/s1934538/clickstream/clickstream-enwiki-2021-07.tsv.gz,Bridgerton,34759,211855,2947,249561,172422
hdfs://spark-nn.eemcs.utwente.nl/user/s1934538/clickstream/clickstream-enwiki-2021-07.tsv.gz,Freddie_Mercury,102764,590496,4630,697890,266082
hdfs://spark-nn.eemcs.utwente.nl/user/s1934538/clickstream/clickstream-enwiki-2021-07.tsv.gz,Royal_Rumble_(2018),7093,4474,101,11668,8222
hdfs://spark-nn.eemcs.utwente.nl/user/s1934538/clickstream/clickstream-enwiki-2021-07.tsv.gz,Joaquin_Phoenix,156718,192107,1020,349845,213198
hdfs://spark-nn.eemcs.utwente.nl/user/s1934538/clickstream/clickstream-enwiki-2021-07.tsv.gz,Afghanistan,113782,387509,7559,508850,315153
hdfs://spark-nn.eemcs.utwente.nl/user/s1934538/clickstream/clickstream-enwiki-2021-07.tsv.gz,The_Flash_(film),69667,62567,675,132909,95274
hdfs://spark-nn.eemcs.utwente.nl/user/s1934538/clickstream/clickstream-enwiki-2021-07.tsv.gz,It_Chapter_Two,36994,82207,821,120022,81751
hdfs://spark-nn.eemcs.utwente.nl/user/s1934538/clickstream/clickstream-enwiki-2021-07.tsv.gz,United_States_Electoral_College,10338,26866,135,37339,6366
hdfs://spark-nn.eemcs.utwente.nl/user/s1934538/clickstream/clickstream-enwiki-2021-07.tsv.gz,Grover,1120,5117,86,6323,1300
hdfs://spark-nn.eemcs.utwente.nl/user/s1934538/clickstream/clickstream-enwiki-2021-07.tsv.gz,COVID-19_pandemic,386421,456416,2604,845441,438229
hdfs://spark-nn.eemcs.utwente.nl/user/s1934538/clickstream/clickstream-enwiki-2021-07.tsv.gz,2022_FIFA_World_Cup,312764,850948,12402,1176114,512613
hdfs://spark-nn.eemcs.utwente.nl/user/s1934538/clickstream/clickstream-enwiki-2021-07.tsv.gz,XXXTentacion,70762,659156,7363,737281,112066
hdfs://spark-nn.eemcs.utwente.nl/user/s1934538/clickstream/clickstream-enwiki-2021-07.tsv.gz,The_Mandalorian,71169,235090,4670,310929,211763
hdfs://spark-nn.eemcs.utwente.nl/user/s1934538/clickstream/clickstream-enwiki-2021-07.tsv.gz,Avicii,23156,245855,1650,270661,128106
hdfs://spark-nn.eemcs.utwente.nl/user/s1934538/clickstream/clickstream-enwiki-2021-07.tsv.gz,Carlos_Alcaraz,6006,21042,95,27143,4975
hdfs://spark-nn.eemcs.utwente.nl/user/s1934538/clickstream/clickstream-enwiki-2021-07.tsv.gz,ICC_Men's_T20_World_Cup,17462,210328,647,228437,110536
hdfs://spark-nn.eemcs.utwente.nl/user/s1934538/clickstream/clickstream-enwiki-2021-07.tsv.gz,Zack_Snyder's_Justice_League,99945,181956,1993,283894,151175
hdfs://spark-nn.eemcs.utwente.nl/user/s1934538/clickstream/clickstream-enwiki-2021-07.tsv.gz,Russo-Ukrainian_War,18948,31043,295,50286,28095
hdfs://spark-nn.eemcs.utwente.nl/user/s1934538/clickstream/clickstream-enwiki-2021-07.tsv.gz,William_Murdoch,507,1132,21,1660,317
hdfs://spark-nn.eemcs.utwente.nl/user/s1934538/clickstream/clickstream-enwiki-2021-07.tsv.gz,Death_of_Elisa_Lam,16904,122258,387,139549,32943
hdfs://spark-nn.eemcs.utwente.nl/user/s1934538/clickstream/clickstream-enwiki-2021-07.tsv.gz,Saaho,21321,52639,204,74164,28647
hdfs://spark-nn.eemcs.utwente.nl/user/s1934538/clickstream/clickstream-enwiki-2021-07.tsv.gz,Tasuku_Honjo,901,184085,73,185059,5215
hdfs://spark-nn.eemcs.utwente.nl/user/s1934538/clickstream/clickstream-enwiki-2021-07.tsv.gz,Hamilton_(musical),42350,193678,1860,237888,164649
hdfs://spark-nn.eemcs.utwente.nl/user/s1934538/clickstream/clickstream-enwiki-2021-07.tsv.gz,Key_frame,533,5223,20,5776,375
hdfs://spark-nn.eemcs.utwente.nl/user/s1934538/clickstream/clickstream-enwiki-2021-07.tsv.gz,Simone_Biles,195185,2959630,24228,3179043,941969
hdfs://spark-nn.eemcs.utwente.nl/user/s1934538/clickstream/clickstream-enwiki-2021-07.tsv.gz,Louis_Tomlinson,30275,52529,316,83120,29384
hdfs://spark-nn.eemcs.utwente.nl/user/s1934538/clickstream/clickstream-enwiki-2021-07.tsv.gz,YouTube,129903,2511724,9886,2651513,113937
hdfs://spark-nn.eemcs.utwente.nl/user/s1934538/clickstream/clickstream-enwiki-2021-07.tsv.gz,Lisa_Marie_Presley,154294,88815,644,243753,137483
hdfs://spark-nn.eemcs.utwente.nl/user/s1934538/clickstream/clickstream-enwiki-2021-07.tsv.gz,Shakira,33670,250363,2847,286880,142420
hdfs://spark-nn.eemcs.utwente.nl/user/s1934538/clickstream/clickstream-enwiki-2021-07.tsv.gz,Lionel_Messi,269097,1810834,18945,2098876,642850
hdfs://spark-nn.eemcs.utwente.nl/user/s1934538/clickstream/clickstream-enwiki-2021-07.tsv.gz,United_States_Senate,48905,44225,1060,94190,46980
hdfs://spark-nn.eemcs.utwente.nl/user/s1934538/clickstream/clickstream-enwiki-2021-07.tsv.gz,Laal_Singh_Chaddha,57804,92750,64,150618,82919
hdfs://spark-nn.eemcs.utwente.nl/user/s1934538/clickstream/clickstream-enwiki-2021-07.tsv.gz,The_Nun_(2018_film),31932,74981,500,107413,61125
hdfs://spark-nn.eemcs.utwente.nl/user/s1934538/clickstream/clickstream-enwiki-2021-07.tsv.gz,Michael_Bloomberg,28658,33741,263,62662,27817
hdfs://spark-nn.eemcs.utwente.nl/user/s1934538/clickstream/clickstream-enwiki-2021-07.tsv.gz,Qasem_Soleimani,11576,20416,105,32097,18170
hdfs://spark-nn.eemcs.utwente.nl/user/s1934538/clickstream/clickstream-enwiki-2021-07.tsv.gz,Black_Adam_(film),99549,65334,748,165631,135637
hdfs://spark-nn.eemcs.utwente.nl/user/s1934538/clickstream/clickstream-enwiki-2021-07.tsv.gz,Area_51,15522,151571,1467,168560,42705
hdfs://spark-nn.eemcs.utwente.nl/user/s1934538/clickstream/clickstream-enwiki-2021-07.tsv.gz,1917_(2019_film),23792,85752,1559,111103,62440
hdfs://spark-nn.eemcs.utwente.nl/user/s1934538/clickstream/clickstream-enwiki-2021-07.tsv.gz,The_Suicide_Squad_(film),296968,888980,24404,1210352,887609
hdfs://spark-nn.eemcs.utwente.nl/user/s1934538/clickstream/clickstream-enwiki-2021-07.tsv.gz,NATO,52866,116964,1957,171787,66725
hdfs://spark-nn.eemcs.utwente.nl/user/s1934538/clickstream/clickstream-enwiki-2021-07.tsv.gz,Cardi_B,55934,291143,5840,352917,130073
hdfs://spark-nn.eemcs.utwente.nl/user/s1934538/clickstream/clickstream-enwiki-2021-07.tsv.gz,Sridevi,41041,97136,234,138411,64283
hdfs://spark-nn.eemcs.utwente.nl/user/s1934538/clickstream/clickstream-enwiki-2021-07.tsv.gz,Doctor_Strange_in_the_Multiverse_of_Madness,216625,240947,3210,460782,241517
hdfs://spark-nn.eemcs.utwente.nl/user/s1934538/clickstream/clickstream-enwiki-2021-07.tsv.gz,Luke_Perry,67703,188142,1068,256913,88746
hdfs://spark-nn.eemcs.utwente.nl/user/s1934538/clickstream/clickstream-enwiki-2021-07.tsv.gz,Eddie_Van_Halen,50221,93496,958,144675,55669
hdfs://spark-nn.eemcs.utwente.nl/user/s1934538/clickstream/clickstream-enwiki-2021-07.tsv.gz,Greta_Thunberg,12271,134532,28616,175419,50470
hdfs://spark-nn.eemcs.utwente.nl/user/s1934538/clickstream/clickstream-enwiki-2021-07.tsv.gz,"Meghan,_Duchess_of_Sussex",90166,195120,1446,286732,156350
hdfs://spark-nn.eemcs.utwente.nl/user/s1934538/clickstream/clickstream-enwiki-2021-07.tsv.gz,Tunnel,3758,10878,158,14794,3491
hdfs://spark-nn.eemcs.utwente.nl/user/s1934538/clickstream/clickstream-enwiki-2021-07.tsv.gz,Israel,77326,217685,5666,300677,148830
hdfs://spark-nn.eemcs.utwente.nl/user/s1934538/clickstream/clickstream-enwiki-2021-07.tsv.gz,List_of_awards_and_nominations_received_by_Meryl_Streep,11344,9685,206,21235,8383
hdfs://spark-nn.eemcs.utwente.nl/user/s1934538/clickstream/clickstream-enwiki-2021-07.tsv.gz,Sinéad_O'Connor,16670,94183,899,111752,37853
hdfs://spark-nn.eemcs.utwente.nl/user/s1934538/clickstream/clickstream-enwiki-2021-07.tsv.gz,The_Queen's_Gambit_(miniseries),44235,211397,2161,257793,131634
hdfs://spark-nn.eemcs.utwente.nl/user/s1934538/clickstream/clickstream-enwiki-2021-07.tsv.gz,Watts_family_murders,17992,271919,664,290575,63306
hdfs://spark-nn.eemcs.utwente.nl/user/s1934538/clickstream/clickstream-enwiki-2021-07.tsv.gz,Sushant_Singh_Rajput,31384,171694,903,203981,79794
hdfs://spark-nn.eemcs.utwente.nl/user/s1934538/clickstream/clickstream-enwiki-2021-07.tsv.gz,Jeffrey_Epstein,53906,317064,2235,373205,137550
hdfs://spark-nn.eemcs.utwente.nl/user/s1934538/clickstream/clickstream-enwiki-2021-07.tsv.gz,Ted_Bundy,43637,410652,5343,459632,116201
hdfs://spark-nn.eemcs.utwente.nl/user/s1934538/clickstream/clickstream-enwiki-2021-07.tsv.gz,Wikipedia,274549,1213671,708,1488928,244138
hdfs://spark-nn.eemcs.utwente.nl/user/s1934538/clickstream/clickstream-enwiki-2021-07.tsv.gz,Us_(2019_film),33453,116434,552,150439,50625
hdfs://spark-nn.eemcs.utwente.nl/user/s1934538/clickstream/clickstream-enwiki-2021-07.tsv.gz,The_Weeknd,68896,233510,3206,305612,130606
hdfs://spark-nn.eemcs.utwente.nl/user/s1934538/clickstream/clickstream-enwiki-2021-07.tsv.gz,Deadpool_2,52946,67792,1782,122520,87130
hdfs://spark-nn.eemcs.utwente.nl/user/s1934538/clickstream/clickstream-enwiki-2021-07.tsv.gz,Mortal_Kombat_(2021_film),47869,179324,4213,231406,181309
hdfs://spark-nn.eemcs.utwente.nl/user/s1934538/clickstream/clickstream-enwiki-2021-07.tsv.gz,Kenosha_unrest_shooting,4439,55491,397,60327,11480
hdfs://spark-nn.eemcs.utwente.nl/user/s1934538/clickstream/clickstream-enwiki-2021-07.tsv.gz,2018_Asian_Games,53043,45490,722,99255,93881
hdfs://spark-nn.eemcs.utwente.nl/user/s1934538/clickstream/clickstream-enwiki-2021-07.tsv.gz,The_Witcher_(TV_series),44981,261460,5770,312211,192578
hdfs://spark-nn.eemcs.utwente.nl/user/s1934538/clickstream/clickstream-enwiki-2021-07.tsv.gz,List_of_highest-grossing_films,140035,222065,1625,363725,207916
hdfs://spark-nn.eemcs.utwente.nl/user/s1934538/clickstream/clickstream-enwiki-2021-07.tsv.gz,2018_Winter_Olympics,172696,88438,851,261985,166087
hdfs://spark-nn.eemcs.utwente.nl/user/s1934538/clickstream/clickstream-enwiki-2021-07.tsv.gz,Grimes_(musician),135876,194549,702,331127,126831
hdfs://spark-nn.eemcs.utwente.nl/user/s1934538/clickstream/clickstream-enwiki-2021-07.tsv.gz,Cook's_Country,499,3065,15,3579,1090
hdfs://spark-nn.eemcs.utwente.nl/user/s1934538/clickstream/clickstream-enwiki-2021-07.tsv.gz,Cleopatra,48100,4863161,2055,4913316,396256
hdfs://spark-nn.eemcs.utwente.nl/user/s1934538/clickstream/clickstream-enwiki-2021-07.tsv.gz,Chadwick_Boseman,78849,252103,1373,332325,99317
hdfs://spark-nn.eemcs.utwente.nl/user/s1934538/clickstream/clickstream-enwiki-2021-07.tsv.gz,Mac_Miller,31107,199616,1551,232274,71828
hdfs://spark-nn.eemcs.utwente.nl/user/s1934538/clickstream/clickstream-enwiki-2021-07.tsv.gz,Kylian_Mbappé,48675,255676,2200,306551,65909
hdfs://spark-nn.eemcs.utwente.nl/user/s1934538/clickstream/clickstream-enwiki-2021-07.tsv.gz,Crazy_Rich_Asians_(film),37925,106537,1255,145717,133241
hdfs://spark-nn.eemcs.utwente.nl/user/s1934538/clickstream/clickstream-enwiki-2021-07.tsv.gz,Lance_Reddick,43726,73810,387,117923,25241
hdfs://spark-nn.eemcs.utwente.nl/user/s1934538/clickstream/clickstream-enwiki-2021-07.tsv.gz,21_Savage,14987,63276,690,78953,30387
hdfs://spark-nn.eemcs.utwente.nl/user/s1934538/clickstream/clickstream-enwiki-2021-07.tsv.gz,September_11_attacks,109728,279833,3700,393261,241070
hdfs://spark-nn.eemcs.utwente.nl/user/s1934538/clickstream/clickstream-enwiki-2021-07.tsv.gz,The_Sandman_(TV_series),21651,18470,353,40474,30587
hdfs://spark-nn.eemcs.utwente.nl/user/s1934538/clickstream/clickstream-enwiki-2021-07.tsv.gz,Don't_Look_Up_(2021_film),96137,49414,422,145973,61319
hdfs://spark-nn.eemcs.utwente.nl/user/s1934538/clickstream/clickstream-enwiki-2021-07.tsv.gz,"Princess_Margaret,_Countess_of_Snowdon",105089,251406,1692,358187,199618
hdfs://spark-nn.eemcs.utwente.nl/user/s1934538/clickstream/clickstream-enwiki-2021-07.tsv.gz,XXX:_Return_of_Xander_Cage,72132,711479,1173,784784,104813
hdfs://spark-nn.eemcs.utwente.nl/user/s1934538/clickstream/clickstream-enwiki-2021-07.tsv.gz,Deaths_in_2021,1416935,2316290,17918,3751143,2153558
hdfs://spark-nn.eemcs.utwente.nl/user/s1934538/clickstream/clickstream-enwiki-2021-07.tsv.gz,Cameron_Boyce,35430,234290,1074,270794,74585
hdfs://spark-nn.eemcs.utwente.nl/user/s1934538/clickstream/clickstream-enwiki-2021-07.tsv.gz,Ukraine,61062,240309,4257,305628,128174
hdfs://spark-nn.eemcs.utwente.nl/user/s1934538/clickstream/clickstream-enwiki-2021-07.tsv.gz,Brett_Kavanaugh,17758,37394,350,55502,18994
hdfs://spark-nn.eemcs.utwente.nl/user/s1934538/clickstream/clickstream-enwiki-2021-07.tsv.gz,Joker_(2019_film),53071,173908,2205,229184,109210
hdfs://spark-nn.eemcs.utwente.nl/user/s1934538/clickstream/clickstream-enwiki-2021-07.tsv.gz,Stan_Lee,61870,262262,1317,325449,65325
hdfs://spark-nn.eemcs.utwente.nl/user/s1934538/clickstream/clickstream-enwiki-2021-07.tsv.gz,Once_Upon_a_Time_in_Hollywood,162535,592579,11302,766416,885103
hdfs://spark-nn.eemcs.utwente.nl/user/s1934538/clickstream/clickstream-enwiki-2021-07.tsv.gz,Ghislaine_Maxwell,61026,185398,1016,247440,102119
hdfs://spark-nn.eemcs.utwente.nl/user/s1934538/clickstream/clickstream-enwiki-2021-07.tsv.gz,Ant-Man_and_the_Wasp:_Quantumania,303720,137967,857,442544,309994
hdfs://spark-nn.eemcs.utwente.nl/user/s1934538/clickstream/clickstream-enwiki-2021-07.tsv.gz,Jenna_Ortega,34075,60522,1348,95945,22451
hdfs://spark-nn.eemcs.utwente.nl/user/s1934538/clickstream/clickstream-enwiki-2021-07.tsv.gz,Kobe_Bryant_sexual_assault_case,6709,26909,77,33695,2984
hdfs://spark-nn.eemcs.utwente.nl/user/s1934538/clickstream/clickstream-enwiki-2021-07.tsv.gz,List_of_Marvel_Cinematic_Universe_films,392227,971625,2838,1366690,840103
hdfs://spark-nn.eemcs.utwente.nl/user/s1934538/clickstream/clickstream-enwiki-2021-07.tsv.gz,Gaza_Strip,14004,32227,194,46425,16019
hdfs://spark-nn.eemcs.utwente.nl/user/s1934538/clickstream/clickstream-enwiki-2021-07.tsv.gz,Olivia_Newton-John,27694,91940,1241,120875,53215
hdfs://spark-nn.eemcs.utwente.nl/user/s1934538/clickstream/clickstream-enwiki-2021-07.tsv.gz,Joe_Biden,208130,449106,8292,665528,354519
hdfs://spark-nn.eemcs.utwente.nl/user/s1934538/clickstream/clickstream-enwiki-2021-07.tsv.gz,Cristiano_Ronaldo,236494,1372830,7874,1617198,459511
hdfs://spark-nn.eemcs.utwente.nl/user/s1934538/clickstream/clickstream-enwiki-2021-07.tsv.gz,Microsoft_Office,8484,2588035,913,2597432,18562
hdfs://spark-nn.eemcs.utwente.nl/user/s1934538/clickstream/clickstream-enwiki-2021-07.tsv.gz,RRR_(film),52905,139776,540,193221,116077
hdfs://spark-nn.eemcs.utwente.nl/user/s1934538/clickstream/clickstream-enwiki-2021-07.tsv.gz,Black_Panther_(film),56321,131627,2914,190862,119742
hdfs://spark-nn.eemcs.utwente.nl/user/s1934538/clickstream/clickstream-enwiki-2021-07.tsv.gz,Amber_Heard,118744,351827,2222,472793,203428
hdfs://spark-nn.eemcs.utwente.nl/user/s1934538/clickstream/clickstream-enwiki-2021-07.tsv.gz,Star_Wars:_The_Rise_of_Skywalker,88009,74803,1815,164627,87953
hdfs://spark-nn.eemcs.utwente.nl/user/s1934538/clickstream/clickstream-enwiki-2021-07.tsv.gz,Mulan_(2020_film),24370,75271,1170,100811,62352
hdfs://spark-nn.eemcs.utwente.nl/user/s1934538/clickstream/clickstream-enwiki-2021-07.tsv.gz,George_H._W._Bush,133383,104032,92,237507,145841
hdfs://spark-nn.eemcs.utwente.nl/user/s1934538/clickstream/clickstream-enwiki-2021-07.tsv.gz,Shinzo_Abe,38516,40433,361,79310,48101
hdfs://spark-nn.eemcs.utwente.nl/user/s1934538/clickstream/clickstream-enwiki-2021-07.tsv.gz,Media,69,2411,263,2743,1155
hdfs://spark-nn.eemcs.utwente.nl/user/s1934538/clickstream/clickstream-enwiki-2021-07.tsv.gz,Pelé,84475,253018,1974,339467,113565
hdfs://spark-nn.eemcs.utwente.nl/user/s1934538/clickstream/clickstream-enwiki-2021-07.tsv.gz,Richard_Ramirez,23754,247372,1757,272883,77831
hdfs://spark-nn.eemcs.utwente.nl/user/s1934538/clickstream/clickstream-enwiki-2021-07.tsv.gz,Wonder_Woman_1984,46651,146909,3295,196855,97374
hdfs://spark-nn.eemcs.utwente.nl/user/s1934538/clickstream/clickstream-enwiki-2021-07.tsv.gz,List_of_highest-grossing_Indian_films,62416,143904,314,206634,125611
hdfs://spark-nn.eemcs.utwente.nl/user/s1934538/clickstream/clickstream-enwiki-2021-07.tsv.gz,The_Batman_(film),115460,120276,2256,237992,188710
hdfs://spark-nn.eemcs.utwente.nl/user/s1934538/clickstream/clickstream-enwiki-2021-08.tsv.gz,Tina_Turner,24976,215979,2397,243352,81594
hdfs://spark-nn.eemcs.utwente.nl/user/s1934538/clickstream/clickstream-enwiki-2021-08.tsv.gz,Shang-Chi_and_the_Legend_of_the_Ten_Rings,319100,1080817,24877,1424794,855092
hdfs://spark-nn.eemcs.utwente.nl/user/s1934538/clickstream/clickstream-enwiki-2021-08.tsv.gz,Chernobyl_disaster,68299,498927,3848,571074,223854
hdfs://spark-nn.eemcs.utwente.nl/user/s1934538/clickstream/clickstream-enwiki-2021-08.tsv.gz,Sylvester_Stallone,141367,315052,2615,459034,307219
hdfs://spark-nn.eemcs.utwente.nl/user/s1934538/clickstream/clickstream-enwiki-2021-08.tsv.gz,Sushant_Singh_Rajput,29134,113541,423,143098,62098
hdfs://spark-nn.eemcs.utwente.nl/user/s1934538/clickstream/clickstream-enwiki-2021-08.tsv.gz,Kim_Jong-un,92352,189900,1701,283953,170940
hdfs://spark-nn.eemcs.utwente.nl/user/s1934538/clickstream/clickstream-enwiki-2021-08.tsv.gz,Main_Page,73094,170983314,4801529,175857937,36164097
hdfs://spark-nn.eemcs.utwente.nl/user/s1934538/clickstream/clickstream-enwiki-2021-08.tsv.gz,NATO,129035,207725,2812,339572,106812
hdfs://spark-nn.eemcs.utwente.nl/user/s1934538/clickstream/clickstream-enwiki-2021-08.tsv.gz,The_Haunting_of_Bly_Manor,26867,68891,511,96269,49978
hdfs://spark-nn.eemcs.utwente.nl/user/s1934538/clickstream/clickstream-enwiki-2021-08.tsv.gz,R._Kelly,83381,369010,5004,457395,235759
hdfs://spark-nn.eemcs.utwente.nl/user/s1934538/clickstream/clickstream-enwiki-2021-08.tsv.gz,Pornhub,53961,332212,13942,400115,95899
hdfs://spark-nn.eemcs.utwente.nl/user/s1934538/clickstream/clickstream-enwiki-2021-08.tsv.gz,Deadpool_2,56515,70029,1713,128257,89128
hdfs://spark-nn.eemcs.utwente.nl/user/s1934538/clickstream/clickstream-enwiki-2021-08.tsv.gz,UEFA_Euro_2020,66427,185605,3604,255636,134940
hdfs://spark-nn.eemcs.utwente.nl/user/s1934538/clickstream/clickstream-enwiki-2021-08.tsv.gz,WrestleMania_34,18223,10354,155,28732,18714
hdfs://spark-nn.eemcs.utwente.nl/user/s1934538/clickstream/clickstream-enwiki-2021-08.tsv.gz,List_of_Marvel_Cinematic_Universe_films,294231,761391,2389,1058011,635779
hdfs://spark-nn.eemcs.utwente.nl/user/s1934538/clickstream/clickstream-enwiki-2021-08.tsv.gz,Freddie_Mercury,101733,616748,4827,723308,276730
hdfs://spark-nn.eemcs.utwente.nl/user/s1934538/clickstream/clickstream-enwiki-2021-08.tsv.gz,Donald_Glover,45803,142279,1167,189249,82438
hdfs://spark-nn.eemcs.utwente.nl/user/s1934538/clickstream/clickstream-enwiki-2021-08.tsv.gz,Anne_Heche,24779,42880,244,67903,23216
hdfs://spark-nn.eemcs.utwente.nl/user/s1934538/clickstream/clickstream-enwiki-2021-08.tsv.gz,Johnny_Depp,155890,396264,3274,555428,403319
hdfs://spark-nn.eemcs.utwente.nl/user/s1934538/clickstream/clickstream-enwiki-2021-08.tsv.gz,A_Star_Is_Born_(2018_film),30722,107999,834,139555,71614
hdfs://spark-nn.eemcs.utwente.nl/user/s1934538/clickstream/clickstream-enwiki-2021-08.tsv.gz,Tenet_(film),85077,258268,7257,350602,190680
hdfs://spark-nn.eemcs.utwente.nl/user/s1934538/clickstream/clickstream-enwiki-2021-08.tsv.gz,JSON_Web_Token,738,29515,35,30288,2030
hdfs://spark-nn.eemcs.utwente.nl/user/s1934538/clickstream/clickstream-enwiki-2021-08.tsv.gz,Henry_V_of_England,83497,91111,551,175159,128068
hdfs://spark-nn.eemcs.utwente.nl/user/s1934538/clickstream/clickstream-enwiki-2021-08.tsv.gz,Bob_Saget,18525,43491,410,62426,12634
hdfs://spark-nn.eemcs.utwente.nl/user/s1934538/clickstream/clickstream-enwiki-2021-08.tsv.gz,Wikipedia,274308,732330,972,1007610,225619
hdfs://spark-nn.eemcs.utwente.nl/user/s1934538/clickstream/clickstream-enwiki-2021-08.tsv.gz,Asia_Cup,1863,19438,128,21429,11586
hdfs://spark-nn.eemcs.utwente.nl/user/s1934538/clickstream/clickstream-enwiki-2021-08.tsv.gz,Murder_of_Dee_Dee_Blanchard,19534,101921,387,121842,25602
hdfs://spark-nn.eemcs.utwente.nl/user/s1934538/clickstream/clickstream-enwiki-2021-08.tsv.gz,Michael_Bloomberg,30457,36813,157,67427,30998
hdfs://spark-nn.eemcs.utwente.nl/user/s1934538/clickstream/clickstream-enwiki-2021-08.tsv.gz,The_Falcon_and_the_Winter_Soldier,53390,145737,2735,201862,126673
hdfs://spark-nn.eemcs.utwente.nl/user/s1934538/clickstream/clickstream-enwiki-2021-08.tsv.gz,United_States_Senate,49726,50951,817,101494,47570
hdfs://spark-nn.eemcs.utwente.nl/user/s1934538/clickstream/clickstream-enwiki-2021-08.tsv.gz,War_(2019_film),18725,69895,158,88778,22530
hdfs://spark-nn.eemcs.utwente.nl/user/s1934538/clickstream/clickstream-enwiki-2021-08.tsv.gz,Dennis_Nilsen,11933,520455,2691,535079,141201
hdfs://spark-nn.eemcs.utwente.nl/user/s1934538/clickstream/clickstream-enwiki-2021-08.tsv.gz,Betty_White,91349,307840,4048,403237,130170
hdfs://spark-nn.eemcs.utwente.nl/user/s1934538/clickstream/clickstream-enwiki-2021-08.tsv.gz,Parasite_(2019_film),31861,163574,1778,197213,85768
hdfs://spark-nn.eemcs.utwente.nl/user/s1934538/clickstream/clickstream-enwiki-2021-08.tsv.gz,Venom_(2018_film),48684,210716,2652,262052,143810
hdfs://spark-nn.eemcs.utwente.nl/user/s1934538/clickstream/clickstream-enwiki-2021-08.tsv.gz,Tunnel,3768,9252,133,13153,3393
hdfs://spark-nn.eemcs.utwente.nl/user/s1934538/clickstream/clickstream-enwiki-2021-08.tsv.gz,List_of_highest-grossing_films,126059,189066,1313,316438,184720
hdfs://spark-nn.eemcs.utwente.nl/user/s1934538/clickstream/clickstream-enwiki-2021-08.tsv.gz,Pelé,46563,135496,1191,183250,60811
hdfs://spark-nn.eemcs.utwente.nl/user/s1934538/clickstream/clickstream-enwiki-2021-08.tsv.gz,Cleopatra,51286,4269141,2579,4323006,374652
hdfs://spark-nn.eemcs.utwente.nl/user/s1934538/clickstream/clickstream-enwiki-2021-08.tsv.gz,1917_(2019_film),25737,81424,1518,108679,60697
hdfs://spark-nn.eemcs.utwente.nl/user/s1934538/clickstream/clickstream-enwiki-2021-08.tsv.gz,2020_United_States_presidential_election,165989,269084,6799,441872,427199
hdfs://spark-nn.eemcs.utwente.nl/user/s1934538/clickstream/clickstream-enwiki-2021-08.tsv.gz,Kelly_Preston,114277,200015,1365,315657,96022
hdfs://spark-nn.eemcs.utwente.nl/user/s1934538/clickstream/clickstream-enwiki-2021-08.tsv.gz,Aaron_Carter,18628,55937,316,74881,28125
hdfs://spark-nn.eemcs.utwente.nl/user/s1934538/clickstream/clickstream-enwiki-2021-08.tsv.gz,Nipsey_Hussle,25444,165077,1036,191557,59804
hdfs://spark-nn.eemcs.utwente.nl/user/s1934538/clickstream/clickstream-enwiki-2021-08.tsv.gz,2018_Winter_Olympics,159227,85004,1377,245608,173472
hdfs://spark-nn.eemcs.utwente.nl/user/s1934538/clickstream/clickstream-enwiki-2021-08.tsv.gz,Brie_Larson,68492,158223,1426,228141,94774
hdfs://spark-nn.eemcs.utwente.nl/user/s1934538/clickstream/clickstream-enwiki-2021-08.tsv.gz,Sidharth_Shukla,18683,44340,48,63071,16203
hdfs://spark-nn.eemcs.utwente.nl/user/s1934538/clickstream/clickstream-enwiki-2021-08.tsv.gz,Eternals_(film),240472,573318,9561,823351,903167
hdfs://spark-nn.eemcs.utwente.nl/user/s1934538/clickstream/clickstream-enwiki-2021-08.tsv.gz,Stephen_Hawking,29109,340795,2099,372003,146636
hdfs://spark-nn.eemcs.utwente.nl/user/s1934538/clickstream/clickstream-enwiki-2021-08.tsv.gz,Lists_of_deaths_by_year,4080,165723,478,170281,187339
hdfs://spark-nn.eemcs.utwente.nl/user/s1934538/clickstream/clickstream-enwiki-2021-08.tsv.gz,Eddie_Van_Halen,44103,84289,1029,129421,50482
hdfs://spark-nn.eemcs.utwente.nl/user/s1934538/clickstream/clickstream-enwiki-2021-08.tsv.gz,"Meghan,_Duchess_of_Sussex",83823,219750,8066,311639,170088
hdfs://spark-nn.eemcs.utwente.nl/user/s1934538/clickstream/clickstream-enwiki-2021-08.tsv.gz,Bible,15919,4520939,1907,4538765,34589
hdfs://spark-nn.eemcs.utwente.nl/user/s1934538/clickstream/clickstream-enwiki-2021-08.tsv.gz,Sushma_Swaraj,7366,29346,58,36770,9321
hdfs://spark-nn.eemcs.utwente.nl/user/s1934538/clickstream/clickstream-enwiki-2021-08.tsv.gz,Naomi_Osaka,59945,330329,1871,392145,109881
hdfs://spark-nn.eemcs.utwente.nl/user/s1934538/clickstream/clickstream-enwiki-2021-08.tsv.gz,George_H._W._Bush,155208,116544,2092,273844,164748
hdfs://spark-nn.eemcs.utwente.nl/user/s1934538/clickstream/clickstream-enwiki-2021-08.tsv.gz,List_of_James_Bond_films,69111,366867,922,436900,283753
hdfs://spark-nn.eemcs.utwente.nl/user/s1934538/clickstream/clickstream-enwiki-2021-08.tsv.gz,Cristiano_Ronaldo,255072,3210078,23374,3488524,787725
hdfs://spark-nn.eemcs.utwente.nl/user/s1934538/clickstream/clickstream-enwiki-2021-08.tsv.gz,The_Suicide_Squad_(film),978574,4134475,100036,5213085,4844133
hdfs://spark-nn.eemcs.utwente.nl/user/s1934538/clickstream/clickstream-enwiki-2021-08.tsv.gz,"Prince_Philip,_Duke_of_Edinburgh",186190,208806,2105,397101,243006
hdfs://spark-nn.eemcs.utwente.nl/user/s1934538/clickstream/clickstream-enwiki-2021-08.tsv.gz,The_Flash_(film),95022,74510,664,170196,122417
hdfs://spark-nn.eemcs.utwente.nl/user/s1934538/clickstream/clickstream-enwiki-2021-08.tsv.gz,Irrfan_Khan,36522,77673,117,114312,40802
hdfs://spark-nn.eemcs.utwente.nl/user/s1934538/clickstream/clickstream-enwiki-2021-08.tsv.gz,2016_United_States_presidential_election,109090,74859,993,184942,167997
hdfs://spark-nn.eemcs.utwente.nl/user/s1934538/clickstream/clickstream-enwiki-2021-08.tsv.gz,Black_Widow_(2021_film),189357,758720,21440,969517,601093
hdfs://spark-nn.eemcs.utwente.nl/user/s1934538/clickstream/clickstream-enwiki-2021-08.tsv.gz,It_Chapter_Two,31561,52141,583,84285,52864
hdfs://spark-nn.eemcs.utwente.nl/user/s1934538/clickstream/clickstream-enwiki-2021-08.tsv.gz,Manti_Te'o,3111,21340,96,24547,3039
hdfs://spark-nn.eemcs.utwente.nl/user/s1934538/clickstream/clickstream-enwiki-2021-08.tsv.gz,2022_FIFA_World_Cup,101562,225757,4395,331714,173846
hdfs://spark-nn.eemcs.utwente.nl/user/s1934538/clickstream/clickstream-enwiki-2021-08.tsv.gz,State_of_Palestine,43065,115882,217,159164,60136
hdfs://spark-nn.eemcs.utwente.nl/user/s1934538/clickstream/clickstream-enwiki-2021-08.tsv.gz,Deion_Sanders,9507,93388,699,103594,34152
hdfs://spark-nn.eemcs.utwente.nl/user/s1934538/clickstream/clickstream-enwiki-2021-08.tsv.gz,Don't_Look_Up_(2021_film),113320,140753,1232,255305,100498
hdfs://spark-nn.eemcs.utwente.nl/user/s1934538/clickstream/clickstream-enwiki-2021-08.tsv.gz,J._Robert_Oppenheimer,21839,75070,315,97224,35157
hdfs://spark-nn.eemcs.utwente.nl/user/s1934538/clickstream/clickstream-enwiki-2021-08.tsv.gz,Darth_Vader,25294,60090,640,86024,51728
hdfs://spark-nn.eemcs.utwente.nl/user/s1934538/clickstream/clickstream-enwiki-2021-08.tsv.gz,Greta_Thunberg,10208,156779,1870,168857,48966
hdfs://spark-nn.eemcs.utwente.nl/user/s1934538/clickstream/clickstream-enwiki-2021-08.tsv.gz,Croatia,52494,195119,2492,250105,84563
hdfs://spark-nn.eemcs.utwente.nl/user/s1934538/clickstream/clickstream-enwiki-2021-08.tsv.gz,Ghislaine_Maxwell,55112,116136,902,172150,68584
hdfs://spark-nn.eemcs.utwente.nl/user/s1934538/clickstream/clickstream-enwiki-2021-08.tsv.gz,Kylian_Mbappé,70773,514190,4011,588974,112838
hdfs://spark-nn.eemcs.utwente.nl/user/s1934538/clickstream/clickstream-enwiki-2021-08.tsv.gz,The_Weeknd,98932,275335,4044,378311,192919
hdfs://spark-nn.eemcs.utwente.nl/user/s1934538/clickstream/clickstream-enwiki-2021-08.tsv.gz,Coronavirus,21830,161118,4327,187275,63168
hdfs://spark-nn.eemcs.utwente.nl/user/s1934538/clickstream/clickstream-enwiki-2021-08.tsv.gz,John_Wick:_Chapter_4,79140,116137,693,195970,139896
hdfs://spark-nn.eemcs.utwente.nl/user/s1934538/clickstream/clickstream-enwiki-2021-08.tsv.gz,Richard_Jewell,17955,89460,405,107820,39650
hdfs://spark-nn.eemcs.utwente.nl/user/s1934538/clickstream/clickstream-enwiki-2021-08.tsv.gz,Hyphen-minus,760,7246631,20048,7267439,730
hdfs://spark-nn.eemcs.utwente.nl/user/s1934538/clickstream/clickstream-enwiki-2021-08.tsv.gz,2.0_(film),19539,27291,53,46883,15185
hdfs://spark-nn.eemcs.utwente.nl/user/s1934538/clickstream/clickstream-enwiki-2021-08.tsv.gz,Mulan_(2020_film),23060,69906,1148,94114,57880
hdfs://spark-nn.eemcs.utwente.nl/user/s1934538/clickstream/clickstream-enwiki-2021-08.tsv.gz,Burt_Reynolds,59305,153786,1502,214593,102708
hdfs://spark-nn.eemcs.utwente.nl/user/s1934538/clickstream/clickstream-enwiki-2021-08.tsv.gz,List_of_most_popular_websites,13372,31165,113,44650,17767
hdfs://spark-nn.eemcs.utwente.nl/user/s1934538/clickstream/clickstream-enwiki-2021-08.tsv.gz,George_VI,307499,119796,2351,429646,318430
hdfs://spark-nn.eemcs.utwente.nl/user/s1934538/clickstream/clickstream-enwiki-2021-08.tsv.gz,Fantastic_Beasts:_The_Crimes_of_Grindelwald,54794,65754,775,121323,66596
hdfs://spark-nn.eemcs.utwente.nl/user/s1934538/clickstream/clickstream-enwiki-2021-08.tsv.gz,Bipin_Rawat,24518,37488,32,62038,32039
hdfs://spark-nn.eemcs.utwente.nl/user/s1934538/clickstream/clickstream-enwiki-2021-08.tsv.gz,Sinéad_O'Connor,15047,73945,665,89657,29259
hdfs://spark-nn.eemcs.utwente.nl/user/s1934538/clickstream/clickstream-enwiki-2021-08.tsv.gz,Puneeth_Rajkumar,10985,23598,1173,35756,25000
hdfs://spark-nn.eemcs.utwente.nl/user/s1934538/clickstream/clickstream-enwiki-2021-08.tsv.gz,Laal_Singh_Chaddha,47885,60226,91,108202,54746
hdfs://spark-nn.eemcs.utwente.nl/user/s1934538/clickstream/clickstream-enwiki-2021-08.tsv.gz,Rishi_Sunak,17940,59507,346,77793,33068
hdfs://spark-nn.eemcs.utwente.nl/user/s1934538/clickstream/clickstream-enwiki-2021-08.tsv.gz,Kamala_Harris,106982,292700,3027,402709,174151
hdfs://spark-nn.eemcs.utwente.nl/user/s1934538/clickstream/clickstream-enwiki-2021-08.tsv.gz,Donald_Trump,233561,437326,8602,679489,401657
hdfs://spark-nn.eemcs.utwente.nl/user/s1934538/clickstream/clickstream-enwiki-2021-08.tsv.gz,Roe_v._Wade,9099,49424,266,58789,17210
hdfs://spark-nn.eemcs.utwente.nl/user/s1934538/clickstream/clickstream-enwiki-2021-08.tsv.gz,Grover,1311,5824,50,7185,1440
hdfs://spark-nn.eemcs.utwente.nl/user/s1934538/clickstream/clickstream-enwiki-2021-08.tsv.gz,Wonder_Woman_1984,56903,165183,3531,225617,119536
hdfs://spark-nn.eemcs.utwente.nl/user/s1934538/clickstream/clickstream-enwiki-2021-08.tsv.gz,Lionel_Messi,254658,2931293,32505,3218456,806374
hdfs://spark-nn.eemcs.utwente.nl/user/s1934538/clickstream/clickstream-enwiki-2021-08.tsv.gz,Thor:_Love_and_Thunder,219730,106540,944,327214,253094
hdfs://spark-nn.eemcs.utwente.nl/user/s1934538/clickstream/clickstream-enwiki-2021-08.tsv.gz,Ray_Liotta,59006,72943,579,132528,45959
hdfs://spark-nn.eemcs.utwente.nl/user/s1934538/clickstream/clickstream-enwiki-2021-08.tsv.gz,IPv4,9511,38120,142,47773,8320
hdfs://spark-nn.eemcs.utwente.nl/user/s1934538/clickstream/clickstream-enwiki-2021-08.tsv.gz,Jason_Momoa,200548,832417,4880,1037845,493193
hdfs://spark-nn.eemcs.utwente.nl/user/s1934538/clickstream/clickstream-enwiki-2021-08.tsv.gz,Ukraine,63212,302886,3758,369856,122799
hdfs://spark-nn.eemcs.utwente.nl/user/s1934538/clickstream/clickstream-enwiki-2021-08.tsv.gz,Richard_Ramirez,22312,230946,1651,254909,71289
hdfs://spark-nn.eemcs.utwente.nl/user/s1934538/clickstream/clickstream-enwiki-2021-08.tsv.gz,List_of_highest-grossing_Indian_films,51754,127694,164,179612,105602
hdfs://spark-nn.eemcs.utwente.nl/user/s1934538/clickstream/clickstream-enwiki-2021-08.tsv.gz,Star_Wars:_The_Rise_of_Skywalker,78804,66257,1753,146814,79276
hdfs://spark-nn.eemcs.utwente.nl/user/s1934538/clickstream/clickstream-enwiki-2021-08.tsv.gz,John_McCain,34406,87444,924,122774,60994
hdfs://spark-nn.eemcs.utwente.nl/user/s1934538/clickstream/clickstream-enwiki-2021-08.tsv.gz,Captain_Marvel_(film),45051,109166,2374,156591,84059
hdfs://spark-nn.eemcs.utwente.nl/user/s1934538/clickstream/clickstream-enwiki-2021-08.tsv.gz,The_Witcher_(TV_series),52961,217656,4729,275346,174217
hdfs://spark-nn.eemcs.utwente.nl/user/s1934538/clickstream/clickstream-enwiki-2021-08.tsv.gz,Salman_Rushdie,33567,70005,432,104004,43301
hdfs://spark-nn.eemcs.utwente.nl/user/s1934538/clickstream/clickstream-enwiki-2021-08.tsv.gz,Hamilton_(musical),30762,164126,1975,196863,124066
hdfs://spark-nn.eemcs.utwente.nl/user/s1934538/clickstream/clickstream-enwiki-2021-08.tsv.gz,Meat_Loaf,25508,88819,967,115294,42912
hdfs://spark-nn.eemcs.utwente.nl/user/s1934538/clickstream/clickstream-enwiki-2021-08.tsv.gz,The_Sandman_(TV_series),23515,21080,408,45003,34165
hdfs://spark-nn.eemcs.utwente.nl/user/s1934538/clickstream/clickstream-enwiki-2021-08.tsv.gz,XXXTentacion,70435,605239,7769,683443,114912
hdfs://spark-nn.eemcs.utwente.nl/user/s1934538/clickstream/clickstream-enwiki-2021-08.tsv.gz,Elizabeth_II,439835,582153,6597,1028585,761775
hdfs://spark-nn.eemcs.utwente.nl/user/s1934538/clickstream/clickstream-enwiki-2021-08.tsv.gz,Simone_Biles,111616,1148075,9455,1269146,418864
hdfs://spark-nn.eemcs.utwente.nl/user/s1934538/clickstream/clickstream-enwiki-2021-08.tsv.gz,Queen_(band),70832,221869,3445,296146,290593
hdfs://spark-nn.eemcs.utwente.nl/user/s1934538/clickstream/clickstream-enwiki-2021-08.tsv.gz,Ruth_Bader_Ginsburg,20779,103734,640,125153,46702
hdfs://spark-nn.eemcs.utwente.nl/user/s1934538/clickstream/clickstream-enwiki-2021-08.tsv.gz,Zack_Snyder's_Justice_League,119070,193737,1954,314761,171231
hdfs://spark-nn.eemcs.utwente.nl/user/s1934538/clickstream/clickstream-enwiki-2021-08.tsv.gz,Cook's_Country,450,2404,15,2869,885
hdfs://spark-nn.eemcs.utwente.nl/user/s1934538/clickstream/clickstream-enwiki-2021-08.tsv.gz,Once_Upon_a_Time_in_Hollywood,126067,337479,6114,469660,522553
hdfs://spark-nn.eemcs.utwente.nl/user/s1934538/clickstream/clickstream-enwiki-2021-08.tsv.gz,Cecil_Hotel_(Los_Angeles),7603,77556,185,85344,21161
hdfs://spark-nn.eemcs.utwente.nl/user/s1934538/clickstream/clickstream-enwiki-2021-08.tsv.gz,Khabib_Nurmagomedov,67162,310730,3063,380955,203757
hdfs://spark-nn.eemcs.utwente.nl/user/s1934538/clickstream/clickstream-enwiki-2021-08.tsv.gz,Army_of_the_Dead,45847,108224,5835,159906,110891
hdfs://spark-nn.eemcs.utwente.nl/user/s1934538/clickstream/clickstream-enwiki-2021-08.tsv.gz,Amber_Heard,123666,297182,1872,422720,187171
hdfs://spark-nn.eemcs.utwente.nl/user/s1934538/clickstream/clickstream-enwiki-2021-08.tsv.gz,Shakira,32514,203808,1958,238280,115137
hdfs://spark-nn.eemcs.utwente.nl/user/s1934538/clickstream/clickstream-enwiki-2021-08.tsv.gz,Grimes_(musician),134304,184442,929,319675,125773
hdfs://spark-nn.eemcs.utwente.nl/user/s1934538/clickstream/clickstream-enwiki-2021-08.tsv.gz,The_Nun_(2018_film),22578,57632,376,80586,44682
hdfs://spark-nn.eemcs.utwente.nl/user/s1934538/clickstream/clickstream-enwiki-2021-08.tsv.gz,Charles_III,79,165,67,311,344
hdfs://spark-nn.eemcs.utwente.nl/user/s1934538/clickstream/clickstream-enwiki-2021-08.tsv.gz,September_11_attacks,237322,787557,8184,1033063,641264
hdfs://spark-nn.eemcs.utwente.nl/user/s1934538/clickstream/clickstream-enwiki-2021-08.tsv.gz,Lisa_Marie_Presley,146164,87077,349,233590,135860
hdfs://spark-nn.eemcs.utwente.nl/user/s1934538/clickstream/clickstream-enwiki-2021-08.tsv.gz,Elliot_Page,80182,305343,2696,388221,157479
hdfs://spark-nn.eemcs.utwente.nl/user/s1934538/clickstream/clickstream-enwiki-2021-08.tsv.gz,Priyanka_Chopra,93537,236952,940,331429,123742
hdfs://spark-nn.eemcs.utwente.nl/user/s1934538/clickstream/clickstream-enwiki-2021-08.tsv.gz,Joe_Biden,256198,677864,20530,954592,494388
hdfs://spark-nn.eemcs.utwente.nl/user/s1934538/clickstream/clickstream-enwiki-2021-08.tsv.gz,2018_Asian_Games,85331,76393,634,162358,161113
hdfs://spark-nn.eemcs.utwente.nl/user/s1934538/clickstream/clickstream-enwiki-2021-08.tsv.gz,Carlos_Alcaraz,2700,10358,53,13111,2267
hdfs://spark-nn.eemcs.utwente.nl/user/s1934538/clickstream/clickstream-enwiki-2021-08.tsv.gz,Antifa_(United_States),14286,86670,436,101392,23606
hdfs://spark-nn.eemcs.utwente.nl/user/s1934538/clickstream/clickstream-enwiki-2021-08.tsv.gz,Joe_Exotic,17756,73830,420,92006,39193
hdfs://spark-nn.eemcs.utwente.nl/user/s1934538/clickstream/clickstream-enwiki-2021-08.tsv.gz,Ant-Man_and_the_Wasp:_Quantumania,96516,34307,189,131012,86673
hdfs://spark-nn.eemcs.utwente.nl/user/s1934538/clickstream/clickstream-enwiki-2021-08.tsv.gz,Google_logo,1307,20556,12,21875,1124
hdfs://spark-nn.eemcs.utwente.nl/user/s1934538/clickstream/clickstream-enwiki-2021-08.tsv.gz,Adipurush,48903,21740,65,70708,53364
hdfs://spark-nn.eemcs.utwente.nl/user/s1934538/clickstream/clickstream-enwiki-2021-08.tsv.gz,Simple_Mail_Transfer_Protocol,2951,34827,162,37940,3182
hdfs://spark-nn.eemcs.utwente.nl/user/s1934538/clickstream/clickstream-enwiki-2021-08.tsv.gz,Russo-Ukrainian_War,22559,32486,102,55147,31532
hdfs://spark-nn.eemcs.utwente.nl/user/s1934538/clickstream/clickstream-enwiki-2021-08.tsv.gz,Kenosha_unrest_shooting,5328,64216,544,70088,12948
hdfs://spark-nn.eemcs.utwente.nl/user/s1934538/clickstream/clickstream-enwiki-2021-08.tsv.gz,Aquaman_(film),39290,108953,1543,149786,87301
hdfs://spark-nn.eemcs.utwente.nl/user/s1934538/clickstream/clickstream-enwiki-2021-08.tsv.gz,Tom_Brady,70766,330706,3845,405317,156050
hdfs://spark-nn.eemcs.utwente.nl/user/s1934538/clickstream/clickstream-enwiki-2021-08.tsv.gz,RRR_(film),48806,137351,536,186693,106328
hdfs://spark-nn.eemcs.utwente.nl/user/s1934538/clickstream/clickstream-enwiki-2021-08.tsv.gz,FIFA_World_Cup,63518,241568,3499,308585,207107
hdfs://spark-nn.eemcs.utwente.nl/user/s1934538/clickstream/clickstream-enwiki-2021-08.tsv.gz,Taliban,958386,7284482,71721,8314589,5324019
hdfs://spark-nn.eemcs.utwente.nl/user/s1934538/clickstream/clickstream-enwiki-2021-08.tsv.gz,Rihanna,87247,410391,6000,503638,229676
hdfs://spark-nn.eemcs.utwente.nl/user/s1934538/clickstream/clickstream-enwiki-2021-08.tsv.gz,List_of_FIFA_World_Cup_finals,3984,60688,43,64715,17725
hdfs://spark-nn.eemcs.utwente.nl/user/s1934538/clickstream/clickstream-enwiki-2021-08.tsv.gz,List_of_awards_and_nominations_received_by_Meryl_Streep,11152,9164,284,20600,7843
hdfs://spark-nn.eemcs.utwente.nl/user/s1934538/clickstream/clickstream-enwiki-2021-08.tsv.gz,Vivek_Ramaswamy,1067,43315,146,44528,11969
hdfs://spark-nn.eemcs.utwente.nl/user/s1934538/clickstream/clickstream-enwiki-2021-08.tsv.gz,Michael_Jordan,116876,569150,5250,691276,253793
hdfs://spark-nn.eemcs.utwente.nl/user/s1934538/clickstream/clickstream-enwiki-2021-08.tsv.gz,Hamas,37302,44525,394,82221,31493
hdfs://spark-nn.eemcs.utwente.nl/user/s1934538/clickstream/clickstream-enwiki-2021-08.tsv.gz,Bonnie_and_Clyde,23166,187892,1416,212474,54678
hdfs://spark-nn.eemcs.utwente.nl/user/s1934538/clickstream/clickstream-enwiki-2021-08.tsv.gz,The_Batman_(film),147517,175818,3524,326859,267874
hdfs://spark-nn.eemcs.utwente.nl/user/s1934538/clickstream/clickstream-enwiki-2021-08.tsv.gz,Louis_Tomlinson,26152,47748,548,74448,27169
hdfs://spark-nn.eemcs.utwente.nl/user/s1934538/clickstream/clickstream-enwiki-2021-08.tsv.gz,1234,74,1184,15,1273,119
hdfs://spark-nn.eemcs.utwente.nl/user/s1934538/clickstream/clickstream-enwiki-2021-08.tsv.gz,Jimmy_Buffett,10239,69274,874,80387,30641
hdfs://spark-nn.eemcs.utwente.nl/user/s1934538/clickstream/clickstream-enwiki-2021-08.tsv.gz,ICC_Men's_T20_World_Cup,13437,138717,1560,153714,75947
hdfs://spark-nn.eemcs.utwente.nl/user/s1934538/clickstream/clickstream-enwiki-2021-08.tsv.gz,Avicii,22660,220336,1586,244582,112982
hdfs://spark-nn.eemcs.utwente.nl/user/s1934538/clickstream/clickstream-enwiki-2021-08.tsv.gz,Fyre_Festival,11334,74674,604,86612,50689
hdfs://spark-nn.eemcs.utwente.nl/user/s1934538/clickstream/clickstream-enwiki-2021-08.tsv.gz,Bridgerton,27803,174966,2482,205251,142606
hdfs://spark-nn.eemcs.utwente.nl/user/s1934538/clickstream/clickstream-enwiki-2021-08.tsv.gz,Stranger_Things_(season_4),36500,196589,1303,234392,138467
hdfs://spark-nn.eemcs.utwente.nl/user/s1934538/clickstream/clickstream-enwiki-2021-08.tsv.gz,Aaron_Hernandez,10041,117746,1246,129033,45515
hdfs://spark-nn.eemcs.utwente.nl/user/s1934538/clickstream/clickstream-enwiki-2021-08.tsv.gz,Chernobyl_(miniseries),26421,117788,2419,146628,134194
hdfs://spark-nn.eemcs.utwente.nl/user/s1934538/clickstream/clickstream-enwiki-2021-08.tsv.gz,Us_(2019_film),36446,119922,580,156948,53441
hdfs://spark-nn.eemcs.utwente.nl/user/s1934538/clickstream/clickstream-enwiki-2021-08.tsv.gz,K.G.F:_Chapter_2,25740,173560,375,199675,58790
hdfs://spark-nn.eemcs.utwente.nl/user/s1934538/clickstream/clickstream-enwiki-2021-08.tsv.gz,Rami_Malek,81168,181262,701,263131,105283
hdfs://spark-nn.eemcs.utwente.nl/user/s1934538/clickstream/clickstream-enwiki-2021-08.tsv.gz,QAnon,45028,440501,2463,487992,107674
hdfs://spark-nn.eemcs.utwente.nl/user/s1934538/clickstream/clickstream-enwiki-2021-08.tsv.gz,Cricket_World_Cup,12023,71901,356,84280,44441
hdfs://spark-nn.eemcs.utwente.nl/user/s1934538/clickstream/clickstream-enwiki-2021-08.tsv.gz,Stranger_Things_(season_3),24883,48405,515,73803,40313
hdfs://spark-nn.eemcs.utwente.nl/user/s1934538/clickstream/clickstream-enwiki-2021-08.tsv.gz,"Diana,_Princess_of_Wales",144321,363709,3837,511867,307652
hdfs://spark-nn.eemcs.utwente.nl/user/s1934538/clickstream/clickstream-enwiki-2021-08.tsv.gz,Tasuku_Honjo,1116,694234,218,695568,20879
hdfs://spark-nn.eemcs.utwente.nl/user/s1934538/clickstream/clickstream-enwiki-2021-08.tsv.gz,Anna_Sorokin,6980,55460,9374,71814,22070
hdfs://spark-nn.eemcs.utwente.nl/user/s1934538/clickstream/clickstream-enwiki-2021-08.tsv.gz,Royal_Rumble_(2018),7741,4729,140,12610,9325
hdfs://spark-nn.eemcs.utwente.nl/user/s1934538/clickstream/clickstream-enwiki-2021-08.tsv.gz,Charles_Sobhraj,46394,200696,421,247511,47233
hdfs://spark-nn.eemcs.utwente.nl/user/s1934538/clickstream/clickstream-enwiki-2021-08.tsv.gz,21_Savage,13913,57497,772,72182,28936
hdfs://spark-nn.eemcs.utwente.nl/user/s1934538/clickstream/clickstream-enwiki-2021-08.tsv.gz,Avengers:_Infinity_War,65033,93471,1389,159893,90687
hdfs://spark-nn.eemcs.utwente.nl/user/s1934538/clickstream/clickstream-enwiki-2021-08.tsv.gz,Doctor_Strange_in_the_Multiverse_of_Madness,182197,127076,1028,310301,175898
hdfs://spark-nn.eemcs.utwente.nl/user/s1934538/clickstream/clickstream-enwiki-2021-08.tsv.gz,Media,39,2349,271,2659,1172
hdfs://spark-nn.eemcs.utwente.nl/user/s1934538/clickstream/clickstream-enwiki-2021-08.tsv.gz,The_Lion_King_(2019_film),41217,50276,598,92091,48515
hdfs://spark-nn.eemcs.utwente.nl/user/s1934538/clickstream/clickstream-enwiki-2021-09.tsv.gz,Simone_Biles,20638,127131,1337,149106,46875
hdfs://spark-nn.eemcs.utwente.nl/user/s1934538/clickstream/clickstream-enwiki-2021-09.tsv.gz,2016_United_States_presidential_election,112803,82973,1040,196816,170017
hdfs://spark-nn.eemcs.utwente.nl/user/s1934538/clickstream/clickstream-enwiki-2021-09.tsv.gz,The_Lion_King_(2019_film),38834,48082,571,87487,43912
hdfs://spark-nn.eemcs.utwente.nl/user/s1934538/clickstream/clickstream-enwiki-2021-09.tsv.gz,Star_Wars:_The_Rise_of_Skywalker,74281,55942,1411,131634,68930
hdfs://spark-nn.eemcs.utwente.nl/user/s1934538/clickstream/clickstream-enwiki-2021-09.tsv.gz,List_of_FIFA_World_Cup_finals,2823,58144,55,61022,14349
hdfs://spark-nn.eemcs.utwente.nl/user/s1934538/clickstream/clickstream-enwiki-2021-09.tsv.gz,Hyphen-minus,838,8878870,19140,8898848,650
hdfs://spark-nn.eemcs.utwente.nl/user/s1934538/clickstream/clickstream-enwiki-2021-09.tsv.gz,George_VI,284540,112733,599,397872,292487
hdfs://spark-nn.eemcs.utwente.nl/user/s1934538/clickstream/clickstream-enwiki-2021-09.tsv.gz,Article_370_of_the_Constitution_of_India,2320,44779,20,47119,2722
hdfs://spark-nn.eemcs.utwente.nl/user/s1934538/clickstream/clickstream-enwiki-2021-09.tsv.gz,Grimes_(musician),167004,516473,5278,688755,299867
hdfs://spark-nn.eemcs.utwente.nl/user/s1934538/clickstream/clickstream-enwiki-2021-09.tsv.gz,Spanish_flu,35846,369845,5907,411598,86689
hdfs://spark-nn.eemcs.utwente.nl/user/s1934538/clickstream/clickstream-enwiki-2021-09.tsv.gz,Brie_Larson,71221,158966,6378,236565,100077
hdfs://spark-nn.eemcs.utwente.nl/user/s1934538/clickstream/clickstream-enwiki-2021-09.tsv.gz,The_Suicide_Squad_(film),148912,504794,11483,665189,466060
hdfs://spark-nn.eemcs.utwente.nl/user/s1934538/clickstream/clickstream-enwiki-2021-09.tsv.gz,Tunnel,3501,9497,130,13128,3080
hdfs://spark-nn.eemcs.utwente.nl/user/s1934538/clickstream/clickstream-enwiki-2021-09.tsv.gz,Eternals_(film),193098,302999,5033,501130,447764
hdfs://spark-nn.eemcs.utwente.nl/user/s1934538/clickstream/clickstream-enwiki-2021-09.tsv.gz,Death_of_Elisa_Lam,17914,90368,336,108618,26493
hdfs://spark-nn.eemcs.utwente.nl/user/s1934538/clickstream/clickstream-enwiki-2021-09.tsv.gz,When_They_See_Us,31831,35034,223,67088,29580
hdfs://spark-nn.eemcs.utwente.nl/user/s1934538/clickstream/clickstream-enwiki-2021-09.tsv.gz,2018_Winter_Olympics,20072,18214,206,38492,27444
hdfs://spark-nn.eemcs.utwente.nl/user/s1934538/clickstream/clickstream-enwiki-2021-09.tsv.gz,Vivek_Ramaswamy,986,16800,76,17862,4687
hdfs://spark-nn.eemcs.utwente.nl/user/s1934538/clickstream/clickstream-enwiki-2021-09.tsv.gz,XHamster,6153,201385,5584,213122,21058
hdfs://spark-nn.eemcs.utwente.nl/user/s1934538/clickstream/clickstream-enwiki-2021-09.tsv.gz,William_Murdoch,548,1302,10,1860,271
hdfs://spark-nn.eemcs.utwente.nl/user/s1934538/clickstream/clickstream-enwiki-2021-09.tsv.gz,Meat_Loaf,23877,95006,1120,120003,43159
hdfs://spark-nn.eemcs.utwente.nl/user/s1934538/clickstream/clickstream-enwiki-2021-09.tsv.gz,Captain_Marvel_(film),45655,110134,1376,157165,84854
hdfs://spark-nn.eemcs.utwente.nl/user/s1934538/clickstream/clickstream-enwiki-2021-09.tsv.gz,Taliban,159872,671198,8831,839901,529094
hdfs://spark-nn.eemcs.utwente.nl/user/s1934538/clickstream/clickstream-enwiki-2021-09.tsv.gz,Stephen_Hawking,29479,444118,2796,476393,170579
hdfs://spark-nn.eemcs.utwente.nl/user/s1934538/clickstream/clickstream-enwiki-2021-09.tsv.gz,1234,78,1428,21,1527,180
hdfs://spark-nn.eemcs.utwente.nl/user/s1934538/clickstream/clickstream-enwiki-2021-09.tsv.gz,Juneteenth,5227,38322,220,43769,4013
hdfs://spark-nn.eemcs.utwente.nl/user/s1934538/clickstream/clickstream-enwiki-2021-09.tsv.gz,Avicii,28492,949597,5741,983830,297847
hdfs://spark-nn.eemcs.utwente.nl/user/s1934538/clickstream/clickstream-enwiki-2021-09.tsv.gz,John_Wick:_Chapter_4,120184,129278,823,250285,159978
hdfs://spark-nn.eemcs.utwente.nl/user/s1934538/clickstream/clickstream-enwiki-2021-09.tsv.gz,Kamala_Harris,96760,252397,1842,350999,156959
hdfs://spark-nn.eemcs.utwente.nl/user/s1934538/clickstream/clickstream-enwiki-2021-09.tsv.gz,Black_Adam_(film),58971,27910,290,87171,64502
hdfs://spark-nn.eemcs.utwente.nl/user/s1934538/clickstream/clickstream-enwiki-2021-09.tsv.gz,War_(2019_film),16096,56200,114,72410,17971
hdfs://spark-nn.eemcs.utwente.nl/user/s1934538/clickstream/clickstream-enwiki-2021-09.tsv.gz,Bridgerton,39038,174247,2867,216152,147596
hdfs://spark-nn.eemcs.utwente.nl/user/s1934538/clickstream/clickstream-enwiki-2021-09.tsv.gz,Cleopatra,49643,4512834,10076,4572553,362475
hdfs://spark-nn.eemcs.utwente.nl/user/s1934538/clickstream/clickstream-enwiki-2021-09.tsv.gz,Tonya_Harding,20486,95627,440,116553,28605
hdfs://spark-nn.eemcs.utwente.nl/user/s1934538/clickstream/clickstream-enwiki-2021-09.tsv.gz,"Meghan,_Duchess_of_Sussex",73671,197830,1281,272782,149351
hdfs://spark-nn.eemcs.utwente.nl/user/s1934538/clickstream/clickstream-enwiki-2021-09.tsv.gz,Bipin_Rawat,13376,26662,211,40249,18475
hdfs://spark-nn.eemcs.utwente.nl/user/s1934538/clickstream/clickstream-enwiki-2021-09.tsv.gz,Keanu_Reeves,162416,714412,5929,882757,504398
hdfs://spark-nn.eemcs.utwente.nl/user/s1934538/clickstream/clickstream-enwiki-2021-09.tsv.gz,Eddie_Van_Halen,36972,66986,839,104797,40430
hdfs://spark-nn.eemcs.utwente.nl/user/s1934538/clickstream/clickstream-enwiki-2021-09.tsv.gz,List_of_Queen_of_the_South_episodes,12075,8313,169,20557,562
hdfs://spark-nn.eemcs.utwente.nl/user/s1934538/clickstream/clickstream-enwiki-2021-09.tsv.gz,Vladimir_Putin,97434,249713,3808,350955,212718
hdfs://spark-nn.eemcs.utwente.nl/user/s1934538/clickstream/clickstream-enwiki-2021-09.tsv.gz,Carlos_Alcaraz,26936,192444,1485,220865,44474
hdfs://spark-nn.eemcs.utwente.nl/user/s1934538/clickstream/clickstream-enwiki-2021-09.tsv.gz,Thor:_Love_and_Thunder,172349,93058,692,266099,195985
hdfs://spark-nn.eemcs.utwente.nl/user/s1934538/clickstream/clickstream-enwiki-2021-09.tsv.gz,Sylvester_Stallone,89392,252003,2041,343436,243509
hdfs://spark-nn.eemcs.utwente.nl/user/s1934538/clickstream/clickstream-enwiki-2021-09.tsv.gz,The_Last_of_Us_(TV_series),34337,62429,386,97152,79954
hdfs://spark-nn.eemcs.utwente.nl/user/s1934538/clickstream/clickstream-enwiki-2021-09.tsv.gz,Qasem_Soleimani,12888,22955,189,36032,20781
hdfs://spark-nn.eemcs.utwente.nl/user/s1934538/clickstream/clickstream-enwiki-2021-09.tsv.gz,Spider-Man:_No_Way_Home,269828,517958,10275,798061,450468
hdfs://spark-nn.eemcs.utwente.nl/user/s1934538/clickstream/clickstream-enwiki-2021-09.tsv.gz,Burt_Reynolds,51873,173946,2124,227943,104847
hdfs://spark-nn.eemcs.utwente.nl/user/s1934538/clickstream/clickstream-enwiki-2021-09.tsv.gz,Jeffrey_Dahmer,32841,284054,4083,320978,144023
hdfs://spark-nn.eemcs.utwente.nl/user/s1934538/clickstream/clickstream-enwiki-2021-09.tsv.gz,Naomi_Osaka,71271,321104,5447,397822,97280
hdfs://spark-nn.eemcs.utwente.nl/user/s1934538/clickstream/clickstream-enwiki-2021-09.tsv.gz,1917_(2019_film),26649,127323,2313,156285,99643
hdfs://spark-nn.eemcs.utwente.nl/user/s1934538/clickstream/clickstream-enwiki-2021-09.tsv.gz,Adele,22535,185222,3086,210843,68608
hdfs://spark-nn.eemcs.utwente.nl/user/s1934538/clickstream/clickstream-enwiki-2021-09.tsv.gz,Dune_(2021_film),252610,1354828,40094,1647532,976898
hdfs://spark-nn.eemcs.utwente.nl/user/s1934538/clickstream/clickstream-enwiki-2021-09.tsv.gz,QAnon,41185,270024,2172,313381,81043
hdfs://spark-nn.eemcs.utwente.nl/user/s1934538/clickstream/clickstream-enwiki-2021-09.tsv.gz,Stan_Lee,56641,192825,1126,250592,62906
hdfs://spark-nn.eemcs.utwente.nl/user/s1934538/clickstream/clickstream-enwiki-2021-09.tsv.gz,Matthew_Perry,48598,132029,2377,183004,100962
hdfs://spark-nn.eemcs.utwente.nl/user/s1934538/clickstream/clickstream-enwiki-2021-09.tsv.gz,Central_Park_jogger_case,15530,50082,181,65793,10399
hdfs://spark-nn.eemcs.utwente.nl/user/s1934538/clickstream/clickstream-enwiki-2021-09.tsv.gz,It_Chapter_Two,35290,54361,662,90313,58267
hdfs://spark-nn.eemcs.utwente.nl/user/s1934538/clickstream/clickstream-enwiki-2021-09.tsv.gz,Chernobyl_(miniseries),19654,79180,1684,100518,85576
hdfs://spark-nn.eemcs.utwente.nl/user/s1934538/clickstream/clickstream-enwiki-2021-09.tsv.gz,Venom_(2018_film),74732,357557,4593,436882,242462
hdfs://spark-nn.eemcs.utwente.nl/user/s1934538/clickstream/clickstream-enwiki-2021-09.tsv.gz,2023_Cricket_World_Cup,14953,41546,104,56603,17837
hdfs://spark-nn.eemcs.utwente.nl/user/s1934538/clickstream/clickstream-enwiki-2021-09.tsv.gz,Parasite_(2019_film),35054,188821,2470,226345,92790
hdfs://spark-nn.eemcs.utwente.nl/user/s1934538/clickstream/clickstream-enwiki-2021-09.tsv.gz,Sushma_Swaraj,6712,35477,97,42286,7096
hdfs://spark-nn.eemcs.utwente.nl/user/s1934538/clickstream/clickstream-enwiki-2021-09.tsv.gz,Lisa_Marie_Presley,132201,76262,288,208751,123042
hdfs://spark-nn.eemcs.utwente.nl/user/s1934538/clickstream/clickstream-enwiki-2021-09.tsv.gz,Anthony_Bourdain,30162,309813,2370,342345,104128
hdfs://spark-nn.eemcs.utwente.nl/user/s1934538/clickstream/clickstream-enwiki-2021-09.tsv.gz,Squid_Game,115305,5740087,37575,5892967,2267265
hdfs://spark-nn.eemcs.utwente.nl/user/s1934538/clickstream/clickstream-enwiki-2021-09.tsv.gz,Black_Widow_(2021_film),149243,524815,9418,683476,400002
hdfs://spark-nn.eemcs.utwente.nl/user/s1934538/clickstream/clickstream-enwiki-2021-09.tsv.gz,Irrfan_Khan,31468,62320,106,93894,33887
hdfs://spark-nn.eemcs.utwente.nl/user/s1934538/clickstream/clickstream-enwiki-2021-09.tsv.gz,Pornhub,44886,279220,12715,336821,72746
hdfs://spark-nn.eemcs.utwente.nl/user/s1934538/clickstream/clickstream-enwiki-2021-09.tsv.gz,Rami_Malek,121587,325066,2770,449423,188491
hdfs://spark-nn.eemcs.utwente.nl/user/s1934538/clickstream/clickstream-enwiki-2021-09.tsv.gz,Game_of_Thrones_(season_8),14740,41001,613,56354,19210
hdfs://spark-nn.eemcs.utwente.nl/user/s1934538/clickstream/clickstream-enwiki-2021-09.tsv.gz,UEFA_Euro_2020,51216,121668,2282,175166,89288
hdfs://spark-nn.eemcs.utwente.nl/user/s1934538/clickstream/clickstream-enwiki-2021-09.tsv.gz,Avengers:_Endgame,120472,198737,2949,322158,187512
hdfs://spark-nn.eemcs.utwente.nl/user/s1934538/clickstream/clickstream-enwiki-2021-09.tsv.gz,Atal_Bihari_Vajpayee,28504,56085,174,84763,26602
hdfs://spark-nn.eemcs.utwente.nl/user/s1934538/clickstream/clickstream-enwiki-2021-09.tsv.gz,Indian_Premier_League,31234,381837,659,413730,144025
hdfs://spark-nn.eemcs.utwente.nl/user/s1934538/clickstream/clickstream-enwiki-2021-09.tsv.gz,Juice_Wrld,42292,205675,3309,251276,92236
hdfs://spark-nn.eemcs.utwente.nl/user/s1934538/clickstream/clickstream-enwiki-2021-09.tsv.gz,Elon_Musk,220601,1231907,11213,1463721,873197
hdfs://spark-nn.eemcs.utwente.nl/user/s1934538/clickstream/clickstream-enwiki-2021-09.tsv.gz,Media,41,2546,313,2900,1188
hdfs://spark-nn.eemcs.utwente.nl/user/s1934538/clickstream/clickstream-enwiki-2021-09.tsv.gz,HTTP_cookie,2761,445044,127,447932,20710
hdfs://spark-nn.eemcs.utwente.nl/user/s1934538/clickstream/clickstream-enwiki-2021-09.tsv.gz,Fantastic_Beasts:_The_Crimes_of_Grindelwald,56024,70288,1190,127502,79319
hdfs://spark-nn.eemcs.utwente.nl/user/s1934538/clickstream/clickstream-enwiki-2021-09.tsv.gz,Russo-Ukrainian_War,21534,30117,133,51784,29954
hdfs://spark-nn.eemcs.utwente.nl/user/s1934538/clickstream/clickstream-enwiki-2021-09.tsv.gz,Watts_family_murders,18531,354230,685,373446,80707
hdfs://spark-nn.eemcs.utwente.nl/user/s1934538/clickstream/clickstream-enwiki-2021-09.tsv.gz,2020_Summer_Olympics,96545,235448,4889,336882,256661
hdfs://spark-nn.eemcs.utwente.nl/user/s1934538/clickstream/clickstream-enwiki-2021-09.tsv.gz,Joaquin_Phoenix,123056,162784,1031,286871,179628
hdfs://spark-nn.eemcs.utwente.nl/user/s1934538/clickstream/clickstream-enwiki-2021-09.tsv.gz,Deadpool_2,51352,63628,1523,116503,83732
hdfs://spark-nn.eemcs.utwente.nl/user/s1934538/clickstream/clickstream-enwiki-2021-09.tsv.gz,John_McCain,30768,70350,693,101811,50870
hdfs://spark-nn.eemcs.utwente.nl/user/s1934538/clickstream/clickstream-enwiki-2021-09.tsv.gz,Roe_v._Wade,26677,420295,3302,450274,142980
hdfs://spark-nn.eemcs.utwente.nl/user/s1934538/clickstream/clickstream-enwiki-2021-09.tsv.gz,Kelly_Preston,85155,114573,742,200470,59889
hdfs://spark-nn.eemcs.utwente.nl/user/s1934538/clickstream/clickstream-enwiki-2021-09.tsv.gz,Nipsey_Hussle,21757,90031,725,112513,36718
hdfs://spark-nn.eemcs.utwente.nl/user/s1934538/clickstream/clickstream-enwiki-2021-09.tsv.gz,Shakira,24913,199459,2210,226582,99988
hdfs://spark-nn.eemcs.utwente.nl/user/s1934538/clickstream/clickstream-enwiki-2021-09.tsv.gz,The_Falcon_and_the_Winter_Soldier,44147,105798,1808,151753,94373
hdfs://spark-nn.eemcs.utwente.nl/user/s1934538/clickstream/clickstream-enwiki-2021-09.tsv.gz,United_States_Electoral_College,10619,28773,89,39481,6733
hdfs://spark-nn.eemcs.utwente.nl/user/s1934538/clickstream/clickstream-enwiki-2021-09.tsv.gz,Ukraine,52550,298637,4361,355548,103291
hdfs://spark-nn.eemcs.utwente.nl/user/s1934538/clickstream/clickstream-enwiki-2021-09.tsv.gz,Tom_Brady,108308,705528,7327,821163,317541
hdfs://spark-nn.eemcs.utwente.nl/user/s1934538/clickstream/clickstream-enwiki-2021-09.tsv.gz,Mötley_Crüe,31111,90638,1265,123014,138102
hdfs://spark-nn.eemcs.utwente.nl/user/s1934538/clickstream/clickstream-enwiki-2021-09.tsv.gz,Don't_Look_Up_(2021_film),114615,271959,3868,390442,204375
hdfs://spark-nn.eemcs.utwente.nl/user/s1934538/clickstream/clickstream-enwiki-2021-09.tsv.gz,Tenet_(film),69161,195066,2654,266881,139076
hdfs://spark-nn.eemcs.utwente.nl/user/s1934538/clickstream/clickstream-enwiki-2021-09.tsv.gz,"Diana,_Princess_of_Wales",138485,348446,3420,490351,297299
hdfs://spark-nn.eemcs.utwente.nl/user/s1934538/clickstream/clickstream-enwiki-2021-09.tsv.gz,Shang-Chi_and_the_Legend_of_the_Ten_Rings,698945,3945557,80327,4724829,3414043
hdfs://spark-nn.eemcs.utwente.nl/user/s1934538/clickstream/clickstream-enwiki-2021-09.tsv.gz,September_11_attacks,579947,3462547,52676,4095170,2563512
hdfs://spark-nn.eemcs.utwente.nl/user/s1934538/clickstream/clickstream-enwiki-2021-09.tsv.gz,Aretha_Franklin,63331,617961,3690,684982,349310
hdfs://spark-nn.eemcs.utwente.nl/user/s1934538/clickstream/clickstream-enwiki-2021-09.tsv.gz,XXX:_Return_of_Xander_Cage,60072,614440,1070,675582,74350
hdfs://spark-nn.eemcs.utwente.nl/user/s1934538/clickstream/clickstream-enwiki-2021-09.tsv.gz,List_of_awards_and_nominations_received_by_Meryl_Streep,10088,7295,391,17774,6859
hdfs://spark-nn.eemcs.utwente.nl/user/s1934538/clickstream/clickstream-enwiki-2021-09.tsv.gz,2022_FIFA_World_Cup,102104,270901,9169,382174,238336
hdfs://spark-nn.eemcs.utwente.nl/user/s1934538/clickstream/clickstream-enwiki-2021-09.tsv.gz,Aquaman_(film),35291,83875,1408,120574,67821
hdfs://spark-nn.eemcs.utwente.nl/user/s1934538/clickstream/clickstream-enwiki-2021-09.tsv.gz,Stranger_Things_(season_3),18855,35947,341,55143,28940
hdfs://spark-nn.eemcs.utwente.nl/user/s1934538/clickstream/clickstream-enwiki-2021-09.tsv.gz,Priyanka_Chopra,133237,231167,1022,365426,131374
hdfs://spark-nn.eemcs.utwente.nl/user/s1934538/clickstream/clickstream-enwiki-2021-09.tsv.gz,Rihanna,93328,332529,4143,430000,198034
hdfs://spark-nn.eemcs.utwente.nl/user/s1934538/clickstream/clickstream-enwiki-2021-09.tsv.gz,Once_Upon_a_Time_in_Hollywood,98847,248900,4381,352128,363169
hdfs://spark-nn.eemcs.utwente.nl/user/s1934538/clickstream/clickstream-enwiki-2021-09.tsv.gz,J._Robert_Oppenheimer,22957,126416,606,149979,57785
hdfs://spark-nn.eemcs.utwente.nl/user/s1934538/clickstream/clickstream-enwiki-2021-09.tsv.gz,Elizabeth_II,423778,655864,8355,1087997,762101
hdfs://spark-nn.eemcs.utwente.nl/user/s1934538/clickstream/clickstream-enwiki-2021-09.tsv.gz,Brett_Kavanaugh,23067,36345,418,59830,19216
hdfs://spark-nn.eemcs.utwente.nl/user/s1934538/clickstream/clickstream-enwiki-2021-09.tsv.gz,Dennis_Nilsen,17579,176193,899,194671,47660
hdfs://spark-nn.eemcs.utwente.nl/user/s1934538/clickstream/clickstream-enwiki-2021-09.tsv.gz,Kenosha_unrest_shooting,3717,46737,344,50798,9916
hdfs://spark-nn.eemcs.utwente.nl/user/s1934538/clickstream/clickstream-enwiki-2021-09.tsv.gz,The_Umbrella_Academy_(TV_series),30122,121050,2361,153533,81093
hdfs://spark-nn.eemcs.utwente.nl/user/s1934538/clickstream/clickstream-enwiki-2021-09.tsv.gz,Shinzo_Abe,50655,51419,512,102586,63116
hdfs://spark-nn.eemcs.utwente.nl/user/s1934538/clickstream/clickstream-enwiki-2021-09.tsv.gz,RRR_(film),35146,70493,2203,107842,46952
hdfs://spark-nn.eemcs.utwente.nl/user/s1934538/clickstream/clickstream-enwiki-2021-09.tsv.gz,Michael_Bloomberg,31746,40127,174,72047,31975
hdfs://spark-nn.eemcs.utwente.nl/user/s1934538/clickstream/clickstream-enwiki-2021-09.tsv.gz,K.G.F:_Chapter_2,19303,91391,178,110872,33570
hdfs://spark-nn.eemcs.utwente.nl/user/s1934538/clickstream/clickstream-enwiki-2021-09.tsv.gz,Crazy_Rich_Asians_(film),51105,97773,1225,150103,133436
hdfs://spark-nn.eemcs.utwente.nl/user/s1934538/clickstream/clickstream-enwiki-2021-09.tsv.gz,Critical_race_theory,12374,428778,2724,443876,48379
hdfs://spark-nn.eemcs.utwente.nl/user/s1934538/clickstream/clickstream-enwiki-2021-09.tsv.gz,Joker_(2019_film),49507,165262,2342,217111,98613
hdfs://spark-nn.eemcs.utwente.nl/user/s1934538/clickstream/clickstream-enwiki-2021-09.tsv.gz,Betty_White,67295,305407,3813,376515,111260
hdfs://spark-nn.eemcs.utwente.nl/user/s1934538/clickstream/clickstream-enwiki-2021-09.tsv.gz,IPv4,10755,39986,158,50899,9203
hdfs://spark-nn.eemcs.utwente.nl/user/s1934538/clickstream/clickstream-enwiki-2021-09.tsv.gz,Richard_Jewell,18275,87367,467,106109,37261
hdfs://spark-nn.eemcs.utwente.nl/user/s1934538/clickstream/clickstream-enwiki-2021-09.tsv.gz,Top_Gun:_Maverick,61827,91846,2853,156526,88937
hdfs://spark-nn.eemcs.utwente.nl/user/s1934538/clickstream/clickstream-enwiki-2021-09.tsv.gz,Mac_Miller,41200,276725,2120,320045,96136
hdfs://spark-nn.eemcs.utwente.nl/user/s1934538/clickstream/clickstream-enwiki-2021-09.tsv.gz,The_Flash_(film),66407,45177,441,112025,74365
hdfs://spark-nn.eemcs.utwente.nl/user/s1934538/clickstream/clickstream-enwiki-2021-09.tsv.gz,Manti_Te'o,5480,46128,229,51837,5702
hdfs://spark-nn.eemcs.utwente.nl/user/s1934538/clickstream/clickstream-enwiki-2021-09.tsv.gz,Grover,1079,4503,38,5620,1208
hdfs://spark-nn.eemcs.utwente.nl/user/s1934538/clickstream/clickstream-enwiki-2021-09.tsv.gz,Cecil_Hotel_(Los_Angeles),8049,85219,193,93461,27843
hdfs://spark-nn.eemcs.utwente.nl/user/s1934538/clickstream/clickstream-enwiki-2021-09.tsv.gz,Main_Page,75744,168559534,4716326,173351604,33430041
hdfs://spark-nn.eemcs.utwente.nl/user/s1934538/clickstream/clickstream-enwiki-2021-09.tsv.gz,Notre-Dame_de_Paris,11220,74869,756,86845,18973
hdfs://spark-nn.eemcs.utwente.nl/user/s1934538/clickstream/clickstream-enwiki-2021-09.tsv.gz,Charles_Sobhraj,25669,121957,290,147916,27870
hdfs://spark-nn.eemcs.utwente.nl/user/s1934538/clickstream/clickstream-enwiki-2021-09.tsv.gz,Sushant_Singh_Rajput,25472,143071,385,168928,59783
hdfs://spark-nn.eemcs.utwente.nl/user/s1934538/clickstream/clickstream-enwiki-2021-09.tsv.gz,Queen_(band),80932,248268,4093,333293,331648
hdfs://spark-nn.eemcs.utwente.nl/user/s1934538/clickstream/clickstream-enwiki-2021-09.tsv.gz,Afghanistan,472314,1100758,31925,1604997,866096
hdfs://spark-nn.eemcs.utwente.nl/user/s1934538/clickstream/clickstream-enwiki-2021-09.tsv.gz,Aaron_Carter,16906,30320,235,47461,20208
hdfs://spark-nn.eemcs.utwente.nl/user/s1934538/clickstream/clickstream-enwiki-2021-09.tsv.gz,No_Time_to_Die,310191,1257977,37081,1605249,958208
hdfs://spark-nn.eemcs.utwente.nl/user/s1934538/clickstream/clickstream-enwiki-2021-09.tsv.gz,Hamas,24124,31710,500,56334,23721
hdfs://spark-nn.eemcs.utwente.nl/user/s1934538/clickstream/clickstream-enwiki-2021-09.tsv.gz,Jeffrey_Epstein,47154,189682,1633,238469,105731
hdfs://spark-nn.eemcs.utwente.nl/user/s1934538/clickstream/clickstream-enwiki-2021-09.tsv.gz,Ray_Liotta,50672,121729,901,173302,59235
hdfs://spark-nn.eemcs.utwente.nl/user/s1934538/clickstream/clickstream-enwiki-2021-09.tsv.gz,The_Queen's_Gambit_(miniseries),52116,206457,2642,261215,138337
hdfs://spark-nn.eemcs.utwente.nl/user/s1934538/clickstream/clickstream-enwiki-2021-09.tsv.gz,Mulan_(2020_film),21423,63825,1039,86287,51242
hdfs://spark-nn.eemcs.utwente.nl/user/s1934538/clickstream/clickstream-enwiki-2021-09.tsv.gz,"Citizenship_(Amendment)_Act,_2019",3494,25829,34,29357,3167
hdfs://spark-nn.eemcs.utwente.nl/user/s1934538/clickstream/clickstream-enwiki-2021-09.tsv.gz,Cameron_Boyce,35678,214369,783,250830,68043
hdfs://spark-nn.eemcs.utwente.nl/user/s1934538/clickstream/clickstream-enwiki-2021-09.tsv.gz,Joe_Biden,217777,538997,10301,767075,380140
hdfs://spark-nn.eemcs.utwente.nl/user/s1934538/clickstream/clickstream-enwiki-2021-09.tsv.gz,Asia_Cup,1929,19382,122,21433,11770
hdfs://spark-nn.eemcs.utwente.nl/user/s1934538/clickstream/clickstream-enwiki-2021-09.tsv.gz,Chernobyl_disaster,49497,328631,2966,381094,143858
hdfs://spark-nn.eemcs.utwente.nl/user/s1934538/clickstream/clickstream-enwiki-2021-09.tsv.gz,Alexander_Hamilton,67207,210144,1845,279196,142956
hdfs://spark-nn.eemcs.utwente.nl/user/s1934538/clickstream/clickstream-enwiki-2021-09.tsv.gz,Naya_Rivera,56180,85205,329,141714,53807
hdfs://spark-nn.eemcs.utwente.nl/user/s1934538/clickstream/clickstream-enwiki-2021-09.tsv.gz,Amy_Coney_Barrett,33643,51992,506,86141,32569
hdfs://spark-nn.eemcs.utwente.nl/user/s1934538/clickstream/clickstream-enwiki-2021-09.tsv.gz,Cristiano_Ronaldo,255808,2262361,17901,2536070,629796
hdfs://spark-nn.eemcs.utwente.nl/user/s1934538/clickstream/clickstream-enwiki-2021-09.tsv.gz,Kate_Spade,26429,57558,323,84310,33092
hdfs://spark-nn.eemcs.utwente.nl/user/s1934538/clickstream/clickstream-enwiki-2021-09.tsv.gz,List_of_most_popular_websites,14818,33409,109,48336,17737
hdfs://spark-nn.eemcs.utwente.nl/user/s1934538/clickstream/clickstream-enwiki-2021-10.tsv.gz,Coronavirus,13516,120771,2613,136900,37523
hdfs://spark-nn.eemcs.utwente.nl/user/s1934538/clickstream/clickstream-enwiki-2021-10.tsv.gz,Laal_Singh_Chaddha,44905,49376,2734,97015,48512
hdfs://spark-nn.eemcs.utwente.nl/user/s1934538/clickstream/clickstream-enwiki-2021-10.tsv.gz,List_of_James_Bond_films,414862,2400812,3454,2819128,1922987
hdfs://spark-nn.eemcs.utwente.nl/user/s1934538/clickstream/clickstream-enwiki-2021-10.tsv.gz,Kelly_Preston,85818,129017,918,215753,63316
hdfs://spark-nn.eemcs.utwente.nl/user/s1934538/clickstream/clickstream-enwiki-2021-10.tsv.gz,Indian_Premier_League,80676,865025,1196,946897,402927
hdfs://spark-nn.eemcs.utwente.nl/user/s1934538/clickstream/clickstream-enwiki-2021-10.tsv.gz,Stranger_Things_(season_3),19552,36016,361,55929,29475
hdfs://spark-nn.eemcs.utwente.nl/user/s1934538/clickstream/clickstream-enwiki-2021-10.tsv.gz,Ted_Bundy,39561,380462,5359,425382,101664
hdfs://spark-nn.eemcs.utwente.nl/user/s1934538/clickstream/clickstream-enwiki-2021-10.tsv.gz,Meat_Loaf,36270,122384,1372,160026,55493
hdfs://spark-nn.eemcs.utwente.nl/user/s1934538/clickstream/clickstream-enwiki-2021-10.tsv.gz,XHamster,7285,219414,6388,233087,24002
hdfs://spark-nn.eemcs.utwente.nl/user/s1934538/clickstream/clickstream-enwiki-2021-10.tsv.gz,Henry_V_of_England,107358,141493,451,249302,176997
hdfs://spark-nn.eemcs.utwente.nl/user/s1934538/clickstream/clickstream-enwiki-2021-10.tsv.gz,George_VI,319027,116379,1241,436647,318749
hdfs://spark-nn.eemcs.utwente.nl/user/s1934538/clickstream/clickstream-enwiki-2021-10.tsv.gz,Fantastic_Beasts:_The_Crimes_of_Grindelwald,46842,54638,647,102127,59205
hdfs://spark-nn.eemcs.utwente.nl/user/s1934538/clickstream/clickstream-enwiki-2021-10.tsv.gz,Venom_(2018_film),117942,671677,6528,796147,369417
hdfs://spark-nn.eemcs.utwente.nl/user/s1934538/clickstream/clickstream-enwiki-2021-10.tsv.gz,Johnny_Depp,154210,342546,2764,499520,342351
hdfs://spark-nn.eemcs.utwente.nl/user/s1934538/clickstream/clickstream-enwiki-2021-10.tsv.gz,Richard_Ramirez,24025,215712,1689,241426,64768
hdfs://spark-nn.eemcs.utwente.nl/user/s1934538/clickstream/clickstream-enwiki-2021-10.tsv.gz,John_Wick:_Chapter_4,68791,96220,792,165803,105852
hdfs://spark-nn.eemcs.utwente.nl/user/s1934538/clickstream/clickstream-enwiki-2021-10.tsv.gz,XXXTentacion,77113,513442,5995,596550,107538
hdfs://spark-nn.eemcs.utwente.nl/user/s1934538/clickstream/clickstream-enwiki-2021-10.tsv.gz,Israel,72887,210026,4828,287741,138214
hdfs://spark-nn.eemcs.utwente.nl/user/s1934538/clickstream/clickstream-enwiki-2021-10.tsv.gz,Taliban,47897,142803,2465,193165,110954
hdfs://spark-nn.eemcs.utwente.nl/user/s1934538/clickstream/clickstream-enwiki-2021-10.tsv.gz,Amy_Coney_Barrett,25253,38105,246,63604,23520
hdfs://spark-nn.eemcs.utwente.nl/user/s1934538/clickstream/clickstream-enwiki-2021-10.tsv.gz,1917_(2019_film),31941,107410,2231,141582,82568
hdfs://spark-nn.eemcs.utwente.nl/user/s1934538/clickstream/clickstream-enwiki-2021-10.tsv.gz,Once_Upon_a_Time_in_Hollywood,140306,197898,3136,341340,292450
hdfs://spark-nn.eemcs.utwente.nl/user/s1934538/clickstream/clickstream-enwiki-2021-10.tsv.gz,Kobe_Bryant_sexual_assault_case,4732,21995,49,26776,2340
hdfs://spark-nn.eemcs.utwente.nl/user/s1934538/clickstream/clickstream-enwiki-2021-10.tsv.gz,Russo-Ukrainian_War,22844,30723,180,53747,32487
hdfs://spark-nn.eemcs.utwente.nl/user/s1934538/clickstream/clickstream-enwiki-2021-10.tsv.gz,A_Star_Is_Born_(2018_film),32215,91296,652,124163,55538
hdfs://spark-nn.eemcs.utwente.nl/user/s1934538/clickstream/clickstream-enwiki-2021-10.tsv.gz,Keanu_Reeves,97393,530084,4142,631619,338806
hdfs://spark-nn.eemcs.utwente.nl/user/s1934538/clickstream/clickstream-enwiki-2021-10.tsv.gz,Sidharth_Shukla,27638,155742,315,183695,50283
hdfs://spark-nn.eemcs.utwente.nl/user/s1934538/clickstream/clickstream-enwiki-2021-10.tsv.gz,The_Nun_(2018_film),34895,72016,519,107430,59754
hdfs://spark-nn.eemcs.utwente.nl/user/s1934538/clickstream/clickstream-enwiki-2021-10.tsv.gz,When_They_See_Us,15129,25857,134,41120,18046
hdfs://spark-nn.eemcs.utwente.nl/user/s1934538/clickstream/clickstream-enwiki-2021-10.tsv.gz,COVID-19_pandemic,287464,349751,1762,638977,292992
hdfs://spark-nn.eemcs.utwente.nl/user/s1934538/clickstream/clickstream-enwiki-2021-10.tsv.gz,Hyphen-minus,820,8245989,18171,8264980,777
hdfs://spark-nn.eemcs.utwente.nl/user/s1934538/clickstream/clickstream-enwiki-2021-10.tsv.gz,Donald_Glover,36533,106041,752,143326,58269
hdfs://spark-nn.eemcs.utwente.nl/user/s1934538/clickstream/clickstream-enwiki-2021-10.tsv.gz,List_of_awards_and_nominations_received_by_Meryl_Streep,8829,6787,341,15957,6385
hdfs://spark-nn.eemcs.utwente.nl/user/s1934538/clickstream/clickstream-enwiki-2021-10.tsv.gz,1234,45,1442,31,1518,295
hdfs://spark-nn.eemcs.utwente.nl/user/s1934538/clickstream/clickstream-enwiki-2021-10.tsv.gz,K.G.F:_Chapter_2,23934,72030,177,96141,34115
hdfs://spark-nn.eemcs.utwente.nl/user/s1934538/clickstream/clickstream-enwiki-2021-10.tsv.gz,Death_of_Elisa_Lam,14622,77116,240,91978,23782
hdfs://spark-nn.eemcs.utwente.nl/user/s1934538/clickstream/clickstream-enwiki-2021-10.tsv.gz,Shinzo_Abe,51742,36307,534,88583,51517
hdfs://spark-nn.eemcs.utwente.nl/user/s1934538/clickstream/clickstream-enwiki-2021-10.tsv.gz,Spanish_flu,30521,213059,2484,246064,54499
hdfs://spark-nn.eemcs.utwente.nl/user/s1934538/clickstream/clickstream-enwiki-2021-10.tsv.gz,Main_Page,85280,159933121,4966161,164984562,34314890
hdfs://spark-nn.eemcs.utwente.nl/user/s1934538/clickstream/clickstream-enwiki-2021-10.tsv.gz,Tina_Turner,24963,245288,2630,272881,87831
hdfs://spark-nn.eemcs.utwente.nl/user/s1934538/clickstream/clickstream-enwiki-2021-10.tsv.gz,Black_Panther_(film),42005,103402,2085,147492,86960
hdfs://spark-nn.eemcs.utwente.nl/user/s1934538/clickstream/clickstream-enwiki-2021-10.tsv.gz,Charles_Sobhraj,16985,75572,271,92828,17254
hdfs://spark-nn.eemcs.utwente.nl/user/s1934538/clickstream/clickstream-enwiki-2021-10.tsv.gz,Aaron_Hernandez,11834,125475,736,138045,49947
hdfs://spark-nn.eemcs.utwente.nl/user/s1934538/clickstream/clickstream-enwiki-2021-10.tsv.gz,Dune_(2021_film),658550,4904633,103888,5667071,4138242
hdfs://spark-nn.eemcs.utwente.nl/user/s1934538/clickstream/clickstream-enwiki-2021-10.tsv.gz,Wonder_Woman_1984,41769,137732,2383,181884,92717
hdfs://spark-nn.eemcs.utwente.nl/user/s1934538/clickstream/clickstream-enwiki-2021-10.tsv.gz,2016_United_States_presidential_election,112665,89023,1282,202970,171454
hdfs://spark-nn.eemcs.utwente.nl/user/s1934538/clickstream/clickstream-enwiki-2021-10.tsv.gz,Thor:_Love_and_Thunder,142969,77461,1260,221690,156376
hdfs://spark-nn.eemcs.utwente.nl/user/s1934538/clickstream/clickstream-enwiki-2021-10.tsv.gz,Deaths_in_2021,1352990,2378765,13632,3745387,2216033
hdfs://spark-nn.eemcs.utwente.nl/user/s1934538/clickstream/clickstream-enwiki-2021-10.tsv.gz,Pelé,32285,145503,1236,179024,52297
hdfs://spark-nn.eemcs.utwente.nl/user/s1934538/clickstream/clickstream-enwiki-2021-10.tsv.gz,Jeffrey_Epstein,48807,202573,1846,253226,113319
hdfs://spark-nn.eemcs.utwente.nl/user/s1934538/clickstream/clickstream-enwiki-2021-10.tsv.gz,List_of_Marvel_Cinematic_Universe_films,239378,586293,2321,827992,477870
hdfs://spark-nn.eemcs.utwente.nl/user/s1934538/clickstream/clickstream-enwiki-2021-10.tsv.gz,Zack_Snyder's_Justice_League,81702,120986,1458,204146,104952
hdfs://spark-nn.eemcs.utwente.nl/user/s1934538/clickstream/clickstream-enwiki-2021-10.tsv.gz,Us_(2019_film),30557,134494,930,165981,56144
hdfs://spark-nn.eemcs.utwente.nl/user/s1934538/clickstream/clickstream-enwiki-2021-10.tsv.gz,"Meghan,_Duchess_of_Sussex",74006,169602,1248,244856,129844
hdfs://spark-nn.eemcs.utwente.nl/user/s1934538/clickstream/clickstream-enwiki-2021-10.tsv.gz,The_Weeknd,76019,227406,3114,306539,128892
hdfs://spark-nn.eemcs.utwente.nl/user/s1934538/clickstream/clickstream-enwiki-2021-10.tsv.gz,Eternals_(film),306139,1523881,44945,1874965,1416457
hdfs://spark-nn.eemcs.utwente.nl/user/s1934538/clickstream/clickstream-enwiki-2021-10.tsv.gz,The_Last_of_Us_(TV_series),31132,75576,384,107092,80904
hdfs://spark-nn.eemcs.utwente.nl/user/s1934538/clickstream/clickstream-enwiki-2021-10.tsv.gz,COVID-19_pandemic_by_country_and_territory,83834,212171,4029,300034,171011
hdfs://spark-nn.eemcs.utwente.nl/user/s1934538/clickstream/clickstream-enwiki-2021-10.tsv.gz,Jason_Momoa,160220,446462,3389,610071,280205
hdfs://spark-nn.eemcs.utwente.nl/user/s1934538/clickstream/clickstream-enwiki-2021-10.tsv.gz,UEFA_Euro_2020,51393,108100,1862,161355,79446
hdfs://spark-nn.eemcs.utwente.nl/user/s1934538/clickstream/clickstream-enwiki-2021-10.tsv.gz,Royal_Rumble_(2018),5765,4108,49,9922,6656
hdfs://spark-nn.eemcs.utwente.nl/user/s1934538/clickstream/clickstream-enwiki-2021-10.tsv.gz,Deadpool_2,45087,51810,1303,98200,67891
hdfs://spark-nn.eemcs.utwente.nl/user/s1934538/clickstream/clickstream-enwiki-2021-10.tsv.gz,R._Kelly,50080,381369,5080,436529,237361
hdfs://spark-nn.eemcs.utwente.nl/user/s1934538/clickstream/clickstream-enwiki-2021-10.tsv.gz,Dennis_Nilsen,17129,120475,735,138339,31418
hdfs://spark-nn.eemcs.utwente.nl/user/s1934538/clickstream/clickstream-enwiki-2021-10.tsv.gz,Naya_Rivera,64115,123085,439,187639,63268
hdfs://spark-nn.eemcs.utwente.nl/user/s1934538/clickstream/clickstream-enwiki-2021-10.tsv.gz,David_Beckham,47609,179692,1273,228574,83725
hdfs://spark-nn.eemcs.utwente.nl/user/s1934538/clickstream/clickstream-enwiki-2021-10.tsv.gz,Top_Gun:_Maverick,55025,65068,1780,121873,69782
hdfs://spark-nn.eemcs.utwente.nl/user/s1934538/clickstream/clickstream-enwiki-2021-10.tsv.gz,Article_370_of_the_Constitution_of_India,2383,45883,22,48288,2716
hdfs://spark-nn.eemcs.utwente.nl/user/s1934538/clickstream/clickstream-enwiki-2021-10.tsv.gz,Stranger_Things_(season_4),26065,194261,1099,221425,114270
hdfs://spark-nn.eemcs.utwente.nl/user/s1934538/clickstream/clickstream-enwiki-2021-10.tsv.gz,Black_Widow_(2021_film),149384,708005,16048,873437,721401
hdfs://spark-nn.eemcs.utwente.nl/user/s1934538/clickstream/clickstream-enwiki-2021-10.tsv.gz,Anthony_Bourdain,24269,243231,1862,269362,79489
hdfs://spark-nn.eemcs.utwente.nl/user/s1934538/clickstream/clickstream-enwiki-2021-10.tsv.gz,The_Batman_(film),203818,525594,14798,744210,682329
hdfs://spark-nn.eemcs.utwente.nl/user/s1934538/clickstream/clickstream-enwiki-2021-10.tsv.gz,ICC_Men's_T20_World_Cup,94215,1770503,6599,1871317,690914
hdfs://spark-nn.eemcs.utwente.nl/user/s1934538/clickstream/clickstream-enwiki-2021-10.tsv.gz,Anne_Heche,25951,52168,442,78561,27045
hdfs://spark-nn.eemcs.utwente.nl/user/s1934538/clickstream/clickstream-enwiki-2021-10.tsv.gz,Ukraine,52073,227125,3580,282778,102491
hdfs://spark-nn.eemcs.utwente.nl/user/s1934538/clickstream/clickstream-enwiki-2021-10.tsv.gz,Key_frame,478,5065,17,5560,351
hdfs://spark-nn.eemcs.utwente.nl/user/s1934538/clickstream/clickstream-enwiki-2021-10.tsv.gz,Greta_Thunberg,14801,345025,3448,363274,101312
hdfs://spark-nn.eemcs.utwente.nl/user/s1934538/clickstream/clickstream-enwiki-2021-10.tsv.gz,The_Falcon_and_the_Winter_Soldier,34686,73963,1281,109930,65928
hdfs://spark-nn.eemcs.utwente.nl/user/s1934538/clickstream/clickstream-enwiki-2021-10.tsv.gz,Avicii,23912,200739,1455,226106,69561
hdfs://spark-nn.eemcs.utwente.nl/user/s1934538/clickstream/clickstream-enwiki-2021-10.tsv.gz,2020_United_States_presidential_election,166740,252282,7046,426068,408280
hdfs://spark-nn.eemcs.utwente.nl/user/s1934538/clickstream/clickstream-enwiki-2021-10.tsv.gz,State_of_Palestine,35761,85997,173,121931,49851
hdfs://spark-nn.eemcs.utwente.nl/user/s1934538/clickstream/clickstream-enwiki-2021-10.tsv.gz,Crazy_Rich_Asians_(film),32061,84797,1158,118016,98888
hdfs://spark-nn.eemcs.utwente.nl/user/s1934538/clickstream/clickstream-enwiki-2021-10.tsv.gz,Vivek_Ramaswamy,1018,13478,54,14550,3386
hdfs://spark-nn.eemcs.utwente.nl/user/s1934538/clickstream/clickstream-enwiki-2021-10.tsv.gz,Media,46,3221,297,3564,1342
hdfs://spark-nn.eemcs.utwente.nl/user/s1934538/clickstream/clickstream-enwiki-2021-10.tsv.gz,Bridgerton,95873,203394,2995,302262,177617
hdfs://spark-nn.eemcs.utwente.nl/user/s1934538/clickstream/clickstream-enwiki-2021-10.tsv.gz,WandaVision,42879,126458,6037,175374,94192
hdfs://spark-nn.eemcs.utwente.nl/user/s1934538/clickstream/clickstream-enwiki-2021-10.tsv.gz,Shakira,32046,193277,2301,227624,93280
hdfs://spark-nn.eemcs.utwente.nl/user/s1934538/clickstream/clickstream-enwiki-2021-10.tsv.gz,Lists_of_deaths_by_year,3967,144577,874,149418,166302
hdfs://spark-nn.eemcs.utwente.nl/user/s1934538/clickstream/clickstream-enwiki-2021-10.tsv.gz,Asia_Cup,4784,55189,153,60126,32292
hdfs://spark-nn.eemcs.utwente.nl/user/s1934538/clickstream/clickstream-enwiki-2021-10.tsv.gz,Brie_Larson,55185,148838,1242,205265,83879
hdfs://spark-nn.eemcs.utwente.nl/user/s1934538/clickstream/clickstream-enwiki-2021-10.tsv.gz,John_McCain,35615,74280,893,110788,56859
hdfs://spark-nn.eemcs.utwente.nl/user/s1934538/clickstream/clickstream-enwiki-2021-10.tsv.gz,Black_Panther:_Wakanda_Forever,103427,63923,1045,168395,133693
hdfs://spark-nn.eemcs.utwente.nl/user/s1934538/clickstream/clickstream-enwiki-2021-10.tsv.gz,Naomi_Osaka,19399,59056,341,78796,19028
hdfs://spark-nn.eemcs.utwente.nl/user/s1934538/clickstream/clickstream-enwiki-2021-10.tsv.gz,Ant-Man_and_the_Wasp:_Quantumania,69174,32452,383,102009,65938
hdfs://spark-nn.eemcs.utwente.nl/user/s1934538/clickstream/clickstream-enwiki-2021-10.tsv.gz,The_Lion_King_(2019_film),36927,44708,439,82074,38421
hdfs://spark-nn.eemcs.utwente.nl/user/s1934538/clickstream/clickstream-enwiki-2021-10.tsv.gz,Khabib_Nurmagomedov,57639,259442,2331,319412,162024
hdfs://spark-nn.eemcs.utwente.nl/user/s1934538/clickstream/clickstream-enwiki-2021-10.tsv.gz,It_Chapter_Two,61569,139002,1697,202268,139989
hdfs://spark-nn.eemcs.utwente.nl/user/s1934538/clickstream/clickstream-enwiki-2021-10.tsv.gz,Mac_Miller,47187,296462,2057,345706,108041
hdfs://spark-nn.eemcs.utwente.nl/user/s1934538/clickstream/clickstream-enwiki-2021-10.tsv.gz,Bible,17779,4452093,1925,4471797,36392
hdfs://spark-nn.eemcs.utwente.nl/user/s1934538/clickstream/clickstream-enwiki-2021-10.tsv.gz,Central_Park_jogger_case,12015,43184,143,55342,7941
hdfs://spark-nn.eemcs.utwente.nl/user/s1934538/clickstream/clickstream-enwiki-2021-10.tsv.gz,List_of_FIFA_World_Cup_finals,2272,52002,46,54320,14200
hdfs://spark-nn.eemcs.utwente.nl/user/s1934538/clickstream/clickstream-enwiki-2021-10.tsv.gz,List_of_highest-grossing_films,131325,224643,1712,357680,194221
hdfs://spark-nn.eemcs.utwente.nl/user/s1934538/clickstream/clickstream-enwiki-2021-10.tsv.gz,NATO,46655,122262,1966,170883,64633
hdfs://spark-nn.eemcs.utwente.nl/user/s1934538/clickstream/clickstream-enwiki-2021-10.tsv.gz,Carlos_Alcaraz,3807,25548,137,29492,5265
hdfs://spark-nn.eemcs.utwente.nl/user/s1934538/clickstream/clickstream-enwiki-2021-10.tsv.gz,Luke_Perry,44381,179392,1005,224778,87819
hdfs://spark-nn.eemcs.utwente.nl/user/s1934538/clickstream/clickstream-enwiki-2021-10.tsv.gz,Avengers:_Endgame,104117,163158,2991,270266,154395
hdfs://spark-nn.eemcs.utwente.nl/user/s1934538/clickstream/clickstream-enwiki-2021-10.tsv.gz,Hamas,18450,25496,224,44170,18830
hdfs://spark-nn.eemcs.utwente.nl/user/s1934538/clickstream/clickstream-enwiki-2021-10.tsv.gz,Brett_Kavanaugh,19418,57072,506,76996,23173
hdfs://spark-nn.eemcs.utwente.nl/user/s1934538/clickstream/clickstream-enwiki-2021-10.tsv.gz,XXX:_Return_of_Xander_Cage,66432,493810,1035,561277,70375
hdfs://spark-nn.eemcs.utwente.nl/user/s1934538/clickstream/clickstream-enwiki-2021-10.tsv.gz,Hamilton_(musical),32007,207585,1922,241514,140113
hdfs://spark-nn.eemcs.utwente.nl/user/s1934538/clickstream/clickstream-enwiki-2021-10.tsv.gz,Jeffrey_Dahmer,32042,258542,3801,294385,125953
hdfs://spark-nn.eemcs.utwente.nl/user/s1934538/clickstream/clickstream-enwiki-2021-10.tsv.gz,Bird_Box_(film),19497,55934,767,76198,22523
hdfs://spark-nn.eemcs.utwente.nl/user/s1934538/clickstream/clickstream-enwiki-2021-10.tsv.gz,Ruth_Bader_Ginsburg,19482,110234,902,130618,43971
hdfs://spark-nn.eemcs.utwente.nl/user/s1934538/clickstream/clickstream-enwiki-2021-10.tsv.gz,Godzilla_vs._Kong,66406,111632,2566,180604,87731
hdfs://spark-nn.eemcs.utwente.nl/user/s1934538/clickstream/clickstream-enwiki-2021-10.tsv.gz,"Prince_Philip,_Duke_of_Edinburgh",194699,214690,2423,411812,233565
hdfs://spark-nn.eemcs.utwente.nl/user/s1934538/clickstream/clickstream-enwiki-2021-10.tsv.gz,Priyanka_Chopra,81728,178240,645,260613,92091
hdfs://spark-nn.eemcs.utwente.nl/user/s1934538/clickstream/clickstream-enwiki-2021-10.tsv.gz,Parasite_(2019_film),54119,266558,3904,324581,136998
hdfs://spark-nn.eemcs.utwente.nl/user/s1934538/clickstream/clickstream-enwiki-2021-10.tsv.gz,Grimes_(musician),160103,298169,1668,459940,172735
hdfs://spark-nn.eemcs.utwente.nl/user/s1934538/clickstream/clickstream-enwiki-2021-10.tsv.gz,The_Flash_(film),90806,112077,2373,205256,155580
hdfs://spark-nn.eemcs.utwente.nl/user/s1934538/clickstream/clickstream-enwiki-2021-10.tsv.gz,2018_Asian_Games,9656,9516,70,19242,18803
hdfs://spark-nn.eemcs.utwente.nl/user/s1934538/clickstream/clickstream-enwiki-2021-10.tsv.gz,Richard_Jewell,14698,63807,368,78873,27389
hdfs://spark-nn.eemcs.utwente.nl/user/s1934538/clickstream/clickstream-enwiki-2021-10.tsv.gz,William_Murdoch,583,1465,40,2088,378
hdfs://spark-nn.eemcs.utwente.nl/user/s1934538/clickstream/clickstream-enwiki-2021-10.tsv.gz,Valentine's_Day,3395,34028,225,37648,3651
hdfs://spark-nn.eemcs.utwente.nl/user/s1934538/clickstream/clickstream-enwiki-2021-10.tsv.gz,Elliot_Page,64810,232553,1725,299088,121431
hdfs://spark-nn.eemcs.utwente.nl/user/s1934538/clickstream/clickstream-enwiki-2021-10.tsv.gz,Atal_Bihari_Vajpayee,27813,49001,137,76951,25398
hdfs://spark-nn.eemcs.utwente.nl/user/s1934538/clickstream/clickstream-enwiki-2021-10.tsv.gz,Jimmy_Hoffa,28039,114788,1088,143915,57002
hdfs://spark-nn.eemcs.utwente.nl/user/s1934538/clickstream/clickstream-enwiki-2021-10.tsv.gz,Joaquin_Phoenix,139727,252319,1511,393557,255970
hdfs://spark-nn.eemcs.utwente.nl/user/s1934538/clickstream/clickstream-enwiki-2021-10.tsv.gz,Chernobyl_disaster,50844,297534,2968,351346,138432
hdfs://spark-nn.eemcs.utwente.nl/user/s1934538/clickstream/clickstream-enwiki-2021-10.tsv.gz,Freddie_Mercury,109802,555403,4995,670200,261317
hdfs://spark-nn.eemcs.utwente.nl/user/s1934538/clickstream/clickstream-enwiki-2021-10.tsv.gz,Glass_(2019_film),47725,57456,535,105716,36108
hdfs://spark-nn.eemcs.utwente.nl/user/s1934538/clickstream/clickstream-enwiki-2021-10.tsv.gz,Eddie_Van_Halen,49066,114654,1587,165307,61213
hdfs://spark-nn.eemcs.utwente.nl/user/s1934538/clickstream/clickstream-enwiki-2021-10.tsv.gz,Chernobyl_(miniseries),22102,84231,1462,107795,90667
hdfs://spark-nn.eemcs.utwente.nl/user/s1934538/clickstream/clickstream-enwiki-2021-10.tsv.gz,Tom_Brady,117478,911002,8615,1037095,392335
hdfs://spark-nn.eemcs.utwente.nl/user/s1934538/clickstream/clickstream-enwiki-2021-10.tsv.gz,2023_Cricket_World_Cup,29857,72242,136,102235,29936
hdfs://spark-nn.eemcs.utwente.nl/user/s1934538/clickstream/clickstream-enwiki-2021-10.tsv.gz,Irrfan_Khan,29087,57863,114,87064,33002
hdfs://spark-nn.eemcs.utwente.nl/user/s1934538/clickstream/clickstream-enwiki-2021-10.tsv.gz,"Diana,_Princess_of_Wales",143508,380600,3719,527827,320081
hdfs://spark-nn.eemcs.utwente.nl/user/s1934538/clickstream/clickstream-enwiki-2021-10.tsv.gz,Lisa_Marie_Presley,129697,73694,289,203680,119408
hdfs://spark-nn.eemcs.utwente.nl/user/s1934538/clickstream/clickstream-enwiki-2021-10.tsv.gz,Anna_Sorokin,8157,125722,414,134293,38562
hdfs://spark-nn.eemcs.utwente.nl/user/s1934538/clickstream/clickstream-enwiki-2021-10.tsv.gz,Microsoft_Office,9761,635664,943,646368,23417
hdfs://spark-nn.eemcs.utwente.nl/user/s1934538/clickstream/clickstream-enwiki-2021-10.tsv.gz,2020_Summer_Olympics,61628,155503,2886,220017,151685
hdfs://spark-nn.eemcs.utwente.nl/user/s1934538/clickstream/clickstream-enwiki-2021-10.tsv.gz,Rishi_Sunak,28470,199129,1492,229091,106026
hdfs://spark-nn.eemcs.utwente.nl/user/s1934538/clickstream/clickstream-enwiki-2021-10.tsv.gz,2022_FIFA_World_Cup,127035,335136,11617,473788,304535
hdfs://spark-nn.eemcs.utwente.nl/user/s1934538/clickstream/clickstream-enwiki-2021-10.tsv.gz,War_(2019_film),16743,48651,46,65440,16731
hdfs://spark-nn.eemcs.utwente.nl/user/s1934538/clickstream/clickstream-enwiki-2021-10.tsv.gz,Christopher_Scarver,46616,13157,32,59805,20917
hdfs://spark-nn.eemcs.utwente.nl/user/s1934538/clickstream/clickstream-enwiki-2021-10.tsv.gz,Jimmy_Buffett,7440,37621,545,45606,16538
hdfs://spark-nn.eemcs.utwente.nl/user/s1934538/clickstream/clickstream-enwiki-2021-10.tsv.gz,George_H._W._Bush,138664,102956,743,242363,144876
hdfs://spark-nn.eemcs.utwente.nl/user/s1934538/clickstream/clickstream-enwiki-2021-10.tsv.gz,Kim_Jong-un,81434,226623,2171,310228,170252
hdfs://spark-nn.eemcs.utwente.nl/user/s1934538/clickstream/clickstream-enwiki-2021-10.tsv.gz,Vladimir_Putin,89344,240939,3760,334043,203042
hdfs://spark-nn.eemcs.utwente.nl/user/s1934538/clickstream/clickstream-enwiki-2021-10.tsv.gz,Juneteenth,5252,65317,422,70991,6191
hdfs://spark-nn.eemcs.utwente.nl/user/s1934538/clickstream/clickstream-enwiki-2021-10.tsv.gz,Army_of_the_Dead,136967,191097,2469,330533,191562
hdfs://spark-nn.eemcs.utwente.nl/user/s1934538/clickstream/clickstream-enwiki-2021-10.tsv.gz,Ghislaine_Maxwell,41995,78066,424,120485,45441
hdfs://spark-nn.eemcs.utwente.nl/user/s1934538/clickstream/clickstream-enwiki-2021-10.tsv.gz,Kenosha_unrest_shooting,5230,196028,1620,202878,41060
hdfs://spark-nn.eemcs.utwente.nl/user/s1934538/clickstream/clickstream-enwiki-2021-10.tsv.gz,Fyre_Festival,7314,43701,278,51293,30892
hdfs://spark-nn.eemcs.utwente.nl/user/s1934538/clickstream/clickstream-enwiki-2021-10.tsv.gz,Roe_v._Wade,14112,169241,1094,184447,52182
hdfs://spark-nn.eemcs.utwente.nl/user/s1934538/clickstream/clickstream-enwiki-2021-10.tsv.gz,Stranger_Things,77816,227236,5084,310136,228849
hdfs://spark-nn.eemcs.utwente.nl/user/s1934538/clickstream/clickstream-enwiki-2021-10.tsv.gz,Bipin_Rawat,11910,21641,15,33566,14773
hdfs://spark-nn.eemcs.utwente.nl/user/s1934538/clickstream/clickstream-enwiki-2021-10.tsv.gz,Donald_Trump,209979,450340,8298,668617,377884
hdfs://spark-nn.eemcs.utwente.nl/user/s1934538/clickstream/clickstream-enwiki-2021-10.tsv.gz,2018_Winter_Olympics,18004,16960,191,35155,24466
hdfs://spark-nn.eemcs.utwente.nl/user/s1934538/clickstream/clickstream-enwiki-2021-10.tsv.gz,Juice_Wrld,38366,189125,3084,230575,85901
hdfs://spark-nn.eemcs.utwente.nl/user/s1934538/clickstream/clickstream-enwiki-2021-10.tsv.gz,Mulan_(2020_film),19201,49359,697,69257,36744
hdfs://spark-nn.eemcs.utwente.nl/user/s1934538/clickstream/clickstream-enwiki-2021-10.tsv.gz,Tasuku_Honjo,1301,59321,26,60648,2643
hdfs://spark-nn.eemcs.utwente.nl/user/s1934538/clickstream/clickstream-enwiki-2021-10.tsv.gz,Joe_Exotic,25887,113374,603,139864,57020
hdfs://spark-nn.eemcs.utwente.nl/user/s1934538/clickstream/clickstream-enwiki-2021-10.tsv.gz,Tunnel,4055,8852,99,13006,3569
hdfs://spark-nn.eemcs.utwente.nl/user/s1934538/clickstream/clickstream-enwiki-2021-10.tsv.gz,Notre-Dame_de_Paris,12521,76753,726,90000,17238
hdfs://spark-nn.eemcs.utwente.nl/user/s1934538/clickstream/clickstream-enwiki-2021-10.tsv.gz,Captain_Marvel_(film),41660,90176,1321,133157,68238
hdfs://spark-nn.eemcs.utwente.nl/user/s1934538/clickstream/clickstream-enwiki-2021-10.tsv.gz,Critical_race_theory,12171,711256,4433,727860,78766
hdfs://spark-nn.eemcs.utwente.nl/user/s1934538/clickstream/clickstream-enwiki-2022-02.tsv.gz,Gaza_Strip,14623,26228,192,41043,15072
hdfs://spark-nn.eemcs.utwente.nl/user/s1934538/clickstream/clickstream-enwiki-2022-02.tsv.gz,Shang-Chi_and_the_Legend_of_the_Ten_Rings,81908,199223,3688,284819,195678
hdfs://spark-nn.eemcs.utwente.nl/user/s1934538/clickstream/clickstream-enwiki-2022-02.tsv.gz,QAnon,35942,225873,2001,263816,64657
hdfs://spark-nn.eemcs.utwente.nl/user/s1934538/clickstream/clickstream-enwiki-2022-02.tsv.gz,Mac_Miller,30020,250483,3407,283910,81940
hdfs://spark-nn.eemcs.utwente.nl/user/s1934538/clickstream/clickstream-enwiki-2022-02.tsv.gz,Sylvester_Stallone,78493,208628,2102,289223,220025
hdfs://spark-nn.eemcs.utwente.nl/user/s1934538/clickstream/clickstream-enwiki-2022-02.tsv.gz,Sidharth_Shukla,14297,78936,124,93357,20463
hdfs://spark-nn.eemcs.utwente.nl/user/s1934538/clickstream/clickstream-enwiki-2022-02.tsv.gz,List_of_highest-grossing_films,276494,695803,2557,974854,337500
hdfs://spark-nn.eemcs.utwente.nl/user/s1934538/clickstream/clickstream-enwiki-2022-02.tsv.gz,Emma_Raducanu,9742,111329,660,121731,25338
hdfs://spark-nn.eemcs.utwente.nl/user/s1934538/clickstream/clickstream-enwiki-2022-02.tsv.gz,Aaron_Hernandez,10930,131278,808,143016,51247
hdfs://spark-nn.eemcs.utwente.nl/user/s1934538/clickstream/clickstream-enwiki-2022-02.tsv.gz,Charles_Sobhraj,14393,62115,172,76680,13698
hdfs://spark-nn.eemcs.utwente.nl/user/s1934538/clickstream/clickstream-enwiki-2022-02.tsv.gz,"Prince_Philip,_Duke_of_Edinburgh",248964,229900,2396,481260,266450
hdfs://spark-nn.eemcs.utwente.nl/user/s1934538/clickstream/clickstream-enwiki-2022-02.tsv.gz,The_Idol_(TV_series),27756,8231,176,36163,25734
hdfs://spark-nn.eemcs.utwente.nl/user/s1934538/clickstream/clickstream-enwiki-2022-02.tsv.gz,Ruth_Bader_Ginsburg,20300,81506,702,102508,32840
hdfs://spark-nn.eemcs.utwente.nl/user/s1934538/clickstream/clickstream-enwiki-2022-02.tsv.gz,R._Kelly,25715,149367,1981,177063,91608
hdfs://spark-nn.eemcs.utwente.nl/user/s1934538/clickstream/clickstream-enwiki-2022-02.tsv.gz,Joaquin_Phoenix,122791,152835,942,276568,169693
hdfs://spark-nn.eemcs.utwente.nl/user/s1934538/clickstream/clickstream-enwiki-2022-02.tsv.gz,Simple_Mail_Transfer_Protocol,3194,36383,131,39708,3222
hdfs://spark-nn.eemcs.utwente.nl/user/s1934538/clickstream/clickstream-enwiki-2022-02.tsv.gz,Irrfan_Khan,31235,51821,85,83141,36652
hdfs://spark-nn.eemcs.utwente.nl/user/s1934538/clickstream/clickstream-enwiki-2022-02.tsv.gz,Qasem_Soleimani,13562,26273,127,39962,19302
hdfs://spark-nn.eemcs.utwente.nl/user/s1934538/clickstream/clickstream-enwiki-2022-02.tsv.gz,Key_frame,481,5255,15,5751,358
hdfs://spark-nn.eemcs.utwente.nl/user/s1934538/clickstream/clickstream-enwiki-2022-02.tsv.gz,Anthony_Bourdain,32230,205385,1920,239535,73434
hdfs://spark-nn.eemcs.utwente.nl/user/s1934538/clickstream/clickstream-enwiki-2022-02.tsv.gz,Stranger_Things,73220,246885,6468,326573,259486
hdfs://spark-nn.eemcs.utwente.nl/user/s1934538/clickstream/clickstream-enwiki-2022-02.tsv.gz,Juice_Wrld,38228,212457,3749,254434,106737
hdfs://spark-nn.eemcs.utwente.nl/user/s1934538/clickstream/clickstream-enwiki-2022-02.tsv.gz,Lionel_Messi,86257,499333,6744,592334,124322
hdfs://spark-nn.eemcs.utwente.nl/user/s1934538/clickstream/clickstream-enwiki-2022-02.tsv.gz,Grover,1127,4090,54,5271,1187
hdfs://spark-nn.eemcs.utwente.nl/user/s1934538/clickstream/clickstream-enwiki-2022-02.tsv.gz,Sridevi,33315,89858,560,123733,57900
hdfs://spark-nn.eemcs.utwente.nl/user/s1934538/clickstream/clickstream-enwiki-2022-02.tsv.gz,No_Time_to_Die,121988,326781,6543,455312,295763
hdfs://spark-nn.eemcs.utwente.nl/user/s1934538/clickstream/clickstream-enwiki-2022-02.tsv.gz,Media,47,3651,421,4119,1270
hdfs://spark-nn.eemcs.utwente.nl/user/s1934538/clickstream/clickstream-enwiki-2022-02.tsv.gz,Adele,45436,363021,5226,413683,146979
hdfs://spark-nn.eemcs.utwente.nl/user/s1934538/clickstream/clickstream-enwiki-2022-02.tsv.gz,Microsoft_Office,7583,1823458,685,1831726,18060
hdfs://spark-nn.eemcs.utwente.nl/user/s1934538/clickstream/clickstream-enwiki-2022-02.tsv.gz,The_Batman_(film),209666,911179,32921,1153766,714168
hdfs://spark-nn.eemcs.utwente.nl/user/s1934538/clickstream/clickstream-enwiki-2022-02.tsv.gz,FIFA_World_Cup,58914,222028,5610,286552,201858
hdfs://spark-nn.eemcs.utwente.nl/user/s1934538/clickstream/clickstream-enwiki-2022-02.tsv.gz,Naya_Rivera,47989,73024,277,121290,46731
hdfs://spark-nn.eemcs.utwente.nl/user/s1934538/clickstream/clickstream-enwiki-2022-02.tsv.gz,Black_Widow_(2021_film),50392,117313,2064,169769,106677
hdfs://spark-nn.eemcs.utwente.nl/user/s1934538/clickstream/clickstream-enwiki-2022-02.tsv.gz,ICC_Men's_T20_World_Cup,15993,92525,598,109116,50762
hdfs://spark-nn.eemcs.utwente.nl/user/s1934538/clickstream/clickstream-enwiki-2022-02.tsv.gz,Tina_Turner,25212,216026,1983,243221,82776
hdfs://spark-nn.eemcs.utwente.nl/user/s1934538/clickstream/clickstream-enwiki-2022-02.tsv.gz,2.0_(film),23047,32556,83,55686,15352
hdfs://spark-nn.eemcs.utwente.nl/user/s1934538/clickstream/clickstream-enwiki-2022-02.tsv.gz,Squid_Game,41750,262838,6571,311159,154894
hdfs://spark-nn.eemcs.utwente.nl/user/s1934538/clickstream/clickstream-enwiki-2022-02.tsv.gz,Darth_Vader,35352,64235,870,100457,67038
hdfs://spark-nn.eemcs.utwente.nl/user/s1934538/clickstream/clickstream-enwiki-2022-02.tsv.gz,Elon_Musk,120650,1175618,11828,1308096,712102
hdfs://spark-nn.eemcs.utwente.nl/user/s1934538/clickstream/clickstream-enwiki-2022-02.tsv.gz,Kobe_Bryant,68584,418622,5284,492490,143207
hdfs://spark-nn.eemcs.utwente.nl/user/s1934538/clickstream/clickstream-enwiki-2022-02.tsv.gz,Rami_Malek,60431,166316,1427,228174,99823
hdfs://spark-nn.eemcs.utwente.nl/user/s1934538/clickstream/clickstream-enwiki-2022-02.tsv.gz,Stranger_Things_(season_3),21987,35748,473,58208,30321
hdfs://spark-nn.eemcs.utwente.nl/user/s1934538/clickstream/clickstream-enwiki-2022-02.tsv.gz,Jimmy_Hoffa,26107,111571,961,138639,50022
hdfs://spark-nn.eemcs.utwente.nl/user/s1934538/clickstream/clickstream-enwiki-2022-02.tsv.gz,George_H._W._Bush,132385,101698,867,234950,139238
hdfs://spark-nn.eemcs.utwente.nl/user/s1934538/clickstream/clickstream-enwiki-2022-02.tsv.gz,David_Beckham,42171,190754,1534,234459,87514
hdfs://spark-nn.eemcs.utwente.nl/user/s1934538/clickstream/clickstream-enwiki-2022-02.tsv.gz,Kim_Jong-un,73162,214735,1943,289840,149392
hdfs://spark-nn.eemcs.utwente.nl/user/s1934538/clickstream/clickstream-enwiki-2022-02.tsv.gz,Army_of_the_Dead,55556,82758,926,139240,62910
hdfs://spark-nn.eemcs.utwente.nl/user/s1934538/clickstream/clickstream-enwiki-2022-02.tsv.gz,The_Irishman,42690,74565,1411,118666,98631
hdfs://spark-nn.eemcs.utwente.nl/user/s1934538/clickstream/clickstream-enwiki-2022-02.tsv.gz,Cook's_Country,320,2498,35,2853,787
hdfs://spark-nn.eemcs.utwente.nl/user/s1934538/clickstream/clickstream-enwiki-2022-02.tsv.gz,Wikipedia,233469,755387,1488,990344,254320
hdfs://spark-nn.eemcs.utwente.nl/user/s1934538/clickstream/clickstream-enwiki-2022-02.tsv.gz,Croatia,63488,178882,3467,245837,80007
hdfs://spark-nn.eemcs.utwente.nl/user/s1934538/clickstream/clickstream-enwiki-2022-02.tsv.gz,A_Star_Is_Born_(2018_film),26206,73656,650,100512,47116
hdfs://spark-nn.eemcs.utwente.nl/user/s1934538/clickstream/clickstream-enwiki-2022-02.tsv.gz,Bridgerton,44445,168621,5168,218234,177658
hdfs://spark-nn.eemcs.utwente.nl/user/s1934538/clickstream/clickstream-enwiki-2022-02.tsv.gz,Ghislaine_Maxwell,55938,145924,793,202655,78989
hdfs://spark-nn.eemcs.utwente.nl/user/s1934538/clickstream/clickstream-enwiki-2022-02.tsv.gz,Eternals_(film),127103,595536,12207,734846,772771
hdfs://spark-nn.eemcs.utwente.nl/user/s1934538/clickstream/clickstream-enwiki-2022-02.tsv.gz,Thor:_Love_and_Thunder,150805,125413,2748,278966,192693
hdfs://spark-nn.eemcs.utwente.nl/user/s1934538/clickstream/clickstream-enwiki-2022-02.tsv.gz,Ukraine,878805,8789075,159263,9827143,4103634
hdfs://spark-nn.eemcs.utwente.nl/user/s1934538/clickstream/clickstream-enwiki-2022-02.tsv.gz,Amber_Heard,92675,157403,750,250828,84582
hdfs://spark-nn.eemcs.utwente.nl/user/s1934538/clickstream/clickstream-enwiki-2022-02.tsv.gz,The_Lion_King_(2019_film),40505,42548,542,83595,39235
hdfs://spark-nn.eemcs.utwente.nl/user/s1934538/clickstream/clickstream-enwiki-2022-02.tsv.gz,Rishi_Sunak,18287,161828,1194,181309,86240
hdfs://spark-nn.eemcs.utwente.nl/user/s1934538/clickstream/clickstream-enwiki-2022-02.tsv.gz,YouTube,134618,2298655,9953,2443226,123555
hdfs://spark-nn.eemcs.utwente.nl/user/s1934538/clickstream/clickstream-enwiki-2022-02.tsv.gz,Chadwick_Boseman,54094,241788,1428,297310,78540
hdfs://spark-nn.eemcs.utwente.nl/user/s1934538/clickstream/clickstream-enwiki-2022-02.tsv.gz,Spider-Man:_Far_From_Home,81242,105909,1806,188957,90400
hdfs://spark-nn.eemcs.utwente.nl/user/s1934538/clickstream/clickstream-enwiki-2022-02.tsv.gz,Hyphen-minus,901,5914221,21053,5936175,717
hdfs://spark-nn.eemcs.utwente.nl/user/s1934538/clickstream/clickstream-enwiki-2022-02.tsv.gz,Burt_Reynolds,51380,139060,1500,191940,89345
hdfs://spark-nn.eemcs.utwente.nl/user/s1934538/clickstream/clickstream-enwiki-2022-02.tsv.gz,Royal_Rumble_(2018),12206,7739,125,20070,14868
hdfs://spark-nn.eemcs.utwente.nl/user/s1934538/clickstream/clickstream-enwiki-2022-02.tsv.gz,Manti_Te'o,3774,17641,66,21481,2417
hdfs://spark-nn.eemcs.utwente.nl/user/s1934538/clickstream/clickstream-enwiki-2022-02.tsv.gz,Matthew_Perry,43054,126711,988,170753,112234
hdfs://spark-nn.eemcs.utwente.nl/user/s1934538/clickstream/clickstream-enwiki-2022-02.tsv.gz,Deaths_in_2022,1482447,2088812,15108,3586367,2152110
hdfs://spark-nn.eemcs.utwente.nl/user/s1934538/clickstream/clickstream-enwiki-2022-02.tsv.gz,Hamilton_(musical),36977,181690,1892,220559,142483
hdfs://spark-nn.eemcs.utwente.nl/user/s1934538/clickstream/clickstream-enwiki-2022-02.tsv.gz,Russo-Ukrainian_War,977331,4396714,37536,5411581,3396460
hdfs://spark-nn.eemcs.utwente.nl/user/s1934538/clickstream/clickstream-enwiki-2022-02.tsv.gz,Loki_(TV_series),41115,109250,2391,152756,84986
hdfs://spark-nn.eemcs.utwente.nl/user/s1934538/clickstream/clickstream-enwiki-2022-02.tsv.gz,HTTP_cookie,3083,307654,145,310882,18733
hdfs://spark-nn.eemcs.utwente.nl/user/s1934538/clickstream/clickstream-enwiki-2022-02.tsv.gz,Louis_Tomlinson,27953,71735,419,100107,27865
hdfs://spark-nn.eemcs.utwente.nl/user/s1934538/clickstream/clickstream-enwiki-2022-02.tsv.gz,Betty_White,57540,227688,3800,289028,81824
hdfs://spark-nn.eemcs.utwente.nl/user/s1934538/clickstream/clickstream-enwiki-2022-02.tsv.gz,Juneteenth,5741,83025,358,89124,6263
hdfs://spark-nn.eemcs.utwente.nl/user/s1934538/clickstream/clickstream-enwiki-2022-02.tsv.gz,Jason_Momoa,104393,310521,2617,417531,158046
hdfs://spark-nn.eemcs.utwente.nl/user/s1934538/clickstream/clickstream-enwiki-2022-02.tsv.gz,XHamster,7055,358483,5584,371122,36475
hdfs://spark-nn.eemcs.utwente.nl/user/s1934538/clickstream/clickstream-enwiki-2022-02.tsv.gz,Notre-Dame_de_Paris,11052,77226,752,89030,17255
hdfs://spark-nn.eemcs.utwente.nl/user/s1934538/clickstream/clickstream-enwiki-2022-02.tsv.gz,2022_FIFA_World_Cup,147617,482118,14205,643940,349178
hdfs://spark-nn.eemcs.utwente.nl/user/s1934538/clickstream/clickstream-enwiki-2022-02.tsv.gz,Charles_III,100,223,90,413,406
hdfs://spark-nn.eemcs.utwente.nl/user/s1934538/clickstream/clickstream-enwiki-2022-02.tsv.gz,Bird_Box_(film),16454,46940,639,64033,24232
hdfs://spark-nn.eemcs.utwente.nl/user/s1934538/clickstream/clickstream-enwiki-2022-02.tsv.gz,Fantastic_Beasts:_The_Crimes_of_Grindelwald,55559,62138,961,118658,76054
hdfs://spark-nn.eemcs.utwente.nl/user/s1934538/clickstream/clickstream-enwiki-2022-02.tsv.gz,Star_Wars:_The_Rise_of_Skywalker,83100,64154,1638,148892,81967
hdfs://spark-nn.eemcs.utwente.nl/user/s1934538/clickstream/clickstream-enwiki-2022-02.tsv.gz,Once_Upon_a_Time_in_Hollywood,96722,137370,3044,237136,243454
hdfs://spark-nn.eemcs.utwente.nl/user/s1934538/clickstream/clickstream-enwiki-2022-02.tsv.gz,Kenosha_unrest_shooting,5805,86231,1022,93058,14899
hdfs://spark-nn.eemcs.utwente.nl/user/s1934538/clickstream/clickstream-enwiki-2022-02.tsv.gz,Joe_Exotic,27531,86961,584,115076,46066
hdfs://spark-nn.eemcs.utwente.nl/user/s1934538/clickstream/clickstream-enwiki-2022-02.tsv.gz,Joker_(2019_film),50737,144825,1914,197476,91044
hdfs://spark-nn.eemcs.utwente.nl/user/s1934538/clickstream/clickstream-enwiki-2022-02.tsv.gz,Hamas,21010,28711,228,49949,20996
hdfs://spark-nn.eemcs.utwente.nl/user/s1934538/clickstream/clickstream-enwiki-2022-02.tsv.gz,2018_Winter_Olympics,323097,355526,4040,682663,345818
hdfs://spark-nn.eemcs.utwente.nl/user/s1934538/clickstream/clickstream-enwiki-2022-02.tsv.gz,Naomi_Osaka,19336,68892,853,89081,22106
hdfs://spark-nn.eemcs.utwente.nl/user/s1934538/clickstream/clickstream-enwiki-2022-02.tsv.gz,Olivia_Newton-John,22997,69850,1028,93875,44610
hdfs://spark-nn.eemcs.utwente.nl/user/s1934538/clickstream/clickstream-enwiki-2022-02.tsv.gz,Central_Park_jogger_case,11277,42935,233,54445,7585
hdfs://spark-nn.eemcs.utwente.nl/user/s1934538/clickstream/clickstream-enwiki-2022-02.tsv.gz,Lists_of_deaths_by_year,3378,295388,1287,300053,325299
hdfs://spark-nn.eemcs.utwente.nl/user/s1934538/clickstream/clickstream-enwiki-2022-02.tsv.gz,September_11_attacks,84684,220683,3258,308625,160508
hdfs://spark-nn.eemcs.utwente.nl/user/s1934538/clickstream/clickstream-enwiki-2022-02.tsv.gz,Black_Panther_(film),40080,96548,2130,138758,85487
hdfs://spark-nn.eemcs.utwente.nl/user/s1934538/clickstream/clickstream-enwiki-2022-02.tsv.gz,Glass_(2019_film),35636,40732,380,76748,27751
hdfs://spark-nn.eemcs.utwente.nl/user/s1934538/clickstream/clickstream-enwiki-2022-02.tsv.gz,Sushant_Singh_Rajput,19518,75984,664,96166,44702
hdfs://spark-nn.eemcs.utwente.nl/user/s1934538/clickstream/clickstream-enwiki-2022-02.tsv.gz,The_Mandalorian,153245,289213,5767,448225,335517
hdfs://spark-nn.eemcs.utwente.nl/user/s1934538/clickstream/clickstream-enwiki-2022-02.tsv.gz,Mötley_Crüe,187710,353657,3236,544603,565665
hdfs://spark-nn.eemcs.utwente.nl/user/s1934538/clickstream/clickstream-enwiki-2022-02.tsv.gz,Michael_Jordan,96731,576073,7197,680001,209749
hdfs://spark-nn.eemcs.utwente.nl/user/s1934538/clickstream/clickstream-enwiki-2022-02.tsv.gz,RRR_(film),48343,165946,843,215132,74765
hdfs://spark-nn.eemcs.utwente.nl/user/s1934538/clickstream/clickstream-enwiki-2022-02.tsv.gz,Stan_Lee,45164,188712,1159,235035,51795
hdfs://spark-nn.eemcs.utwente.nl/user/s1934538/clickstream/clickstream-enwiki-2022-02.tsv.gz,Avengers:_Infinity_War,53334,71141,1083,125558,67537
hdfs://spark-nn.eemcs.utwente.nl/user/s1934538/clickstream/clickstream-enwiki-2022-02.tsv.gz,WrestleMania_34,34768,13717,311,48796,31764
hdfs://spark-nn.eemcs.utwente.nl/user/s1934538/clickstream/clickstream-enwiki-2022-02.tsv.gz,The_Umbrella_Academy_(TV_series),33981,98846,2126,134953,75633
hdfs://spark-nn.eemcs.utwente.nl/user/s1934538/clickstream/clickstream-enwiki-2022-02.tsv.gz,John_Wick:_Chapter_4,47033,65100,578,112711,57747
hdfs://spark-nn.eemcs.utwente.nl/user/s1934538/clickstream/clickstream-enwiki-2022-02.tsv.gz,Ant-Man_and_the_Wasp:_Quantumania,61484,21641,154,83279,53565
hdfs://spark-nn.eemcs.utwente.nl/user/s1934538/clickstream/clickstream-enwiki-2022-02.tsv.gz,Guardians_of_the_Galaxy_Vol._3,81439,37983,905,120327,77923
hdfs://spark-nn.eemcs.utwente.nl/user/s1934538/clickstream/clickstream-enwiki-2022-02.tsv.gz,Vikram_(2022_film),35268,27772,159,63199,31778
hdfs://spark-nn.eemcs.utwente.nl/user/s1934538/clickstream/clickstream-enwiki-2022-02.tsv.gz,Bonnie_and_Clyde,18782,164306,1538,184626,49695
hdfs://spark-nn.eemcs.utwente.nl/user/s1934538/clickstream/clickstream-enwiki-2022-02.tsv.gz,2023_Cricket_World_Cup,14193,45547,71,59811,19438
hdfs://spark-nn.eemcs.utwente.nl/user/s1934538/clickstream/clickstream-enwiki-2022-02.tsv.gz,Article_370_of_the_Constitution_of_India,1946,36673,53,38672,2443
hdfs://spark-nn.eemcs.utwente.nl/user/s1934538/clickstream/clickstream-enwiki-2022-02.tsv.gz,Richard_Ramirez,17470,227034,1563,246067,59893
hdfs://spark-nn.eemcs.utwente.nl/user/s1934538/clickstream/clickstream-enwiki-2022-02.tsv.gz,Oppenheimer_(film),93195,54311,732,148238,116862
hdfs://spark-nn.eemcs.utwente.nl/user/s1934538/clickstream/clickstream-enwiki-2022-02.tsv.gz,Black_Adam_(film),96794,109919,2284,208997,187767
hdfs://spark-nn.eemcs.utwente.nl/user/s1934538/clickstream/clickstream-enwiki-2022-02.tsv.gz,Aquaman_(film),28833,79436,1179,109448,64259
hdfs://spark-nn.eemcs.utwente.nl/user/s1934538/clickstream/clickstream-enwiki-2022-02.tsv.gz,Watts_family_murders,18144,224166,485,242795,57494
hdfs://spark-nn.eemcs.utwente.nl/user/s1934538/clickstream/clickstream-enwiki-2022-02.tsv.gz,Saaho,18316,30034,126,48476,15269
hdfs://spark-nn.eemcs.utwente.nl/user/s1934538/clickstream/clickstream-enwiki-2022-02.tsv.gz,Carlos_Alcaraz,6402,38898,418,45718,15836
hdfs://spark-nn.eemcs.utwente.nl/user/s1934538/clickstream/clickstream-enwiki-2022-02.tsv.gz,Sinéad_O'Connor,16510,95831,810,113151,40929
hdfs://spark-nn.eemcs.utwente.nl/user/s1934538/clickstream/clickstream-enwiki-2022-02.tsv.gz,NATO,478812,4251553,58071,4788436,1269701
hdfs://spark-nn.eemcs.utwente.nl/user/s1934538/clickstream/clickstream-enwiki-2022-02.tsv.gz,The_Queen's_Gambit_(miniseries),21086,93728,1189,116003,62173
hdfs://spark-nn.eemcs.utwente.nl/user/s1934538/clickstream/clickstream-enwiki-2022-02.tsv.gz,Deadpool_2,47282,45496,1294,94072,66655
hdfs://spark-nn.eemcs.utwente.nl/user/s1934538/clickstream/clickstream-enwiki-2022-02.tsv.gz,UEFA_Euro_2020,41421,64601,1497,107519,61929
hdfs://spark-nn.eemcs.utwente.nl/user/s1934538/clickstream/clickstream-enwiki-2022-02.tsv.gz,Atal_Bihari_Vajpayee,33231,61893,85,95209,30898
hdfs://spark-nn.eemcs.utwente.nl/user/s1934538/clickstream/clickstream-enwiki-2022-02.tsv.gz,Cecil_Hotel_(Los_Angeles),7396,84385,214,91995,22833
hdfs://spark-nn.eemcs.utwente.nl/user/s1934538/clickstream/clickstream-enwiki-2022-02.tsv.gz,Us_(2019_film),46486,87388,559,134433,48901
hdfs://spark-nn.eemcs.utwente.nl/user/s1934538/clickstream/clickstream-enwiki-2022-02.tsv.gz,Chernobyl_disaster,114241,1039138,9561,1162940,433931
hdfs://spark-nn.eemcs.utwente.nl/user/s1934538/clickstream/clickstream-enwiki-2022-02.tsv.gz,Index_(statistics),113,1681,10,1804,160
hdfs://spark-nn.eemcs.utwente.nl/user/s1934538/clickstream/clickstream-enwiki-2022-02.tsv.gz,Shakira,27369,197706,2237,227312,103169
hdfs://spark-nn.eemcs.utwente.nl/user/s1934538/clickstream/clickstream-enwiki-2022-02.tsv.gz,K.G.F:_Chapter_2,25790,103917,994,130701,50972
hdfs://spark-nn.eemcs.utwente.nl/user/s1934538/clickstream/clickstream-enwiki-2022-02.tsv.gz,COVID-19_pandemic,224591,289217,1961,515769,216626
hdfs://spark-nn.eemcs.utwente.nl/user/s1934538/clickstream/clickstream-enwiki-2022-02.tsv.gz,JSON_Web_Token,741,28052,27,28820,2032
hdfs://spark-nn.eemcs.utwente.nl/user/s1934538/clickstream/clickstream-enwiki-2022-02.tsv.gz,21_Savage,11176,60936,793,72905,24290
hdfs://spark-nn.eemcs.utwente.nl/user/s1934538/clickstream/clickstream-enwiki-2022-02.tsv.gz,Salman_Rushdie,24911,58862,7182,90955,37857
hdfs://spark-nn.eemcs.utwente.nl/user/s1934538/clickstream/clickstream-enwiki-2022-02.tsv.gz,XXXTentacion,86297,551676,6932,644905,121687
hdfs://spark-nn.eemcs.utwente.nl/user/s1934538/clickstream/clickstream-enwiki-2022-02.tsv.gz,Asia_Cup,1885,15533,77,17495,10126
hdfs://spark-nn.eemcs.utwente.nl/user/s1934538/clickstream/clickstream-enwiki-2022-02.tsv.gz,Main_Page,81700,146101577,5007992,151191269,35237781
hdfs://spark-nn.eemcs.utwente.nl/user/s1934538/clickstream/clickstream-enwiki-2022-02.tsv.gz,Khabib_Nurmagomedov,53699,249014,2251,304964,168558
hdfs://spark-nn.eemcs.utwente.nl/user/s1934538/clickstream/clickstream-enwiki-2022-02.tsv.gz,Kobe_Bryant_sexual_assault_case,7358,32651,397,40406,3933
hdfs://spark-nn.eemcs.utwente.nl/user/s1934538/clickstream/clickstream-enwiki-2022-02.tsv.gz,Aaron_Carter,19014,50505,346,69865,30428
hdfs://spark-nn.eemcs.utwente.nl/user/s1934538/clickstream/clickstream-enwiki-2022-02.tsv.gz,The_Matrix_Resurrections,95266,275937,7455,378658,172589
hdfs://spark-nn.eemcs.utwente.nl/user/s1934538/clickstream/clickstream-enwiki-2022-02.tsv.gz,Avengers:_Endgame,96642,148494,2588,247724,140088
hdfs://spark-nn.eemcs.utwente.nl/user/s1934538/clickstream/clickstream-enwiki-2022-02.tsv.gz,Afghanistan,167537,287615,8680,463832,314530
hdfs://spark-nn.eemcs.utwente.nl/user/s1934538/clickstream/clickstream-enwiki-2022-02.tsv.gz,Doctor_Strange_in_the_Multiverse_of_Madness,196821,553180,21741,771742,492966
hdfs://spark-nn.eemcs.utwente.nl/user/s1934538/clickstream/clickstream-enwiki-2022-02.tsv.gz,Mulan_(2020_film),18530,43931,800,63261,33677
hdfs://spark-nn.eemcs.utwente.nl/user/s1934538/clickstream/clickstream-enwiki-2022-02.tsv.gz,1234,26,1576,591,2193,640
hdfs://spark-nn.eemcs.utwente.nl/user/s1934538/clickstream/clickstream-enwiki-2022-02.tsv.gz,Freddie_Mercury,73955,455951,8494,538400,209662
hdfs://spark-nn.eemcs.utwente.nl/user/s1934538/clickstream/clickstream-enwiki-2022-02.tsv.gz,United_States_Senate,44657,45595,632,90884,39832
hdfs://spark-nn.eemcs.utwente.nl/user/s1934538/clickstream/clickstream-enwiki-2022-02.tsv.gz,Jurassic_World_Dominion,139054,323762,8599,471415,368763
hdfs://spark-nn.eemcs.utwente.nl/user/s1934538/clickstream/clickstream-enwiki-2022-02.tsv.gz,Joe_Biden,200602,555136,10216,765954,346075
hdfs://spark-nn.eemcs.utwente.nl/user/s1934538/clickstream/clickstream-enwiki-2022-02.tsv.gz,William_Murdoch,604,1247,13,1864,250
hdfs://spark-nn.eemcs.utwente.nl/user/s1934538/clickstream/clickstream-enwiki-2022-02.tsv.gz,Israel,83992,246976,6543,337511,151263
hdfs://spark-nn.eemcs.utwente.nl/user/s1934538/clickstream/clickstream-enwiki-2022-02.tsv.gz,Jeffrey_Dahmer,24561,238173,3499,266233,115872
hdfs://spark-nn.eemcs.utwente.nl/user/s1934538/clickstream/clickstream-enwiki-2022-02.tsv.gz,The_Witcher_(TV_series),40381,386015,8726,435122,248978
hdfs://spark-nn.eemcs.utwente.nl/user/s1934538/clickstream/clickstream-enwiki-2022-02.tsv.gz,List_of_Queen_of_the_South_episodes,8312,5382,184,13878,385
hdfs://spark-nn.eemcs.utwente.nl/user/s1934538/clickstream/clickstream-enwiki-2022-02.tsv.gz,The_Haunting_of_Bly_Manor,19235,40077,438,59750,30632
hdfs://spark-nn.eemcs.utwente.nl/user/s1934538/clickstream/clickstream-enwiki-2022-02.tsv.gz,List_of_FIFA_World_Cup_finals,2958,51515,45,54518,14797
hdfs://spark-nn.eemcs.utwente.nl/user/s1934538/clickstream/clickstream-enwiki-2022-02.tsv.gz,Coronavirus,12779,93491,2892,109162,32118
hdfs://spark-nn.eemcs.utwente.nl/user/s1934538/clickstream/clickstream-enwiki-2022-02.tsv.gz,The_Weeknd,83378,240486,3282,327146,144671
hdfs://spark-nn.eemcs.utwente.nl/user/s1934538/clickstream/clickstream-enwiki-2022-02.tsv.gz,Critical_race_theory,13375,393777,3147,410299,40000
hdfs://spark-nn.eemcs.utwente.nl/user/s1934538/clickstream/clickstream-enwiki-2022-02.tsv.gz,Henry_V_of_England,90367,103740,475,194582,139944
hdfs://spark-nn.eemcs.utwente.nl/user/s1934538/clickstream/clickstream-enwiki-2022-02.tsv.gz,Indian_Premier_League,48443,279460,797,328700,269578
hdfs://spark-nn.eemcs.utwente.nl/user/s1934538/clickstream/clickstream-enwiki-2022-02.tsv.gz,Venom_(2018_film),26796,94714,1337,122847,56483
hdfs://spark-nn.eemcs.utwente.nl/user/s1934538/clickstream/clickstream-enwiki-2022-02.tsv.gz,Stranger_Things_(season_4),35528,257046,1898,294472,139465
hdfs://spark-nn.eemcs.utwente.nl/user/s1934538/clickstream/clickstream-enwiki-2022-02.tsv.gz,Antifa_(United_States),7498,55479,311,63288,10950
hdfs://spark-nn.eemcs.utwente.nl/user/s1934538/clickstream/clickstream-enwiki-2022-02.tsv.gz,Taliban,52328,85513,1455,139296,90300
hdfs://spark-nn.eemcs.utwente.nl/user/s1934538/clickstream/clickstream-enwiki-2022-02.tsv.gz,2020_Summer_Olympics,175158,131409,4065,310632,254976
hdfs://spark-nn.eemcs.utwente.nl/user/s1934538/clickstream/clickstream-enwiki-2022-02.tsv.gz,War_(2019_film),17148,37291,30,54469,14279
hdfs://spark-nn.eemcs.utwente.nl/user/s1934538/clickstream/clickstream-enwiki-2022-02.tsv.gz,The_Flash_(film),84634,65342,1209,151185,112842
hdfs://spark-nn.eemcs.utwente.nl/user/s1934538/clickstream/clickstream-enwiki-2022-02.tsv.gz,Bible,15579,3671098,1981,3688658,29108
hdfs://spark-nn.eemcs.utwente.nl/user/s1934538/clickstream/clickstream-enwiki-2022-02.tsv.gz,Adipurush,36486,25116,2094,63696,45155
hdfs://spark-nn.eemcs.utwente.nl/user/s1934538/clickstream/clickstream-enwiki-2022-02.tsv.gz,Ted_Bundy,36290,333883,4207,374380,83428
hdfs://spark-nn.eemcs.utwente.nl/user/s1934538/clickstream/clickstream-enwiki-2022-02.tsv.gz,Dune_(2021_film),136482,500604,14583,651669,411981
hdfs://spark-nn.eemcs.utwente.nl/user/s1934538/clickstream/clickstream-enwiki-2022-02.tsv.gz,Ponniyin_Selvan:_I,62246,39295,117,101658,92429
hdfs://spark-nn.eemcs.utwente.nl/user/s1934538/clickstream/clickstream-enwiki-2022-02.tsv.gz,Amy_Coney_Barrett,31685,69249,1211,102145,27613
hdfs://spark-nn.eemcs.utwente.nl/user/s1934538/clickstream/clickstream-enwiki-2022-02.tsv.gz,Roe_v._Wade,8908,64122,691,73721,20291
hdfs://spark-nn.eemcs.utwente.nl/user/s1934538/clickstream/clickstream-enwiki-2022-02.tsv.gz,The_Falcon_and_the_Winter_Soldier,30757,59565,995,91317,56406
hdfs://spark-nn.eemcs.utwente.nl/user/s1934538/clickstream/clickstream-enwiki-2022-08.tsv.gz,2018_Asian_Games,39192,23712,194,63098,60844
hdfs://spark-nn.eemcs.utwente.nl/user/s1934538/clickstream/clickstream-enwiki-2022-08.tsv.gz,Ruth_Bader_Ginsburg,15266,63142,351,78759,28977
hdfs://spark-nn.eemcs.utwente.nl/user/s1934538/clickstream/clickstream-enwiki-2022-08.tsv.gz,It_Chapter_Two,34773,62983,554,98310,64773
hdfs://spark-nn.eemcs.utwente.nl/user/s1934538/clickstream/clickstream-enwiki-2022-08.tsv.gz,The_Irishman,45442,82522,1612,129576,113152
hdfs://spark-nn.eemcs.utwente.nl/user/s1934538/clickstream/clickstream-enwiki-2022-08.tsv.gz,Avengers:_Endgame,204483,172936,2611,380030,154515
hdfs://spark-nn.eemcs.utwente.nl/user/s1934538/clickstream/clickstream-enwiki-2022-08.tsv.gz,List_of_Marvel_Cinematic_Universe_films,213324,635291,2908,851523,525643
hdfs://spark-nn.eemcs.utwente.nl/user/s1934538/clickstream/clickstream-enwiki-2022-08.tsv.gz,Priyanka_Chopra,80210,235487,572,316269,115475
hdfs://spark-nn.eemcs.utwente.nl/user/s1934538/clickstream/clickstream-enwiki-2022-08.tsv.gz,Sylvester_Stallone,159327,663966,6880,830173,602672
hdfs://spark-nn.eemcs.utwente.nl/user/s1934538/clickstream/clickstream-enwiki-2022-08.tsv.gz,The_Haunting_of_Bly_Manor,24056,52521,549,77126,39794
hdfs://spark-nn.eemcs.utwente.nl/user/s1934538/clickstream/clickstream-enwiki-2022-08.tsv.gz,Aaron_Hernandez,8208,93844,523,102575,38186
hdfs://spark-nn.eemcs.utwente.nl/user/s1934538/clickstream/clickstream-enwiki-2022-08.tsv.gz,"Prince_Philip,_Duke_of_Edinburgh",155628,145049,1090,301767,178370
hdfs://spark-nn.eemcs.utwente.nl/user/s1934538/clickstream/clickstream-enwiki-2022-08.tsv.gz,Taliban,59806,89950,1234,150990,115766
hdfs://spark-nn.eemcs.utwente.nl/user/s1934538/clickstream/clickstream-enwiki-2022-08.tsv.gz,Pornhub,41152,358886,12536,412574,75297
hdfs://spark-nn.eemcs.utwente.nl/user/s1934538/clickstream/clickstream-enwiki-2022-08.tsv.gz,The_Witcher_(TV_series),26151,164112,3745,194008,108317
hdfs://spark-nn.eemcs.utwente.nl/user/s1934538/clickstream/clickstream-enwiki-2022-08.tsv.gz,Elliot_Page,66812,291242,1396,359450,137456
hdfs://spark-nn.eemcs.utwente.nl/user/s1934538/clickstream/clickstream-enwiki-2022-08.tsv.gz,Carlos_Alcaraz,11112,49083,188,60383,13017
hdfs://spark-nn.eemcs.utwente.nl/user/s1934538/clickstream/clickstream-enwiki-2022-08.tsv.gz,Nipsey_Hussle,21933,132963,884,155780,51216
hdfs://spark-nn.eemcs.utwente.nl/user/s1934538/clickstream/clickstream-enwiki-2022-08.tsv.gz,Tom_Brady,65878,362285,3623,431786,154664
hdfs://spark-nn.eemcs.utwente.nl/user/s1934538/clickstream/clickstream-enwiki-2022-08.tsv.gz,Once_Upon_a_Time_in_Hollywood,110381,155354,2806,268541,272601
hdfs://spark-nn.eemcs.utwente.nl/user/s1934538/clickstream/clickstream-enwiki-2022-08.tsv.gz,Wikipedia,260499,1502523,814,1763836,761904
hdfs://spark-nn.eemcs.utwente.nl/user/s1934538/clickstream/clickstream-enwiki-2022-08.tsv.gz,Everything_Everywhere_All_at_Once,68676,476874,8100,553650,290695
hdfs://spark-nn.eemcs.utwente.nl/user/s1934538/clickstream/clickstream-enwiki-2022-08.tsv.gz,Russo-Ukrainian_War,127914,521520,5821,655255,350645
hdfs://spark-nn.eemcs.utwente.nl/user/s1934538/clickstream/clickstream-enwiki-2022-08.tsv.gz,Chernobyl_disaster,42771,281314,2851,326936,139381
hdfs://spark-nn.eemcs.utwente.nl/user/s1934538/clickstream/clickstream-enwiki-2022-08.tsv.gz,Bird_Box_(film),15391,58795,528,74714,25405
hdfs://spark-nn.eemcs.utwente.nl/user/s1934538/clickstream/clickstream-enwiki-2022-08.tsv.gz,Olivia_Newton-John,337006,5248712,79237,5664955,2639036
hdfs://spark-nn.eemcs.utwente.nl/user/s1934538/clickstream/clickstream-enwiki-2022-08.tsv.gz,The_Weeknd,76378,244480,2222,323080,144481
hdfs://spark-nn.eemcs.utwente.nl/user/s1934538/clickstream/clickstream-enwiki-2022-08.tsv.gz,IPv4,9340,32399,126,41865,8178
hdfs://spark-nn.eemcs.utwente.nl/user/s1934538/clickstream/clickstream-enwiki-2022-08.tsv.gz,Bonnie_and_Clyde,17754,152584,935,171273,47139
hdfs://spark-nn.eemcs.utwente.nl/user/s1934538/clickstream/clickstream-enwiki-2022-08.tsv.gz,Saaho,28362,42044,119,70525,18303
hdfs://spark-nn.eemcs.utwente.nl/user/s1934538/clickstream/clickstream-enwiki-2022-08.tsv.gz,Cricket_World_Cup,12926,82016,285,95227,63898
hdfs://spark-nn.eemcs.utwente.nl/user/s1934538/clickstream/clickstream-enwiki-2022-08.tsv.gz,Joe_Biden,196748,538030,7901,742679,344000
hdfs://spark-nn.eemcs.utwente.nl/user/s1934538/clickstream/clickstream-enwiki-2022-08.tsv.gz,Sushma_Swaraj,12520,30563,62,43145,12719
hdfs://spark-nn.eemcs.utwente.nl/user/s1934538/clickstream/clickstream-enwiki-2022-08.tsv.gz,Doctor_Strange_in_the_Multiverse_of_Madness,137117,373914,7659,518690,304756
hdfs://spark-nn.eemcs.utwente.nl/user/s1934538/clickstream/clickstream-enwiki-2022-08.tsv.gz,COVID-19_pandemic_by_country_and_territory,18600,45215,1389,65204,32374
hdfs://spark-nn.eemcs.utwente.nl/user/s1934538/clickstream/clickstream-enwiki-2022-08.tsv.gz,Jimmy_Hoffa,28681,111617,984,141282,55113
hdfs://spark-nn.eemcs.utwente.nl/user/s1934538/clickstream/clickstream-enwiki-2022-08.tsv.gz,Christopher_Scarver,62156,13968,15,76139,23429
hdfs://spark-nn.eemcs.utwente.nl/user/s1934538/clickstream/clickstream-enwiki-2022-08.tsv.gz,Game_of_Thrones_(season_8),43060,89717,1202,133979,49239
hdfs://spark-nn.eemcs.utwente.nl/user/s1934538/clickstream/clickstream-enwiki-2022-08.tsv.gz,Kylian_Mbappé,40923,263512,2561,306996,61894
hdfs://spark-nn.eemcs.utwente.nl/user/s1934538/clickstream/clickstream-enwiki-2022-08.tsv.gz,Chadwick_Boseman,56726,217986,1157,275869,80699
hdfs://spark-nn.eemcs.utwente.nl/user/s1934538/clickstream/clickstream-enwiki-2022-08.tsv.gz,Joe_Exotic,13205,47069,227,60501,26703
hdfs://spark-nn.eemcs.utwente.nl/user/s1934538/clickstream/clickstream-enwiki-2022-08.tsv.gz,Spider-Man:_No_Way_Home,141867,347538,19067,508472,259532
hdfs://spark-nn.eemcs.utwente.nl/user/s1934538/clickstream/clickstream-enwiki-2022-08.tsv.gz,Avatar:_The_Way_of_Water,90810,167334,2268,260412,120544
hdfs://spark-nn.eemcs.utwente.nl/user/s1934538/clickstream/clickstream-enwiki-2022-08.tsv.gz,Gaza_Strip,24100,85628,637,110365,42640
hdfs://spark-nn.eemcs.utwente.nl/user/s1934538/clickstream/clickstream-enwiki-2022-08.tsv.gz,The_Flash_(film),117840,105469,2193,225502,136324
hdfs://spark-nn.eemcs.utwente.nl/user/s1934538/clickstream/clickstream-enwiki-2022-08.tsv.gz,Tasuku_Honjo,547,33165,10,33722,1410
hdfs://spark-nn.eemcs.utwente.nl/user/s1934538/clickstream/clickstream-enwiki-2022-08.tsv.gz,Lists_of_deaths_by_year,3250,175774,1103,180127,204584
hdfs://spark-nn.eemcs.utwente.nl/user/s1934538/clickstream/clickstream-enwiki-2022-08.tsv.gz,Cardi_B,35599,196224,2018,233841,72205
hdfs://spark-nn.eemcs.utwente.nl/user/s1934538/clickstream/clickstream-enwiki-2022-08.tsv.gz,Indian_Premier_League,15740,54591,195,70526,38539
hdfs://spark-nn.eemcs.utwente.nl/user/s1934538/clickstream/clickstream-enwiki-2022-08.tsv.gz,Jason_Momoa,76165,324693,2766,403624,170370
hdfs://spark-nn.eemcs.utwente.nl/user/s1934538/clickstream/clickstream-enwiki-2022-08.tsv.gz,Vladimir_Putin,128561,339622,5054,473237,269058
hdfs://spark-nn.eemcs.utwente.nl/user/s1934538/clickstream/clickstream-enwiki-2022-08.tsv.gz,Qasem_Soleimani,16275,35342,1556,53173,31490
hdfs://spark-nn.eemcs.utwente.nl/user/s1934538/clickstream/clickstream-enwiki-2022-08.tsv.gz,Freddie_Mercury,83138,490803,3822,577763,222331
hdfs://spark-nn.eemcs.utwente.nl/user/s1934538/clickstream/clickstream-enwiki-2022-08.tsv.gz,RRR_(film),85894,729026,5132,820052,418245
hdfs://spark-nn.eemcs.utwente.nl/user/s1934538/clickstream/clickstream-enwiki-2022-08.tsv.gz,Ted_Bundy,33885,308053,3931,345869,96036
hdfs://spark-nn.eemcs.utwente.nl/user/s1934538/clickstream/clickstream-enwiki-2022-08.tsv.gz,Naomi_Osaka,22564,139496,933,162993,38590
hdfs://spark-nn.eemcs.utwente.nl/user/s1934538/clickstream/clickstream-enwiki-2022-08.tsv.gz,Amber_Heard,69176,292564,2366,364106,143069
hdfs://spark-nn.eemcs.utwente.nl/user/s1934538/clickstream/clickstream-enwiki-2022-08.tsv.gz,Volodymyr_Zelenskyy,83571,152899,3627,240097,119841
hdfs://spark-nn.eemcs.utwente.nl/user/s1934538/clickstream/clickstream-enwiki-2022-08.tsv.gz,The_Shape_of_Water,21025,42702,439,64166,29087
hdfs://spark-nn.eemcs.utwente.nl/user/s1934538/clickstream/clickstream-enwiki-2022-08.tsv.gz,Shang-Chi_and_the_Legend_of_the_Ten_Rings,78615,122361,1701,202677,111909
hdfs://spark-nn.eemcs.utwente.nl/user/s1934538/clickstream/clickstream-enwiki-2022-08.tsv.gz,When_They_See_Us,8894,21898,101,30893,14579
hdfs://spark-nn.eemcs.utwente.nl/user/s1934538/clickstream/clickstream-enwiki-2022-08.tsv.gz,2.0_(film),37117,38480,66,75663,18981
hdfs://spark-nn.eemcs.utwente.nl/user/s1934538/clickstream/clickstream-enwiki-2022-08.tsv.gz,Stranger_Things,163954,969580,17621,1151155,1033349
hdfs://spark-nn.eemcs.utwente.nl/user/s1934538/clickstream/clickstream-enwiki-2022-08.tsv.gz,Oppenheimer_(film),150804,174851,2498,328153,305934
hdfs://spark-nn.eemcs.utwente.nl/user/s1934538/clickstream/clickstream-enwiki-2022-08.tsv.gz,Sridevi,42996,99090,279,142365,68105
hdfs://spark-nn.eemcs.utwente.nl/user/s1934538/clickstream/clickstream-enwiki-2022-08.tsv.gz,Naya_Rivera,63201,74857,351,138409,57650
hdfs://spark-nn.eemcs.utwente.nl/user/s1934538/clickstream/clickstream-enwiki-2022-08.tsv.gz,Central_Park_jogger_case,10439,34126,151,44716,6716
hdfs://spark-nn.eemcs.utwente.nl/user/s1934538/clickstream/clickstream-enwiki-2022-08.tsv.gz,Media,19,2066,204,2289,1041
hdfs://spark-nn.eemcs.utwente.nl/user/s1934538/clickstream/clickstream-enwiki-2022-08.tsv.gz,Ray_Liotta,71101,435115,3578,509794,97354
hdfs://spark-nn.eemcs.utwente.nl/user/s1934538/clickstream/clickstream-enwiki-2022-08.tsv.gz,Mission:_Impossible_–_Dead_Reckoning_Part_One,91560,47363,533,139456,120413
hdfs://spark-nn.eemcs.utwente.nl/user/s1934538/clickstream/clickstream-enwiki-2022-08.tsv.gz,Jeffrey_Epstein,52067,225806,1865,279738,136559
hdfs://spark-nn.eemcs.utwente.nl/user/s1934538/clickstream/clickstream-enwiki-2022-08.tsv.gz,2018_Winter_Olympics,9529,6783,96,16408,11335
hdfs://spark-nn.eemcs.utwente.nl/user/s1934538/clickstream/clickstream-enwiki-2022-08.tsv.gz,Jawan_(film),72874,2300,197,75371,66136
hdfs://spark-nn.eemcs.utwente.nl/user/s1934538/clickstream/clickstream-enwiki-2022-08.tsv.gz,Microsoft_Office,6901,2039149,661,2046711,17425
hdfs://spark-nn.eemcs.utwente.nl/user/s1934538/clickstream/clickstream-enwiki-2022-08.tsv.gz,John_Wick:_Chapter_4,71722,80038,1543,153303,95442
hdfs://spark-nn.eemcs.utwente.nl/user/s1934538/clickstream/clickstream-enwiki-2022-08.tsv.gz,Matthew_Perry,41609,124533,4021,170163,103557
hdfs://spark-nn.eemcs.utwente.nl/user/s1934538/clickstream/clickstream-enwiki-2022-08.tsv.gz,FIFA_World_Cup,55240,232605,3919,291764,237929
hdfs://spark-nn.eemcs.utwente.nl/user/s1934538/clickstream/clickstream-enwiki-2022-08.tsv.gz,Watts_family_murders,10040,232556,319,242915,62450
hdfs://spark-nn.eemcs.utwente.nl/user/s1934538/clickstream/clickstream-enwiki-2022-08.tsv.gz,Laal_Singh_Chaddha,156301,4473220,41706,4671227,1373978
hdfs://spark-nn.eemcs.utwente.nl/user/s1934538/clickstream/clickstream-enwiki-2022-08.tsv.gz,Hamilton_(musical),28187,155956,1735,185878,119466
hdfs://spark-nn.eemcs.utwente.nl/user/s1934538/clickstream/clickstream-enwiki-2022-08.tsv.gz,Richard_Jewell,11550,52597,278,64425,22667
hdfs://spark-nn.eemcs.utwente.nl/user/s1934538/clickstream/clickstream-enwiki-2022-08.tsv.gz,Hyphen-minus,833,7011178,20126,7032137,813
hdfs://spark-nn.eemcs.utwente.nl/user/s1934538/clickstream/clickstream-enwiki-2022-08.tsv.gz,Puneeth_Rajkumar,17863,63541,562,81966,34094
hdfs://spark-nn.eemcs.utwente.nl/user/s1934538/clickstream/clickstream-enwiki-2022-08.tsv.gz,Jimmy_Buffett,10355,67066,750,78171,29217
hdfs://spark-nn.eemcs.utwente.nl/user/s1934538/clickstream/clickstream-enwiki-2022-08.tsv.gz,Fantastic_Beasts:_The_Crimes_of_Grindelwald,53961,59664,827,114452,59346
hdfs://spark-nn.eemcs.utwente.nl/user/s1934538/clickstream/clickstream-enwiki-2022-08.tsv.gz,Area_51,18920,125621,997,145538,50423
hdfs://spark-nn.eemcs.utwente.nl/user/s1934538/clickstream/clickstream-enwiki-2022-08.tsv.gz,The_Kashmir_Files,34905,136398,962,172265,70853
hdfs://spark-nn.eemcs.utwente.nl/user/s1934538/clickstream/clickstream-enwiki-2022-08.tsv.gz,ICC_Men's_T20_World_Cup,16725,122565,672,139962,86359
hdfs://spark-nn.eemcs.utwente.nl/user/s1934538/clickstream/clickstream-enwiki-2022-08.tsv.gz,Greta_Thunberg,10142,102672,1060,113874,26453
hdfs://spark-nn.eemcs.utwente.nl/user/s1934538/clickstream/clickstream-enwiki-2022-08.tsv.gz,"Meghan,_Duchess_of_Sussex",74696,265908,1890,342494,175366
hdfs://spark-nn.eemcs.utwente.nl/user/s1934538/clickstream/clickstream-enwiki-2022-08.tsv.gz,NATO,65978,218577,6899,291454,132545
hdfs://spark-nn.eemcs.utwente.nl/user/s1934538/clickstream/clickstream-enwiki-2022-08.tsv.gz,Hamas,34506,37862,289,72657,37063
hdfs://spark-nn.eemcs.utwente.nl/user/s1934538/clickstream/clickstream-enwiki-2022-08.tsv.gz,Burt_Reynolds,57433,160238,2228,219899,106493
hdfs://spark-nn.eemcs.utwente.nl/user/s1934538/clickstream/clickstream-enwiki-2022-08.tsv.gz,Joaquin_Phoenix,134449,169737,1607,305793,196993
hdfs://spark-nn.eemcs.utwente.nl/user/s1934538/clickstream/clickstream-enwiki-2022-08.tsv.gz,The_Lion_King_(2019_film),42029,44968,484,87481,45282
hdfs://spark-nn.eemcs.utwente.nl/user/s1934538/clickstream/clickstream-enwiki-2022-08.tsv.gz,Louis_Tomlinson,42341,58802,246,101389,29119
hdfs://spark-nn.eemcs.utwente.nl/user/s1934538/clickstream/clickstream-enwiki-2022-08.tsv.gz,Brahmāstra:_Part_One_–_Shiva,106538,445714,1909,554161,198482
hdfs://spark-nn.eemcs.utwente.nl/user/s1934538/clickstream/clickstream-enwiki-2022-08.tsv.gz,Anthony_Bourdain,23296,203785,1666,228747,80756
hdfs://spark-nn.eemcs.utwente.nl/user/s1934538/clickstream/clickstream-enwiki-2022-08.tsv.gz,The_Matrix_Resurrections,62563,81184,1368,145115,69764
hdfs://spark-nn.eemcs.utwente.nl/user/s1934538/clickstream/clickstream-enwiki-2022-08.tsv.gz,Ghislaine_Maxwell,44615,154789,762,200166,72849
hdfs://spark-nn.eemcs.utwente.nl/user/s1934538/clickstream/clickstream-enwiki-2022-08.tsv.gz,Charles_Sobhraj,11363,42108,88,53559,10157
hdfs://spark-nn.eemcs.utwente.nl/user/s1934538/clickstream/clickstream-enwiki-2022-08.tsv.gz,Kamala_Harris,76018,133223,1213,210454,95752
hdfs://spark-nn.eemcs.utwente.nl/user/s1934538/clickstream/clickstream-enwiki-2022-08.tsv.gz,1234,71,1703,27,1801,252
hdfs://spark-nn.eemcs.utwente.nl/user/s1934538/clickstream/clickstream-enwiki-2022-08.tsv.gz,The_Nun_(2018_film),18875,49550,583,69008,39263
hdfs://spark-nn.eemcs.utwente.nl/user/s1934538/clickstream/clickstream-enwiki-2022-08.tsv.gz,Stan_Lee,47454,174977,889,223320,54499
hdfs://spark-nn.eemcs.utwente.nl/user/s1934538/clickstream/clickstream-enwiki-2022-08.tsv.gz,Key_frame,528,3754,11,4293,368
hdfs://spark-nn.eemcs.utwente.nl/user/s1934538/clickstream/clickstream-enwiki-2022-08.tsv.gz,QAnon,44922,183991,1194,230107,67610
hdfs://spark-nn.eemcs.utwente.nl/user/s1934538/clickstream/clickstream-enwiki-2022-08.tsv.gz,Croatia,52211,206108,2361,260680,85244
hdfs://spark-nn.eemcs.utwente.nl/user/s1934538/clickstream/clickstream-enwiki-2022-08.tsv.gz,Coronavirus,6085,36797,1096,43978,13851
hdfs://spark-nn.eemcs.utwente.nl/user/s1934538/clickstream/clickstream-enwiki-2022-08.tsv.gz,2023_Cricket_World_Cup,26596,78649,137,105382,34168
hdfs://spark-nn.eemcs.utwente.nl/user/s1934538/clickstream/clickstream-enwiki-2022-08.tsv.gz,Brie_Larson,63518,132108,1136,196762,77206
hdfs://spark-nn.eemcs.utwente.nl/user/s1934538/clickstream/clickstream-enwiki-2022-08.tsv.gz,"Princess_Margaret,_Countess_of_Snowdon",80335,157255,996,238586,140023
hdfs://spark-nn.eemcs.utwente.nl/user/s1934538/clickstream/clickstream-enwiki-2022-08.tsv.gz,The_Batman_(film),100709,332584,6829,440122,237887
hdfs://spark-nn.eemcs.utwente.nl/user/s1934538/clickstream/clickstream-enwiki-2022-08.tsv.gz,Valentine's_Day,2780,33428,149,36357,2807
hdfs://spark-nn.eemcs.utwente.nl/user/s1934538/clickstream/clickstream-enwiki-2022-08.tsv.gz,Johnny_Depp,113914,357557,3463,474934,244185
hdfs://spark-nn.eemcs.utwente.nl/user/s1934538/clickstream/clickstream-enwiki-2022-08.tsv.gz,Henry_V_of_England,72957,70502,318,143777,102636
hdfs://spark-nn.eemcs.utwente.nl/user/s1934538/clickstream/clickstream-enwiki-2022-08.tsv.gz,Black_Panther_(film),48712,121177,2051,171940,100105
hdfs://spark-nn.eemcs.utwente.nl/user/s1934538/clickstream/clickstream-enwiki-2022-08.tsv.gz,Deaths_in_2022,1522904,2603888,18796,4145588,2499651
hdfs://spark-nn.eemcs.utwente.nl/user/s1934538/clickstream/clickstream-enwiki-2022-08.tsv.gz,Squid_Game,21274,181785,3122,206181,92759
hdfs://spark-nn.eemcs.utwente.nl/user/s1934538/clickstream/clickstream-enwiki-2022-08.tsv.gz,Bible,17480,1529528,2250,1549258,30305
hdfs://spark-nn.eemcs.utwente.nl/user/s1934538/clickstream/clickstream-enwiki-2022-08.tsv.gz,Avicii,19447,204193,1342,224982,62772
hdfs://spark-nn.eemcs.utwente.nl/user/s1934538/clickstream/clickstream-enwiki-2022-08.tsv.gz,Emma_Raducanu,25994,257420,1421,284835,53946
hdfs://spark-nn.eemcs.utwente.nl/user/s1934538/clickstream/clickstream-enwiki-2022-08.tsv.gz,Cristiano_Ronaldo,122947,935115,4459,1062521,212643
hdfs://spark-nn.eemcs.utwente.nl/user/s1934538/clickstream/clickstream-enwiki-2022-08.tsv.gz,Murder_of_Dee_Dee_Blanchard,18842,106001,350,125193,29029
hdfs://spark-nn.eemcs.utwente.nl/user/s1934538/clickstream/clickstream-enwiki-2022-08.tsv.gz,Eternals_(film),80499,178531,3224,262254,217779
hdfs://spark-nn.eemcs.utwente.nl/user/s1934538/clickstream/clickstream-enwiki-2022-08.tsv.gz,XXXTentacion,67736,840675,5969,914380,110942
hdfs://spark-nn.eemcs.utwente.nl/user/s1934538/clickstream/clickstream-enwiki-2022-08.tsv.gz,United_States_Electoral_College,12477,31582,83,44142,7818
hdfs://spark-nn.eemcs.utwente.nl/user/s1934538/clickstream/clickstream-enwiki-2022-08.tsv.gz,Cleopatra,62282,4854778,2712,4919772,442426
hdfs://spark-nn.eemcs.utwente.nl/user/s1934538/clickstream/clickstream-enwiki-2022-08.tsv.gz,Kenosha_unrest_shooting,11137,32469,95,43701,8872
hdfs://spark-nn.eemcs.utwente.nl/user/s1934538/clickstream/clickstream-enwiki-2022-08.tsv.gz,Guardians_of_the_Galaxy_Vol._3,92014,51356,651,144021,120489
hdfs://spark-nn.eemcs.utwente.nl/user/s1934538/clickstream/clickstream-enwiki-2022-08.tsv.gz,Vikram_(2022_film),90785,506807,3051,600643,283471
hdfs://spark-nn.eemcs.utwente.nl/user/s1934538/clickstream/clickstream-enwiki-2022-08.tsv.gz,State_of_Palestine,56178,129961,214,186353,92200
hdfs://spark-nn.eemcs.utwente.nl/user/s1934538/clickstream/clickstream-enwiki-2022-08.tsv.gz,Spider-Man:_Across_the_Spider-Verse,59457,48159,513,108129,53521
hdfs://spark-nn.eemcs.utwente.nl/user/s1934538/clickstream/clickstream-enwiki-2022-08.tsv.gz,George_H._W._Bush,149921,108719,876,259516,162046
hdfs://spark-nn.eemcs.utwente.nl/user/s1934538/clickstream/clickstream-enwiki-2022-08.tsv.gz,Godzilla_vs._Kong,45422,78114,1099,124635,71461
hdfs://spark-nn.eemcs.utwente.nl/user/s1934538/clickstream/clickstream-enwiki-2022-08.tsv.gz,No_Time_to_Die,108062,210854,3310,322226,196379
hdfs://spark-nn.eemcs.utwente.nl/user/s1934538/clickstream/clickstream-enwiki-2022-08.tsv.gz,Black_Panther:_Wakanda_Forever,133813,213270,4139,351222,280307
hdfs://spark-nn.eemcs.utwente.nl/user/s1934538/clickstream/clickstream-enwiki-2022-08.tsv.gz,Death_of_Elisa_Lam,16588,106092,209,122889,33429
hdfs://spark-nn.eemcs.utwente.nl/user/s1934538/clickstream/clickstream-enwiki-2022-08.tsv.gz,Ukraine,102485,400865,11067,514417,239061
hdfs://spark-nn.eemcs.utwente.nl/user/s1934538/clickstream/clickstream-enwiki-2022-08.tsv.gz,Fyre_Festival,15850,108312,1281,125443,69935
hdfs://spark-nn.eemcs.utwente.nl/user/s1934538/clickstream/clickstream-enwiki-2022-08.tsv.gz,Meat_Loaf,23192,106890,1288,131370,44486
hdfs://spark-nn.eemcs.utwente.nl/user/s1934538/clickstream/clickstream-enwiki-2022-08.tsv.gz,Vivek_Ramaswamy,346,13700,30,14076,2012
hdfs://spark-nn.eemcs.utwente.nl/user/s1934538/clickstream/clickstream-enwiki-2022-08.tsv.gz,The_Queen's_Gambit_(miniseries),19844,77581,665,98090,50126
hdfs://spark-nn.eemcs.utwente.nl/user/s1934538/clickstream/clickstream-enwiki-2022-08.tsv.gz,Tina_Turner,22236,181077,1644,204957,64894
hdfs://spark-nn.eemcs.utwente.nl/user/s1934538/clickstream/clickstream-enwiki-2022-08.tsv.gz,Barbie_(film),89354,59823,658,149835,112553
hdfs://spark-nn.eemcs.utwente.nl/user/s1934538/clickstream/clickstream-enwiki-2022-08.tsv.gz,The_Umbrella_Academy_(TV_series),46289,330295,7753,384337,271039
hdfs://spark-nn.eemcs.utwente.nl/user/s1934538/clickstream/clickstream-enwiki-2022-08.tsv.gz,2022_Russian_invasion_of_Ukraine,814567,1031688,5895,1852150,982212
hdfs://spark-nn.eemcs.utwente.nl/user/s1934538/clickstream/clickstream-enwiki-2022-08.tsv.gz,Jeffrey_Dahmer,35083,332711,3236,371030,176601
hdfs://spark-nn.eemcs.utwente.nl/user/s1934538/clickstream/clickstream-enwiki-2022-08.tsv.gz,Royal_Rumble_(2018),6321,4546,45,10912,7910
hdfs://spark-nn.eemcs.utwente.nl/user/s1934538/clickstream/clickstream-enwiki-2022-08.tsv.gz,William_Murdoch,803,1302,18,2123,422
hdfs://spark-nn.eemcs.utwente.nl/user/s1934538/clickstream/clickstream-enwiki-2022-08.tsv.gz,XXX:_Return_of_Xander_Cage,70441,572781,1017,644239,81881
hdfs://spark-nn.eemcs.utwente.nl/user/s1934538/clickstream/clickstream-enwiki-2022-08.tsv.gz,Tunnel,3957,7213,117,11287,3293
hdfs://spark-nn.eemcs.utwente.nl/user/s1934538/clickstream/clickstream-enwiki-2022-08.tsv.gz,COVID-19_pandemic,89289,200582,60841,350712,131609
hdfs://spark-nn.eemcs.utwente.nl/user/s1934538/clickstream/clickstream-enwiki-2022-08.tsv.gz,J._Robert_Oppenheimer,76801,255772,543,333116,116722
hdfs://spark-nn.eemcs.utwente.nl/user/s1934538/clickstream/clickstream-enwiki-2022-08.tsv.gz,House_of_the_Dragon,396149,3356053,82509,3834711,3643942
hdfs://spark-nn.eemcs.utwente.nl/user/s1934538/clickstream/clickstream-enwiki-2022-08.tsv.gz,JSON_Web_Token,782,25475,30,26287,2092
hdfs://spark-nn.eemcs.utwente.nl/user/s1934538/clickstream/clickstream-enwiki-2022-08.tsv.gz,Leave_the_World_Behind_(film),12512,3891,10,16413,6559
hdfs://spark-nn.eemcs.utwente.nl/user/s1934538/clickstream/clickstream-enwiki-2022-08.tsv.gz,Kate_Spade,23090,45380,246,68716,24229
hdfs://spark-nn.eemcs.utwente.nl/user/s1934538/clickstream/clickstream-enwiki-2022-08.tsv.gz,Salman_Rushdie,240388,3786313,173625,4200326,2092731
hdfs://spark-nn.eemcs.utwente.nl/user/s1934538/clickstream/clickstream-enwiki-2022-11.tsv.gz,It_Chapter_Two,31100,52772,500,84372,50525
hdfs://spark-nn.eemcs.utwente.nl/user/s1934538/clickstream/clickstream-enwiki-2022-11.tsv.gz,Croatia,61237,302497,3657,367391,102073
hdfs://spark-nn.eemcs.utwente.nl/user/s1934538/clickstream/clickstream-enwiki-2022-11.tsv.gz,Cristiano_Ronaldo,296125,3475201,17311,3788637,777229
hdfs://spark-nn.eemcs.utwente.nl/user/s1934538/clickstream/clickstream-enwiki-2022-11.tsv.gz,Khabib_Nurmagomedov,69418,269062,1861,340341,181846
hdfs://spark-nn.eemcs.utwente.nl/user/s1934538/clickstream/clickstream-enwiki-2022-11.tsv.gz,Saaho,16746,32730,78,49554,13425
hdfs://spark-nn.eemcs.utwente.nl/user/s1934538/clickstream/clickstream-enwiki-2022-11.tsv.gz,2022_FIFA_World_Cup,2851736,17057178,54426,19963340,6262209
hdfs://spark-nn.eemcs.utwente.nl/user/s1934538/clickstream/clickstream-enwiki-2022-11.tsv.gz,The_Kashmir_Files,23245,84171,739,108155,41920
hdfs://spark-nn.eemcs.utwente.nl/user/s1934538/clickstream/clickstream-enwiki-2022-11.tsv.gz,"Citizenship_(Amendment)_Act,_2019",2561,27481,13,30055,2927
hdfs://spark-nn.eemcs.utwente.nl/user/s1934538/clickstream/clickstream-enwiki-2022-11.tsv.gz,Adele,38797,244523,29646,312966,133137
hdfs://spark-nn.eemcs.utwente.nl/user/s1934538/clickstream/clickstream-enwiki-2022-11.tsv.gz,Black_Adam_(film),218354,2006729,48244,2273327,895672
hdfs://spark-nn.eemcs.utwente.nl/user/s1934538/clickstream/clickstream-enwiki-2022-11.tsv.gz,Ant-Man_and_the_Wasp:_Quantumania,105721,109878,2170,217769,133554
hdfs://spark-nn.eemcs.utwente.nl/user/s1934538/clickstream/clickstream-enwiki-2022-11.tsv.gz,Google_logo,1469,20292,19,21780,1422
hdfs://spark-nn.eemcs.utwente.nl/user/s1934538/clickstream/clickstream-enwiki-2022-11.tsv.gz,Chernobyl_disaster,36816,260085,2177,299078,118429
hdfs://spark-nn.eemcs.utwente.nl/user/s1934538/clickstream/clickstream-enwiki-2022-11.tsv.gz,Key_frame,850,3815,15,4680,364
hdfs://spark-nn.eemcs.utwente.nl/user/s1934538/clickstream/clickstream-enwiki-2022-11.tsv.gz,Thor:_Love_and_Thunder,107934,314842,5407,428183,213199
hdfs://spark-nn.eemcs.utwente.nl/user/s1934538/clickstream/clickstream-enwiki-2022-11.tsv.gz,Everything_Everywhere_All_at_Once,51276,294555,5610,351441,170137
hdfs://spark-nn.eemcs.utwente.nl/user/s1934538/clickstream/clickstream-enwiki-2022-11.tsv.gz,Salman_Rushdie,21509,72468,736,94713,40859
hdfs://spark-nn.eemcs.utwente.nl/user/s1934538/clickstream/clickstream-enwiki-2022-11.tsv.gz,Greta_Thunberg,12488,226137,2228,240853,54480
hdfs://spark-nn.eemcs.utwente.nl/user/s1934538/clickstream/clickstream-enwiki-2022-11.tsv.gz,Shang-Chi_and_the_Legend_of_the_Ten_Rings,53964,102509,1145,157618,79968
hdfs://spark-nn.eemcs.utwente.nl/user/s1934538/clickstream/clickstream-enwiki-2022-11.tsv.gz,The_Nun_(2018_film),20490,59696,325,80511,39717
hdfs://spark-nn.eemcs.utwente.nl/user/s1934538/clickstream/clickstream-enwiki-2022-11.tsv.gz,Dune_(2021_film),54815,173937,3563,232315,150867
hdfs://spark-nn.eemcs.utwente.nl/user/s1934538/clickstream/clickstream-enwiki-2022-11.tsv.gz,Cameron_Boyce,21412,127843,527,149782,37427
hdfs://spark-nn.eemcs.utwente.nl/user/s1934538/clickstream/clickstream-enwiki-2022-11.tsv.gz,List_of_awards_and_nominations_received_by_Meryl_Streep,5178,7134,12,12324,4761
hdfs://spark-nn.eemcs.utwente.nl/user/s1934538/clickstream/clickstream-enwiki-2022-11.tsv.gz,HTTP_cookie,1978,270216,793,272987,44946
hdfs://spark-nn.eemcs.utwente.nl/user/s1934538/clickstream/clickstream-enwiki-2022-11.tsv.gz,Bridgerton,35482,113902,1934,151318,104744
hdfs://spark-nn.eemcs.utwente.nl/user/s1934538/clickstream/clickstream-enwiki-2022-11.tsv.gz,Main_Page,73627,136504978,5198921,141777526,33622591
hdfs://spark-nn.eemcs.utwente.nl/user/s1934538/clickstream/clickstream-enwiki-2022-11.tsv.gz,Priyanka_Chopra,92689,274919,559,368167,112181
hdfs://spark-nn.eemcs.utwente.nl/user/s1934538/clickstream/clickstream-enwiki-2022-11.tsv.gz,Atal_Bihari_Vajpayee,24598,45816,36,70450,21419
hdfs://spark-nn.eemcs.utwente.nl/user/s1934538/clickstream/clickstream-enwiki-2022-11.tsv.gz,Deadpool_2,92425,65559,1668,159652,93133
hdfs://spark-nn.eemcs.utwente.nl/user/s1934538/clickstream/clickstream-enwiki-2022-11.tsv.gz,Simone_Biles,13754,57088,667,71509,23900
hdfs://spark-nn.eemcs.utwente.nl/user/s1934538/clickstream/clickstream-enwiki-2022-11.tsv.gz,Aaron_Hernandez,11606,130543,811,142960,49356
hdfs://spark-nn.eemcs.utwente.nl/user/s1934538/clickstream/clickstream-enwiki-2022-11.tsv.gz,Godzilla_vs._Kong,43654,75708,1153,120515,67609
hdfs://spark-nn.eemcs.utwente.nl/user/s1934538/clickstream/clickstream-enwiki-2022-11.tsv.gz,Bob_Saget,25114,106003,1059,132176,27744
hdfs://spark-nn.eemcs.utwente.nl/user/s1934538/clickstream/clickstream-enwiki-2022-11.tsv.gz,Vikram_(2022_film),56909,204790,977,262676,98511
hdfs://spark-nn.eemcs.utwente.nl/user/s1934538/clickstream/clickstream-enwiki-2022-11.tsv.gz,Kylian_Mbappé,153408,1084112,6770,1244290,302637
hdfs://spark-nn.eemcs.utwente.nl/user/s1934538/clickstream/clickstream-enwiki-2022-11.tsv.gz,List_of_James_Bond_films,65366,368604,1858,435828,247141
hdfs://spark-nn.eemcs.utwente.nl/user/s1934538/clickstream/clickstream-enwiki-2022-11.tsv.gz,Stranger_Things,79409,319564,6905,405878,317648
hdfs://spark-nn.eemcs.utwente.nl/user/s1934538/clickstream/clickstream-enwiki-2022-11.tsv.gz,Pornhub,42308,386779,12329,441416,78203
hdfs://spark-nn.eemcs.utwente.nl/user/s1934538/clickstream/clickstream-enwiki-2022-11.tsv.gz,IPv4,11320,46530,118,57968,9858
hdfs://spark-nn.eemcs.utwente.nl/user/s1934538/clickstream/clickstream-enwiki-2022-11.tsv.gz,Bible,19235,957987,1855,979077,32907
hdfs://spark-nn.eemcs.utwente.nl/user/s1934538/clickstream/clickstream-enwiki-2022-11.tsv.gz,The_Queen's_Gambit_(miniseries),30106,93053,821,123980,57827
hdfs://spark-nn.eemcs.utwente.nl/user/s1934538/clickstream/clickstream-enwiki-2022-11.tsv.gz,Grover,1343,5359,64,6766,1313
hdfs://spark-nn.eemcs.utwente.nl/user/s1934538/clickstream/clickstream-enwiki-2022-11.tsv.gz,Amy_Coney_Barrett,26818,32917,224,59959,19380
hdfs://spark-nn.eemcs.utwente.nl/user/s1934538/clickstream/clickstream-enwiki-2022-11.tsv.gz,J._Robert_Oppenheimer,51089,144866,384,196339,67288
hdfs://spark-nn.eemcs.utwente.nl/user/s1934538/clickstream/clickstream-enwiki-2022-11.tsv.gz,List_of_Queen_of_the_South_episodes,3721,3105,104,6930,149
hdfs://spark-nn.eemcs.utwente.nl/user/s1934538/clickstream/clickstream-enwiki-2022-11.tsv.gz,Microsoft_Office,7279,460580,572,468431,18397
hdfs://spark-nn.eemcs.utwente.nl/user/s1934538/clickstream/clickstream-enwiki-2022-11.tsv.gz,Ukraine,109645,425551,17161,552357,253219
hdfs://spark-nn.eemcs.utwente.nl/user/s1934538/clickstream/clickstream-enwiki-2022-11.tsv.gz,Michael_Bloomberg,38227,39070,263,77560,35128
hdfs://spark-nn.eemcs.utwente.nl/user/s1934538/clickstream/clickstream-enwiki-2022-11.tsv.gz,Nipsey_Hussle,24274,82131,950,107355,34112
hdfs://spark-nn.eemcs.utwente.nl/user/s1934538/clickstream/clickstream-enwiki-2022-11.tsv.gz,Watts_family_murders,6277,132395,253,138925,34234
hdfs://spark-nn.eemcs.utwente.nl/user/s1934538/clickstream/clickstream-enwiki-2022-11.tsv.gz,Jurassic_World_Dominion,74045,149884,3264,227193,141117
hdfs://spark-nn.eemcs.utwente.nl/user/s1934538/clickstream/clickstream-enwiki-2022-11.tsv.gz,Shinzo_Abe,44545,72548,1309,118402,76748
hdfs://spark-nn.eemcs.utwente.nl/user/s1934538/clickstream/clickstream-enwiki-2022-11.tsv.gz,Betty_White,31134,94355,1200,126689,32697
hdfs://spark-nn.eemcs.utwente.nl/user/s1934538/clickstream/clickstream-enwiki-2022-11.tsv.gz,Lists_of_deaths_by_year,2400,140239,705,143344,155917
hdfs://spark-nn.eemcs.utwente.nl/user/s1934538/clickstream/clickstream-enwiki-2022-11.tsv.gz,Hyphen-minus,939,10378655,21374,10400968,811
hdfs://spark-nn.eemcs.utwente.nl/user/s1934538/clickstream/clickstream-enwiki-2022-11.tsv.gz,The_Last_of_Us_(TV_series),39729,97776,1485,138990,93068
hdfs://spark-nn.eemcs.utwente.nl/user/s1934538/clickstream/clickstream-enwiki-2022-11.tsv.gz,Juneteenth,5638,34648,209,40495,4180
hdfs://spark-nn.eemcs.utwente.nl/user/s1934538/clickstream/clickstream-enwiki-2022-11.tsv.gz,Juice_Wrld,36821,204661,2795,244277,93316
hdfs://spark-nn.eemcs.utwente.nl/user/s1934538/clickstream/clickstream-enwiki-2022-11.tsv.gz,Rihanna,79149,323034,4310,406493,224930
hdfs://spark-nn.eemcs.utwente.nl/user/s1934538/clickstream/clickstream-enwiki-2022-11.tsv.gz,Richard_Jewell,7917,60977,372,69266,28029
hdfs://spark-nn.eemcs.utwente.nl/user/s1934538/clickstream/clickstream-enwiki-2022-11.tsv.gz,Christopher_Scarver,339391,216879,98,556368,154122
hdfs://spark-nn.eemcs.utwente.nl/user/s1934538/clickstream/clickstream-enwiki-2022-11.tsv.gz,Murder_of_Dee_Dee_Blanchard,10733,73920,248,84901,17521
hdfs://spark-nn.eemcs.utwente.nl/user/s1934538/clickstream/clickstream-enwiki-2022-11.tsv.gz,The_Shape_of_Water,33960,52464,488,86912,36750
hdfs://spark-nn.eemcs.utwente.nl/user/s1934538/clickstream/clickstream-enwiki-2022-11.tsv.gz,Doctor_Strange_in_the_Multiverse_of_Madness,92646,172531,2815,267992,131580
hdfs://spark-nn.eemcs.utwente.nl/user/s1934538/clickstream/clickstream-enwiki-2022-11.tsv.gz,Spider-Man:_Across_the_Spider-Verse,61802,74660,983,137445,71742
hdfs://spark-nn.eemcs.utwente.nl/user/s1934538/clickstream/clickstream-enwiki-2022-11.tsv.gz,Tonya_Harding,20895,89167,523,110585,30299
hdfs://spark-nn.eemcs.utwente.nl/user/s1934538/clickstream/clickstream-enwiki-2022-11.tsv.gz,The_Witcher_(TV_series),49918,235059,4830,289807,158574
hdfs://spark-nn.eemcs.utwente.nl/user/s1934538/clickstream/clickstream-enwiki-2022-11.tsv.gz,The_Flash_(film),62326,55940,675,118941,66486
hdfs://spark-nn.eemcs.utwente.nl/user/s1934538/clickstream/clickstream-enwiki-2022-11.tsv.gz,Meat_Loaf,23565,116135,1111,140811,47300
hdfs://spark-nn.eemcs.utwente.nl/user/s1934538/clickstream/clickstream-enwiki-2022-11.tsv.gz,List_of_FIFA_World_Cup_finals,73640,2097529,1364,2172533,457581
hdfs://spark-nn.eemcs.utwente.nl/user/s1934538/clickstream/clickstream-enwiki-2022-11.tsv.gz,WrestleMania_34,11593,5704,46,17343,11741
hdfs://spark-nn.eemcs.utwente.nl/user/s1934538/clickstream/clickstream-enwiki-2022-11.tsv.gz,Wikipedia,245958,1393232,1265,1640455,734746
hdfs://spark-nn.eemcs.utwente.nl/user/s1934538/clickstream/clickstream-enwiki-2022-11.tsv.gz,Chadwick_Boseman,218965,1336351,4849,1560165,382251
hdfs://spark-nn.eemcs.utwente.nl/user/s1934538/clickstream/clickstream-enwiki-2022-11.tsv.gz,XNXX,21018,1409622,7885,1438525,114264
hdfs://spark-nn.eemcs.utwente.nl/user/s1934538/clickstream/clickstream-enwiki-2022-11.tsv.gz,Sinéad_O'Connor,17497,171883,1540,190920,60426
hdfs://spark-nn.eemcs.utwente.nl/user/s1934538/clickstream/clickstream-enwiki-2022-11.tsv.gz,John_McCain,53523,99615,1838,154976,89070
hdfs://spark-nn.eemcs.utwente.nl/user/s1934538/clickstream/clickstream-enwiki-2022-11.tsv.gz,List_of_highest-grossing_Indian_films,115668,379749,1376,496793,267159
hdfs://spark-nn.eemcs.utwente.nl/user/s1934538/clickstream/clickstream-enwiki-2022-11.tsv.gz,Tina_Turner,23039,249391,2259,274689,78875
hdfs://spark-nn.eemcs.utwente.nl/user/s1934538/clickstream/clickstream-enwiki-2022-11.tsv.gz,Kantara_(film),112378,2453746,9852,2575976,748411
hdfs://spark-nn.eemcs.utwente.nl/user/s1934538/clickstream/clickstream-enwiki-2022-11.tsv.gz,Guardians_of_the_Galaxy_Vol._3,130760,71984,1721,204465,151572
hdfs://spark-nn.eemcs.utwente.nl/user/s1934538/clickstream/clickstream-enwiki-2022-11.tsv.gz,Jeffrey_Dahmer,88897,2751331,19416,2859644,1031429
hdfs://spark-nn.eemcs.utwente.nl/user/s1934538/clickstream/clickstream-enwiki-2022-11.tsv.gz,Naya_Rivera,87338,101627,286,189251,68914
hdfs://spark-nn.eemcs.utwente.nl/user/s1934538/clickstream/clickstream-enwiki-2022-11.tsv.gz,Captain_Marvel_(film),25757,62399,732,88888,37484
hdfs://spark-nn.eemcs.utwente.nl/user/s1934538/clickstream/clickstream-enwiki-2022-11.tsv.gz,Chernobyl_(miniseries),17744,54584,1219,73547,72450
hdfs://spark-nn.eemcs.utwente.nl/user/s1934538/clickstream/clickstream-enwiki-2022-11.tsv.gz,Charles_III,907679,764904,11872,1684455,1147633
hdfs://spark-nn.eemcs.utwente.nl/user/s1934538/clickstream/clickstream-enwiki-2022-11.tsv.gz,2023_Indian_Premier_League,26616,99736,813,127165,69591
hdfs://spark-nn.eemcs.utwente.nl/user/s1934538/clickstream/clickstream-enwiki-2022-11.tsv.gz,2020_Summer_Olympics,58848,48053,2195,109096,89589
hdfs://spark-nn.eemcs.utwente.nl/user/s1934538/clickstream/clickstream-enwiki-2022-11.tsv.gz,"Diana,_Princess_of_Wales",624886,1375533,16866,2017285,1246270
hdfs://spark-nn.eemcs.utwente.nl/user/s1934538/clickstream/clickstream-enwiki-2022-11.tsv.gz,No_Time_to_Die,89924,154004,2414,246342,145117
hdfs://spark-nn.eemcs.utwente.nl/user/s1934538/clickstream/clickstream-enwiki-2022-11.tsv.gz,Henry_V_of_England,78915,78120,260,157295,111515
hdfs://spark-nn.eemcs.utwente.nl/user/s1934538/clickstream/clickstream-enwiki-2022-11.tsv.gz,Richard_Ramirez,15443,167171,1634,184248,49689
hdfs://spark-nn.eemcs.utwente.nl/user/s1934538/clickstream/clickstream-enwiki-2022-11.tsv.gz,Royal_Rumble_(2018),6293,3813,51,10157,8017
hdfs://spark-nn.eemcs.utwente.nl/user/s1934538/clickstream/clickstream-enwiki-2022-11.tsv.gz,Black_Widow_(2021_film),49134,87037,1067,137238,59604
hdfs://spark-nn.eemcs.utwente.nl/user/s1934538/clickstream/clickstream-enwiki-2022-11.tsv.gz,David_Beckham,72056,431167,2659,505882,200104
hdfs://spark-nn.eemcs.utwente.nl/user/s1934538/clickstream/clickstream-enwiki-2022-11.tsv.gz,Irrfan_Khan,23921,49746,689,74356,29506
hdfs://spark-nn.eemcs.utwente.nl/user/s1934538/clickstream/clickstream-enwiki-2022-11.tsv.gz,Oppenheimer_(film),132839,123070,1204,257113,231073
hdfs://spark-nn.eemcs.utwente.nl/user/s1934538/clickstream/clickstream-enwiki-2022-11.tsv.gz,Sushant_Singh_Rajput,16183,80513,116,96812,40959
hdfs://spark-nn.eemcs.utwente.nl/user/s1934538/clickstream/clickstream-enwiki-2022-11.tsv.gz,XHamster,13408,173221,5077,191706,25800
hdfs://spark-nn.eemcs.utwente.nl/user/s1934538/clickstream/clickstream-enwiki-2022-11.tsv.gz,Critical_race_theory,26725,193057,877,220659,19629
hdfs://spark-nn.eemcs.utwente.nl/user/s1934538/clickstream/clickstream-enwiki-2022-11.tsv.gz,Joe_Biden,282028,823033,15737,1120798,552984
hdfs://spark-nn.eemcs.utwente.nl/user/s1934538/clickstream/clickstream-enwiki-2022-11.tsv.gz,Avengers:_Endgame,213366,176499,2437,392302,152143
hdfs://spark-nn.eemcs.utwente.nl/user/s1934538/clickstream/clickstream-enwiki-2022-11.tsv.gz,A_Star_Is_Born_(2018_film),20325,65321,427,86073,36798
hdfs://spark-nn.eemcs.utwente.nl/user/s1934538/clickstream/clickstream-enwiki-2022-11.tsv.gz,Pelé,147825,502584,9468,659877,249707
hdfs://spark-nn.eemcs.utwente.nl/user/s1934538/clickstream/clickstream-enwiki-2022-11.tsv.gz,Simple_Mail_Transfer_Protocol,2858,35810,126,38794,3454
hdfs://spark-nn.eemcs.utwente.nl/user/s1934538/clickstream/clickstream-enwiki-2022-11.tsv.gz,The_Idol_(TV_series),24299,31154,196,55649,34199
hdfs://spark-nn.eemcs.utwente.nl/user/s1934538/clickstream/clickstream-enwiki-2022-11.tsv.gz,Cricket_World_Cup,57231,446816,1700,505747,276119
hdfs://spark-nn.eemcs.utwente.nl/user/s1934538/clickstream/clickstream-enwiki-2022-11.tsv.gz,Stan_Lee,42470,155413,857,198740,46083
hdfs://spark-nn.eemcs.utwente.nl/user/s1934538/clickstream/clickstream-enwiki-2022-11.tsv.gz,XXX:_Return_of_Xander_Cage,61282,2582539,1409,2645230,185272
hdfs://spark-nn.eemcs.utwente.nl/user/s1934538/clickstream/clickstream-enwiki-2022-11.tsv.gz,Darth_Vader,21790,63421,557,85768,43673
hdfs://spark-nn.eemcs.utwente.nl/user/s1934538/clickstream/clickstream-enwiki-2022-11.tsv.gz,2018_Asian_Games,10136,5754,21,15911,13899
hdfs://spark-nn.eemcs.utwente.nl/user/s1934538/clickstream/clickstream-enwiki-2022-11.tsv.gz,Avatar:_The_Way_of_Water,191674,950039,18131,1159844,564721
hdfs://spark-nn.eemcs.utwente.nl/user/s1934538/clickstream/clickstream-enwiki-2022-11.tsv.gz,Tom_Brady,85619,498261,5550,589430,220426
hdfs://spark-nn.eemcs.utwente.nl/user/s1934538/clickstream/clickstream-enwiki-2022-11.tsv.gz,Aaron_Carter,366958,6167323,78512,6612793,2141259
hdfs://spark-nn.eemcs.utwente.nl/user/s1934538/clickstream/clickstream-enwiki-2022-11.tsv.gz,1234,55,2129,24,2208,313
hdfs://spark-nn.eemcs.utwente.nl/user/s1934538/clickstream/clickstream-enwiki-2022-11.tsv.gz,Olivia_Newton-John,29174,221601,2133,252908,89586
hdfs://spark-nn.eemcs.utwente.nl/user/s1934538/clickstream/clickstream-enwiki-2022-11.tsv.gz,Notre-Dame_de_Paris,11813,82496,686,94995,17722
hdfs://spark-nn.eemcs.utwente.nl/user/s1934538/clickstream/clickstream-enwiki-2022-11.tsv.gz,Burt_Reynolds,55014,128371,1059,184444,87053
hdfs://spark-nn.eemcs.utwente.nl/user/s1934538/clickstream/clickstream-enwiki-2022-11.tsv.gz,Roe_v._Wade,23280,181775,1963,207018,58524
hdfs://spark-nn.eemcs.utwente.nl/user/s1934538/clickstream/clickstream-enwiki-2022-11.tsv.gz,Mission:_Impossible_–_Dead_Reckoning_Part_One,56261,37501,454,94216,70283
hdfs://spark-nn.eemcs.utwente.nl/user/s1934538/clickstream/clickstream-enwiki-2022-11.tsv.gz,Indian_Premier_League,25590,111452,830,137872,98205
hdfs://spark-nn.eemcs.utwente.nl/user/s1934538/clickstream/clickstream-enwiki-2022-11.tsv.gz,State_of_Palestine,58141,148238,215,206594,83066
hdfs://spark-nn.eemcs.utwente.nl/user/s1934538/clickstream/clickstream-enwiki-2022-11.tsv.gz,2.0_(film),23197,37566,29,60792,13111
hdfs://spark-nn.eemcs.utwente.nl/user/s1934538/clickstream/clickstream-enwiki-2022-11.tsv.gz,Ray_Liotta,65026,235406,2031,302463,64483
hdfs://spark-nn.eemcs.utwente.nl/user/s1934538/clickstream/clickstream-enwiki-2022-11.tsv.gz,Deaths_in_2022,1397970,2517427,20379,3935776,2477626
hdfs://spark-nn.eemcs.utwente.nl/user/s1934538/clickstream/clickstream-enwiki-2022-11.tsv.gz,Army_of_the_Dead,42447,36031,292,78770,38626
hdfs://spark-nn.eemcs.utwente.nl/user/s1934538/clickstream/clickstream-enwiki-2022-11.tsv.gz,War_(2019_film),46807,63587,75,110469,27038
hdfs://spark-nn.eemcs.utwente.nl/user/s1934538/clickstream/clickstream-enwiki-2022-11.tsv.gz,21_Savage,37621,250507,2771,290899,119188
hdfs://spark-nn.eemcs.utwente.nl/user/s1934538/clickstream/clickstream-enwiki-2022-11.tsv.gz,Wonder_Woman_1984,29480,42792,797,73069,30025
hdfs://spark-nn.eemcs.utwente.nl/user/s1934538/clickstream/clickstream-enwiki-2022-11.tsv.gz,Elon_Musk,300563,2864113,33099,3197775,1927018
hdfs://spark-nn.eemcs.utwente.nl/user/s1934538/clickstream/clickstream-enwiki-2022-11.tsv.gz,Valentine's_Day,3789,57128,2875,63792,4328
hdfs://spark-nn.eemcs.utwente.nl/user/s1934538/clickstream/clickstream-enwiki-2022-11.tsv.gz,List_of_Marvel_Cinematic_Universe_films,222289,581943,2695,806927,531464
hdfs://spark-nn.eemcs.utwente.nl/user/s1934538/clickstream/clickstream-enwiki-2022-11.tsv.gz,George_H._W._Bush,161601,105848,866,268315,164390
hdfs://spark-nn.eemcs.utwente.nl/user/s1934538/clickstream/clickstream-enwiki-2022-11.tsv.gz,Anthony_Bourdain,20778,212288,1494,234560,97547
hdfs://spark-nn.eemcs.utwente.nl/user/s1934538/clickstream/clickstream-enwiki-2022-11.tsv.gz,Luke_Perry,32839,97982,496,131317,49387
hdfs://spark-nn.eemcs.utwente.nl/user/s1934538/clickstream/clickstream-enwiki-2022-11.tsv.gz,Ted_Bundy,39533,357201,5767,402501,94748
hdfs://spark-nn.eemcs.utwente.nl/user/s1934538/clickstream/clickstream-enwiki-2022-11.tsv.gz,Hamilton_(musical),23275,155844,1532,180651,103986
hdfs://spark-nn.eemcs.utwente.nl/user/s1934538/clickstream/clickstream-enwiki-2022-11.tsv.gz,Vivek_Ramaswamy,340,13787,79,14206,2050
hdfs://spark-nn.eemcs.utwente.nl/user/s1934538/clickstream/clickstream-enwiki-2022-11.tsv.gz,2022_Russian_invasion_of_Ukraine,806257,1015447,5367,1827071,883889
hdfs://spark-nn.eemcs.utwente.nl/user/s1934538/clickstream/clickstream-enwiki-2022-11.tsv.gz,United_States_Electoral_College,29073,57777,245,87095,16670
hdfs://spark-nn.eemcs.utwente.nl/user/s1934538/clickstream/clickstream-enwiki-2022-11.tsv.gz,Article_370_of_the_Constitution_of_India,2325,47131,22,49478,2474
hdfs://spark-nn.eemcs.utwente.nl/user/s1934538/clickstream/clickstream-enwiki-2022-11.tsv.gz,Laal_Singh_Chaddha,32964,167078,532,200574,62234
hdfs://spark-nn.eemcs.utwente.nl/user/s1934538/clickstream/clickstream-enwiki-2022-11.tsv.gz,Black_Panther:_Wakanda_Forever,890144,4808415,111057,5809616,3988162
hdfs://spark-nn.eemcs.utwente.nl/user/s1934538/clickstream/clickstream-enwiki-2022-11.tsv.gz,Manti_Te'o,6016,98712,327,105055,12953
hdfs://spark-nn.eemcs.utwente.nl/user/s1934538/clickstream/clickstream-enwiki-2022-11.tsv.gz,Avicii,17004,205324,1463,223791,60834
hdfs://spark-nn.eemcs.utwente.nl/user/s1934538/clickstream/clickstream-enwiki-2022-11.tsv.gz,Sylvester_Stallone,108708,664143,4658,777509,449301
hdfs://spark-nn.eemcs.utwente.nl/user/s1934538/clickstream/clickstream-enwiki-2022-11.tsv.gz,Death_of_Elisa_Lam,10212,62028,201,72441,20595
hdfs://spark-nn.eemcs.utwente.nl/user/s1934538/clickstream/clickstream-enwiki-2022-11.tsv.gz,Mötley_Crüe,32036,105825,1332,139193,160915
hdfs://spark-nn.eemcs.utwente.nl/user/s1934538/clickstream/clickstream-enwiki-2022-11.tsv.gz,Top_Gun:_Maverick,160063,469676,11897,641636,432121
hdfs://spark-nn.eemcs.utwente.nl/user/s1934538/clickstream/clickstream-enwiki-2022-11.tsv.gz,The_Mandalorian,49864,116284,2455,168603,111309
hdfs://spark-nn.eemcs.utwente.nl/user/s1934538/clickstream/clickstream-enwiki-2022-11.tsv.gz,Amber_Heard,74714,243531,1439,319684,115856
hdfs://spark-nn.eemcs.utwente.nl/user/s1934538/clickstream/clickstream-enwiki-2022-11.tsv.gz,Anne_Heche,38838,197560,1684,238082,83753
hdfs://spark-nn.eemcs.utwente.nl/user/s1934538/clickstream/clickstream-enwiki-2022-11.tsv.gz,Fantastic_Beasts:_The_Crimes_of_Grindelwald,35278,37064,412,72754,36650
hdfs://spark-nn.eemcs.utwente.nl/user/s1934538/clickstream/clickstream-enwiki-2022-11.tsv.gz,Eternals_(film),75196,126718,2009,203923,139397
hdfs://spark-nn.eemcs.utwente.nl/user/s1934538/clickstream/clickstream-enwiki-2022-11.tsv.gz,Line_shaft,381,645,22,1048,110
hdfs://spark-nn.eemcs.utwente.nl/user/s1934538/clickstream/clickstream-enwiki-2022-11.tsv.gz,Louis_Tomlinson,33355,77403,1107,111865,45129
hdfs://spark-nn.eemcs.utwente.nl/user/s1934538/clickstream/clickstream-enwiki-2022-11.tsv.gz,The_Matrix_Resurrections,61650,70275,1059,132984,60229
hdfs://spark-nn.eemcs.utwente.nl/user/s1934538/clickstream/clickstream-enwiki-2022-11.tsv.gz,Volodymyr_Zelenskyy,93567,198716,2153,294436,152902
hdfs://spark-nn.eemcs.utwente.nl/user/s1934538/clickstream/clickstream-enwiki-2022-11.tsv.gz,Emma_Raducanu,3707,63237,363,67307,11557
hdfs://spark-nn.eemcs.utwente.nl/user/s1934538/clickstream/clickstream-enwiki-2022-11.tsv.gz,Tunnel,4068,9604,91,13763,3225
hdfs://spark-nn.eemcs.utwente.nl/user/s1934538/clickstream/clickstream-enwiki-2022-11.tsv.gz,2018_Winter_Olympics,13067,9367,95,22529,14608
hdfs://spark-nn.eemcs.utwente.nl/user/s1934538/clickstream/clickstream-enwiki-2022-11.tsv.gz,Game_of_Thrones,83040,384346,6307,473693,269937
hdfs://spark-nn.eemcs.utwente.nl/user/s1934538/clickstream/clickstream-enwiki-2022-11.tsv.gz,United_States_Senate,197231,319551,6303,523085,250369
hdfs://spark-nn.eemcs.utwente.nl/user/s1934538/clickstream/clickstream-enwiki-2022-11.tsv.gz,Kate_Spade,21144,68290,330,89764,32213
hdfs://spark-nn.eemcs.utwente.nl/user/s1934538/clickstream/clickstream-enwiki-2022-11.tsv.gz,2016_United_States_presidential_election,211449,126973,1702,340124,303109
hdfs://spark-nn.eemcs.utwente.nl/user/s1934538/clickstream/clickstream-enwiki-2022-11.tsv.gz,The_Super_Mario_Bros._Movie,75465,159464,5077,240006,165844
hdfs://spark-nn.eemcs.utwente.nl/user/s1934538/clickstream/clickstream-enwiki-2022-11.tsv.gz,The_Irishman,43796,76865,1354,122015,103346
hdfs://spark-nn.eemcs.utwente.nl/user/s1934538/clickstream/clickstream-enwiki-2022-11.tsv.gz,Puneeth_Rajkumar,43582,130415,204,174201,65930
hdfs://spark-nn.eemcs.utwente.nl/user/s1934538/clickstream/clickstream-enwiki-2022-11.tsv.gz,Central_Park_jogger_case,9416,44871,192,54479,6717
hdfs://spark-nn.eemcs.utwente.nl/user/s1934538/clickstream/clickstream-enwiki-2022-11.tsv.gz,Stranger_Things_(season_3),15540,29830,337,45707,23634
hdfs://spark-nn.eemcs.utwente.nl/user/s1934538/clickstream/clickstream-enwiki-2022-11.tsv.gz,Jimmy_Hoffa,27190,98289,680,126159,48673
hdfs://spark-nn.eemcs.utwente.nl/user/s1934538/clickstream/clickstream-enwiki-2022-11.tsv.gz,Parasite_(2019_film),24091,132077,918,157086,59959
hdfs://spark-nn.eemcs.utwente.nl/user/s1934538/clickstream/clickstream-enwiki-2022-11.tsv.gz,Eddie_Van_Halen,48613,86571,782,135966,55186
hdfs://spark-nn.eemcs.utwente.nl/user/s1934538/clickstream/clickstream-enwiki-2022-11.tsv.gz,Jason_Momoa,95363,605418,3378,704159,354268
hdfs://spark-nn.eemcs.utwente.nl/user/s1934538/clickstream/clickstream-enwiki-2022-11.tsv.gz,Barbie_(film),74832,39360,541,114733,77847
hdfs://spark-nn.eemcs.utwente.nl/user/s1934538/clickstream/clickstream-enwiki-2022-11.tsv.gz,Leave_the_World_Behind_(film),12056,3785,16,15857,7307
hdfs://spark-nn.eemcs.utwente.nl/user/s1934538/clickstream/clickstream-enwiki-2022-11.tsv.gz,Ponniyin_Selvan:_I,121108,1228835,4742,1354685,770092
hdfs://spark-nn.eemcs.utwente.nl/user/s1934538/clickstream/clickstream-enwiki-2022-11.tsv.gz,YouTube,117549,4271263,10753,4399565,116164
hdfs://spark-nn.eemcs.utwente.nl/user/s1934538/clickstream/clickstream-enwiki-2022-11.tsv.gz,XXXTentacion,92506,1068908,11830,1173244,120227
hdfs://spark-nn.eemcs.utwente.nl/user/s1934538/clickstream/clickstream-enwiki-2022-11.tsv.gz,Qasem_Soleimani,17560,36298,133,53991,30400
hdfs://spark-nn.eemcs.utwente.nl/user/s1934538/clickstream/clickstream-enwiki-2022-11.tsv.gz,Matthew_Perry,60899,512686,15191,588776,307045
hdfs://spark-nn.eemcs.utwente.nl/user/s1934538/clickstream/clickstream-enwiki-2022-12.tsv.gz,List_of_highest-grossing_Indian_films,80685,219711,1675,302071,182663
hdfs://spark-nn.eemcs.utwente.nl/user/s1934538/clickstream/clickstream-enwiki-2022-12.tsv.gz,Black_Panther:_Wakanda_Forever,296360,1066115,27311,1389786,764828
hdfs://spark-nn.eemcs.utwente.nl/user/s1934538/clickstream/clickstream-enwiki-2022-12.tsv.gz,Cameron_Boyce,20915,114324,383,135622,38858
hdfs://spark-nn.eemcs.utwente.nl/user/s1934538/clickstream/clickstream-enwiki-2022-12.tsv.gz,List_of_FIFA_World_Cup_finals,113088,4595240,5236,4713564,1059351
hdfs://spark-nn.eemcs.utwente.nl/user/s1934538/clickstream/clickstream-enwiki-2022-12.tsv.gz,Sridevi,35085,82356,154,117595,56233
hdfs://spark-nn.eemcs.utwente.nl/user/s1934538/clickstream/clickstream-enwiki-2022-12.tsv.gz,The_Flash_(film),84331,71833,5321,161485,95581
hdfs://spark-nn.eemcs.utwente.nl/user/s1934538/clickstream/clickstream-enwiki-2022-12.tsv.gz,Rihanna,73406,247564,3328,324298,193844
hdfs://spark-nn.eemcs.utwente.nl/user/s1934538/clickstream/clickstream-enwiki-2022-12.tsv.gz,XHamster,6304,216011,5427,227742,26182
hdfs://spark-nn.eemcs.utwente.nl/user/s1934538/clickstream/clickstream-enwiki-2022-12.tsv.gz,Afghanistan,120790,232985,4703,358478,256706
hdfs://spark-nn.eemcs.utwente.nl/user/s1934538/clickstream/clickstream-enwiki-2022-12.tsv.gz,R._Kelly,39016,286786,3054,328856,190513
hdfs://spark-nn.eemcs.utwente.nl/user/s1934538/clickstream/clickstream-enwiki-2022-12.tsv.gz,Spider-Man:_No_Way_Home,141911,217408,3562,362881,170220
hdfs://spark-nn.eemcs.utwente.nl/user/s1934538/clickstream/clickstream-enwiki-2022-12.tsv.gz,The_Super_Mario_Bros._Movie,89313,184998,6091,280402,189010
hdfs://spark-nn.eemcs.utwente.nl/user/s1934538/clickstream/clickstream-enwiki-2022-12.tsv.gz,Stranger_Things_(season_3),13570,23826,282,37678,20006
hdfs://spark-nn.eemcs.utwente.nl/user/s1934538/clickstream/clickstream-enwiki-2022-12.tsv.gz,Us_(2019_film),35309,61076,262,96647,32115
hdfs://spark-nn.eemcs.utwente.nl/user/s1934538/clickstream/clickstream-enwiki-2022-12.tsv.gz,Media,41,2099,178,2318,1156
hdfs://spark-nn.eemcs.utwente.nl/user/s1934538/clickstream/clickstream-enwiki-2022-12.tsv.gz,Deadpool_2,85344,40258,1140,126742,76684
hdfs://spark-nn.eemcs.utwente.nl/user/s1934538/clickstream/clickstream-enwiki-2022-12.tsv.gz,Grover,1892,5379,62,7333,1550
hdfs://spark-nn.eemcs.utwente.nl/user/s1934538/clickstream/clickstream-enwiki-2022-12.tsv.gz,Jawan_(film),93713,53824,9097,156634,98740
hdfs://spark-nn.eemcs.utwente.nl/user/s1934538/clickstream/clickstream-enwiki-2022-12.tsv.gz,Avicii,18492,168496,1174,188162,54485
hdfs://spark-nn.eemcs.utwente.nl/user/s1934538/clickstream/clickstream-enwiki-2022-12.tsv.gz,War_(2019_film),42942,48463,87,91492,24375
hdfs://spark-nn.eemcs.utwente.nl/user/s1934538/clickstream/clickstream-enwiki-2022-12.tsv.gz,Shang-Chi_and_the_Legend_of_the_Ten_Rings,52000,81119,1080,134199,78393
hdfs://spark-nn.eemcs.utwente.nl/user/s1934538/clickstream/clickstream-enwiki-2022-12.tsv.gz,"Meghan,_Duchess_of_Sussex",245146,1393068,8815,1647029,1119328
hdfs://spark-nn.eemcs.utwente.nl/user/s1934538/clickstream/clickstream-enwiki-2022-12.tsv.gz,Kamala_Harris,67879,138947,1380,208206,96865
hdfs://spark-nn.eemcs.utwente.nl/user/s1934538/clickstream/clickstream-enwiki-2022-12.tsv.gz,House_of_the_Dragon,66982,401924,10184,479090,305601
hdfs://spark-nn.eemcs.utwente.nl/user/s1934538/clickstream/clickstream-enwiki-2022-12.tsv.gz,George_VI,432450,168887,741,602078,437278
hdfs://spark-nn.eemcs.utwente.nl/user/s1934538/clickstream/clickstream-enwiki-2022-12.tsv.gz,Meat_Loaf,23818,134101,1751,159670,50587
hdfs://spark-nn.eemcs.utwente.nl/user/s1934538/clickstream/clickstream-enwiki-2022-12.tsv.gz,Matthew_Perry,51243,233410,1818,286471,155692
hdfs://spark-nn.eemcs.utwente.nl/user/s1934538/clickstream/clickstream-enwiki-2022-12.tsv.gz,The_Witcher_(TV_series),80931,310055,7315,398301,253324
hdfs://spark-nn.eemcs.utwente.nl/user/s1934538/clickstream/clickstream-enwiki-2022-12.tsv.gz,Kelly_Preston,140877,189252,990,331119,97306
hdfs://spark-nn.eemcs.utwente.nl/user/s1934538/clickstream/clickstream-enwiki-2022-12.tsv.gz,William_Murdoch,613,1054,21,1688,376
hdfs://spark-nn.eemcs.utwente.nl/user/s1934538/clickstream/clickstream-enwiki-2022-12.tsv.gz,The_Sandman_(TV_series),50864,149940,2868,203672,142753
hdfs://spark-nn.eemcs.utwente.nl/user/s1934538/clickstream/clickstream-enwiki-2022-12.tsv.gz,The_Weeknd,55637,211509,2413,269559,127104
hdfs://spark-nn.eemcs.utwente.nl/user/s1934538/clickstream/clickstream-enwiki-2022-12.tsv.gz,Pornhub,40764,524046,12285,577095,79255
hdfs://spark-nn.eemcs.utwente.nl/user/s1934538/clickstream/clickstream-enwiki-2022-12.tsv.gz,Jimmy_Hoffa,33082,106503,811,140396,57235
hdfs://spark-nn.eemcs.utwente.nl/user/s1934538/clickstream/clickstream-enwiki-2022-12.tsv.gz,Taliban,41688,84855,9118,135661,102898
hdfs://spark-nn.eemcs.utwente.nl/user/s1934538/clickstream/clickstream-enwiki-2022-12.tsv.gz,Louis_Tomlinson,25416,56593,382,82391,24694
hdfs://spark-nn.eemcs.utwente.nl/user/s1934538/clickstream/clickstream-enwiki-2022-12.tsv.gz,September_11_attacks,92627,221488,3257,317372,195564
hdfs://spark-nn.eemcs.utwente.nl/user/s1934538/clickstream/clickstream-enwiki-2022-12.tsv.gz,2018_FIFA_World_Cup,1987739,1612972,12026,3612737,1806190
hdfs://spark-nn.eemcs.utwente.nl/user/s1934538/clickstream/clickstream-enwiki-2022-12.tsv.gz,ChatGPT,26233,1836579,5682,1868494,241450
hdfs://spark-nn.eemcs.utwente.nl/user/s1934538/clickstream/clickstream-enwiki-2022-12.tsv.gz,Croatia,125929,1115592,11273,1252794,330766
hdfs://spark-nn.eemcs.utwente.nl/user/s1934538/clickstream/clickstream-enwiki-2022-12.tsv.gz,Army_of_the_Dead,50710,38123,391,89224,46833
hdfs://spark-nn.eemcs.utwente.nl/user/s1934538/clickstream/clickstream-enwiki-2022-12.tsv.gz,Hyphen-minus,839,5307997,20239,5329075,742
hdfs://spark-nn.eemcs.utwente.nl/user/s1934538/clickstream/clickstream-enwiki-2022-12.tsv.gz,Area_51,19247,142907,1356,163510,56314
hdfs://spark-nn.eemcs.utwente.nl/user/s1934538/clickstream/clickstream-enwiki-2022-12.tsv.gz,Article_370_of_the_Constitution_of_India,2323,41519,13,43855,2425
hdfs://spark-nn.eemcs.utwente.nl/user/s1934538/clickstream/clickstream-enwiki-2022-12.tsv.gz,Kylian_Mbappé,666216,7663306,38942,8368464,2135334
hdfs://spark-nn.eemcs.utwente.nl/user/s1934538/clickstream/clickstream-enwiki-2022-12.tsv.gz,The_Idol_(TV_series),24295,26589,127,51011,32452
hdfs://spark-nn.eemcs.utwente.nl/user/s1934538/clickstream/clickstream-enwiki-2022-12.tsv.gz,Ruth_Bader_Ginsburg,14771,52501,365,67637,22717
hdfs://spark-nn.eemcs.utwente.nl/user/s1934538/clickstream/clickstream-enwiki-2022-12.tsv.gz,Pathaan_(film),97562,651471,5169,754202,326612
hdfs://spark-nn.eemcs.utwente.nl/user/s1934538/clickstream/clickstream-enwiki-2022-12.tsv.gz,Jenna_Ortega,888931,6236872,26593,7152396,1861383
hdfs://spark-nn.eemcs.utwente.nl/user/s1934538/clickstream/clickstream-enwiki-2022-12.tsv.gz,Priyanka_Chopra,67162,198529,598,266289,100911
hdfs://spark-nn.eemcs.utwente.nl/user/s1934538/clickstream/clickstream-enwiki-2022-12.tsv.gz,Naya_Rivera,58507,80814,353,139674,56322
hdfs://spark-nn.eemcs.utwente.nl/user/s1934538/clickstream/clickstream-enwiki-2022-12.tsv.gz,List_of_highest-grossing_films,275158,975928,8262,1259348,577257
hdfs://spark-nn.eemcs.utwente.nl/user/s1934538/clickstream/clickstream-enwiki-2022-12.tsv.gz,Kenosha_unrest_shooting,12782,39820,63,52665,11060
hdfs://spark-nn.eemcs.utwente.nl/user/s1934538/clickstream/clickstream-enwiki-2022-12.tsv.gz,XXX:_Return_of_Xander_Cage,60311,4852985,1788,4915084,329488
hdfs://spark-nn.eemcs.utwente.nl/user/s1934538/clickstream/clickstream-enwiki-2022-12.tsv.gz,Khabib_Nurmagomedov,43849,173274,1414,218537,124443
hdfs://spark-nn.eemcs.utwente.nl/user/s1934538/clickstream/clickstream-enwiki-2022-12.tsv.gz,NATO,67230,178487,4613,250330,118990
hdfs://spark-nn.eemcs.utwente.nl/user/s1934538/clickstream/clickstream-enwiki-2022-12.tsv.gz,Venom_(2018_film),13192,52543,632,66367,29128
hdfs://spark-nn.eemcs.utwente.nl/user/s1934538/clickstream/clickstream-enwiki-2022-12.tsv.gz,Simple_Mail_Transfer_Protocol,2507,26898,94,29499,2746
hdfs://spark-nn.eemcs.utwente.nl/user/s1934538/clickstream/clickstream-enwiki-2022-12.tsv.gz,Elon_Musk,170406,1768653,23580,1962639,1076121
hdfs://spark-nn.eemcs.utwente.nl/user/s1934538/clickstream/clickstream-enwiki-2022-12.tsv.gz,2022_FIFA_World_Cup,3043317,11039554,500941,14583812,6038664
hdfs://spark-nn.eemcs.utwente.nl/user/s1934538/clickstream/clickstream-enwiki-2022-12.tsv.gz,Carlos_Alcaraz,12893,27653,82,40628,11050
hdfs://spark-nn.eemcs.utwente.nl/user/s1934538/clickstream/clickstream-enwiki-2022-12.tsv.gz,The_Shape_of_Water,49725,54434,571,104730,44418
hdfs://spark-nn.eemcs.utwente.nl/user/s1934538/clickstream/clickstream-enwiki-2022-12.tsv.gz,George_H._W._Bush,128473,98787,2204,229464,139783
hdfs://spark-nn.eemcs.utwente.nl/user/s1934538/clickstream/clickstream-enwiki-2022-12.tsv.gz,Key_frame,631,3553,15,4199,260
hdfs://spark-nn.eemcs.utwente.nl/user/s1934538/clickstream/clickstream-enwiki-2022-12.tsv.gz,Stranger_Things,70376,251273,6223,327872,278865
hdfs://spark-nn.eemcs.utwente.nl/user/s1934538/clickstream/clickstream-enwiki-2022-12.tsv.gz,The_Batman_(film),113701,345351,8287,467339,278649
hdfs://spark-nn.eemcs.utwente.nl/user/s1934538/clickstream/clickstream-enwiki-2022-12.tsv.gz,Saltburn_(film),19415,4668,18,24101,11555
hdfs://spark-nn.eemcs.utwente.nl/user/s1934538/clickstream/clickstream-enwiki-2022-12.tsv.gz,Anna_Sorokin,16705,189463,673,206841,72098
hdfs://spark-nn.eemcs.utwente.nl/user/s1934538/clickstream/clickstream-enwiki-2022-12.tsv.gz,Israel,104062,279814,6366,390242,226263
hdfs://spark-nn.eemcs.utwente.nl/user/s1934538/clickstream/clickstream-enwiki-2022-12.tsv.gz,Mulan_(2020_film),17386,38478,489,56353,30128
hdfs://spark-nn.eemcs.utwente.nl/user/s1934538/clickstream/clickstream-enwiki-2022-12.tsv.gz,Kim_Jong-un,70105,146651,1446,218202,128638
hdfs://spark-nn.eemcs.utwente.nl/user/s1934538/clickstream/clickstream-enwiki-2022-12.tsv.gz,Top_Gun:_Maverick,316544,695456,17471,1029471,795236
hdfs://spark-nn.eemcs.utwente.nl/user/s1934538/clickstream/clickstream-enwiki-2022-12.tsv.gz,YouTube,108463,2597817,8932,2715212,110737
hdfs://spark-nn.eemcs.utwente.nl/user/s1934538/clickstream/clickstream-enwiki-2022-12.tsv.gz,Simone_Biles,11458,43830,284,55572,19062
hdfs://spark-nn.eemcs.utwente.nl/user/s1934538/clickstream/clickstream-enwiki-2022-12.tsv.gz,Joe_Biden,173575,385124,7214,565913,298824
hdfs://spark-nn.eemcs.utwente.nl/user/s1934538/clickstream/clickstream-enwiki-2022-12.tsv.gz,John_Wick:_Chapter_4,67736,82474,1993,152203,112094
hdfs://spark-nn.eemcs.utwente.nl/user/s1934538/clickstream/clickstream-enwiki-2022-12.tsv.gz,Juice_Wrld,30087,211604,2201,243892,93641
hdfs://spark-nn.eemcs.utwente.nl/user/s1934538/clickstream/clickstream-enwiki-2022-12.tsv.gz,John_McCain,32072,60867,691,93630,52404
hdfs://spark-nn.eemcs.utwente.nl/user/s1934538/clickstream/clickstream-enwiki-2022-12.tsv.gz,Aaron_Hernandez,13365,98049,460,111874,39150
hdfs://spark-nn.eemcs.utwente.nl/user/s1934538/clickstream/clickstream-enwiki-2022-12.tsv.gz,Bridgerton,25385,98045,1782,125212,94969
hdfs://spark-nn.eemcs.utwente.nl/user/s1934538/clickstream/clickstream-enwiki-2022-12.tsv.gz,Sylvester_Stallone,121434,576356,3628,701418,445472
hdfs://spark-nn.eemcs.utwente.nl/user/s1934538/clickstream/clickstream-enwiki-2022-12.tsv.gz,Notre-Dame_de_Paris,13764,87447,1047,102258,23606
hdfs://spark-nn.eemcs.utwente.nl/user/s1934538/clickstream/clickstream-enwiki-2022-12.tsv.gz,Shinzo_Abe,45966,81428,1516,128910,87391
hdfs://spark-nn.eemcs.utwente.nl/user/s1934538/clickstream/clickstream-enwiki-2022-12.tsv.gz,Naomi_Osaka,10924,58788,486,70198,14562
hdfs://spark-nn.eemcs.utwente.nl/user/s1934538/clickstream/clickstream-enwiki-2022-12.tsv.gz,COVID-19_pandemic_by_country_and_territory,12064,36877,1307,50248,22354
hdfs://spark-nn.eemcs.utwente.nl/user/s1934538/clickstream/clickstream-enwiki-2022-12.tsv.gz,David_Beckham,114606,659278,4337,778221,350877
hdfs://spark-nn.eemcs.utwente.nl/user/s1934538/clickstream/clickstream-enwiki-2022-12.tsv.gz,Qasem_Soleimani,12538,30348,86,42972,21748
hdfs://spark-nn.eemcs.utwente.nl/user/s1934538/clickstream/clickstream-enwiki-2022-12.tsv.gz,Volodymyr_Zelenskyy,112170,414601,4713,531484,265461
hdfs://spark-nn.eemcs.utwente.nl/user/s1934538/clickstream/clickstream-enwiki-2022-12.tsv.gz,Henry_V_of_England,79516,87788,259,167563,117171
hdfs://spark-nn.eemcs.utwente.nl/user/s1934538/clickstream/clickstream-enwiki-2022-12.tsv.gz,Murder_of_Dee_Dee_Blanchard,11719,89794,288,101801,23374
hdfs://spark-nn.eemcs.utwente.nl/user/s1934538/clickstream/clickstream-enwiki-2022-12.tsv.gz,Dark_Phoenix_(film),32926,26039,307,59272,32693
hdfs://spark-nn.eemcs.utwente.nl/user/s1934538/clickstream/clickstream-enwiki-2022-12.tsv.gz,Laal_Singh_Chaddha,28652,138723,504,167879,54401
hdfs://spark-nn.eemcs.utwente.nl/user/s1934538/clickstream/clickstream-enwiki-2022-12.tsv.gz,Christopher_Scarver,136831,78340,32,215203,62003
hdfs://spark-nn.eemcs.utwente.nl/user/s1934538/clickstream/clickstream-enwiki-2022-12.tsv.gz,Antifa_(United_States),7427,50157,212,57796,10916
hdfs://spark-nn.eemcs.utwente.nl/user/s1934538/clickstream/clickstream-enwiki-2022-12.tsv.gz,United_States_Electoral_College,11541,29936,120,41597,7804
hdfs://spark-nn.eemcs.utwente.nl/user/s1934538/clickstream/clickstream-enwiki-2022-12.tsv.gz,Avengers:_Infinity_War,59286,56350,1029,116665,55637
hdfs://spark-nn.eemcs.utwente.nl/user/s1934538/clickstream/clickstream-enwiki-2022-12.tsv.gz,The_Last_of_Us_(TV_series),77387,332002,4593,413982,285174
hdfs://spark-nn.eemcs.utwente.nl/user/s1934538/clickstream/clickstream-enwiki-2022-12.tsv.gz,List_of_awards_and_nominations_received_by_Meryl_Streep,6070,7415,28,13513,5838
hdfs://spark-nn.eemcs.utwente.nl/user/s1934538/clickstream/clickstream-enwiki-2022-12.tsv.gz,Gaza_Strip,22552,31738,232,54522,24802
hdfs://spark-nn.eemcs.utwente.nl/user/s1934538/clickstream/clickstream-enwiki-2022-12.tsv.gz,Emma_Raducanu,3877,53138,328,57343,10135
hdfs://spark-nn.eemcs.utwente.nl/user/s1934538/clickstream/clickstream-enwiki-2022-12.tsv.gz,The_Irishman,56306,89421,1491,147218,132721
hdfs://spark-nn.eemcs.utwente.nl/user/s1934538/clickstream/clickstream-enwiki-2022-12.tsv.gz,Kobe_Bryant,56184,333877,2622,392683,120476
hdfs://spark-nn.eemcs.utwente.nl/user/s1934538/clickstream/clickstream-enwiki-2022-12.tsv.gz,Ponniyin_Selvan:_I,65126,328673,1468,395267,238311
hdfs://spark-nn.eemcs.utwente.nl/user/s1934538/clickstream/clickstream-enwiki-2022-12.tsv.gz,Olivia_Newton-John,42418,217429,2826,262673,95278
hdfs://spark-nn.eemcs.utwente.nl/user/s1934538/clickstream/clickstream-enwiki-2022-12.tsv.gz,Richard_Jewell,8266,40014,233,48513,18327
hdfs://spark-nn.eemcs.utwente.nl/user/s1934538/clickstream/clickstream-enwiki-2022-12.tsv.gz,Star_Wars:_The_Rise_of_Skywalker,82894,56796,1300,140990,76509
hdfs://spark-nn.eemcs.utwente.nl/user/s1934538/clickstream/clickstream-enwiki-2022-12.tsv.gz,Line_shaft,350,624,11,985,87
hdfs://spark-nn.eemcs.utwente.nl/user/s1934538/clickstream/clickstream-enwiki-2022-12.tsv.gz,Cecil_Hotel_(Los_Angeles),5801,51566,152,57519,14117
hdfs://spark-nn.eemcs.utwente.nl/user/s1934538/clickstream/clickstream-enwiki-2022-12.tsv.gz,Sushma_Swaraj,8337,13639,33,22009,6694
hdfs://spark-nn.eemcs.utwente.nl/user/s1934538/clickstream/clickstream-enwiki-2022-12.tsv.gz,Jeffrey_Epstein,81159,344506,2131,427796,208131
hdfs://spark-nn.eemcs.utwente.nl/user/s1934538/clickstream/clickstream-enwiki-2022-12.tsv.gz,XNXX,14195,794297,7462,815954,70330
hdfs://spark-nn.eemcs.utwente.nl/user/s1934538/clickstream/clickstream-enwiki-2022-12.tsv.gz,Aaron_Carter,45037,295763,3128,343928,120106
hdfs://spark-nn.eemcs.utwente.nl/user/s1934538/clickstream/clickstream-enwiki-2022-12.tsv.gz,Thor:_Love_and_Thunder,98755,191767,4657,295179,157319
hdfs://spark-nn.eemcs.utwente.nl/user/s1934538/clickstream/clickstream-enwiki-2022-12.tsv.gz,Tonya_Harding,19554,72278,389,92221,25302
hdfs://spark-nn.eemcs.utwente.nl/user/s1934538/clickstream/clickstream-enwiki-2022-12.tsv.gz,United_States_Senate,81237,97360,3688,182285,96306
hdfs://spark-nn.eemcs.utwente.nl/user/s1934538/clickstream/clickstream-enwiki-2022-12.tsv.gz,Puneeth_Rajkumar,18634,65834,318,84786,34621
hdfs://spark-nn.eemcs.utwente.nl/user/s1934538/clickstream/clickstream-enwiki-2022-12.tsv.gz,Brie_Larson,59664,112706,792,173162,71827
hdfs://spark-nn.eemcs.utwente.nl/user/s1934538/clickstream/clickstream-enwiki-2022-12.tsv.gz,Roe_v._Wade,14413,100232,1316,115961,33740
hdfs://spark-nn.eemcs.utwente.nl/user/s1934538/clickstream/clickstream-enwiki-2022-12.tsv.gz,Pelé,541679,5296355,15668,5853702,2234299
hdfs://spark-nn.eemcs.utwente.nl/user/s1934538/clickstream/clickstream-enwiki-2022-12.tsv.gz,Zack_Snyder's_Justice_League,61075,70305,814,132194,61280
hdfs://spark-nn.eemcs.utwente.nl/user/s1934538/clickstream/clickstream-enwiki-2022-12.tsv.gz,2018_Asian_Games,11123,6833,47,18003,14794
hdfs://spark-nn.eemcs.utwente.nl/user/s1934538/clickstream/clickstream-enwiki-2022-12.tsv.gz,Deion_Sanders,57412,1035368,6239,1099019,363211
hdfs://spark-nn.eemcs.utwente.nl/user/s1934538/clickstream/clickstream-enwiki-2022-12.tsv.gz,Tom_Brady,88309,581751,5801,675861,240917
hdfs://spark-nn.eemcs.utwente.nl/user/s1934538/clickstream/clickstream-enwiki-2022-12.tsv.gz,Darth_Vader,25067,57502,625,83194,51496
hdfs://spark-nn.eemcs.utwente.nl/user/s1934538/clickstream/clickstream-enwiki-2022-12.tsv.gz,WrestleMania_34,11856,6142,66,18064,12143
hdfs://spark-nn.eemcs.utwente.nl/user/s1934538/clickstream/clickstream-enwiki-2022-12.tsv.gz,Coronavirus,6981,36358,745,44084,14243
hdfs://spark-nn.eemcs.utwente.nl/user/s1934538/clickstream/clickstream-enwiki-2022-12.tsv.gz,1917_(2019_film),23867,152011,2766,178644,102870
hdfs://spark-nn.eemcs.utwente.nl/user/s1934538/clickstream/clickstream-enwiki-2022-12.tsv.gz,Mac_Miller,24562,135082,997,160641,49048
hdfs://spark-nn.eemcs.utwente.nl/user/s1934538/clickstream/clickstream-enwiki-2022-12.tsv.gz,Game_of_Thrones,71981,251160,5648,328789,210299
hdfs://spark-nn.eemcs.utwente.nl/user/s1934538/clickstream/clickstream-enwiki-2022-12.tsv.gz,Everything_Everywhere_All_at_Once,113361,529768,11679,654808,350968
hdfs://spark-nn.eemcs.utwente.nl/user/s1934538/clickstream/clickstream-enwiki-2022-12.tsv.gz,List_of_Marvel_Cinematic_Universe_films,172107,464475,2214,638796,424666
hdfs://spark-nn.eemcs.utwente.nl/user/s1934538/clickstream/clickstream-enwiki-2022-12.tsv.gz,Main_Page,73757,135948233,5094876,141116866,34235482
hdfs://spark-nn.eemcs.utwente.nl/user/s1934538/clickstream/clickstream-enwiki-2022-12.tsv.gz,Greta_Thunberg,49714,609360,4444,663518,161469
hdfs://spark-nn.eemcs.utwente.nl/user/s1934538/clickstream/clickstream-enwiki-2022-12.tsv.gz,Bonnie_and_Clyde,20135,190196,1271,211602,53925
hdfs://spark-nn.eemcs.utwente.nl/user/s1934538/clickstream/clickstream-enwiki-2022-12.tsv.gz,Mortal_Kombat_(2021_film),20326,68501,978,89805,89474
hdfs://spark-nn.eemcs.utwente.nl/user/s1934538/clickstream/clickstream-enwiki-2022-12.tsv.gz,Guardians_of_the_Galaxy_Vol._3,155903,197250,7465,360618,326292
hdfs://spark-nn.eemcs.utwente.nl/user/s1934538/clickstream/clickstream-enwiki-2022-12.tsv.gz,Wonder_Woman_1984,52497,88753,2427,143677,72171
hdfs://spark-nn.eemcs.utwente.nl/user/s1934538/clickstream/clickstream-enwiki-2022-12.tsv.gz,K.G.F:_Chapter_2,48406,164450,880,213736,66399
hdfs://spark-nn.eemcs.utwente.nl/user/s1934538/clickstream/clickstream-enwiki-2022-12.tsv.gz,Keanu_Reeves,72337,482626,2662,557625,342194
hdfs://spark-nn.eemcs.utwente.nl/user/s1934538/clickstream/clickstream-enwiki-2022-12.tsv.gz,2.0_(film),21085,30123,43,51251,12394
hdfs://spark-nn.eemcs.utwente.nl/user/s1934538/clickstream/clickstream-enwiki-2022-12.tsv.gz,Mission:_Impossible_–_Dead_Reckoning_Part_One,102133,85436,1315,188884,157383
hdfs://spark-nn.eemcs.utwente.nl/user/s1934538/clickstream/clickstream-enwiki-2022-12.tsv.gz,Anne_Heche,41788,335677,2781,380246,119187
hdfs://spark-nn.eemcs.utwente.nl/user/s1934538/clickstream/clickstream-enwiki-2022-12.tsv.gz,Death_of_Elisa_Lam,11459,51995,181,63635,20912
hdfs://spark-nn.eemcs.utwente.nl/user/s1934538/clickstream/clickstream-enwiki-2022-12.tsv.gz,J._Robert_Oppenheimer,193189,988922,2081,1184192,433955
hdfs://spark-nn.eemcs.utwente.nl/user/s1934538/clickstream/clickstream-enwiki-2022-12.tsv.gz,HTTP_cookie,2218,223422,100,225740,26056
hdfs://spark-nn.eemcs.utwente.nl/user/s1934538/clickstream/clickstream-enwiki-2022-12.tsv.gz,Gadar_2,16902,59544,30,76476,47925
hdfs://spark-nn.eemcs.utwente.nl/user/s1934538/clickstream/clickstream-enwiki-2022-12.tsv.gz,Jimmy_Buffett,8235,47244,507,55986,19736
hdfs://spark-nn.eemcs.utwente.nl/user/s1934538/clickstream/clickstream-enwiki-2022-12.tsv.gz,Bible,20227,75257,1589,97073,35075
hdfs://spark-nn.eemcs.utwente.nl/user/s1934538/clickstream/clickstream-enwiki-2022-12.tsv.gz,Tenet_(film),78244,134365,1590,214199,111270
hdfs://spark-nn.eemcs.utwente.nl/user/s1934538/clickstream/clickstream-enwiki-2022-12.tsv.gz,Ant-Man_and_the_Wasp:_Quantumania,95064,85495,2502,183061,113405
hdfs://spark-nn.eemcs.utwente.nl/user/s1934538/clickstream/clickstream-enwiki-2022-12.tsv.gz,Black_Widow_(2021_film),44650,64335,1020,110005,55016
hdfs://spark-nn.eemcs.utwente.nl/user/s1934538/clickstream/clickstream-enwiki-2022-12.tsv.gz,No_Time_to_Die,133420,171202,2758,307380,184015
hdfs://spark-nn.eemcs.utwente.nl/user/s1934538/clickstream/clickstream-enwiki-2022-12.tsv.gz,UEFA_Euro_2020,303878,567488,7706,879072,381179
hdfs://spark-nn.eemcs.utwente.nl/user/s1934538/clickstream/clickstream-enwiki-2022-12.tsv.gz,Chadwick_Boseman,77879,255834,1164,334877,83985
hdfs://spark-nn.eemcs.utwente.nl/user/s1934538/clickstream/clickstream-enwiki-2022-12.tsv.gz,Glass_(2019_film),45281,43240,864,89385,30804
hdfs://spark-nn.eemcs.utwente.nl/user/s1934538/clickstream/clickstream-enwiki-2022-12.tsv.gz,Mötley_Crüe,28245,85993,1139,115377,134562
hdfs://spark-nn.eemcs.utwente.nl/user/s1934538/clickstream/clickstream-enwiki-2022-12.tsv.gz,Irrfan_Khan,22650,51474,138,74262,28083
hdfs://spark-nn.eemcs.utwente.nl/user/s1934538/clickstream/clickstream-enwiki-2022-12.tsv.gz,Lisa_Marie_Presley,218555,153249,371,372175,215210
hdfs://spark-nn.eemcs.utwente.nl/user/s1934538/clickstream/clickstream-enwiki-2022-12.tsv.gz,"Diana,_Princess_of_Wales",334581,748737,7002,1090320,654268
hdfs://spark-nn.eemcs.utwente.nl/user/s1934538/clickstream/clickstream-enwiki-2022-12.tsv.gz,XXXTentacion,88307,1194671,6433,1289411,132982
hdfs://spark-nn.eemcs.utwente.nl/user/s1934538/clickstream/clickstream-enwiki-2022-12.tsv.gz,Joaquin_Phoenix,132362,147567,887,280816,177741
hdfs://spark-nn.eemcs.utwente.nl/user/s1934538/clickstream/clickstream-enwiki-2022-12.tsv.gz,Adipurush,37100,54081,164,91345,44560
hdfs://spark-nn.eemcs.utwente.nl/user/s1934538/clickstream/clickstream-enwiki-2022-12.tsv.gz,The_Falcon_and_the_Winter_Soldier,21367,29679,606,51652,32893
hdfs://spark-nn.eemcs.utwente.nl/user/s1934538/clickstream/clickstream-enwiki-2022-12.tsv.gz,ICC_Men's_T20_World_Cup,18524,96261,599,115384,57090
hdfs://spark-nn.eemcs.utwente.nl/user/s1934538/clickstream/clickstream-enwiki-2022-12.tsv.gz,State_of_Palestine,69821,171990,594,242405,106287
hdfs://spark-nn.eemcs.utwente.nl/user/s1934538/clickstream/clickstream-enwiki-2022-12.tsv.gz,Hamas,28803,26741,246,55790,29749
hdfs://spark-nn.eemcs.utwente.nl/user/s1934538/clickstream/clickstream-enwiki-2022-12.tsv.gz,Sushant_Singh_Rajput,15785,105345,264,121394,51301
hdfs://spark-nn.eemcs.utwente.nl/user/s1934538/clickstream/clickstream-enwiki-2022-12.tsv.gz,Avatar:_The_Way_of_Water,1182693,8638466,168229,9989388,4959774
hdfs://spark-nn.eemcs.utwente.nl/user/s1934538/clickstream/clickstream-enwiki-2018-11.tsv.gz,Game_of_Thrones_(season_8),54947,387853,1394,444194,141077
hdfs://spark-nn.eemcs.utwente.nl/user/s1934538/clickstream/clickstream-enwiki-2018-11.tsv.gz,Queen_(band),664951,2668320,32432,3365703,3699016
hdfs://spark-nn.eemcs.utwente.nl/user/s1934538/clickstream/clickstream-enwiki-2018-11.tsv.gz,Deion_Sanders,11601,93030,487,105118,27278
hdfs://spark-nn.eemcs.utwente.nl/user/s1934538/clickstream/clickstream-enwiki-2018-11.tsv.gz,Donald_Glover,104822,267773,2721,375316,95371
hdfs://spark-nn.eemcs.utwente.nl/user/s1934538/clickstream/clickstream-enwiki-2018-11.tsv.gz,WrestleMania_34,33700,34303,903,68906,48125
hdfs://spark-nn.eemcs.utwente.nl/user/s1934538/clickstream/clickstream-enwiki-2018-11.tsv.gz,R._Kelly,22210,91232,669,114111,55445
hdfs://spark-nn.eemcs.utwente.nl/user/s1934538/clickstream/clickstream-enwiki-2018-11.tsv.gz,State_of_Palestine,42975,79384,860,123219,54271
hdfs://spark-nn.eemcs.utwente.nl/user/s1934538/clickstream/clickstream-enwiki-2018-11.tsv.gz,List_of_highest-grossing_films,127949,319902,1786,449637,209892
hdfs://spark-nn.eemcs.utwente.nl/user/s1934538/clickstream/clickstream-enwiki-2018-11.tsv.gz,2018_FIFA_World_Cup,61873,1268244,2448,1332565,129961
hdfs://spark-nn.eemcs.utwente.nl/user/s1934538/clickstream/clickstream-enwiki-2018-11.tsv.gz,A_Star_Is_Born_(2018_film),115443,1511633,17482,1644558,738139
hdfs://spark-nn.eemcs.utwente.nl/user/s1934538/clickstream/clickstream-enwiki-2018-11.tsv.gz,Joaquin_Phoenix,118741,144415,871,264027,183969
hdfs://spark-nn.eemcs.utwente.nl/user/s1934538/clickstream/clickstream-enwiki-2018-11.tsv.gz,2018_Winter_Olympics,27866,97288,584,125738,40974
hdfs://spark-nn.eemcs.utwente.nl/user/s1934538/clickstream/clickstream-enwiki-2018-11.tsv.gz,Anne_Heche,25618,41279,506,67403,18914
hdfs://spark-nn.eemcs.utwente.nl/user/s1934538/clickstream/clickstream-enwiki-2018-11.tsv.gz,Grover,1053,5944,34,7031,1276
hdfs://spark-nn.eemcs.utwente.nl/user/s1934538/clickstream/clickstream-enwiki-2018-11.tsv.gz,Cook's_Country,379,10072,22,10473,60
hdfs://spark-nn.eemcs.utwente.nl/user/s1934538/clickstream/clickstream-enwiki-2018-11.tsv.gz,Jeffrey_Dahmer,28703,353715,3223,385641,151256
hdfs://spark-nn.eemcs.utwente.nl/user/s1934538/clickstream/clickstream-enwiki-2018-11.tsv.gz,XXXTentacion,131993,566991,11762,710746,222815
hdfs://spark-nn.eemcs.utwente.nl/user/s1934538/clickstream/clickstream-enwiki-2018-11.tsv.gz,Priyanka_Chopra,153648,620799,3063,777510,297272
hdfs://spark-nn.eemcs.utwente.nl/user/s1934538/clickstream/clickstream-enwiki-2018-11.tsv.gz,Aretha_Franklin,20498,247826,1347,269671,36893
hdfs://spark-nn.eemcs.utwente.nl/user/s1934538/clickstream/clickstream-enwiki-2018-11.tsv.gz,Asia_Cup,2242,15614,85,17941,4141
hdfs://spark-nn.eemcs.utwente.nl/user/s1934538/clickstream/clickstream-enwiki-2018-11.tsv.gz,DMX_(rapper),12872,73859,486,87217,32316
hdfs://spark-nn.eemcs.utwente.nl/user/s1934538/clickstream/clickstream-enwiki-2018-11.tsv.gz,Gaza_Strip,15917,59726,395,76038,27126
hdfs://spark-nn.eemcs.utwente.nl/user/s1934538/clickstream/clickstream-enwiki-2018-11.tsv.gz,Captain_Marvel_(film),108594,142743,2773,254110,159894
hdfs://spark-nn.eemcs.utwente.nl/user/s1934538/clickstream/clickstream-enwiki-2018-11.tsv.gz,XHamster,7770,4395192,2204,4405166,41243
hdfs://spark-nn.eemcs.utwente.nl/user/s1934538/clickstream/clickstream-enwiki-2018-11.tsv.gz,Exo_(band),31224,4252007,1280,4284511,3386646
hdfs://spark-nn.eemcs.utwente.nl/user/s1934538/clickstream/clickstream-enwiki-2018-11.tsv.gz,Tasuku_Honjo,3033,10466,25,13524,3073
hdfs://spark-nn.eemcs.utwente.nl/user/s1934538/clickstream/clickstream-enwiki-2018-11.tsv.gz,Deadpool_2,105847,221599,8004,335450,211004
hdfs://spark-nn.eemcs.utwente.nl/user/s1934538/clickstream/clickstream-enwiki-2018-11.tsv.gz,2.0_(film),102367,1638156,28097,1768620,564782
hdfs://spark-nn.eemcs.utwente.nl/user/s1934538/clickstream/clickstream-enwiki-2018-11.tsv.gz,David_Beckham,43247,181940,1245,226432,62823
hdfs://spark-nn.eemcs.utwente.nl/user/s1934538/clickstream/clickstream-enwiki-2018-11.tsv.gz,XNXX,53,6728,124,6905,802
hdfs://spark-nn.eemcs.utwente.nl/user/s1934538/clickstream/clickstream-enwiki-2018-11.tsv.gz,The_Mandalorian,29378,33300,402,63080,32103
hdfs://spark-nn.eemcs.utwente.nl/user/s1934538/clickstream/clickstream-enwiki-2018-11.tsv.gz,J._Robert_Oppenheimer,16124,68061,246,84431,26436
hdfs://spark-nn.eemcs.utwente.nl/user/s1934538/clickstream/clickstream-enwiki-2018-11.tsv.gz,Cameron_Boyce,9993,22724,140,32857,6524
hdfs://spark-nn.eemcs.utwente.nl/user/s1934538/clickstream/clickstream-enwiki-2018-11.tsv.gz,Sylvester_Stallone,131014,601850,3305,736169,421251
hdfs://spark-nn.eemcs.utwente.nl/user/s1934538/clickstream/clickstream-enwiki-2018-11.tsv.gz,Luke_Perry,31641,45469,327,77437,13982
hdfs://spark-nn.eemcs.utwente.nl/user/s1934538/clickstream/clickstream-enwiki-2018-11.tsv.gz,Aaron_Carter,18962,57448,339,76749,23949
hdfs://spark-nn.eemcs.utwente.nl/user/s1934538/clickstream/clickstream-enwiki-2018-11.tsv.gz,Amy_Coney_Barrett,4612,25672,314,30598,4724
hdfs://spark-nn.eemcs.utwente.nl/user/s1934538/clickstream/clickstream-enwiki-2018-11.tsv.gz,2022_FIFA_World_Cup,44364,81008,1385,126757,70328
hdfs://spark-nn.eemcs.utwente.nl/user/s1934538/clickstream/clickstream-enwiki-2018-11.tsv.gz,Wikipedia,45678,524795,1381,571854,223198
hdfs://spark-nn.eemcs.utwente.nl/user/s1934538/clickstream/clickstream-enwiki-2018-11.tsv.gz,Johnny_Depp,142364,387752,3673,533789,346333
hdfs://spark-nn.eemcs.utwente.nl/user/s1934538/clickstream/clickstream-enwiki-2018-11.tsv.gz,"Prince_Philip,_Duke_of_Edinburgh",224967,311868,16611,553446,313390
hdfs://spark-nn.eemcs.utwente.nl/user/s1934538/clickstream/clickstream-enwiki-2018-11.tsv.gz,The_Lion_King_(2019_film),166418,551751,8259,726428,950816
hdfs://spark-nn.eemcs.utwente.nl/user/s1934538/clickstream/clickstream-enwiki-2018-11.tsv.gz,Aquaman_(film),101241,326199,10818,438258,246727
hdfs://spark-nn.eemcs.utwente.nl/user/s1934538/clickstream/clickstream-enwiki-2018-11.tsv.gz,Indian_Premier_League,13278,40225,76,53579,31258
hdfs://spark-nn.eemcs.utwente.nl/user/s1934538/clickstream/clickstream-enwiki-2018-11.tsv.gz,Lisa_Marie_Presley,119898,74671,237,194806,97770
hdfs://spark-nn.eemcs.utwente.nl/user/s1934538/clickstream/clickstream-enwiki-2018-11.tsv.gz,Spanish_flu,37148,124895,3099,165142,33311
hdfs://spark-nn.eemcs.utwente.nl/user/s1934538/clickstream/clickstream-enwiki-2018-11.tsv.gz,Tina_Turner,16756,436699,5497,458952,80113
hdfs://spark-nn.eemcs.utwente.nl/user/s1934538/clickstream/clickstream-enwiki-2018-11.tsv.gz,FIFA_World_Cup,28502,111060,1492,141054,90891
hdfs://spark-nn.eemcs.utwente.nl/user/s1934538/clickstream/clickstream-enwiki-2018-11.tsv.gz,Aaron_Hernandez,15712,145348,933,161993,42277
hdfs://spark-nn.eemcs.utwente.nl/user/s1934538/clickstream/clickstream-enwiki-2018-11.tsv.gz,Afghanistan,43389,142520,2056,187965,126211
hdfs://spark-nn.eemcs.utwente.nl/user/s1934538/clickstream/clickstream-enwiki-2018-11.tsv.gz,Line_shaft,614,1154,49,1817,123
hdfs://spark-nn.eemcs.utwente.nl/user/s1934538/clickstream/clickstream-enwiki-2018-11.tsv.gz,Pornhub,34525,429756,9694,473975,76877
hdfs://spark-nn.eemcs.utwente.nl/user/s1934538/clickstream/clickstream-enwiki-2018-11.tsv.gz,John_McCain,39045,481487,2009,522541,91366
hdfs://spark-nn.eemcs.utwente.nl/user/s1934538/clickstream/clickstream-enwiki-2018-11.tsv.gz,Bipin_Rawat,4716,19200,16,23932,7893
hdfs://spark-nn.eemcs.utwente.nl/user/s1934538/clickstream/clickstream-enwiki-2018-11.tsv.gz,Dennis_Nilsen,4958,28266,151,33375,6148
hdfs://spark-nn.eemcs.utwente.nl/user/s1934538/clickstream/clickstream-enwiki-2018-11.tsv.gz,Media,63,211344,434,211841,3006
hdfs://spark-nn.eemcs.utwente.nl/user/s1934538/clickstream/clickstream-enwiki-2018-11.tsv.gz,Joe_Biden,41029,137216,2291,180536,67191
hdfs://spark-nn.eemcs.utwente.nl/user/s1934538/clickstream/clickstream-enwiki-2018-11.tsv.gz,Naomi_Osaka,4434,42933,149,47516,6279
hdfs://spark-nn.eemcs.utwente.nl/user/s1934538/clickstream/clickstream-enwiki-2018-11.tsv.gz,Simone_Biles,18062,129072,1205,148339,45704
hdfs://spark-nn.eemcs.utwente.nl/user/s1934538/clickstream/clickstream-enwiki-2018-11.tsv.gz,Jeffrey_Epstein,9078,97756,621,107455,36685
hdfs://spark-nn.eemcs.utwente.nl/user/s1934538/clickstream/clickstream-enwiki-2018-11.tsv.gz,Lance_Reddick,26198,18865,100,45163,8238
hdfs://spark-nn.eemcs.utwente.nl/user/s1934538/clickstream/clickstream-enwiki-2018-11.tsv.gz,Key_frame,663,6752,10,7425,684
hdfs://spark-nn.eemcs.utwente.nl/user/s1934538/clickstream/clickstream-enwiki-2018-11.tsv.gz,Chernobyl_disaster,32911,226946,5720,265577,74815
hdfs://spark-nn.eemcs.utwente.nl/user/s1934538/clickstream/clickstream-enwiki-2018-11.tsv.gz,Rihanna,51360,242281,3017,296658,139842
hdfs://spark-nn.eemcs.utwente.nl/user/s1934538/clickstream/clickstream-enwiki-2018-11.tsv.gz,Article_370_of_the_Constitution_of_India,3705,22604,25,26334,2119
hdfs://spark-nn.eemcs.utwente.nl/user/s1934538/clickstream/clickstream-enwiki-2018-11.tsv.gz,1234,66,1654,22,1742,131
hdfs://spark-nn.eemcs.utwente.nl/user/s1934538/clickstream/clickstream-enwiki-2018-11.tsv.gz,Brie_Larson,85328,109356,876,195560,72193
hdfs://spark-nn.eemcs.utwente.nl/user/s1934538/clickstream/clickstream-enwiki-2018-11.tsv.gz,Juneteenth,4090,17022,52,21164,2283
hdfs://spark-nn.eemcs.utwente.nl/user/s1934538/clickstream/clickstream-enwiki-2018-11.tsv.gz,Sushma_Swaraj,5007,72835,131,77973,12927
hdfs://spark-nn.eemcs.utwente.nl/user/s1934538/clickstream/clickstream-enwiki-2018-11.tsv.gz,Charles_III,131,360,81,572,402
hdfs://spark-nn.eemcs.utwente.nl/user/s1934538/clickstream/clickstream-enwiki-2018-11.tsv.gz,Cricket_World_Cup,8618,153259,445,162322,79162
hdfs://spark-nn.eemcs.utwente.nl/user/s1934538/clickstream/clickstream-enwiki-2018-11.tsv.gz,Stephen_Hawking,40426,516874,4356,561656,154691
hdfs://spark-nn.eemcs.utwente.nl/user/s1934538/clickstream/clickstream-enwiki-2018-11.tsv.gz,Jimmy_Hoffa,22276,76673,545,99494,31989
hdfs://spark-nn.eemcs.utwente.nl/user/s1934538/clickstream/clickstream-enwiki-2018-11.tsv.gz,Juice_Wrld,15583,124233,1982,141798,38462
hdfs://spark-nn.eemcs.utwente.nl/user/s1934538/clickstream/clickstream-enwiki-2018-11.tsv.gz,Stranger_Things,50290,339281,8084,397655,260612
hdfs://spark-nn.eemcs.utwente.nl/user/s1934538/clickstream/clickstream-enwiki-2018-11.tsv.gz,Elon_Musk,82382,960815,5775,1048972,433884
hdfs://spark-nn.eemcs.utwente.nl/user/s1934538/clickstream/clickstream-enwiki-2018-11.tsv.gz,Roe_v._Wade,14925,127003,729,142657,34384
hdfs://spark-nn.eemcs.utwente.nl/user/s1934538/clickstream/clickstream-enwiki-2018-11.tsv.gz,Matthew_Perry,61538,177107,962,239607,121923
hdfs://spark-nn.eemcs.utwente.nl/user/s1934538/clickstream/clickstream-enwiki-2018-11.tsv.gz,Cleopatra,38477,176639,4020,219136,80655
hdfs://spark-nn.eemcs.utwente.nl/user/s1934538/clickstream/clickstream-enwiki-2018-11.tsv.gz,List_of_Marvel_Cinematic_Universe_films,71071,656031,2195,729297,216651
hdfs://spark-nn.eemcs.utwente.nl/user/s1934538/clickstream/clickstream-enwiki-2018-11.tsv.gz,Sridevi,32678,117420,441,150539,46254
hdfs://spark-nn.eemcs.utwente.nl/user/s1934538/clickstream/clickstream-enwiki-2018-11.tsv.gz,Keanu_Reeves,61458,352848,2061,416367,189694
hdfs://spark-nn.eemcs.utwente.nl/user/s1934538/clickstream/clickstream-enwiki-2018-11.tsv.gz,"Princess_Margaret,_Countess_of_Snowdon",120401,355987,2168,478556,284888
hdfs://spark-nn.eemcs.utwente.nl/user/s1934538/clickstream/clickstream-enwiki-2018-11.tsv.gz,George_VI,345593,195901,2150,543644,380784
hdfs://spark-nn.eemcs.utwente.nl/user/s1934538/clickstream/clickstream-enwiki-2018-11.tsv.gz,Hamilton_(musical),31487,265864,1803,299154,154697
hdfs://spark-nn.eemcs.utwente.nl/user/s1934538/clickstream/clickstream-enwiki-2018-11.tsv.gz,Olivia_Newton-John,18994,77534,745,97273,39167
hdfs://spark-nn.eemcs.utwente.nl/user/s1934538/clickstream/clickstream-enwiki-2018-11.tsv.gz,"Meghan,_Duchess_of_Sussex",103557,559088,2944,665589,267026
hdfs://spark-nn.eemcs.utwente.nl/user/s1934538/clickstream/clickstream-enwiki-2018-11.tsv.gz,Sushant_Singh_Rajput,34170,115349,406,149925,89933
hdfs://spark-nn.eemcs.utwente.nl/user/s1934538/clickstream/clickstream-enwiki-2018-11.tsv.gz,Google_logo,1088,16399,15,17502,2368
hdfs://spark-nn.eemcs.utwente.nl/user/s1934538/clickstream/clickstream-enwiki-2018-11.tsv.gz,JSON_Web_Token,1003,20106,20,21129,1959
hdfs://spark-nn.eemcs.utwente.nl/user/s1934538/clickstream/clickstream-enwiki-2018-11.tsv.gz,Antifa_(United_States),14892,230360,550,245802,30026
hdfs://spark-nn.eemcs.utwente.nl/user/s1934538/clickstream/clickstream-enwiki-2018-11.tsv.gz,Critical_race_theory,1865,18417,35,20317,3571
hdfs://spark-nn.eemcs.utwente.nl/user/s1934538/clickstream/clickstream-enwiki-2018-11.tsv.gz,Naya_Rivera,21207,26686,74,47967,9091
hdfs://spark-nn.eemcs.utwente.nl/user/s1934538/clickstream/clickstream-enwiki-2018-11.tsv.gz,A_Quiet_Place_(film),36821,231035,2242,270098,67803
hdfs://spark-nn.eemcs.utwente.nl/user/s1934538/clickstream/clickstream-enwiki-2018-11.tsv.gz,Cecil_Hotel_(Los_Angeles),6328,25598,31,31957,10810
hdfs://spark-nn.eemcs.utwente.nl/user/s1934538/clickstream/clickstream-enwiki-2018-11.tsv.gz,Kobe_Bryant,38055,209552,1679,249286,63513
hdfs://spark-nn.eemcs.utwente.nl/user/s1934538/clickstream/clickstream-enwiki-2018-11.tsv.gz,Khabib_Nurmagomedov,42648,153743,1925,198316,90144
hdfs://spark-nn.eemcs.utwente.nl/user/s1934538/clickstream/clickstream-enwiki-2018-11.tsv.gz,The_Witcher_(TV_series),22278,27165,336,49779,9413
hdfs://spark-nn.eemcs.utwente.nl/user/s1934538/clickstream/clickstream-enwiki-2018-11.tsv.gz,Us_(2019_film),20128,12499,537,33164,16235
hdfs://spark-nn.eemcs.utwente.nl/user/s1934538/clickstream/clickstream-enwiki-2018-11.tsv.gz,Richard_Ramirez,9336,117551,1727,128614,29793
hdfs://spark-nn.eemcs.utwente.nl/user/s1934538/clickstream/clickstream-enwiki-2018-11.tsv.gz,Cristiano_Ronaldo,100021,714981,4354,819356,159833
hdfs://spark-nn.eemcs.utwente.nl/user/s1934538/clickstream/clickstream-enwiki-2018-11.tsv.gz,Area_51,13148,179058,1284,193490,47627
hdfs://spark-nn.eemcs.utwente.nl/user/s1934538/clickstream/clickstream-enwiki-2018-11.tsv.gz,William_Murdoch,610,1431,12,2053,277
hdfs://spark-nn.eemcs.utwente.nl/user/s1934538/clickstream/clickstream-enwiki-2018-11.tsv.gz,Dark_Phoenix_(film),94404,57116,985,152505,101651
hdfs://spark-nn.eemcs.utwente.nl/user/s1934538/clickstream/clickstream-enwiki-2018-11.tsv.gz,The_Weeknd,48706,134380,1179,184265,70519
hdfs://spark-nn.eemcs.utwente.nl/user/s1934538/clickstream/clickstream-enwiki-2018-11.tsv.gz,Coronavirus,945,8336,41,9322,1433
hdfs://spark-nn.eemcs.utwente.nl/user/s1934538/clickstream/clickstream-enwiki-2018-11.tsv.gz,Darth_Vader,18787,3336244,755,3355786,48138
hdfs://spark-nn.eemcs.utwente.nl/user/s1934538/clickstream/clickstream-enwiki-2018-11.tsv.gz,The_Irishman,59,403,27,489,489
hdfs://spark-nn.eemcs.utwente.nl/user/s1934538/clickstream/clickstream-enwiki-2018-11.tsv.gz,Vladimir_Putin,58881,220337,2770,281988,136503
hdfs://spark-nn.eemcs.utwente.nl/user/s1934538/clickstream/clickstream-enwiki-2018-11.tsv.gz,The_Irishman_(2019_film),58439,46980,379,105798,88128
hdfs://spark-nn.eemcs.utwente.nl/user/s1934538/clickstream/clickstream-enwiki-2018-11.tsv.gz,2020_United_States_presidential_election,24781,245506,2564,272851,25864
hdfs://spark-nn.eemcs.utwente.nl/user/s1934538/clickstream/clickstream-enwiki-2018-11.tsv.gz,NATO,38322,147648,2724,188694,63531
hdfs://spark-nn.eemcs.utwente.nl/user/s1934538/clickstream/clickstream-enwiki-2018-11.tsv.gz,Fantastic_Beasts:_The_Crimes_of_Grindelwald,492579,2326751,53461,2872791,1524954
hdfs://spark-nn.eemcs.utwente.nl/user/s1934538/clickstream/clickstream-enwiki-2018-11.tsv.gz,Puneeth_Rajkumar,12542,23316,26,35884,17688
hdfs://spark-nn.eemcs.utwente.nl/user/s1934538/clickstream/clickstream-enwiki-2018-11.tsv.gz,Louis_Tomlinson,40150,105996,517,146663,19875
hdfs://spark-nn.eemcs.utwente.nl/user/s1934538/clickstream/clickstream-enwiki-2018-11.tsv.gz,Chadwick_Boseman,46394,88125,768,135287,38791
hdfs://spark-nn.eemcs.utwente.nl/user/s1934538/clickstream/clickstream-enwiki-2018-11.tsv.gz,Eddie_Van_Halen,24897,36516,312,61725,24380
hdfs://spark-nn.eemcs.utwente.nl/user/s1934538/clickstream/clickstream-enwiki-2018-11.tsv.gz,Irrfan_Khan,26412,59978,199,86589,39893
hdfs://spark-nn.eemcs.utwente.nl/user/s1934538/clickstream/clickstream-enwiki-2018-11.tsv.gz,Avicii,19589,215634,2579,237802,53412
hdfs://spark-nn.eemcs.utwente.nl/user/s1934538/clickstream/clickstream-enwiki-2018-11.tsv.gz,Kate_Spade,19682,73256,601,93539,29388
hdfs://spark-nn.eemcs.utwente.nl/user/s1934538/clickstream/clickstream-enwiki-2018-11.tsv.gz,Saaho,59137,60262,958,120357,81366
hdfs://spark-nn.eemcs.utwente.nl/user/s1934538/clickstream/clickstream-enwiki-2018-11.tsv.gz,United_States_Electoral_College,38688,149175,271,188134,28515
hdfs://spark-nn.eemcs.utwente.nl/user/s1934538/clickstream/clickstream-enwiki-2018-11.tsv.gz,Tom_Brady,62636,381879,3663,448178,137898
hdfs://spark-nn.eemcs.utwente.nl/user/s1934538/clickstream/clickstream-enwiki-2018-11.tsv.gz,Kelly_Preston,58895,37075,129,96099,25814
hdfs://spark-nn.eemcs.utwente.nl/user/s1934538/clickstream/clickstream-enwiki-2018-11.tsv.gz,Kamala_Harris,32413,311013,2518,345944,101904
hdfs://spark-nn.eemcs.utwente.nl/user/s1934538/clickstream/clickstream-enwiki-2018-11.tsv.gz,2016_United_States_presidential_election,65344,426606,4017,495967,36770
hdfs://spark-nn.eemcs.utwente.nl/user/s1934538/clickstream/clickstream-enwiki-2018-11.tsv.gz,Israel,71212,285717,4852,361781,163121
hdfs://spark-nn.eemcs.utwente.nl/user/s1934538/clickstream/clickstream-enwiki-2018-11.tsv.gz,The_Shape_of_Water,33683,143104,2039,178826,91166
hdfs://spark-nn.eemcs.utwente.nl/user/s1934538/clickstream/clickstream-enwiki-2018-11.tsv.gz,Simple_Mail_Transfer_Protocol,5135,45110,151,50396,6295
hdfs://spark-nn.eemcs.utwente.nl/user/s1934538/clickstream/clickstream-enwiki-2018-12.tsv.gz,Charles_Sobhraj,3124,29192,110,32426,5229
hdfs://spark-nn.eemcs.utwente.nl/user/s1934538/clickstream/clickstream-enwiki-2018-12.tsv.gz,Naomi_Osaka,4678,40884,160,45722,6005
hdfs://spark-nn.eemcs.utwente.nl/user/s1934538/clickstream/clickstream-enwiki-2018-12.tsv.gz,Tina_Turner,17221,276025,2130,295376,66368
hdfs://spark-nn.eemcs.utwente.nl/user/s1934538/clickstream/clickstream-enwiki-2018-12.tsv.gz,Game_of_Thrones,109420,544808,14208,668436,469348
hdfs://spark-nn.eemcs.utwente.nl/user/s1934538/clickstream/clickstream-enwiki-2018-12.tsv.gz,Antifa_(United_States),8677,112130,408,121215,17446
hdfs://spark-nn.eemcs.utwente.nl/user/s1934538/clickstream/clickstream-enwiki-2018-12.tsv.gz,"Meghan,_Duchess_of_Sussex",108369,579293,3759,691421,327761
hdfs://spark-nn.eemcs.utwente.nl/user/s1934538/clickstream/clickstream-enwiki-2018-12.tsv.gz,List_of_highest-grossing_Indian_films,381422,1508483,1889,1891794,764540
hdfs://spark-nn.eemcs.utwente.nl/user/s1934538/clickstream/clickstream-enwiki-2018-12.tsv.gz,Freddie_Mercury,336621,2569491,17278,2923390,1177981
hdfs://spark-nn.eemcs.utwente.nl/user/s1934538/clickstream/clickstream-enwiki-2018-12.tsv.gz,Wikipedia,48973,501726,1426,552125,251546
hdfs://spark-nn.eemcs.utwente.nl/user/s1934538/clickstream/clickstream-enwiki-2018-12.tsv.gz,Juice_Wrld,19129,132461,1178,152768,42609
hdfs://spark-nn.eemcs.utwente.nl/user/s1934538/clickstream/clickstream-enwiki-2018-12.tsv.gz,Kobe_Bryant,34230,216699,1530,252459,66378
hdfs://spark-nn.eemcs.utwente.nl/user/s1934538/clickstream/clickstream-enwiki-2018-12.tsv.gz,Kobe_Bryant_sexual_assault_case,2797,21570,15,24382,2900
hdfs://spark-nn.eemcs.utwente.nl/user/s1934538/clickstream/clickstream-enwiki-2018-12.tsv.gz,Vladimir_Putin,70145,309023,4058,383226,189962
hdfs://spark-nn.eemcs.utwente.nl/user/s1934538/clickstream/clickstream-enwiki-2018-12.tsv.gz,FIFA_World_Cup,29372,108851,1613,139836,99324
hdfs://spark-nn.eemcs.utwente.nl/user/s1934538/clickstream/clickstream-enwiki-2018-12.tsv.gz,2022_FIFA_World_Cup,43405,83061,1369,127835,70380
hdfs://spark-nn.eemcs.utwente.nl/user/s1934538/clickstream/clickstream-enwiki-2018-12.tsv.gz,John_McCain,42040,161456,1945,205441,86429
hdfs://spark-nn.eemcs.utwente.nl/user/s1934538/clickstream/clickstream-enwiki-2018-12.tsv.gz,Keanu_Reeves,81590,505676,2935,590201,268426
hdfs://spark-nn.eemcs.utwente.nl/user/s1934538/clickstream/clickstream-enwiki-2018-12.tsv.gz,Black_Panther_(film),107909,303462,7296,418667,275535
hdfs://spark-nn.eemcs.utwente.nl/user/s1934538/clickstream/clickstream-enwiki-2018-12.tsv.gz,Tasuku_Honjo,3101,9624,23,12748,3472
hdfs://spark-nn.eemcs.utwente.nl/user/s1934538/clickstream/clickstream-enwiki-2018-12.tsv.gz,XXX:_Return_of_Xander_Cage,37849,106776,1074,145699,27661
hdfs://spark-nn.eemcs.utwente.nl/user/s1934538/clickstream/clickstream-enwiki-2018-12.tsv.gz,Fantastic_Beasts:_The_Crimes_of_Grindelwald,223384,837718,17820,1078922,549330
hdfs://spark-nn.eemcs.utwente.nl/user/s1934538/clickstream/clickstream-enwiki-2018-12.tsv.gz,The_Umbrella_Academy_(TV_series),24869,28984,492,54345,40700
hdfs://spark-nn.eemcs.utwente.nl/user/s1934538/clickstream/clickstream-enwiki-2018-12.tsv.gz,A_Quiet_Place_(film),65657,577958,7498,651113,164801
hdfs://spark-nn.eemcs.utwente.nl/user/s1934538/clickstream/clickstream-enwiki-2018-12.tsv.gz,XHamster,10203,4342481,2263,4354947,33945
hdfs://spark-nn.eemcs.utwente.nl/user/s1934538/clickstream/clickstream-enwiki-2018-12.tsv.gz,Atal_Bihari_Vajpayee,28379,182328,1272,211979,31935
hdfs://spark-nn.eemcs.utwente.nl/user/s1934538/clickstream/clickstream-enwiki-2018-12.tsv.gz,Article_370_of_the_Constitution_of_India,3833,23420,16,27269,2295
hdfs://spark-nn.eemcs.utwente.nl/user/s1934538/clickstream/clickstream-enwiki-2018-12.tsv.gz,Royal_Rumble_(2018),26868,69778,1570,98216,69683
hdfs://spark-nn.eemcs.utwente.nl/user/s1934538/clickstream/clickstream-enwiki-2018-12.tsv.gz,Aaron_Carter,13176,36037,228,49441,15658
hdfs://spark-nn.eemcs.utwente.nl/user/s1934538/clickstream/clickstream-enwiki-2018-12.tsv.gz,Charles_III,102,276,82,460,401
hdfs://spark-nn.eemcs.utwente.nl/user/s1934538/clickstream/clickstream-enwiki-2018-12.tsv.gz,Asia_Cup,1318,31793,150,33261,7138
hdfs://spark-nn.eemcs.utwente.nl/user/s1934538/clickstream/clickstream-enwiki-2018-12.tsv.gz,2.0_(film),223635,4514826,36930,4775391,1173606
hdfs://spark-nn.eemcs.utwente.nl/user/s1934538/clickstream/clickstream-enwiki-2018-12.tsv.gz,Main_Page,31170,504947300,4013760,508992230,32596992
hdfs://spark-nn.eemcs.utwente.nl/user/s1934538/clickstream/clickstream-enwiki-2018-12.tsv.gz,Aretha_Franklin,19699,108847,1949,130495,40628
hdfs://spark-nn.eemcs.utwente.nl/user/s1934538/clickstream/clickstream-enwiki-2018-12.tsv.gz,Line_shaft,579,1034,47,1660,128
hdfs://spark-nn.eemcs.utwente.nl/user/s1934538/clickstream/clickstream-enwiki-2018-12.tsv.gz,Salman_Rushdie,27963,54306,358,82627,33007
hdfs://spark-nn.eemcs.utwente.nl/user/s1934538/clickstream/clickstream-enwiki-2018-12.tsv.gz,IPv4,11690,49738,154,61582,10146
hdfs://spark-nn.eemcs.utwente.nl/user/s1934538/clickstream/clickstream-enwiki-2018-12.tsv.gz,Ray_Liotta,33099,558730,2490,594319,110396
hdfs://spark-nn.eemcs.utwente.nl/user/s1934538/clickstream/clickstream-enwiki-2018-12.tsv.gz,Sylvester_Stallone,115753,497476,3005,616234,386103
hdfs://spark-nn.eemcs.utwente.nl/user/s1934538/clickstream/clickstream-enwiki-2018-12.tsv.gz,WrestleMania_34,30581,30378,649,61608,42119
hdfs://spark-nn.eemcs.utwente.nl/user/s1934538/clickstream/clickstream-enwiki-2018-12.tsv.gz,Donald_Glover,76576,296378,2708,375662,111602
hdfs://spark-nn.eemcs.utwente.nl/user/s1934538/clickstream/clickstream-enwiki-2018-12.tsv.gz,QAnon,5907,359279,1355,366541,69322
hdfs://spark-nn.eemcs.utwente.nl/user/s1934538/clickstream/clickstream-enwiki-2018-12.tsv.gz,2016_United_States_presidential_election,107694,174007,3194,284895,213528
hdfs://spark-nn.eemcs.utwente.nl/user/s1934538/clickstream/clickstream-enwiki-2018-12.tsv.gz,Saaho,72225,89312,620,162157,110491
hdfs://spark-nn.eemcs.utwente.nl/user/s1934538/clickstream/clickstream-enwiki-2018-12.tsv.gz,Naya_Rivera,23576,28720,70,52366,10657
hdfs://spark-nn.eemcs.utwente.nl/user/s1934538/clickstream/clickstream-enwiki-2018-12.tsv.gz,J._Robert_Oppenheimer,17881,69730,251,87862,29054
hdfs://spark-nn.eemcs.utwente.nl/user/s1934538/clickstream/clickstream-enwiki-2018-12.tsv.gz,United_States_Electoral_College,20824,68260,132,89216,11277
hdfs://spark-nn.eemcs.utwente.nl/user/s1934538/clickstream/clickstream-enwiki-2018-12.tsv.gz,Christopher_Scarver,73574,25841,16,99431,34235
hdfs://spark-nn.eemcs.utwente.nl/user/s1934538/clickstream/clickstream-enwiki-2018-12.tsv.gz,Tom_Brady,63023,380274,3417,446714,134426
hdfs://spark-nn.eemcs.utwente.nl/user/s1934538/clickstream/clickstream-enwiki-2018-12.tsv.gz,Us_(2019_film),91660,389237,1696,482593,314945
hdfs://spark-nn.eemcs.utwente.nl/user/s1934538/clickstream/clickstream-enwiki-2018-12.tsv.gz,Tunnel,4277,12187,115,16579,4223
hdfs://spark-nn.eemcs.utwente.nl/user/s1934538/clickstream/clickstream-enwiki-2018-12.tsv.gz,DMX_(rapper),13206,107987,553,121746,40249
hdfs://spark-nn.eemcs.utwente.nl/user/s1934538/clickstream/clickstream-enwiki-2018-12.tsv.gz,Lisa_Marie_Presley,162919,89878,215,253012,120561
hdfs://spark-nn.eemcs.utwente.nl/user/s1934538/clickstream/clickstream-enwiki-2018-12.tsv.gz,Aaron_Hernandez,16985,114477,655,132117,39411
hdfs://spark-nn.eemcs.utwente.nl/user/s1934538/clickstream/clickstream-enwiki-2018-12.tsv.gz,Israel,69832,268631,4841,343304,158176
hdfs://spark-nn.eemcs.utwente.nl/user/s1934538/clickstream/clickstream-enwiki-2018-12.tsv.gz,Cricket_World_Cup,7300,68269,415,75984,41503
hdfs://spark-nn.eemcs.utwente.nl/user/s1934538/clickstream/clickstream-enwiki-2018-12.tsv.gz,Jenna_Ortega,5498,16069,219,21786,3574
hdfs://spark-nn.eemcs.utwente.nl/user/s1934538/clickstream/clickstream-enwiki-2018-12.tsv.gz,Valentine's_Day,3582,49200,426,53208,1006
hdfs://spark-nn.eemcs.utwente.nl/user/s1934538/clickstream/clickstream-enwiki-2018-12.tsv.gz,Henry_V_of_England,47336,24036,166,71538,52481
hdfs://spark-nn.eemcs.utwente.nl/user/s1934538/clickstream/clickstream-enwiki-2018-12.tsv.gz,Brie_Larson,155600,256015,2547,414162,163487
hdfs://spark-nn.eemcs.utwente.nl/user/s1934538/clickstream/clickstream-enwiki-2018-12.tsv.gz,Pornhub,38397,345676,10928,395001,74892
hdfs://spark-nn.eemcs.utwente.nl/user/s1934538/clickstream/clickstream-enwiki-2018-12.tsv.gz,Manti_Te'o,8180,57743,150,66073,3450
hdfs://spark-nn.eemcs.utwente.nl/user/s1934538/clickstream/clickstream-enwiki-2018-12.tsv.gz,The_Irishman_(2019_film),67576,67128,767,135471,113049
hdfs://spark-nn.eemcs.utwente.nl/user/s1934538/clickstream/clickstream-enwiki-2018-12.tsv.gz,Taliban,16819,98902,471,116192,46195
hdfs://spark-nn.eemcs.utwente.nl/user/s1934538/clickstream/clickstream-enwiki-2018-12.tsv.gz,Stan_Lee,100583,462474,7000,570057,159483
hdfs://spark-nn.eemcs.utwente.nl/user/s1934538/clickstream/clickstream-enwiki-2018-12.tsv.gz,Notre-Dame_de_Paris,9532,67547,429,77508,13120
hdfs://spark-nn.eemcs.utwente.nl/user/s1934538/clickstream/clickstream-enwiki-2018-12.tsv.gz,Hamas,13648,36169,268,50085,17474
hdfs://spark-nn.eemcs.utwente.nl/user/s1934538/clickstream/clickstream-enwiki-2018-12.tsv.gz,Olivia_Newton-John,22035,118278,967,141280,53230
hdfs://spark-nn.eemcs.utwente.nl/user/s1934538/clickstream/clickstream-enwiki-2018-12.tsv.gz,Darth_Vader,24051,1861632,1735,1887418,71448
hdfs://spark-nn.eemcs.utwente.nl/user/s1934538/clickstream/clickstream-enwiki-2018-12.tsv.gz,Eddie_Van_Halen,27908,42239,325,70472,28124
hdfs://spark-nn.eemcs.utwente.nl/user/s1934538/clickstream/clickstream-enwiki-2018-12.tsv.gz,List_of_most_popular_websites,25405,82393,146,107944,50410
hdfs://spark-nn.eemcs.utwente.nl/user/s1934538/clickstream/clickstream-enwiki-2018-12.tsv.gz,Elizabeth_II,439492,722379,3362,1165233,876602
hdfs://spark-nn.eemcs.utwente.nl/user/s1934538/clickstream/clickstream-enwiki-2018-12.tsv.gz,Indian_Premier_League,20446,64662,129,85237,61882
hdfs://spark-nn.eemcs.utwente.nl/user/s1934538/clickstream/clickstream-enwiki-2018-12.tsv.gz,Ukraine,45330,162185,3901,211416,90767
hdfs://spark-nn.eemcs.utwente.nl/user/s1934538/clickstream/clickstream-enwiki-2018-12.tsv.gz,Ted_Bundy,44982,572320,4813,622115,141229
hdfs://spark-nn.eemcs.utwente.nl/user/s1934538/clickstream/clickstream-enwiki-2018-12.tsv.gz,1234,73,1586,19,1678,83
hdfs://spark-nn.eemcs.utwente.nl/user/s1934538/clickstream/clickstream-enwiki-2018-12.tsv.gz,State_of_Palestine,41724,70881,130,112735,50578
hdfs://spark-nn.eemcs.utwente.nl/user/s1934538/clickstream/clickstream-enwiki-2018-12.tsv.gz,Chernobyl_disaster,28248,212820,1271,242339,68209
hdfs://spark-nn.eemcs.utwente.nl/user/s1934538/clickstream/clickstream-enwiki-2018-12.tsv.gz,Afghanistan,42646,137142,2167,181955,124084
hdfs://spark-nn.eemcs.utwente.nl/user/s1934538/clickstream/clickstream-enwiki-2018-12.tsv.gz,George_H._W._Bush,1108189,5556953,226297,6891439,4537480
hdfs://spark-nn.eemcs.utwente.nl/user/s1934538/clickstream/clickstream-enwiki-2018-12.tsv.gz,2018_FIFA_World_Cup,67216,1259294,2799,1329309,140099
hdfs://spark-nn.eemcs.utwente.nl/user/s1934538/clickstream/clickstream-enwiki-2018-12.tsv.gz,The_Weeknd,43487,125752,1056,170295,69295
hdfs://spark-nn.eemcs.utwente.nl/user/s1934538/clickstream/clickstream-enwiki-2018-12.tsv.gz,Jimmy_Buffett,6965,39754,370,47089,13938
hdfs://spark-nn.eemcs.utwente.nl/user/s1934538/clickstream/clickstream-enwiki-2018-12.tsv.gz,Grover,1278,7702,77,9057,1907
hdfs://spark-nn.eemcs.utwente.nl/user/s1934538/clickstream/clickstream-enwiki-2018-12.tsv.gz,Joker_(2019_film),91204,103629,731,195564,130238
hdfs://spark-nn.eemcs.utwente.nl/user/s1934538/clickstream/clickstream-enwiki-2018-12.tsv.gz,Sushma_Swaraj,5129,29517,86,34732,8505
hdfs://spark-nn.eemcs.utwente.nl/user/s1934538/clickstream/clickstream-enwiki-2018-12.tsv.gz,Amy_Coney_Barrett,1894,9485,185,11564,1863
hdfs://spark-nn.eemcs.utwente.nl/user/s1934538/clickstream/clickstream-enwiki-2018-12.tsv.gz,Fyre_Festival,4498,93637,387,98522,49515
hdfs://spark-nn.eemcs.utwente.nl/user/s1934538/clickstream/clickstream-enwiki-2018-12.tsv.gz,XNXX,3847,347989,6597,358433,50741
hdfs://spark-nn.eemcs.utwente.nl/user/s1934538/clickstream/clickstream-enwiki-2018-12.tsv.gz,Glass_(2019_film),132504,334779,4601,471884,237151
hdfs://spark-nn.eemcs.utwente.nl/user/s1934538/clickstream/clickstream-enwiki-2018-12.tsv.gz,Death_of_Elisa_Lam,6663,57435,1013,65111,17202
hdfs://spark-nn.eemcs.utwente.nl/user/s1934538/clickstream/clickstream-enwiki-2018-12.tsv.gz,Mulan_(2020_film),26279,34766,420,61465,73420
hdfs://spark-nn.eemcs.utwente.nl/user/s1934538/clickstream/clickstream-enwiki-2018-12.tsv.gz,YouTube,132473,974998,9468,1116939,149074
hdfs://spark-nn.eemcs.utwente.nl/user/s1934538/clickstream/clickstream-enwiki-2018-12.tsv.gz,Richard_Jewell,2117,12801,56,14974,3410
hdfs://spark-nn.eemcs.utwente.nl/user/s1934538/clickstream/clickstream-enwiki-2018-12.tsv.gz,Cook's_Country,249,2753,23,3025,31
hdfs://spark-nn.eemcs.utwente.nl/user/s1934538/clickstream/clickstream-enwiki-2018-12.tsv.gz,Irrfan_Khan,29954,58283,235,88472,40537
hdfs://spark-nn.eemcs.utwente.nl/user/s1934538/clickstream/clickstream-enwiki-2018-12.tsv.gz,Critical_race_theory,1401,14942,36,16379,2739
hdfs://spark-nn.eemcs.utwente.nl/user/s1934538/clickstream/clickstream-enwiki-2018-12.tsv.gz,Cameron_Boyce,10561,24646,134,35341,6986
hdfs://spark-nn.eemcs.utwente.nl/user/s1934538/clickstream/clickstream-enwiki-2018-12.tsv.gz,Tonya_Harding,38078,203934,971,242983,53772
hdfs://spark-nn.eemcs.utwente.nl/user/s1934538/clickstream/clickstream-enwiki-2018-12.tsv.gz,United_States_Senate,65204,93816,6720,165740,63929
hdfs://spark-nn.eemcs.utwente.nl/user/s1934538/clickstream/clickstream-enwiki-2018-12.tsv.gz,Bible,18599,86645,1841,107085,36100
hdfs://spark-nn.eemcs.utwente.nl/user/s1934538/clickstream/clickstream-enwiki-2018-12.tsv.gz,Joaquin_Phoenix,122626,146941,951,270518,189214
hdfs://spark-nn.eemcs.utwente.nl/user/s1934538/clickstream/clickstream-enwiki-2018-12.tsv.gz,"Diana,_Princess_of_Wales",118328,232783,2375,353486,208796
hdfs://spark-nn.eemcs.utwente.nl/user/s1934538/clickstream/clickstream-enwiki-2018-12.tsv.gz,Lists_of_deaths_by_year,25787,2257230,1074677,3357694,91450
hdfs://spark-nn.eemcs.utwente.nl/user/s1934538/clickstream/clickstream-enwiki-2018-12.tsv.gz,Cristiano_Ronaldo,96421,739047,4297,839765,172919
hdfs://spark-nn.eemcs.utwente.nl/user/s1934538/clickstream/clickstream-enwiki-2018-12.tsv.gz,Johnny_Depp,178807,374275,2933,556015,348560
hdfs://spark-nn.eemcs.utwente.nl/user/s1934538/clickstream/clickstream-enwiki-2018-12.tsv.gz,Joe_Biden,62032,186293,3671,251996,88776
hdfs://spark-nn.eemcs.utwente.nl/user/s1934538/clickstream/clickstream-enwiki-2018-12.tsv.gz,R._Kelly,26129,153997,976,181102,80027
hdfs://spark-nn.eemcs.utwente.nl/user/s1934538/clickstream/clickstream-enwiki-2018-12.tsv.gz,Aquaman_(film),408421,3391490,87294,3887205,2438765
hdfs://spark-nn.eemcs.utwente.nl/user/s1934538/clickstream/clickstream-enwiki-2018-12.tsv.gz,Puneeth_Rajkumar,13428,24892,1217,39537,21063
hdfs://spark-nn.eemcs.utwente.nl/user/s1934538/clickstream/clickstream-enwiki-2018-12.tsv.gz,Deaths_in_2019,6852,40701,103,47656,3336
hdfs://spark-nn.eemcs.utwente.nl/user/s1934538/clickstream/clickstream-enwiki-2018-12.tsv.gz,Matthew_Perry,80161,191066,668,271895,124906
hdfs://spark-nn.eemcs.utwente.nl/user/s1934538/clickstream/clickstream-enwiki-2018-12.tsv.gz,Crazy_Rich_Asians_(film),101755,577854,7630,687239,719516
hdfs://spark-nn.eemcs.utwente.nl/user/s1934538/clickstream/clickstream-enwiki-2018-12.tsv.gz,Jeffrey_Dahmer,27346,396967,3599,427912,176823
hdfs://spark-nn.eemcs.utwente.nl/user/s1934538/clickstream/clickstream-enwiki-2018-12.tsv.gz,Michael_Jordan,67064,481005,4263,552332,183146
hdfs://spark-nn.eemcs.utwente.nl/user/s1934538/clickstream/clickstream-enwiki-2019-03.tsv.gz,Cristiano_Ronaldo,143710,951162,6457,1101329,230288
hdfs://spark-nn.eemcs.utwente.nl/user/s1934538/clickstream/clickstream-enwiki-2019-03.tsv.gz,2018_Winter_Olympics,24449,30589,463,55501,35773
hdfs://spark-nn.eemcs.utwente.nl/user/s1934538/clickstream/clickstream-enwiki-2019-03.tsv.gz,Grimes_(musician),135196,74409,540,210145,44761
hdfs://spark-nn.eemcs.utwente.nl/user/s1934538/clickstream/clickstream-enwiki-2019-03.tsv.gz,Sushant_Singh_Rajput,34497,75417,221,110135,69142
hdfs://spark-nn.eemcs.utwente.nl/user/s1934538/clickstream/clickstream-enwiki-2019-03.tsv.gz,Darth_Vader,17334,804526,594,822454,45927
hdfs://spark-nn.eemcs.utwente.nl/user/s1934538/clickstream/clickstream-enwiki-2019-03.tsv.gz,Amy_Coney_Barrett,1724,5881,26,7631,1777
hdfs://spark-nn.eemcs.utwente.nl/user/s1934538/clickstream/clickstream-enwiki-2019-03.tsv.gz,2018_FIFA_World_Cup,78344,329418,2354,410116,148079
hdfs://spark-nn.eemcs.utwente.nl/user/s1934538/clickstream/clickstream-enwiki-2019-03.tsv.gz,Sushma_Swaraj,7668,68892,98,76658,19217
hdfs://spark-nn.eemcs.utwente.nl/user/s1934538/clickstream/clickstream-enwiki-2019-03.tsv.gz,Microsoft_Office,9350,80339,742,90431,24687
hdfs://spark-nn.eemcs.utwente.nl/user/s1934538/clickstream/clickstream-enwiki-2019-03.tsv.gz,Kim_Jong-un,51768,185843,1975,239586,136619
hdfs://spark-nn.eemcs.utwente.nl/user/s1934538/clickstream/clickstream-enwiki-2019-03.tsv.gz,Google_logo,1120,22938,19,24077,2713
hdfs://spark-nn.eemcs.utwente.nl/user/s1934538/clickstream/clickstream-enwiki-2019-03.tsv.gz,XHamster,10534,2568717,2300,2581551,32215
hdfs://spark-nn.eemcs.utwente.nl/user/s1934538/clickstream/clickstream-enwiki-2019-03.tsv.gz,Stranger_Things,64779,345631,7533,417943,362464
hdfs://spark-nn.eemcs.utwente.nl/user/s1934538/clickstream/clickstream-enwiki-2019-03.tsv.gz,QAnon,8997,280967,1604,291568,65528
hdfs://spark-nn.eemcs.utwente.nl/user/s1934538/clickstream/clickstream-enwiki-2019-03.tsv.gz,Coronavirus,967,13269,79,14315,1630
hdfs://spark-nn.eemcs.utwente.nl/user/s1934538/clickstream/clickstream-enwiki-2019-03.tsv.gz,Black_Panther_(film),112406,314055,6319,432780,261550
hdfs://spark-nn.eemcs.utwente.nl/user/s1934538/clickstream/clickstream-enwiki-2019-03.tsv.gz,The_Weeknd,44188,122454,1183,167825,68071
hdfs://spark-nn.eemcs.utwente.nl/user/s1934538/clickstream/clickstream-enwiki-2019-03.tsv.gz,Bipin_Rawat,12237,35281,120,47638,19717
hdfs://spark-nn.eemcs.utwente.nl/user/s1934538/clickstream/clickstream-enwiki-2019-03.tsv.gz,Article_370_of_the_Constitution_of_India,10783,100795,246,111824,8449
hdfs://spark-nn.eemcs.utwente.nl/user/s1934538/clickstream/clickstream-enwiki-2019-03.tsv.gz,XXX:_Return_of_Xander_Cage,31026,72059,687,103772,35816
hdfs://spark-nn.eemcs.utwente.nl/user/s1934538/clickstream/clickstream-enwiki-2019-03.tsv.gz,Notre-Dame_de_Paris,9835,72168,456,82459,14418
hdfs://spark-nn.eemcs.utwente.nl/user/s1934538/clickstream/clickstream-enwiki-2019-03.tsv.gz,Kate_Spade,27267,70495,530,98292,30342
hdfs://spark-nn.eemcs.utwente.nl/user/s1934538/clickstream/clickstream-enwiki-2019-03.tsv.gz,The_Irishman_(2019_film),72635,113592,1513,187740,151389
hdfs://spark-nn.eemcs.utwente.nl/user/s1934538/clickstream/clickstream-enwiki-2019-03.tsv.gz,Aretha_Franklin,24246,197199,1747,223192,59287
hdfs://spark-nn.eemcs.utwente.nl/user/s1934538/clickstream/clickstream-enwiki-2019-03.tsv.gz,Juneteenth,1968,40911,75,42954,4070
hdfs://spark-nn.eemcs.utwente.nl/user/s1934538/clickstream/clickstream-enwiki-2019-03.tsv.gz,Naya_Rivera,24391,33388,65,57844,11225
hdfs://spark-nn.eemcs.utwente.nl/user/s1934538/clickstream/clickstream-enwiki-2019-03.tsv.gz,Game_of_Thrones_(season_8),125444,760868,6222,892534,319138
hdfs://spark-nn.eemcs.utwente.nl/user/s1934538/clickstream/clickstream-enwiki-2019-03.tsv.gz,Bob_Saget,27476,80877,513,108866,20291
hdfs://spark-nn.eemcs.utwente.nl/user/s1934538/clickstream/clickstream-enwiki-2019-03.tsv.gz,Cameron_Boyce,11088,25697,90,36875,7277
hdfs://spark-nn.eemcs.utwente.nl/user/s1934538/clickstream/clickstream-enwiki-2019-03.tsv.gz,Pornhub,43566,390881,11088,445535,73871
hdfs://spark-nn.eemcs.utwente.nl/user/s1934538/clickstream/clickstream-enwiki-2019-03.tsv.gz,Saaho,36843,91417,252,128512,95327
hdfs://spark-nn.eemcs.utwente.nl/user/s1934538/clickstream/clickstream-enwiki-2019-03.tsv.gz,Taliban,30395,123843,511,154749,72454
hdfs://spark-nn.eemcs.utwente.nl/user/s1934538/clickstream/clickstream-enwiki-2019-03.tsv.gz,Charles_Sobhraj,3165,30448,79,33692,7574
hdfs://spark-nn.eemcs.utwente.nl/user/s1934538/clickstream/clickstream-enwiki-2019-03.tsv.gz,Indian_Premier_League,60846,368953,854,430653,266717
hdfs://spark-nn.eemcs.utwente.nl/user/s1934538/clickstream/clickstream-enwiki-2019-03.tsv.gz,21_Savage,26602,173851,2829,203282,59785
hdfs://spark-nn.eemcs.utwente.nl/user/s1934538/clickstream/clickstream-enwiki-2019-03.tsv.gz,Olivia_Newton-John,21981,168656,1457,192094,80693
hdfs://spark-nn.eemcs.utwente.nl/user/s1934538/clickstream/clickstream-enwiki-2019-03.tsv.gz,Royal_Rumble_(2018),11495,8881,98,20474,13964
hdfs://spark-nn.eemcs.utwente.nl/user/s1934538/clickstream/clickstream-enwiki-2019-03.tsv.gz,The_Lion_King_(2019_film),83549,152759,2811,239119,197465
hdfs://spark-nn.eemcs.utwente.nl/user/s1934538/clickstream/clickstream-enwiki-2019-03.tsv.gz,Stan_Lee,126405,373972,3454,503831,165795
hdfs://spark-nn.eemcs.utwente.nl/user/s1934538/clickstream/clickstream-enwiki-2019-03.tsv.gz,Priyanka_Chopra,383432,738235,3222,1124889,437962
hdfs://spark-nn.eemcs.utwente.nl/user/s1934538/clickstream/clickstream-enwiki-2019-03.tsv.gz,RRR_(film),67021,103651,525,171197,100703
hdfs://spark-nn.eemcs.utwente.nl/user/s1934538/clickstream/clickstream-enwiki-2019-03.tsv.gz,David_Beckham,40769,366337,2347,409453,131915
hdfs://spark-nn.eemcs.utwente.nl/user/s1934538/clickstream/clickstream-enwiki-2019-03.tsv.gz,Bird_Box_(film),41749,251697,3220,296666,95587
hdfs://spark-nn.eemcs.utwente.nl/user/s1934538/clickstream/clickstream-enwiki-2019-03.tsv.gz,Us_(2019_film),358521,4118561,32712,4509794,1518959
hdfs://spark-nn.eemcs.utwente.nl/user/s1934538/clickstream/clickstream-enwiki-2019-03.tsv.gz,Cricket_World_Cup,12788,141653,1092,155533,93563
hdfs://spark-nn.eemcs.utwente.nl/user/s1934538/clickstream/clickstream-enwiki-2019-03.tsv.gz,Venom_(2018_film),53382,247012,5197,305591,157906
hdfs://spark-nn.eemcs.utwente.nl/user/s1934538/clickstream/clickstream-enwiki-2019-03.tsv.gz,Meat_Loaf,19440,76030,725,96195,34537
hdfs://spark-nn.eemcs.utwente.nl/user/s1934538/clickstream/clickstream-enwiki-2019-03.tsv.gz,Stranger_Things_(season_3),29283,111840,1791,142914,108821
hdfs://spark-nn.eemcs.utwente.nl/user/s1934538/clickstream/clickstream-enwiki-2019-03.tsv.gz,Game_of_Thrones,193902,1125073,29346,1348321,1062593
hdfs://spark-nn.eemcs.utwente.nl/user/s1934538/clickstream/clickstream-enwiki-2019-03.tsv.gz,Joker_(2019_film),104490,144493,1200,250183,151184
hdfs://spark-nn.eemcs.utwente.nl/user/s1934538/clickstream/clickstream-enwiki-2019-03.tsv.gz,Mac_Miller,46019,235504,2691,284214,84386
hdfs://spark-nn.eemcs.utwente.nl/user/s1934538/clickstream/clickstream-enwiki-2019-03.tsv.gz,Alexander_Hamilton,68398,294728,1978,365104,154781
hdfs://spark-nn.eemcs.utwente.nl/user/s1934538/clickstream/clickstream-enwiki-2019-03.tsv.gz,Avengers:_Endgame,683897,1385861,32014,2101772,1210578
hdfs://spark-nn.eemcs.utwente.nl/user/s1934538/clickstream/clickstream-enwiki-2019-03.tsv.gz,Michael_Jordan,89787,730586,5628,826001,255038
hdfs://spark-nn.eemcs.utwente.nl/user/s1934538/clickstream/clickstream-enwiki-2019-03.tsv.gz,Khabib_Nurmagomedov,70168,144911,1782,216861,104419
hdfs://spark-nn.eemcs.utwente.nl/user/s1934538/clickstream/clickstream-enwiki-2019-03.tsv.gz,Rihanna,61910,253065,3637,318612,150602
hdfs://spark-nn.eemcs.utwente.nl/user/s1934538/clickstream/clickstream-enwiki-2019-03.tsv.gz,Keanu_Reeves,84820,685455,4348,774623,352905
hdfs://spark-nn.eemcs.utwente.nl/user/s1934538/clickstream/clickstream-enwiki-2019-03.tsv.gz,Godzilla_vs._Kong,63438,21880,2670,87988,65636
hdfs://spark-nn.eemcs.utwente.nl/user/s1934538/clickstream/clickstream-enwiki-2019-03.tsv.gz,The_Witcher_(TV_series),14305,41245,238,55788,28195
hdfs://spark-nn.eemcs.utwente.nl/user/s1934538/clickstream/clickstream-enwiki-2019-03.tsv.gz,2020_Summer_Olympics,46261,121257,2351,169869,116941
hdfs://spark-nn.eemcs.utwente.nl/user/s1934538/clickstream/clickstream-enwiki-2019-03.tsv.gz,Richard_Jewell,4444,21219,144,25807,5744
hdfs://spark-nn.eemcs.utwente.nl/user/s1934538/clickstream/clickstream-enwiki-2019-03.tsv.gz,HTTP_cookie,7220,308716,128,316064,33982
hdfs://spark-nn.eemcs.utwente.nl/user/s1934538/clickstream/clickstream-enwiki-2019-03.tsv.gz,Luke_Perry,268266,5960065,98171,6326502,1112142
hdfs://spark-nn.eemcs.utwente.nl/user/s1934538/clickstream/clickstream-enwiki-2019-03.tsv.gz,Charles_III,146,955,289,1390,1095
hdfs://spark-nn.eemcs.utwente.nl/user/s1934538/clickstream/clickstream-enwiki-2019-03.tsv.gz,Exo_(band),23390,306713,668,330771,160699
hdfs://spark-nn.eemcs.utwente.nl/user/s1934538/clickstream/clickstream-enwiki-2019-03.tsv.gz,Valentine's_Day,5136,56510,469,62115,1226
hdfs://spark-nn.eemcs.utwente.nl/user/s1934538/clickstream/clickstream-enwiki-2019-03.tsv.gz,Manti_Te'o,3570,18408,65,22043,944
hdfs://spark-nn.eemcs.utwente.nl/user/s1934538/clickstream/clickstream-enwiki-2019-03.tsv.gz,Irrfan_Khan,23437,43139,145,66721,29649
hdfs://spark-nn.eemcs.utwente.nl/user/s1934538/clickstream/clickstream-enwiki-2019-03.tsv.gz,2016_United_States_presidential_election,111302,244584,3134,359020,242227
hdfs://spark-nn.eemcs.utwente.nl/user/s1934538/clickstream/clickstream-enwiki-2019-03.tsv.gz,Joaquin_Phoenix,126736,132692,1047,260475,186315
hdfs://spark-nn.eemcs.utwente.nl/user/s1934538/clickstream/clickstream-enwiki-2019-03.tsv.gz,Kelly_Preston,66094,44958,123,111175,30416
hdfs://spark-nn.eemcs.utwente.nl/user/s1934538/clickstream/clickstream-enwiki-2019-03.tsv.gz,State_of_Palestine,54384,112254,227,166865,75722
hdfs://spark-nn.eemcs.utwente.nl/user/s1934538/clickstream/clickstream-enwiki-2019-03.tsv.gz,"Diana,_Princess_of_Wales",115312,234310,2048,351670,198663
hdfs://spark-nn.eemcs.utwente.nl/user/s1934538/clickstream/clickstream-enwiki-2019-03.tsv.gz,Cleopatra,41025,185545,2071,228641,87803
hdfs://spark-nn.eemcs.utwente.nl/user/s1934538/clickstream/clickstream-enwiki-2019-03.tsv.gz,List_of_FIFA_World_Cup_finals,1866,56693,59,58618,15197
hdfs://spark-nn.eemcs.utwente.nl/user/s1934538/clickstream/clickstream-enwiki-2019-03.tsv.gz,Atal_Bihari_Vajpayee,32011,93279,111,125401,30153
hdfs://spark-nn.eemcs.utwente.nl/user/s1934538/clickstream/clickstream-enwiki-2019-03.tsv.gz,Jenna_Ortega,8891,12373,1714,22978,5237
hdfs://spark-nn.eemcs.utwente.nl/user/s1934538/clickstream/clickstream-enwiki-2019-03.tsv.gz,Antifa_(United_States),13243,90769,808,104820,15933
hdfs://spark-nn.eemcs.utwente.nl/user/s1934538/clickstream/clickstream-enwiki-2019-03.tsv.gz,Burt_Reynolds,73993,165811,1556,241360,85196
hdfs://spark-nn.eemcs.utwente.nl/user/s1934538/clickstream/clickstream-enwiki-2019-03.tsv.gz,Avicii,19789,282057,2642,304488,74171
hdfs://spark-nn.eemcs.utwente.nl/user/s1934538/clickstream/clickstream-enwiki-2019-03.tsv.gz,Top_Gun:_Maverick,68445,49788,382,118615,90050
hdfs://spark-nn.eemcs.utwente.nl/user/s1934538/clickstream/clickstream-enwiki-2019-03.tsv.gz,Matthew_Perry,75088,257842,4172,337102,136060
hdfs://spark-nn.eemcs.utwente.nl/user/s1934538/clickstream/clickstream-enwiki-2019-03.tsv.gz,Adele,24007,186384,2580,212971,65931
hdfs://spark-nn.eemcs.utwente.nl/user/s1934538/clickstream/clickstream-enwiki-2019-03.tsv.gz,Hyphen-minus,5840,45314663,7615434,52935937,1071
hdfs://spark-nn.eemcs.utwente.nl/user/s1934538/clickstream/clickstream-enwiki-2019-03.tsv.gz,Asia_Cup,696,10412,115,11223,5934
hdfs://spark-nn.eemcs.utwente.nl/user/s1934538/clickstream/clickstream-enwiki-2019-03.tsv.gz,Kobe_Bryant,45411,335321,2917,383649,99998
hdfs://spark-nn.eemcs.utwente.nl/user/s1934538/clickstream/clickstream-enwiki-2019-03.tsv.gz,Queen_(band),322301,1162857,12496,1497654,1515114
hdfs://spark-nn.eemcs.utwente.nl/user/s1934538/clickstream/clickstream-enwiki-2019-03.tsv.gz,John_McCain,48212,303786,4099,356097,154917
hdfs://spark-nn.eemcs.utwente.nl/user/s1934538/clickstream/clickstream-enwiki-2019-03.tsv.gz,Joe_Biden,51728,368050,7000,426778,121391
hdfs://spark-nn.eemcs.utwente.nl/user/s1934538/clickstream/clickstream-enwiki-2019-03.tsv.gz,Once_Upon_a_Time_in_Hollywood,295610,688989,11360,995959,1152908
hdfs://spark-nn.eemcs.utwente.nl/user/s1934538/clickstream/clickstream-enwiki-2019-03.tsv.gz,Tom_Brady,39853,199723,1964,241540,79390
hdfs://spark-nn.eemcs.utwente.nl/user/s1934538/clickstream/clickstream-enwiki-2019-03.tsv.gz,The_Nun_(2018_film),28562,108558,932,138052,83579
hdfs://spark-nn.eemcs.utwente.nl/user/s1934538/clickstream/clickstream-enwiki-2019-03.tsv.gz,Stephen_Hawking,34291,520448,4120,558859,199260
hdfs://spark-nn.eemcs.utwente.nl/user/s1934538/clickstream/clickstream-enwiki-2019-03.tsv.gz,2020_United_States_presidential_election,100411,390950,9399,500760,409590
hdfs://spark-nn.eemcs.utwente.nl/user/s1934538/clickstream/clickstream-enwiki-2019-03.tsv.gz,Kobe_Bryant_sexual_assault_case,4203,31998,25,36226,3599
hdfs://spark-nn.eemcs.utwente.nl/user/s1934538/clickstream/clickstream-enwiki-2019-03.tsv.gz,Murder_of_Dee_Dee_Blanchard,304169,2662482,4549,2971200,543769
hdfs://spark-nn.eemcs.utwente.nl/user/s1934538/clickstream/clickstream-enwiki-2019-03.tsv.gz,List_of_James_Bond_films,26659,355175,908,382742,165337
hdfs://spark-nn.eemcs.utwente.nl/user/s1934538/clickstream/clickstream-enwiki-2019-03.tsv.gz,UEFA_Euro_2020,73037,405118,6069,484224,146314
hdfs://spark-nn.eemcs.utwente.nl/user/s1934538/clickstream/clickstream-enwiki-2019-03.tsv.gz,Rami_Malek,235761,850683,5489,1091933,385260
hdfs://spark-nn.eemcs.utwente.nl/user/s1934538/clickstream/clickstream-enwiki-2019-03.tsv.gz,Christopher_Scarver,66018,18791,16,84825,27529
hdfs://spark-nn.eemcs.utwente.nl/user/s1934538/clickstream/clickstream-enwiki-2019-03.tsv.gz,Key_frame,704,6747,29,7480,618
hdfs://spark-nn.eemcs.utwente.nl/user/s1934538/clickstream/clickstream-enwiki-2019-03.tsv.gz,FIFA_World_Cup,37291,136288,2024,175603,143989
hdfs://spark-nn.eemcs.utwente.nl/user/s1934538/clickstream/clickstream-enwiki-2019-03.tsv.gz,Nipsey_Hussle,24217,134726,386,159329,54008
hdfs://spark-nn.eemcs.utwente.nl/user/s1934538/clickstream/clickstream-enwiki-2019-03.tsv.gz,Roe_v._Wade,14685,115280,715,130680,31393
hdfs://spark-nn.eemcs.utwente.nl/user/s1934538/clickstream/clickstream-enwiki-2019-03.tsv.gz,Lionel_Messi,79554,766302,8191,854047,174602
hdfs://spark-nn.eemcs.utwente.nl/user/s1934538/clickstream/clickstream-enwiki-2019-03.tsv.gz,XNXX,3097,119791,8139,131027,39472
hdfs://spark-nn.eemcs.utwente.nl/user/s1934538/clickstream/clickstream-enwiki-2019-03.tsv.gz,List_of_highest-grossing_films,155996,432574,3311,591881,269152
hdfs://spark-nn.eemcs.utwente.nl/user/s1934538/clickstream/clickstream-enwiki-2019-03.tsv.gz,United_States_Electoral_College,29307,219747,589,249643,27770
hdfs://spark-nn.eemcs.utwente.nl/user/s1934538/clickstream/clickstream-enwiki-2019-03.tsv.gz,September_11_attacks,85105,371358,3177,459640,204318
hdfs://spark-nn.eemcs.utwente.nl/user/s1934538/clickstream/clickstream-enwiki-2019-03.tsv.gz,Aquaman_(film),154476,914561,16748,1085785,635177
hdfs://spark-nn.eemcs.utwente.nl/user/s1934538/clickstream/clickstream-enwiki-2019-03.tsv.gz,Ted_Bundy,38233,838926,8055,885214,198298
hdfs://spark-nn.eemcs.utwente.nl/user/s1934538/clickstream/clickstream-enwiki-2019-03.tsv.gz,XXXTentacion,99328,529435,9880,638643,142858
hdfs://spark-nn.eemcs.utwente.nl/user/s1934538/clickstream/clickstream-enwiki-2019-03.tsv.gz,Grover,1347,7903,48,9298,1848
hdfs://spark-nn.eemcs.utwente.nl/user/s1934538/clickstream/clickstream-enwiki-2019-03.tsv.gz,Cardi_B,70856,977997,9974,1058827,372855
hdfs://spark-nn.eemcs.utwente.nl/user/s1934538/clickstream/clickstream-enwiki-2019-03.tsv.gz,Amber_Heard,227327,592338,3077,822742,434949
hdfs://spark-nn.eemcs.utwente.nl/user/s1934538/clickstream/clickstream-enwiki-2019-03.tsv.gz,Wonder_Woman_1984,110356,51831,897,163084,94907
hdfs://spark-nn.eemcs.utwente.nl/user/s1934538/clickstream/clickstream-enwiki-2019-03.tsv.gz,Jeffrey_Dahmer,28789,398270,3485,430544,167664
hdfs://spark-nn.eemcs.utwente.nl/user/s1934538/clickstream/clickstream-enwiki-2019-03.tsv.gz,J._Robert_Oppenheimer,17894,80944,319,99157,31021
hdfs://spark-nn.eemcs.utwente.nl/user/s1934538/clickstream/clickstream-enwiki-2019-03.tsv.gz,Fantastic_Beasts:_The_Crimes_of_Grindelwald,128592,553831,9579,692002,385878
hdfs://spark-nn.eemcs.utwente.nl/user/s1934538/clickstream/clickstream-enwiki-2019-03.tsv.gz,Critical_race_theory,1951,17857,35,19843,3781
hdfs://spark-nn.eemcs.utwente.nl/user/s1934538/clickstream/clickstream-enwiki-2019-03.tsv.gz,Lance_Reddick,18534,22641,129,41304,10808
hdfs://spark-nn.eemcs.utwente.nl/user/s1934538/clickstream/clickstream-enwiki-2019-03.tsv.gz,List_of_awards_and_nominations_received_by_Meryl_Streep,15349,10557,86,25992,10334
hdfs://spark-nn.eemcs.utwente.nl/user/s1934538/clickstream/clickstream-enwiki-2019-03.tsv.gz,R._Kelly,74478,1028417,12865,1115760,528661
hdfs://spark-nn.eemcs.utwente.nl/user/s1934538/clickstream/clickstream-enwiki-2019-03.tsv.gz,"Meghan,_Duchess_of_Sussex",94158,428271,3047,525476,251062
hdfs://spark-nn.eemcs.utwente.nl/user/s1934538/clickstream/clickstream-enwiki-2019-03.tsv.gz,NATO,45423,156108,2425,203956,67647
hdfs://spark-nn.eemcs.utwente.nl/user/s1934538/clickstream/clickstream-enwiki-2019-03.tsv.gz,United_States_Senate,52600,73008,3530,129138,57824
hdfs://spark-nn.eemcs.utwente.nl/user/s1934538/clickstream/clickstream-enwiki-2019-03.tsv.gz,Qasem_Soleimani,3099,16331,83,19513,8587
hdfs://spark-nn.eemcs.utwente.nl/user/s1934538/clickstream/clickstream-enwiki-2019-03.tsv.gz,Donald_Glover,66189,253688,2051,321928,116666
hdfs://spark-nn.eemcs.utwente.nl/user/s1934538/clickstream/clickstream-enwiki-2019-03.tsv.gz,Simple_Mail_Transfer_Protocol,5329,40403,220,45952,5667
hdfs://spark-nn.eemcs.utwente.nl/user/s1934538/clickstream/clickstream-enwiki-2019-03.tsv.gz,Cecil_Hotel_(Los_Angeles),4984,27705,38,32727,11314
hdfs://spark-nn.eemcs.utwente.nl/user/s1934538/clickstream/clickstream-enwiki-2019-03.tsv.gz,A_Quiet_Place_(film),36434,227992,2036,266462,74097
hdfs://spark-nn.eemcs.utwente.nl/user/s1934538/clickstream/clickstream-enwiki-2019-03.tsv.gz,Spider-Man:_Far_From_Home,189403,187521,3479,380403,242020
hdfs://spark-nn.eemcs.utwente.nl/user/s1934538/clickstream/clickstream-enwiki-2019-03.tsv.gz,Jimmy_Hoffa,28161,89813,708,118682,40703
hdfs://spark-nn.eemcs.utwente.nl/user/s1934538/clickstream/clickstream-enwiki-2019-04.tsv.gz,Simple_Mail_Transfer_Protocol,4806,40748,173,45727,5687
hdfs://spark-nn.eemcs.utwente.nl/user/s1934538/clickstream/clickstream-enwiki-2019-04.tsv.gz,Richard_Jewell,2838,21915,283,25036,8127
hdfs://spark-nn.eemcs.utwente.nl/user/s1934538/clickstream/clickstream-enwiki-2019-04.tsv.gz,Jeffrey_Epstein,8593,61640,506,70739,18568
hdfs://spark-nn.eemcs.utwente.nl/user/s1934538/clickstream/clickstream-enwiki-2019-04.tsv.gz,Article_370_of_the_Constitution_of_India,12319,170323,114,182756,13103
hdfs://spark-nn.eemcs.utwente.nl/user/s1934538/clickstream/clickstream-enwiki-2019-04.tsv.gz,Asia_Cup,810,13017,137,13964,7154
hdfs://spark-nn.eemcs.utwente.nl/user/s1934538/clickstream/clickstream-enwiki-2019-04.tsv.gz,IPv4,13452,53229,144,66825,11056
hdfs://spark-nn.eemcs.utwente.nl/user/s1934538/clickstream/clickstream-enwiki-2019-04.tsv.gz,Aaron_Hernandez,8499,117709,505,126713,44116
hdfs://spark-nn.eemcs.utwente.nl/user/s1934538/clickstream/clickstream-enwiki-2019-04.tsv.gz,Lists_of_deaths_by_year,7447,190669,307,198423,190352
hdfs://spark-nn.eemcs.utwente.nl/user/s1934538/clickstream/clickstream-enwiki-2019-04.tsv.gz,Manti_Te'o,4198,15141,96,19435,2106
hdfs://spark-nn.eemcs.utwente.nl/user/s1934538/clickstream/clickstream-enwiki-2019-04.tsv.gz,Jimmy_Hoffa,21284,71442,585,93311,33101
hdfs://spark-nn.eemcs.utwente.nl/user/s1934538/clickstream/clickstream-enwiki-2019-04.tsv.gz,Hyphen-minus,5450,39903664,7421711,47330825,1108
hdfs://spark-nn.eemcs.utwente.nl/user/s1934538/clickstream/clickstream-enwiki-2019-04.tsv.gz,Irrfan_Khan,21562,42395,135,64092,28779
hdfs://spark-nn.eemcs.utwente.nl/user/s1934538/clickstream/clickstream-enwiki-2019-04.tsv.gz,Exo_(band),25016,213322,613,238951,159417
hdfs://spark-nn.eemcs.utwente.nl/user/s1934538/clickstream/clickstream-enwiki-2019-04.tsv.gz,Priyanka_Chopra,164614,371729,1516,537859,196491
hdfs://spark-nn.eemcs.utwente.nl/user/s1934538/clickstream/clickstream-enwiki-2019-04.tsv.gz,Death_of_Elisa_Lam,9675,62498,272,72445,17605
hdfs://spark-nn.eemcs.utwente.nl/user/s1934538/clickstream/clickstream-enwiki-2019-04.tsv.gz,WrestleMania_34,93768,94674,778,189220,129426
hdfs://spark-nn.eemcs.utwente.nl/user/s1934538/clickstream/clickstream-enwiki-2019-04.tsv.gz,Betty_White,52881,238234,2092,293207,70420
hdfs://spark-nn.eemcs.utwente.nl/user/s1934538/clickstream/clickstream-enwiki-2019-04.tsv.gz,Stan_Lee,161100,430302,3419,594821,194767
hdfs://spark-nn.eemcs.utwente.nl/user/s1934538/clickstream/clickstream-enwiki-2019-04.tsv.gz,David_Beckham,33816,181441,1550,216807,65934
hdfs://spark-nn.eemcs.utwente.nl/user/s1934538/clickstream/clickstream-enwiki-2019-04.tsv.gz,Top_Gun:_Maverick,61661,48205,374,110240,81816
hdfs://spark-nn.eemcs.utwente.nl/user/s1934538/clickstream/clickstream-enwiki-2019-04.tsv.gz,Star_Wars:_The_Rise_of_Skywalker,298491,560679,17638,876808,542919
hdfs://spark-nn.eemcs.utwente.nl/user/s1934538/clickstream/clickstream-enwiki-2019-04.tsv.gz,Juneteenth,2195,58934,95,61224,5920
hdfs://spark-nn.eemcs.utwente.nl/user/s1934538/clickstream/clickstream-enwiki-2019-04.tsv.gz,Ghislaine_Maxwell,2331,4102,95,6528,1655
hdfs://spark-nn.eemcs.utwente.nl/user/s1934538/clickstream/clickstream-enwiki-2019-04.tsv.gz,Black_Panther_(film),137840,332349,5255,475444,272541
hdfs://spark-nn.eemcs.utwente.nl/user/s1934538/clickstream/clickstream-enwiki-2019-04.tsv.gz,XHamster,14353,69672,2048,86073,16459
hdfs://spark-nn.eemcs.utwente.nl/user/s1934538/clickstream/clickstream-enwiki-2019-04.tsv.gz,Avengers:_Infinity_War,650959,1301360,23894,1976213,1290401
hdfs://spark-nn.eemcs.utwente.nl/user/s1934538/clickstream/clickstream-enwiki-2019-04.tsv.gz,Grimes_(musician),113886,67502,629,182017,42897
hdfs://spark-nn.eemcs.utwente.nl/user/s1934538/clickstream/clickstream-enwiki-2019-04.tsv.gz,Murder_of_Dee_Dee_Blanchard,257561,2443199,4199,2704959,418699
hdfs://spark-nn.eemcs.utwente.nl/user/s1934538/clickstream/clickstream-enwiki-2019-04.tsv.gz,Kelly_Preston,64982,54400,173,119555,36300
hdfs://spark-nn.eemcs.utwente.nl/user/s1934538/clickstream/clickstream-enwiki-2019-04.tsv.gz,"Prince_Philip,_Duke_of_Edinburgh",204103,214222,5276,423601,253911
hdfs://spark-nn.eemcs.utwente.nl/user/s1934538/clickstream/clickstream-enwiki-2019-04.tsv.gz,Jeffrey_Dahmer,31296,418023,3607,452926,180834
hdfs://spark-nn.eemcs.utwente.nl/user/s1934538/clickstream/clickstream-enwiki-2019-04.tsv.gz,United_States_Electoral_College,23745,134327,284,158356,17213
hdfs://spark-nn.eemcs.utwente.nl/user/s1934538/clickstream/clickstream-enwiki-2019-04.tsv.gz,Hamas,21136,38366,467,59969,21574
hdfs://spark-nn.eemcs.utwente.nl/user/s1934538/clickstream/clickstream-enwiki-2019-04.tsv.gz,Hamilton_(musical),30987,256845,1522,289354,135509
hdfs://spark-nn.eemcs.utwente.nl/user/s1934538/clickstream/clickstream-enwiki-2019-04.tsv.gz,Valentine's_Day,3103,30041,221,33365,3073
hdfs://spark-nn.eemcs.utwente.nl/user/s1934538/clickstream/clickstream-enwiki-2019-04.tsv.gz,Israel,90489,330379,6665,427533,220798
hdfs://spark-nn.eemcs.utwente.nl/user/s1934538/clickstream/clickstream-enwiki-2019-04.tsv.gz,Fyre_Festival,22589,274285,1406,298280,128501
hdfs://spark-nn.eemcs.utwente.nl/user/s1934538/clickstream/clickstream-enwiki-2019-04.tsv.gz,Atal_Bihari_Vajpayee,30352,85624,91,116067,27648
hdfs://spark-nn.eemcs.utwente.nl/user/s1934538/clickstream/clickstream-enwiki-2019-04.tsv.gz,The_Nun_(2018_film),51277,241887,2149,295313,215483
hdfs://spark-nn.eemcs.utwente.nl/user/s1934538/clickstream/clickstream-enwiki-2019-04.tsv.gz,Naya_Rivera,20412,25421,117,45950,9255
hdfs://spark-nn.eemcs.utwente.nl/user/s1934538/clickstream/clickstream-enwiki-2019-04.tsv.gz,Deadpool_2,98522,163062,3879,265463,201419
hdfs://spark-nn.eemcs.utwente.nl/user/s1934538/clickstream/clickstream-enwiki-2019-04.tsv.gz,Mötley_Crüe,274832,1228997,9157,1512986,2109634
hdfs://spark-nn.eemcs.utwente.nl/user/s1934538/clickstream/clickstream-enwiki-2019-04.tsv.gz,Mac_Miller,37689,196491,2084,236264,69737
hdfs://spark-nn.eemcs.utwente.nl/user/s1934538/clickstream/clickstream-enwiki-2019-04.tsv.gz,Bob_Saget,19791,47363,361,67515,13417
hdfs://spark-nn.eemcs.utwente.nl/user/s1934538/clickstream/clickstream-enwiki-2019-04.tsv.gz,Jimmy_Buffett,10696,58445,841,69982,21529
hdfs://spark-nn.eemcs.utwente.nl/user/s1934538/clickstream/clickstream-enwiki-2019-04.tsv.gz,2.0_(film),38146,331696,1387,371229,97091
hdfs://spark-nn.eemcs.utwente.nl/user/s1934538/clickstream/clickstream-enwiki-2019-04.tsv.gz,Coronavirus,900,9744,78,10722,1498
hdfs://spark-nn.eemcs.utwente.nl/user/s1934538/clickstream/clickstream-enwiki-2019-04.tsv.gz,Charles_Sobhraj,4844,24956,77,29877,7245
hdfs://spark-nn.eemcs.utwente.nl/user/s1934538/clickstream/clickstream-enwiki-2019-04.tsv.gz,2018_FIFA_World_Cup,66263,139895,1618,207776,100135
hdfs://spark-nn.eemcs.utwente.nl/user/s1934538/clickstream/clickstream-enwiki-2019-04.tsv.gz,Us_(2019_film),143842,1539099,14666,1697607,440907
hdfs://spark-nn.eemcs.utwente.nl/user/s1934538/clickstream/clickstream-enwiki-2019-04.tsv.gz,Bipin_Rawat,4234,13221,15,17470,6715
hdfs://spark-nn.eemcs.utwente.nl/user/s1934538/clickstream/clickstream-enwiki-2019-04.tsv.gz,Game_of_Thrones,572279,4003678,97752,4673709,3678405
hdfs://spark-nn.eemcs.utwente.nl/user/s1934538/clickstream/clickstream-enwiki-2019-04.tsv.gz,R._Kelly,26902,144644,1513,173059,77866
hdfs://spark-nn.eemcs.utwente.nl/user/s1934538/clickstream/clickstream-enwiki-2019-04.tsv.gz,Google_logo,1094,17493,13,18600,2125
hdfs://spark-nn.eemcs.utwente.nl/user/s1934538/clickstream/clickstream-enwiki-2019-04.tsv.gz,The_Umbrella_Academy_(TV_series),95584,488671,6563,590818,364361
hdfs://spark-nn.eemcs.utwente.nl/user/s1934538/clickstream/clickstream-enwiki-2019-04.tsv.gz,Wonder_Woman_1984,113872,46798,483,161153,92307
hdfs://spark-nn.eemcs.utwente.nl/user/s1934538/clickstream/clickstream-enwiki-2019-04.tsv.gz,Indian_Premier_League,58400,401819,977,461196,278302
hdfs://spark-nn.eemcs.utwente.nl/user/s1934538/clickstream/clickstream-enwiki-2019-04.tsv.gz,Game_of_Thrones_(season_8),755973,5778461,119179,6653613,2231022
hdfs://spark-nn.eemcs.utwente.nl/user/s1934538/clickstream/clickstream-enwiki-2019-04.tsv.gz,XNXX,3223,264885,9042,277150,81075
hdfs://spark-nn.eemcs.utwente.nl/user/s1934538/clickstream/clickstream-enwiki-2019-04.tsv.gz,Joaquin_Phoenix,264511,540747,4528,809786,660805
hdfs://spark-nn.eemcs.utwente.nl/user/s1934538/clickstream/clickstream-enwiki-2019-04.tsv.gz,Anne_Heche,27511,78427,341,106279,30071
hdfs://spark-nn.eemcs.utwente.nl/user/s1934538/clickstream/clickstream-enwiki-2019-04.tsv.gz,A_Quiet_Place_(film),42661,316693,2765,362119,106036
hdfs://spark-nn.eemcs.utwente.nl/user/s1934538/clickstream/clickstream-enwiki-2019-04.tsv.gz,Jenna_Ortega,8408,14637,2075,25120,5542
hdfs://spark-nn.eemcs.utwente.nl/user/s1934538/clickstream/clickstream-enwiki-2019-04.tsv.gz,Roe_v._Wade,15615,132781,1060,149456,32474
hdfs://spark-nn.eemcs.utwente.nl/user/s1934538/clickstream/clickstream-enwiki-2019-04.tsv.gz,Elon_Musk,143163,761367,5350,909880,567236
hdfs://spark-nn.eemcs.utwente.nl/user/s1934538/clickstream/clickstream-enwiki-2019-04.tsv.gz,Pornhub,40306,362466,11029,413801,74242
hdfs://spark-nn.eemcs.utwente.nl/user/s1934538/clickstream/clickstream-enwiki-2019-04.tsv.gz,"Princess_Margaret,_Countess_of_Snowdon",105094,255961,1501,362556,227068
hdfs://spark-nn.eemcs.utwente.nl/user/s1934538/clickstream/clickstream-enwiki-2019-04.tsv.gz,Wikipedia,44181,914835,1275,960291,208868
hdfs://spark-nn.eemcs.utwente.nl/user/s1934538/clickstream/clickstream-enwiki-2019-04.tsv.gz,Tina_Turner,20223,197308,1553,219084,54348
hdfs://spark-nn.eemcs.utwente.nl/user/s1934538/clickstream/clickstream-enwiki-2019-04.tsv.gz,The_Weeknd,38650,99687,1070,139407,57725
hdfs://spark-nn.eemcs.utwente.nl/user/s1934538/clickstream/clickstream-enwiki-2019-04.tsv.gz,DMX_(rapper),13084,67838,406,81328,30991
hdfs://spark-nn.eemcs.utwente.nl/user/s1934538/clickstream/clickstream-enwiki-2019-04.tsv.gz,Dennis_Nilsen,4750,21643,160,26553,5236
hdfs://spark-nn.eemcs.utwente.nl/user/s1934538/clickstream/clickstream-enwiki-2019-04.tsv.gz,Croatia,37137,143617,2427,183181,60036
hdfs://spark-nn.eemcs.utwente.nl/user/s1934538/clickstream/clickstream-enwiki-2019-04.tsv.gz,Puneeth_Rajkumar,7845,16756,29,24630,11273
hdfs://spark-nn.eemcs.utwente.nl/user/s1934538/clickstream/clickstream-enwiki-2019-04.tsv.gz,Fantastic_Beasts:_The_Crimes_of_Grindelwald,83024,249909,4344,337277,190882
hdfs://spark-nn.eemcs.utwente.nl/user/s1934538/clickstream/clickstream-enwiki-2019-04.tsv.gz,2023_Cricket_World_Cup,37195,23376,16,60587,19521
hdfs://spark-nn.eemcs.utwente.nl/user/s1934538/clickstream/clickstream-enwiki-2019-04.tsv.gz,The_Irishman,63,242,63,368,500
hdfs://spark-nn.eemcs.utwente.nl/user/s1934538/clickstream/clickstream-enwiki-2019-04.tsv.gz,Stranger_Things_(season_3),14145,89584,687,104416,47997
hdfs://spark-nn.eemcs.utwente.nl/user/s1934538/clickstream/clickstream-enwiki-2019-04.tsv.gz,Cleopatra,47602,168434,1986,218022,92711
hdfs://spark-nn.eemcs.utwente.nl/user/s1934538/clickstream/clickstream-enwiki-2019-04.tsv.gz,Luke_Perry,50717,206940,2057,259714,66374
hdfs://spark-nn.eemcs.utwente.nl/user/s1934538/clickstream/clickstream-enwiki-2019-04.tsv.gz,Kamala_Harris,31870,299946,2283,334099,102073
hdfs://spark-nn.eemcs.utwente.nl/user/s1934538/clickstream/clickstream-enwiki-2019-04.tsv.gz,Crazy_Rich_Asians_(film),53244,374685,4776,432705,464672
hdfs://spark-nn.eemcs.utwente.nl/user/s1934538/clickstream/clickstream-enwiki-2019-04.tsv.gz,Tonya_Harding,27445,130628,689,158762,29128
hdfs://spark-nn.eemcs.utwente.nl/user/s1934538/clickstream/clickstream-enwiki-2019-04.tsv.gz,John_McCain,35218,104990,1023,141231,61530
hdfs://spark-nn.eemcs.utwente.nl/user/s1934538/clickstream/clickstream-enwiki-2019-04.tsv.gz,Freddie_Mercury,214859,1590930,10714,1816503,635455
hdfs://spark-nn.eemcs.utwente.nl/user/s1934538/clickstream/clickstream-enwiki-2019-04.tsv.gz,Lance_Reddick,26605,31561,181,58347,12519
hdfs://spark-nn.eemcs.utwente.nl/user/s1934538/clickstream/clickstream-enwiki-2019-04.tsv.gz,Ted_Bundy,46034,997228,8022,1051284,259005
hdfs://spark-nn.eemcs.utwente.nl/user/s1934538/clickstream/clickstream-enwiki-2019-04.tsv.gz,Salman_Rushdie,25667,218029,692,244388,63604
hdfs://spark-nn.eemcs.utwente.nl/user/s1934538/clickstream/clickstream-enwiki-2019-04.tsv.gz,United_States_Senate,43557,58506,1052,103115,47981
hdfs://spark-nn.eemcs.utwente.nl/user/s1934538/clickstream/clickstream-enwiki-2019-04.tsv.gz,Darth_Vader,31059,254905,755,286719,60647
hdfs://spark-nn.eemcs.utwente.nl/user/s1934538/clickstream/clickstream-enwiki-2019-04.tsv.gz,Brett_Kavanaugh,25110,86989,426,112525,30745
hdfs://spark-nn.eemcs.utwente.nl/user/s1934538/clickstream/clickstream-enwiki-2019-04.tsv.gz,Matthew_Perry,64837,161908,671,227416,102307
hdfs://spark-nn.eemcs.utwente.nl/user/s1934538/clickstream/clickstream-enwiki-2019-04.tsv.gz,List_of_FIFA_World_Cup_finals,1534,49342,108,50984,12042
hdfs://spark-nn.eemcs.utwente.nl/user/s1934538/clickstream/clickstream-enwiki-2019-04.tsv.gz,2022_FIFA_World_Cup,45281,94178,1577,141036,67095
hdfs://spark-nn.eemcs.utwente.nl/user/s1934538/clickstream/clickstream-enwiki-2019-04.tsv.gz,Spanish_flu,21534,76543,649,98726,20300
hdfs://spark-nn.eemcs.utwente.nl/user/s1934538/clickstream/clickstream-enwiki-2019-04.tsv.gz,2020_Summer_Olympics,43939,111243,2328,157510,116769
hdfs://spark-nn.eemcs.utwente.nl/user/s1934538/clickstream/clickstream-enwiki-2019-04.tsv.gz,Cameron_Boyce,13224,27500,101,40825,7882
hdfs://spark-nn.eemcs.utwente.nl/user/s1934538/clickstream/clickstream-enwiki-2019-04.tsv.gz,Deaths_in_2019,1251703,1887783,8082,3147568,1742804
hdfs://spark-nn.eemcs.utwente.nl/user/s1934538/clickstream/clickstream-enwiki-2019-04.tsv.gz,Charles_III,96,385,69,550,399
hdfs://spark-nn.eemcs.utwente.nl/user/s1934538/clickstream/clickstream-enwiki-2019-04.tsv.gz,Critical_race_theory,1940,21059,36,23035,4361
hdfs://spark-nn.eemcs.utwente.nl/user/s1934538/clickstream/clickstream-enwiki-2019-04.tsv.gz,Juice_Wrld,15879,127206,1559,144644,41166
hdfs://spark-nn.eemcs.utwente.nl/user/s1934538/clickstream/clickstream-enwiki-2019-04.tsv.gz,Once_Upon_a_Time_in_Hollywood,145132,136152,4282,285566,264107
hdfs://spark-nn.eemcs.utwente.nl/user/s1934538/clickstream/clickstream-enwiki-2019-04.tsv.gz,Elizabeth_II,428375,679502,715,1108592,847025
hdfs://spark-nn.eemcs.utwente.nl/user/s1934538/clickstream/clickstream-enwiki-2019-04.tsv.gz,QAnon,4712,169396,889,174997,36285
hdfs://spark-nn.eemcs.utwente.nl/user/s1934538/clickstream/clickstream-enwiki-2019-04.tsv.gz,Mulan_(2020_film),33968,37632,300,71900,78900
hdfs://spark-nn.eemcs.utwente.nl/user/s1934538/clickstream/clickstream-enwiki-2019-04.tsv.gz,RRR_(film),60377,47691,550,108618,66963
hdfs://spark-nn.eemcs.utwente.nl/user/s1934538/clickstream/clickstream-enwiki-2019-04.tsv.gz,1234,159,1513,10,1682,302
hdfs://spark-nn.eemcs.utwente.nl/user/s1934538/clickstream/clickstream-enwiki-2019-04.tsv.gz,Godzilla_vs._Kong,84618,28722,301,113641,74450
hdfs://spark-nn.eemcs.utwente.nl/user/s1934538/clickstream/clickstream-enwiki-2019-04.tsv.gz,Meat_Loaf,19047,74523,697,94267,33633
hdfs://spark-nn.eemcs.utwente.nl/user/s1934538/clickstream/clickstream-enwiki-2019-04.tsv.gz,Cricket_World_Cup,14906,195917,1778,212601,132591
hdfs://spark-nn.eemcs.utwente.nl/user/s1934538/clickstream/clickstream-enwiki-2019-04.tsv.gz,Greta_Thunberg,11332,300381,2968,314681,126389
hdfs://spark-nn.eemcs.utwente.nl/user/s1934538/clickstream/clickstream-enwiki-2019-04.tsv.gz,Chadwick_Boseman,80828,108491,1003,190322,65072
hdfs://spark-nn.eemcs.utwente.nl/user/s1934538/clickstream/clickstream-enwiki-2019-04.tsv.gz,Central_Park_jogger_case,25280,307669,796,333745,43763
hdfs://spark-nn.eemcs.utwente.nl/user/s1934538/clickstream/clickstream-enwiki-2019-04.tsv.gz,Brie_Larson,389435,1122585,9174,1521194,675820
hdfs://spark-nn.eemcs.utwente.nl/user/s1934538/clickstream/clickstream-enwiki-2019-04.tsv.gz,2020_United_States_presidential_election,105021,350568,8297,463886,374989
hdfs://spark-nn.eemcs.utwente.nl/user/s1934538/clickstream/clickstream-enwiki-2019-04.tsv.gz,FIFA_World_Cup,30687,116256,1537,148480,115821
hdfs://spark-nn.eemcs.utwente.nl/user/s1934538/clickstream/clickstream-enwiki-2019-04.tsv.gz,Ruth_Bader_Ginsburg,50741,351342,1483,403566,168538
hdfs://spark-nn.eemcs.utwente.nl/user/s1934538/clickstream/clickstream-enwiki-2019-04.tsv.gz,Bible,18134,6392980,1959,6413073,40460
hdfs://spark-nn.eemcs.utwente.nl/user/s1934538/clickstream/clickstream-enwiki-2019-04.tsv.gz,The_Mandalorian,68050,197998,3026,269074,218913
hdfs://spark-nn.eemcs.utwente.nl/user/s1934538/clickstream/clickstream-enwiki-2019-04.tsv.gz,Aquaman_(film),159892,703222,10632,873746,457517
hdfs://spark-nn.eemcs.utwente.nl/user/s1934538/clickstream/clickstream-enwiki-2019-04.tsv.gz,2018_Asian_Games,7493,20380,81,27954,15751
hdfs://spark-nn.eemcs.utwente.nl/user/s1934538/clickstream/clickstream-enwiki-2019-04.tsv.gz,Main_Page,24782,495549155,4454839,500028776,33427089
hdfs://spark-nn.eemcs.utwente.nl/user/s1934538/clickstream/clickstream-enwiki-2019-04.tsv.gz,Joe_Biden,70645,767662,13780,852087,262095
hdfs://spark-nn.eemcs.utwente.nl/user/s1934538/clickstream/clickstream-enwiki-2019-04.tsv.gz,Donald_Glover,102523,383401,3184,489108,167458
hdfs://spark-nn.eemcs.utwente.nl/user/s1934538/clickstream/clickstream-enwiki-2019-04.tsv.gz,Saaho,32411,56976,157,89544,53001
hdfs://spark-nn.eemcs.utwente.nl/user/s1934538/clickstream/clickstream-enwiki-2019-04.tsv.gz,Sylvester_Stallone,76635,320772,2037,399444,258656
hdfs://spark-nn.eemcs.utwente.nl/user/s1934538/clickstream/clickstream-enwiki-2019-04.tsv.gz,List_of_Marvel_Cinematic_Universe_films,716039,4085948,8452,4810439,1575169
hdfs://spark-nn.eemcs.utwente.nl/user/s1934538/clickstream/clickstream-enwiki-2019-04.tsv.gz,NATO,45235,171609,8595,225439,73987
hdfs://spark-nn.eemcs.utwente.nl/user/s1934538/clickstream/clickstream-enwiki-2019-04.tsv.gz,Tunnel,3307,11967,115,15389,3238
hdfs://spark-nn.eemcs.utwente.nl/user/s1934538/clickstream/clickstream-enwiki-2019-06.tsv.gz,Cameron_Boyce,16987,33100,163,50250,9904
hdfs://spark-nn.eemcs.utwente.nl/user/s1934538/clickstream/clickstream-enwiki-2019-06.tsv.gz,Freddie_Mercury,136628,1065401,7781,1209810,434860
hdfs://spark-nn.eemcs.utwente.nl/user/s1934538/clickstream/clickstream-enwiki-2019-06.tsv.gz,Deaths_in_2019,1193173,1936145,9824,3139142,1731458
hdfs://spark-nn.eemcs.utwente.nl/user/s1934538/clickstream/clickstream-enwiki-2019-06.tsv.gz,The_Witcher_(TV_series),18304,52087,489,70880,40036
hdfs://spark-nn.eemcs.utwente.nl/user/s1934538/clickstream/clickstream-enwiki-2019-06.tsv.gz,Jason_Momoa,198549,437368,2059,637976,263893
hdfs://spark-nn.eemcs.utwente.nl/user/s1934538/clickstream/clickstream-enwiki-2019-06.tsv.gz,DMX_(rapper),13395,68729,436,82560,30468
hdfs://spark-nn.eemcs.utwente.nl/user/s1934538/clickstream/clickstream-enwiki-2019-06.tsv.gz,Juneteenth,5805,1108174,11025,1125004,95851
hdfs://spark-nn.eemcs.utwente.nl/user/s1934538/clickstream/clickstream-enwiki-2019-06.tsv.gz,Dark_Phoenix_(film),351697,2817345,80944,3249986,1820810
hdfs://spark-nn.eemcs.utwente.nl/user/s1934538/clickstream/clickstream-enwiki-2019-06.tsv.gz,Taliban,20654,56666,770,78090,44563
hdfs://spark-nn.eemcs.utwente.nl/user/s1934538/clickstream/clickstream-enwiki-2019-06.tsv.gz,Tunnel,3526,10556,96,14178,3264
hdfs://spark-nn.eemcs.utwente.nl/user/s1934538/clickstream/clickstream-enwiki-2019-06.tsv.gz,Godzilla_vs._Kong,287632,148207,950,436789,329865
hdfs://spark-nn.eemcs.utwente.nl/user/s1934538/clickstream/clickstream-enwiki-2019-06.tsv.gz,Top_Gun:_Maverick,73150,59743,470,133363,99954
hdfs://spark-nn.eemcs.utwente.nl/user/s1934538/clickstream/clickstream-enwiki-2019-06.tsv.gz,Central_Park_jogger_case,827902,5309877,13502,6151281,847830
hdfs://spark-nn.eemcs.utwente.nl/user/s1934538/clickstream/clickstream-enwiki-2019-06.tsv.gz,Richard_Jewell,5141,40911,504,46556,18815
hdfs://spark-nn.eemcs.utwente.nl/user/s1934538/clickstream/clickstream-enwiki-2019-06.tsv.gz,Cricket_World_Cup,93076,1160863,9848,1263787,740166
hdfs://spark-nn.eemcs.utwente.nl/user/s1934538/clickstream/clickstream-enwiki-2019-06.tsv.gz,Greta_Thunberg,4578,107327,1190,113095,31877
hdfs://spark-nn.eemcs.utwente.nl/user/s1934538/clickstream/clickstream-enwiki-2019-06.tsv.gz,Lisa_Marie_Presley,127634,174295,944,302873,168674
hdfs://spark-nn.eemcs.utwente.nl/user/s1934538/clickstream/clickstream-enwiki-2019-06.tsv.gz,The_Shape_of_Water,24534,62739,715,87988,39964
hdfs://spark-nn.eemcs.utwente.nl/user/s1934538/clickstream/clickstream-enwiki-2019-06.tsv.gz,Amy_Coney_Barrett,1254,3326,54,4634,1170
hdfs://spark-nn.eemcs.utwente.nl/user/s1934538/clickstream/clickstream-enwiki-2019-06.tsv.gz,XXX:_Return_of_Xander_Cage,29180,132924,922,163026,37676
hdfs://spark-nn.eemcs.utwente.nl/user/s1934538/clickstream/clickstream-enwiki-2019-06.tsv.gz,Tonya_Harding,24269,113173,494,137936,26113
hdfs://spark-nn.eemcs.utwente.nl/user/s1934538/clickstream/clickstream-enwiki-2019-06.tsv.gz,"Meghan,_Duchess_of_Sussex",100761,378477,2588,481826,268941
hdfs://spark-nn.eemcs.utwente.nl/user/s1934538/clickstream/clickstream-enwiki-2019-06.tsv.gz,Qasem_Soleimani,5412,8632,29,14073,6803
hdfs://spark-nn.eemcs.utwente.nl/user/s1934538/clickstream/clickstream-enwiki-2019-06.tsv.gz,Area_51,49274,264839,1811,315924,105504
hdfs://spark-nn.eemcs.utwente.nl/user/s1934538/clickstream/clickstream-enwiki-2019-06.tsv.gz,Manti_Te'o,2955,12747,43,15745,1661
hdfs://spark-nn.eemcs.utwente.nl/user/s1934538/clickstream/clickstream-enwiki-2019-06.tsv.gz,Aretha_Franklin,18206,89801,861,108868,34142
hdfs://spark-nn.eemcs.utwente.nl/user/s1934538/clickstream/clickstream-enwiki-2019-06.tsv.gz,Anthony_Bourdain,18396,391054,3101,412551,101168
hdfs://spark-nn.eemcs.utwente.nl/user/s1934538/clickstream/clickstream-enwiki-2019-06.tsv.gz,Jeffrey_Epstein,9102,45372,261,54735,16559
hdfs://spark-nn.eemcs.utwente.nl/user/s1934538/clickstream/clickstream-enwiki-2019-06.tsv.gz,Sushma_Swaraj,11438,80387,131,91956,22196
hdfs://spark-nn.eemcs.utwente.nl/user/s1934538/clickstream/clickstream-enwiki-2019-06.tsv.gz,List_of_awards_and_nominations_received_by_Meryl_Streep,18194,14795,205,33194,10321
hdfs://spark-nn.eemcs.utwente.nl/user/s1934538/clickstream/clickstream-enwiki-2019-06.tsv.gz,List_of_Queen_of_the_South_episodes,42274,9115,87,51476,1916
hdfs://spark-nn.eemcs.utwente.nl/user/s1934538/clickstream/clickstream-enwiki-2019-06.tsv.gz,Keanu_Reeves,368240,4240700,27912,4636852,2110983
hdfs://spark-nn.eemcs.utwente.nl/user/s1934538/clickstream/clickstream-enwiki-2019-06.tsv.gz,Hyphen-minus,5653,43116548,7495117,50617318,1023
hdfs://spark-nn.eemcs.utwente.nl/user/s1934538/clickstream/clickstream-enwiki-2019-06.tsv.gz,QAnon,3940,68710,612,73262,18565
hdfs://spark-nn.eemcs.utwente.nl/user/s1934538/clickstream/clickstream-enwiki-2019-06.tsv.gz,Elizabeth_II,476750,914154,6407,1397311,1037774
hdfs://spark-nn.eemcs.utwente.nl/user/s1934538/clickstream/clickstream-enwiki-2019-06.tsv.gz,Naomi_Osaka,29729,104643,778,135150,26021
hdfs://spark-nn.eemcs.utwente.nl/user/s1934538/clickstream/clickstream-enwiki-2019-06.tsv.gz,Eddie_Van_Halen,35884,57120,610,93614,46653
hdfs://spark-nn.eemcs.utwente.nl/user/s1934538/clickstream/clickstream-enwiki-2019-06.tsv.gz,Charles_III,86,332,62,480,356
hdfs://spark-nn.eemcs.utwente.nl/user/s1934538/clickstream/clickstream-enwiki-2019-06.tsv.gz,Johnny_Depp,106121,301168,2420,409709,237942
hdfs://spark-nn.eemcs.utwente.nl/user/s1934538/clickstream/clickstream-enwiki-2019-06.tsv.gz,Amber_Heard,96641,157778,669,255088,119665
hdfs://spark-nn.eemcs.utwente.nl/user/s1934538/clickstream/clickstream-enwiki-2019-06.tsv.gz,Hamilton_(musical),30320,241349,1442,273111,133765
hdfs://spark-nn.eemcs.utwente.nl/user/s1934538/clickstream/clickstream-enwiki-2019-06.tsv.gz,Deadpool_2,100429,151725,2748,254902,169547
hdfs://spark-nn.eemcs.utwente.nl/user/s1934538/clickstream/clickstream-enwiki-2019-06.tsv.gz,The_Mandalorian,32770,28795,345,61910,45495
hdfs://spark-nn.eemcs.utwente.nl/user/s1934538/clickstream/clickstream-enwiki-2019-06.tsv.gz,Israel,65943,236451,4004,306398,145599
hdfs://spark-nn.eemcs.utwente.nl/user/s1934538/clickstream/clickstream-enwiki-2019-06.tsv.gz,Puneeth_Rajkumar,7647,15025,17,22689,11422
hdfs://spark-nn.eemcs.utwente.nl/user/s1934538/clickstream/clickstream-enwiki-2019-06.tsv.gz,1917_(2019_film),53044,15689,3566,72299,32158
hdfs://spark-nn.eemcs.utwente.nl/user/s1934538/clickstream/clickstream-enwiki-2019-06.tsv.gz,Ted_Bundy,62293,1431111,7429,1500833,323260
hdfs://spark-nn.eemcs.utwente.nl/user/s1934538/clickstream/clickstream-enwiki-2019-06.tsv.gz,Meat_Loaf,19871,83057,882,103810,34026
hdfs://spark-nn.eemcs.utwente.nl/user/s1934538/clickstream/clickstream-enwiki-2019-06.tsv.gz,Afghanistan,50413,206823,2220,259456,130337
hdfs://spark-nn.eemcs.utwente.nl/user/s1934538/clickstream/clickstream-enwiki-2019-06.tsv.gz,Spanish_flu,19728,64167,646,84541,17600
hdfs://spark-nn.eemcs.utwente.nl/user/s1934538/clickstream/clickstream-enwiki-2019-06.tsv.gz,Fantastic_Beasts:_The_Crimes_of_Grindelwald,65461,125586,2002,193049,105840
hdfs://spark-nn.eemcs.utwente.nl/user/s1934538/clickstream/clickstream-enwiki-2019-06.tsv.gz,JSON_Web_Token,997,21095,23,22115,1709
hdfs://spark-nn.eemcs.utwente.nl/user/s1934538/clickstream/clickstream-enwiki-2019-06.tsv.gz,2018_Winter_Olympics,28915,28140,276,57331,32314
hdfs://spark-nn.eemcs.utwente.nl/user/s1934538/clickstream/clickstream-enwiki-2019-06.tsv.gz,Avengers:_Endgame,622828,3663371,85110,4371309,2048649
hdfs://spark-nn.eemcs.utwente.nl/user/s1934538/clickstream/clickstream-enwiki-2019-06.tsv.gz,No_Time_to_Die,240,790,20,1050,666
hdfs://spark-nn.eemcs.utwente.nl/user/s1934538/clickstream/clickstream-enwiki-2019-06.tsv.gz,Aaron_Hernandez,6915,72708,313,79936,26332
hdfs://spark-nn.eemcs.utwente.nl/user/s1934538/clickstream/clickstream-enwiki-2019-06.tsv.gz,"Princess_Margaret,_Countess_of_Snowdon",115146,241136,1386,357668,229895
hdfs://spark-nn.eemcs.utwente.nl/user/s1934538/clickstream/clickstream-enwiki-2019-06.tsv.gz,Priyanka_Chopra,264765,468821,4274,737860,260663
hdfs://spark-nn.eemcs.utwente.nl/user/s1934538/clickstream/clickstream-enwiki-2019-06.tsv.gz,Parasite_(2019_film),38168,152016,1064,191248,71106
hdfs://spark-nn.eemcs.utwente.nl/user/s1934538/clickstream/clickstream-enwiki-2019-06.tsv.gz,Bird_Box_(film),24506,128437,1389,154332,48935
hdfs://spark-nn.eemcs.utwente.nl/user/s1934538/clickstream/clickstream-enwiki-2019-06.tsv.gz,Pornhub,31536,396779,12008,440323,69985
hdfs://spark-nn.eemcs.utwente.nl/user/s1934538/clickstream/clickstream-enwiki-2019-06.tsv.gz,Game_of_Thrones_(season_8),59273,323584,6742,389599,135432
hdfs://spark-nn.eemcs.utwente.nl/user/s1934538/clickstream/clickstream-enwiki-2019-06.tsv.gz,Brie_Larson,138202,395931,2591,536724,223243
hdfs://spark-nn.eemcs.utwente.nl/user/s1934538/clickstream/clickstream-enwiki-2019-06.tsv.gz,Grimes_(musician),30040,39031,271,69342,24700
hdfs://spark-nn.eemcs.utwente.nl/user/s1934538/clickstream/clickstream-enwiki-2019-06.tsv.gz,Stranger_Things_(season_3),42131,379476,3494,425101,177322
hdfs://spark-nn.eemcs.utwente.nl/user/s1934538/clickstream/clickstream-enwiki-2019-06.tsv.gz,Croatia,40064,183519,2116,225699,69489
hdfs://spark-nn.eemcs.utwente.nl/user/s1934538/clickstream/clickstream-enwiki-2019-06.tsv.gz,Henry_V_of_England,48894,26192,251,75337,54133
hdfs://spark-nn.eemcs.utwente.nl/user/s1934538/clickstream/clickstream-enwiki-2019-06.tsv.gz,Cristiano_Ronaldo,172318,784962,6658,963938,230111
hdfs://spark-nn.eemcs.utwente.nl/user/s1934538/clickstream/clickstream-enwiki-2019-06.tsv.gz,Glass_(2019_film),76741,245680,2791,325212,109170
hdfs://spark-nn.eemcs.utwente.nl/user/s1934538/clickstream/clickstream-enwiki-2019-06.tsv.gz,Salman_Rushdie,25650,54170,369,80189,34416
hdfs://spark-nn.eemcs.utwente.nl/user/s1934538/clickstream/clickstream-enwiki-2019-06.tsv.gz,The_Irishman_(2019_film),65736,64537,726,130999,94575
hdfs://spark-nn.eemcs.utwente.nl/user/s1934538/clickstream/clickstream-enwiki-2019-06.tsv.gz,The_Umbrella_Academy_(TV_series),42020,196171,2675,240866,142379
hdfs://spark-nn.eemcs.utwente.nl/user/s1934538/clickstream/clickstream-enwiki-2019-06.tsv.gz,Jimmy_Buffett,10182,70313,571,81066,24602
hdfs://spark-nn.eemcs.utwente.nl/user/s1934538/clickstream/clickstream-enwiki-2019-06.tsv.gz,A_Quiet_Place_(film),28591,147353,1513,177457,51736
hdfs://spark-nn.eemcs.utwente.nl/user/s1934538/clickstream/clickstream-enwiki-2019-06.tsv.gz,Khabib_Nurmagomedov,67008,176280,1652,244940,126196
hdfs://spark-nn.eemcs.utwente.nl/user/s1934538/clickstream/clickstream-enwiki-2019-06.tsv.gz,Cecil_Hotel_(Los_Angeles),4251,16283,26,20560,7855
hdfs://spark-nn.eemcs.utwente.nl/user/s1934538/clickstream/clickstream-enwiki-2019-06.tsv.gz,Kate_Spade,26128,99574,5905,131607,45875
hdfs://spark-nn.eemcs.utwente.nl/user/s1934538/clickstream/clickstream-enwiki-2019-06.tsv.gz,Richard_Ramirez,9454,132106,1183,142743,35168
hdfs://spark-nn.eemcs.utwente.nl/user/s1934538/clickstream/clickstream-enwiki-2019-06.tsv.gz,A_Star_Is_Born_(2018_film),69685,608402,4515,682602,351147
hdfs://spark-nn.eemcs.utwente.nl/user/s1934538/clickstream/clickstream-enwiki-2019-06.tsv.gz,Spider-Man:_Far_From_Home,292011,1307514,35852,1635377,819614
hdfs://spark-nn.eemcs.utwente.nl/user/s1934538/clickstream/clickstream-enwiki-2019-06.tsv.gz,Donald_Trump,267319,1069492,15287,1352098,836357
hdfs://spark-nn.eemcs.utwente.nl/user/s1934538/clickstream/clickstream-enwiki-2019-06.tsv.gz,Charles_Sobhraj,3089,23117,67,26273,6134
hdfs://spark-nn.eemcs.utwente.nl/user/s1934538/clickstream/clickstream-enwiki-2019-06.tsv.gz,Deion_Sanders,6884,75243,258,82385,22714
hdfs://spark-nn.eemcs.utwente.nl/user/s1934538/clickstream/clickstream-enwiki-2019-06.tsv.gz,Death_of_Elisa_Lam,8393,57394,273,66060,17115
hdfs://spark-nn.eemcs.utwente.nl/user/s1934538/clickstream/clickstream-enwiki-2019-06.tsv.gz,2020_Summer_Olympics,87129,202565,4988,294682,243310
hdfs://spark-nn.eemcs.utwente.nl/user/s1934538/clickstream/clickstream-enwiki-2019-06.tsv.gz,Ukraine,64195,164520,3398,232113,104373
hdfs://spark-nn.eemcs.utwente.nl/user/s1934538/clickstream/clickstream-enwiki-2019-06.tsv.gz,J._Robert_Oppenheimer,19564,70870,195,90629,30643
hdfs://spark-nn.eemcs.utwente.nl/user/s1934538/clickstream/clickstream-enwiki-2019-06.tsv.gz,List_of_FIFA_World_Cup_finals,3903,163821,2924,170648,36848
hdfs://spark-nn.eemcs.utwente.nl/user/s1934538/clickstream/clickstream-enwiki-2019-06.tsv.gz,Gaza_Strip,13984,41516,206,55706,18059
hdfs://spark-nn.eemcs.utwente.nl/user/s1934538/clickstream/clickstream-enwiki-2019-06.tsv.gz,XNXX,3372,292865,10063,306300,73259
hdfs://spark-nn.eemcs.utwente.nl/user/s1934538/clickstream/clickstream-enwiki-2019-06.tsv.gz,When_They_See_Us,177652,2971275,16567,3165494,1839452
hdfs://spark-nn.eemcs.utwente.nl/user/s1934538/clickstream/clickstream-enwiki-2019-06.tsv.gz,Shakira,18718,179255,1608,199581,85752
hdfs://spark-nn.eemcs.utwente.nl/user/s1934538/clickstream/clickstream-enwiki-2019-06.tsv.gz,List_of_Marvel_Cinematic_Universe_films,193348,1094996,3471,1291815,420521
hdfs://spark-nn.eemcs.utwente.nl/user/s1934538/clickstream/clickstream-enwiki-2019-06.tsv.gz,HTTP_cookie,4206,250072,105,254383,36244
hdfs://spark-nn.eemcs.utwente.nl/user/s1934538/clickstream/clickstream-enwiki-2019-06.tsv.gz,Adele,20640,176970,1985,199595,56997
hdfs://spark-nn.eemcs.utwente.nl/user/s1934538/clickstream/clickstream-enwiki-2019-06.tsv.gz,Juice_Wrld,12577,92071,708,105356,29523
hdfs://spark-nn.eemcs.utwente.nl/user/s1934538/clickstream/clickstream-enwiki-2019-06.tsv.gz,Betty_White,70617,246275,2121,319013,75994
hdfs://spark-nn.eemcs.utwente.nl/user/s1934538/clickstream/clickstream-enwiki-2019-06.tsv.gz,Matthew_Perry,75015,225046,1039,301100,135267
hdfs://spark-nn.eemcs.utwente.nl/user/s1934538/clickstream/clickstream-enwiki-2019-06.tsv.gz,Christopher_Scarver,61940,21809,10,83759,27625
hdfs://spark-nn.eemcs.utwente.nl/user/s1934538/clickstream/clickstream-enwiki-2019-06.tsv.gz,Main_Page,22413,472115215,4011325,476148953,32109966
hdfs://spark-nn.eemcs.utwente.nl/user/s1934538/clickstream/clickstream-enwiki-2019-06.tsv.gz,2018_Asian_Games,8445,21824,163,30432,16930
hdfs://spark-nn.eemcs.utwente.nl/user/s1934538/clickstream/clickstream-enwiki-2019-06.tsv.gz,Mötley_Crüe,60874,263196,2100,326170,415232
hdfs://spark-nn.eemcs.utwente.nl/user/s1934538/clickstream/clickstream-enwiki-2019-06.tsv.gz,XHamster,13081,55928,2344,71353,14033
hdfs://spark-nn.eemcs.utwente.nl/user/s1934538/clickstream/clickstream-enwiki-2019-06.tsv.gz,Saaho,55784,253469,1108,310361,231970
hdfs://spark-nn.eemcs.utwente.nl/user/s1934538/clickstream/clickstream-enwiki-2019-06.tsv.gz,George_H._W._Bush,109653,110757,765,221175,118176
hdfs://spark-nn.eemcs.utwente.nl/user/s1934538/clickstream/clickstream-enwiki-2019-06.tsv.gz,Olivia_Newton-John,19744,100483,780,121007,53180
hdfs://spark-nn.eemcs.utwente.nl/user/s1934538/clickstream/clickstream-enwiki-2019-06.tsv.gz,Coronavirus,664,5361,36,6061,775
hdfs://spark-nn.eemcs.utwente.nl/user/s1934538/clickstream/clickstream-enwiki-2019-06.tsv.gz,Joker_(2019_film),90917,131295,2172,224384,140685
hdfs://spark-nn.eemcs.utwente.nl/user/s1934538/clickstream/clickstream-enwiki-2019-06.tsv.gz,Valentine's_Day,2728,29834,195,32757,2550
hdfs://spark-nn.eemcs.utwente.nl/user/s1934538/clickstream/clickstream-enwiki-2019-06.tsv.gz,List_of_most_popular_websites,32292,70624,197,103113,48156
hdfs://spark-nn.eemcs.utwente.nl/user/s1934538/clickstream/clickstream-enwiki-2019-06.tsv.gz,Queen_(band),93841,328118,4379,426338,395644
hdfs://spark-nn.eemcs.utwente.nl/user/s1934538/clickstream/clickstream-enwiki-2019-06.tsv.gz,Us_(2019_film),81036,877497,6207,964740,254919
hdfs://spark-nn.eemcs.utwente.nl/user/s1934538/clickstream/clickstream-enwiki-2019-06.tsv.gz,Kylian_Mbappé,35441,204267,2301,242009,44014
hdfs://spark-nn.eemcs.utwente.nl/user/s1934538/clickstream/clickstream-enwiki-2019-06.tsv.gz,Sinéad_O'Connor,10730,74148,598,85476,21647
hdfs://spark-nn.eemcs.utwente.nl/user/s1934538/clickstream/clickstream-enwiki-2019-06.tsv.gz,Kelly_Preston,66658,50329,154,117141,34586
hdfs://spark-nn.eemcs.utwente.nl/user/s1934538/clickstream/clickstream-enwiki-2019-06.tsv.gz,Luke_Perry,55860,276349,1546,333755,84417
hdfs://spark-nn.eemcs.utwente.nl/user/s1934538/clickstream/clickstream-enwiki-2019-06.tsv.gz,United_States_Senate,43477,54464,766,98707,39472
hdfs://spark-nn.eemcs.utwente.nl/user/s1934538/clickstream/clickstream-enwiki-2019-06.tsv.gz,WrestleMania_34,19466,12172,170,31808,20892
hdfs://spark-nn.eemcs.utwente.nl/user/s1934538/clickstream/clickstream-enwiki-2019-06.tsv.gz,UEFA_Euro_2020,130777,376311,7690,514778,158206
hdfs://spark-nn.eemcs.utwente.nl/user/s1934538/clickstream/clickstream-enwiki-2019-06.tsv.gz,Louis_Tomlinson,26882,50763,300,77945,12499
hdfs://spark-nn.eemcs.utwente.nl/user/s1934538/clickstream/clickstream-enwiki-2019-06.tsv.gz,Grover,1234,5545,45,6824,1397
hdfs://spark-nn.eemcs.utwente.nl/user/s1934538/clickstream/clickstream-enwiki-2019-06.tsv.gz,George_VI,357761,172762,832,531355,373094
hdfs://spark-nn.eemcs.utwente.nl/user/s1934538/clickstream/clickstream-enwiki-2019-06.tsv.gz,1234,101,1449,12,1562,129
hdfs://spark-nn.eemcs.utwente.nl/user/s1934538/clickstream/clickstream-enwiki-2019-06.tsv.gz,Game_of_Thrones,134874,611426,15631,761931,618613
hdfs://spark-nn.eemcs.utwente.nl/user/s1934538/clickstream/clickstream-enwiki-2019-06.tsv.gz,List_of_highest-grossing_Indian_films,68388,365050,917,434355,199813
hdfs://spark-nn.eemcs.utwente.nl/user/s1934538/clickstream/clickstream-enwiki-2019-06.tsv.gz,The_Irishman,50,213,29,292,429
hdfs://spark-nn.eemcs.utwente.nl/user/s1934538/clickstream/clickstream-enwiki-2019-06.tsv.gz,Rishi_Sunak,15881,14631,186,30698,4745
hdfs://spark-nn.eemcs.utwente.nl/user/s1934538/clickstream/clickstream-enwiki-2019-06.tsv.gz,Kim_Jong-un,52638,177878,1784,232300,131623
hdfs://spark-nn.eemcs.utwente.nl/user/s1934538/clickstream/clickstream-enwiki-2019-06.tsv.gz,Mulan_(2020_film),49501,78491,600,128592,147103
hdfs://spark-nn.eemcs.utwente.nl/user/s1934538/clickstream/clickstream-enwiki-2019-06.tsv.gz,2.0_(film),29671,136035,631,166337,39615
hdfs://spark-nn.eemcs.utwente.nl/user/s1934538/clickstream/clickstream-enwiki-2019-06.tsv.gz,List_of_James_Bond_films,15175,190088,516,205779,90051
hdfs://spark-nn.eemcs.utwente.nl/user/s1934538/clickstream/clickstream-enwiki-2019-06.tsv.gz,Media,66,17836,417,18319,1904
hdfs://spark-nn.eemcs.utwente.nl/user/s1934538/clickstream/clickstream-enwiki-2019-06.tsv.gz,Vladimir_Putin,93820,225355,3137,322312,184998
hdfs://spark-nn.eemcs.utwente.nl/user/s1934538/clickstream/clickstream-enwiki-2019-06.tsv.gz,Antifa_(United_States),8267,134535,437,143239,20079
hdfs://spark-nn.eemcs.utwente.nl/user/s1934538/clickstream/clickstream-enwiki-2019-06.tsv.gz,Dennis_Nilsen,4649,24556,143,29348,6120
hdfs://spark-nn.eemcs.utwente.nl/user/s1934538/clickstream/clickstream-enwiki-2019-06.tsv.gz,Stranger_Things,110422,523975,10891,645288,601153
hdfs://spark-nn.eemcs.utwente.nl/user/s1934538/clickstream/clickstream-enwiki-2019-06.tsv.gz,Once_Upon_a_Time_in_Hollywood,175100,320870,5903,501873,362450
hdfs://spark-nn.eemcs.utwente.nl/user/s1934538/clickstream/clickstream-enwiki-2019-06.tsv.gz,Lists_of_deaths_by_year,7548,159732,298,167578,149849
hdfs://spark-nn.eemcs.utwente.nl/user/s1934538/clickstream/clickstream-enwiki-2019-10.tsv.gz,Roe_v._Wade,13678,90266,487,104431,26900
hdfs://spark-nn.eemcs.utwente.nl/user/s1934538/clickstream/clickstream-enwiki-2019-10.tsv.gz,Keanu_Reeves,99339,610446,6343,716128,323461
hdfs://spark-nn.eemcs.utwente.nl/user/s1934538/clickstream/clickstream-enwiki-2019-10.tsv.gz,Gaza_Strip,14790,31299,154,46243,15500
hdfs://spark-nn.eemcs.utwente.nl/user/s1934538/clickstream/clickstream-enwiki-2019-10.tsv.gz,Shakira,21327,178265,1927,201519,85634
hdfs://spark-nn.eemcs.utwente.nl/user/s1934538/clickstream/clickstream-enwiki-2019-10.tsv.gz,Lance_Reddick,31509,28231,104,59844,11206
hdfs://spark-nn.eemcs.utwente.nl/user/s1934538/clickstream/clickstream-enwiki-2019-10.tsv.gz,Mortal_Kombat_(2021_film),24243,22252,334,46829,78392
hdfs://spark-nn.eemcs.utwente.nl/user/s1934538/clickstream/clickstream-enwiki-2019-10.tsv.gz,Joker_(2019_film),661453,10452968,183616,11298037,4671246
hdfs://spark-nn.eemcs.utwente.nl/user/s1934538/clickstream/clickstream-enwiki-2019-10.tsv.gz,Critical_race_theory,2231,22356,53,24640,4423
hdfs://spark-nn.eemcs.utwente.nl/user/s1934538/clickstream/clickstream-enwiki-2019-10.tsv.gz,UEFA_Euro_2020,96781,411296,11065,519142,193461
hdfs://spark-nn.eemcs.utwente.nl/user/s1934538/clickstream/clickstream-enwiki-2019-10.tsv.gz,The_Umbrella_Academy_(TV_series),22062,127623,1847,151532,73061
hdfs://spark-nn.eemcs.utwente.nl/user/s1934538/clickstream/clickstream-enwiki-2019-10.tsv.gz,Elizabeth_II,469156,662522,9015,1140693,904764
hdfs://spark-nn.eemcs.utwente.nl/user/s1934538/clickstream/clickstream-enwiki-2019-10.tsv.gz,List_of_FIFA_World_Cup_finals,1965,49742,64,51771,13397
hdfs://spark-nn.eemcs.utwente.nl/user/s1934538/clickstream/clickstream-enwiki-2019-10.tsv.gz,Qasem_Soleimani,4733,14610,87,19430,9256
hdfs://spark-nn.eemcs.utwente.nl/user/s1934538/clickstream/clickstream-enwiki-2019-10.tsv.gz,Darth_Vader,34095,181948,662,216705,67858
hdfs://spark-nn.eemcs.utwente.nl/user/s1934538/clickstream/clickstream-enwiki-2019-10.tsv.gz,Area_51,14479,263127,1631,279237,44324
hdfs://spark-nn.eemcs.utwente.nl/user/s1934538/clickstream/clickstream-enwiki-2019-10.tsv.gz,Microsoft_Office,9180,202427,577,212184,22533
hdfs://spark-nn.eemcs.utwente.nl/user/s1934538/clickstream/clickstream-enwiki-2019-10.tsv.gz,Black_Panther_(film),47317,127576,3402,178295,96466
hdfs://spark-nn.eemcs.utwente.nl/user/s1934538/clickstream/clickstream-enwiki-2019-10.tsv.gz,Aaron_Carter,31166,278960,1647,311773,109274
hdfs://spark-nn.eemcs.utwente.nl/user/s1934538/clickstream/clickstream-enwiki-2019-10.tsv.gz,Pelé,35866,177827,1347,215040,62307
hdfs://spark-nn.eemcs.utwente.nl/user/s1934538/clickstream/clickstream-enwiki-2019-10.tsv.gz,Parasite_(2019_film),58319,624554,9101,691974,262794
hdfs://spark-nn.eemcs.utwente.nl/user/s1934538/clickstream/clickstream-enwiki-2019-10.tsv.gz,List_of_awards_and_nominations_received_by_Meryl_Streep,12987,9429,193,22609,7410
hdfs://spark-nn.eemcs.utwente.nl/user/s1934538/clickstream/clickstream-enwiki-2019-10.tsv.gz,Priyanka_Chopra,138582,380046,1428,520056,204679
hdfs://spark-nn.eemcs.utwente.nl/user/s1934538/clickstream/clickstream-enwiki-2019-10.tsv.gz,XXXTentacion,88136,502864,4951,595951,104585
hdfs://spark-nn.eemcs.utwente.nl/user/s1934538/clickstream/clickstream-enwiki-2019-10.tsv.gz,Naya_Rivera,28886,37048,88,66022,12912
hdfs://spark-nn.eemcs.utwente.nl/user/s1934538/clickstream/clickstream-enwiki-2019-10.tsv.gz,Juice_Wrld,12592,86957,1740,101289,29649
hdfs://spark-nn.eemcs.utwente.nl/user/s1934538/clickstream/clickstream-enwiki-2019-10.tsv.gz,Chernobyl_(miniseries),33695,203578,4037,241310,213573
hdfs://spark-nn.eemcs.utwente.nl/user/s1934538/clickstream/clickstream-enwiki-2019-10.tsv.gz,Donald_Trump,277527,883037,13478,1174042,729082
hdfs://spark-nn.eemcs.utwente.nl/user/s1934538/clickstream/clickstream-enwiki-2019-10.tsv.gz,United_States_Electoral_College,28846,128853,241,157940,22008
hdfs://spark-nn.eemcs.utwente.nl/user/s1934538/clickstream/clickstream-enwiki-2019-10.tsv.gz,Anne_Heche,31238,63375,242,94855,26821
hdfs://spark-nn.eemcs.utwente.nl/user/s1934538/clickstream/clickstream-enwiki-2019-10.tsv.gz,Coronavirus,936,8400,54,9390,1124
hdfs://spark-nn.eemcs.utwente.nl/user/s1934538/clickstream/clickstream-enwiki-2019-10.tsv.gz,Greta_Thunberg,38918,1176065,9671,1224654,322075
hdfs://spark-nn.eemcs.utwente.nl/user/s1934538/clickstream/clickstream-enwiki-2019-10.tsv.gz,List_of_most_popular_websites,15035,5889492,247,5904774,58526
hdfs://spark-nn.eemcs.utwente.nl/user/s1934538/clickstream/clickstream-enwiki-2019-10.tsv.gz,FIFA_World_Cup,35850,157139,2425,195414,141961
hdfs://spark-nn.eemcs.utwente.nl/user/s1934538/clickstream/clickstream-enwiki-2019-10.tsv.gz,Chernobyl_disaster,69782,673834,5420,749036,285588
hdfs://spark-nn.eemcs.utwente.nl/user/s1934538/clickstream/clickstream-enwiki-2019-10.tsv.gz,United_States_Senate,65845,115399,1497,182741,70162
hdfs://spark-nn.eemcs.utwente.nl/user/s1934538/clickstream/clickstream-enwiki-2019-10.tsv.gz,Hyphen-minus,6408,142725605,7929382,150661395,940
hdfs://spark-nn.eemcs.utwente.nl/user/s1934538/clickstream/clickstream-enwiki-2019-10.tsv.gz,David_Beckham,38141,171555,1400,211096,72763
hdfs://spark-nn.eemcs.utwente.nl/user/s1934538/clickstream/clickstream-enwiki-2019-10.tsv.gz,Hamilton_(musical),33036,267604,1718,302358,142564
hdfs://spark-nn.eemcs.utwente.nl/user/s1934538/clickstream/clickstream-enwiki-2019-10.tsv.gz,Joe_Biden,99527,358325,5141,462993,185659
hdfs://spark-nn.eemcs.utwente.nl/user/s1934538/clickstream/clickstream-enwiki-2019-10.tsv.gz,Ted_Bundy,46892,595669,6304,648865,129098
hdfs://spark-nn.eemcs.utwente.nl/user/s1934538/clickstream/clickstream-enwiki-2019-10.tsv.gz,The_Irishman,362,2531,1154,4047,5413
hdfs://spark-nn.eemcs.utwente.nl/user/s1934538/clickstream/clickstream-enwiki-2019-10.tsv.gz,Kamala_Harris,32095,246482,1681,280258,87100
hdfs://spark-nn.eemcs.utwente.nl/user/s1934538/clickstream/clickstream-enwiki-2019-10.tsv.gz,Ray_Liotta,37549,53992,407,91948,30831
hdfs://spark-nn.eemcs.utwente.nl/user/s1934538/clickstream/clickstream-enwiki-2019-10.tsv.gz,Jimmy_Hoffa,68839,208340,2310,279489,96333
hdfs://spark-nn.eemcs.utwente.nl/user/s1934538/clickstream/clickstream-enwiki-2019-10.tsv.gz,Dark_Phoenix_(film),74185,314682,4763,393630,198713
hdfs://spark-nn.eemcs.utwente.nl/user/s1934538/clickstream/clickstream-enwiki-2019-10.tsv.gz,2018_Winter_Olympics,21498,21916,261,43675,26129
hdfs://spark-nn.eemcs.utwente.nl/user/s1934538/clickstream/clickstream-enwiki-2019-10.tsv.gz,Ukraine,50311,197889,4778,252978,114994
hdfs://spark-nn.eemcs.utwente.nl/user/s1934538/clickstream/clickstream-enwiki-2019-10.tsv.gz,Freddie_Mercury,120038,913497,6316,1039851,365009
hdfs://spark-nn.eemcs.utwente.nl/user/s1934538/clickstream/clickstream-enwiki-2019-10.tsv.gz,Henry_V_of_England,84096,120393,775,205264,137268
hdfs://spark-nn.eemcs.utwente.nl/user/s1934538/clickstream/clickstream-enwiki-2019-10.tsv.gz,The_Nun_(2018_film),35441,108663,740,144844,89214
hdfs://spark-nn.eemcs.utwente.nl/user/s1934538/clickstream/clickstream-enwiki-2019-10.tsv.gz,Meat_Loaf,23655,75501,904,100060,35010
hdfs://spark-nn.eemcs.utwente.nl/user/s1934538/clickstream/clickstream-enwiki-2019-10.tsv.gz,XXX:_Return_of_Xander_Cage,29353,74013,782,104148,38076
hdfs://spark-nn.eemcs.utwente.nl/user/s1934538/clickstream/clickstream-enwiki-2019-10.tsv.gz,Top_Gun:_Maverick,56168,59914,1235,117317,82967
hdfs://spark-nn.eemcs.utwente.nl/user/s1934538/clickstream/clickstream-enwiki-2019-10.tsv.gz,Afghanistan,46175,147565,2658,196398,95810
hdfs://spark-nn.eemcs.utwente.nl/user/s1934538/clickstream/clickstream-enwiki-2019-10.tsv.gz,QAnon,10635,127961,920,139516,29425
hdfs://spark-nn.eemcs.utwente.nl/user/s1934538/clickstream/clickstream-enwiki-2019-10.tsv.gz,YouTube,121600,1047104,9351,1178055,138186
hdfs://spark-nn.eemcs.utwente.nl/user/s1934538/clickstream/clickstream-enwiki-2019-10.tsv.gz,William_Murdoch,607,1816,14,2437,268
hdfs://spark-nn.eemcs.utwente.nl/user/s1934538/clickstream/clickstream-enwiki-2019-10.tsv.gz,Anna_Sorokin,6988,41598,135,48721,10548
hdfs://spark-nn.eemcs.utwente.nl/user/s1934538/clickstream/clickstream-enwiki-2019-10.tsv.gz,Us_(2019_film),50471,275837,3608,329916,91051
hdfs://spark-nn.eemcs.utwente.nl/user/s1934538/clickstream/clickstream-enwiki-2019-10.tsv.gz,Juneteenth,1792,19876,43,21711,1958
hdfs://spark-nn.eemcs.utwente.nl/user/s1934538/clickstream/clickstream-enwiki-2019-10.tsv.gz,NATO,48922,146481,2570,197973,69613
hdfs://spark-nn.eemcs.utwente.nl/user/s1934538/clickstream/clickstream-enwiki-2019-10.tsv.gz,Dennis_Nilsen,7814,54172,498,62484,16453
hdfs://spark-nn.eemcs.utwente.nl/user/s1934538/clickstream/clickstream-enwiki-2019-10.tsv.gz,Star_Wars:_The_Rise_of_Skywalker,224558,485396,16906,726860,443733
hdfs://spark-nn.eemcs.utwente.nl/user/s1934538/clickstream/clickstream-enwiki-2019-10.tsv.gz,Saaho,74142,627483,5778,707403,167137
hdfs://spark-nn.eemcs.utwente.nl/user/s1934538/clickstream/clickstream-enwiki-2019-10.tsv.gz,Jason_Momoa,200756,577098,3773,781627,384456
hdfs://spark-nn.eemcs.utwente.nl/user/s1934538/clickstream/clickstream-enwiki-2019-10.tsv.gz,Cristiano_Ronaldo,131329,788505,5943,925777,202095
hdfs://spark-nn.eemcs.utwente.nl/user/s1934538/clickstream/clickstream-enwiki-2019-10.tsv.gz,2016_United_States_presidential_election,112108,347367,3591,463066,274565
hdfs://spark-nn.eemcs.utwente.nl/user/s1934538/clickstream/clickstream-enwiki-2019-10.tsv.gz,Lists_of_deaths_by_year,5549,136998,701,143248,132426
hdfs://spark-nn.eemcs.utwente.nl/user/s1934538/clickstream/clickstream-enwiki-2019-10.tsv.gz,Manti_Te'o,9278,71689,355,81322,8849
hdfs://spark-nn.eemcs.utwente.nl/user/s1934538/clickstream/clickstream-enwiki-2019-10.tsv.gz,Simple_Mail_Transfer_Protocol,4767,4708689,161,4713617,6734
hdfs://spark-nn.eemcs.utwente.nl/user/s1934538/clickstream/clickstream-enwiki-2019-10.tsv.gz,Louis_Tomlinson,35074,69715,774,105563,21946
hdfs://spark-nn.eemcs.utwente.nl/user/s1934538/clickstream/clickstream-enwiki-2019-10.tsv.gz,Burt_Reynolds,37980,138122,1093,177195,68205
hdfs://spark-nn.eemcs.utwente.nl/user/s1934538/clickstream/clickstream-enwiki-2019-10.tsv.gz,Atal_Bihari_Vajpayee,20699,63942,176,84817,16068
hdfs://spark-nn.eemcs.utwente.nl/user/s1934538/clickstream/clickstream-enwiki-2019-10.tsv.gz,Anthony_Bourdain,15428,166079,1324,182831,50015
hdfs://spark-nn.eemcs.utwente.nl/user/s1934538/clickstream/clickstream-enwiki-2019-10.tsv.gz,George_H._W._Bush,142531,146499,838,289868,155013
hdfs://spark-nn.eemcs.utwente.nl/user/s1934538/clickstream/clickstream-enwiki-2019-10.tsv.gz,JSON_Web_Token,982,25859,35,26876,2328
hdfs://spark-nn.eemcs.utwente.nl/user/s1934538/clickstream/clickstream-enwiki-2019-10.tsv.gz,Central_Park_jogger_case,66512,247354,635,314501,41625
hdfs://spark-nn.eemcs.utwente.nl/user/s1934538/clickstream/clickstream-enwiki-2019-10.tsv.gz,Main_Page,32222,474799546,4793268,479625036,33645381
hdfs://spark-nn.eemcs.utwente.nl/user/s1934538/clickstream/clickstream-enwiki-2019-10.tsv.gz,Captain_Marvel_(film),59943,162308,2273,224524,98264
hdfs://spark-nn.eemcs.utwente.nl/user/s1934538/clickstream/clickstream-enwiki-2019-10.tsv.gz,Ruth_Bader_Ginsburg,28230,156330,994,185554,59787
hdfs://spark-nn.eemcs.utwente.nl/user/s1934538/clickstream/clickstream-enwiki-2019-10.tsv.gz,Death_of_Elisa_Lam,9633,73149,278,83060,19637
hdfs://spark-nn.eemcs.utwente.nl/user/s1934538/clickstream/clickstream-enwiki-2019-10.tsv.gz,Cecil_Hotel_(Los_Angeles),7825,31727,85,39637,15092
hdfs://spark-nn.eemcs.utwente.nl/user/s1934538/clickstream/clickstream-enwiki-2019-10.tsv.gz,No_Time_to_Die,137221,129383,2687,269291,228163
hdfs://spark-nn.eemcs.utwente.nl/user/s1934538/clickstream/clickstream-enwiki-2019-10.tsv.gz,Cardi_B,69073,701652,7395,778120,221234
hdfs://spark-nn.eemcs.utwente.nl/user/s1934538/clickstream/clickstream-enwiki-2019-10.tsv.gz,Matthew_Perry,94553,261069,1227,356849,193812
hdfs://spark-nn.eemcs.utwente.nl/user/s1934538/clickstream/clickstream-enwiki-2019-10.tsv.gz,WrestleMania_34,19757,10511,307,30575,21005
hdfs://spark-nn.eemcs.utwente.nl/user/s1934538/clickstream/clickstream-enwiki-2019-10.tsv.gz,Grimes_(musician),36812,54619,641,92072,38270
hdfs://spark-nn.eemcs.utwente.nl/user/s1934538/clickstream/clickstream-enwiki-2019-10.tsv.gz,Godzilla_vs._Kong,75941,61089,756,137786,89080
hdfs://spark-nn.eemcs.utwente.nl/user/s1934538/clickstream/clickstream-enwiki-2019-10.tsv.gz,List_of_highest-grossing_films,185310,538186,3401,726897,295674
hdfs://spark-nn.eemcs.utwente.nl/user/s1934538/clickstream/clickstream-enwiki-2019-10.tsv.gz,"Princess_Margaret,_Countess_of_Snowdon",131270,317043,2051,450364,304666
hdfs://spark-nn.eemcs.utwente.nl/user/s1934538/clickstream/clickstream-enwiki-2019-10.tsv.gz,1234,111,1400,18,1529,118
hdfs://spark-nn.eemcs.utwente.nl/user/s1934538/clickstream/clickstream-enwiki-2019-10.tsv.gz,Jeffrey_Epstein,35222,684150,3068,722440,186527
hdfs://spark-nn.eemcs.utwente.nl/user/s1934538/clickstream/clickstream-enwiki-2019-10.tsv.gz,Key_frame,573,6244,43,6860,503
hdfs://spark-nn.eemcs.utwente.nl/user/s1934538/clickstream/clickstream-enwiki-2019-10.tsv.gz,List_of_highest-grossing_Indian_films,115995,644103,3068,763166,316205
hdfs://spark-nn.eemcs.utwente.nl/user/s1934538/clickstream/clickstream-enwiki-2019-10.tsv.gz,2.0_(film),38030,113419,515,151964,33107
hdfs://spark-nn.eemcs.utwente.nl/user/s1934538/clickstream/clickstream-enwiki-2019-10.tsv.gz,Kim_Jong-un,45319,120518,1484,167321,99561
hdfs://spark-nn.eemcs.utwente.nl/user/s1934538/clickstream/clickstream-enwiki-2019-10.tsv.gz,Cook's_Country,273,2852,36,3161,743
hdfs://spark-nn.eemcs.utwente.nl/user/s1934538/clickstream/clickstream-enwiki-2019-10.tsv.gz,The_Mandalorian,69385,367839,5585,442809,344798
hdfs://spark-nn.eemcs.utwente.nl/user/s1934538/clickstream/clickstream-enwiki-2019-10.tsv.gz,Stranger_Things_(season_3),30657,121835,1664,154156,93217
hdfs://spark-nn.eemcs.utwente.nl/user/s1934538/clickstream/clickstream-enwiki-2019-10.tsv.gz,Aaron_Hernandez,10433,91730,424,102587,35460
hdfs://spark-nn.eemcs.utwente.nl/user/s1934538/clickstream/clickstream-enwiki-2019-10.tsv.gz,Tina_Turner,21503,216891,2008,240402,58638
hdfs://spark-nn.eemcs.utwente.nl/user/s1934538/clickstream/clickstream-enwiki-2019-10.tsv.gz,Avengers:_Endgame,208213,488063,12059,708335,433635
hdfs://spark-nn.eemcs.utwente.nl/user/s1934538/clickstream/clickstream-enwiki-2019-10.tsv.gz,It_Chapter_Two,154915,719637,15493,890045,471496
hdfs://spark-nn.eemcs.utwente.nl/user/s1934538/clickstream/clickstream-enwiki-2019-10.tsv.gz,Avicii,19203,223211,1829,244243,113594
hdfs://spark-nn.eemcs.utwente.nl/user/s1934538/clickstream/clickstream-enwiki-2019-10.tsv.gz,2018_FIFA_World_Cup,67142,126448,1504,195094,91418
hdfs://spark-nn.eemcs.utwente.nl/user/s1934538/clickstream/clickstream-enwiki-2019-10.tsv.gz,Sinéad_O'Connor,14479,88078,742,103299,28738
hdfs://spark-nn.eemcs.utwente.nl/user/s1934538/clickstream/clickstream-enwiki-2019-10.tsv.gz,2020_United_States_presidential_election,101611,351656,5807,459074,261161
hdfs://spark-nn.eemcs.utwente.nl/user/s1934538/clickstream/clickstream-enwiki-2019-10.tsv.gz,RRR_(film),61968,74289,114,136371,78702
hdfs://spark-nn.eemcs.utwente.nl/user/s1934538/clickstream/clickstream-enwiki-2019-10.tsv.gz,Elon_Musk,78547,717626,4936,801109,412019
hdfs://spark-nn.eemcs.utwente.nl/user/s1934538/clickstream/clickstream-enwiki-2019-10.tsv.gz,The_Lion_King_(2019_film),122354,592689,7167,722210,439948
hdfs://spark-nn.eemcs.utwente.nl/user/s1934538/clickstream/clickstream-enwiki-2019-10.tsv.gz,Alexander_Hamilton,71849,283222,1836,356907,156285
hdfs://spark-nn.eemcs.utwente.nl/user/s1934538/clickstream/clickstream-enwiki-2019-10.tsv.gz,Spanish_flu,24554,91220,948,116722,28189
hdfs://spark-nn.eemcs.utwente.nl/user/s1934538/clickstream/clickstream-enwiki-2019-10.tsv.gz,Avengers:_Infinity_War,64570,108936,2204,175710,92168
hdfs://spark-nn.eemcs.utwente.nl/user/s1934538/clickstream/clickstream-enwiki-2019-10.tsv.gz,State_of_Palestine,34897,96907,408,132212,52105
hdfs://spark-nn.eemcs.utwente.nl/user/s1934538/clickstream/clickstream-enwiki-2019-10.tsv.gz,2023_Cricket_World_Cup,9453,22043,125,31621,9380
hdfs://spark-nn.eemcs.utwente.nl/user/s1934538/clickstream/clickstream-enwiki-2019-10.tsv.gz,Aretha_Franklin,21250,101109,757,123116,40409
hdfs://spark-nn.eemcs.utwente.nl/user/s1934538/clickstream/clickstream-enwiki-2019-10.tsv.gz,Lisa_Marie_Presley,106978,60944,199,168121,94931
hdfs://spark-nn.eemcs.utwente.nl/user/s1934538/clickstream/clickstream-enwiki-2019-10.tsv.gz,Aquaman_(film),71813,207839,3287,282939,162341
hdfs://spark-nn.eemcs.utwente.nl/user/s1934538/clickstream/clickstream-enwiki-2019-10.tsv.gz,Tunnel,4679,14539,197,19415,4106
hdfs://spark-nn.eemcs.utwente.nl/user/s1934538/clickstream/clickstream-enwiki-2019-10.tsv.gz,Richard_Jewell,99519,1286356,7796,1393671,512717
hdfs://spark-nn.eemcs.utwente.nl/user/s1934538/clickstream/clickstream-enwiki-2019-10.tsv.gz,Deadpool_2,85749,97505,1689,184943,102171
hdfs://spark-nn.eemcs.utwente.nl/user/s1934538/clickstream/clickstream-enwiki-2019-10.tsv.gz,Notre-Dame_de_Paris,14865,91137,1013,107015,22887
hdfs://spark-nn.eemcs.utwente.nl/user/s1934538/clickstream/clickstream-enwiki-2019-10.tsv.gz,The_Irishman_(2019_film),175784,876018,17370,1069172,613696
hdfs://spark-nn.eemcs.utwente.nl/user/s1934538/clickstream/clickstream-enwiki-2019-10.tsv.gz,Israel,77241,264987,5142,347370,166777
hdfs://spark-nn.eemcs.utwente.nl/user/s1934538/clickstream/clickstream-enwiki-2019-10.tsv.gz,Joaquin_Phoenix,1123363,3520472,17401,4661236,3855240
hdfs://spark-nn.eemcs.utwente.nl/user/s1934538/clickstream/clickstream-enwiki-2021-02.tsv.gz,Key_frame,729,6865,17,7611,492
hdfs://spark-nn.eemcs.utwente.nl/user/s1934538/clickstream/clickstream-enwiki-2021-02.tsv.gz,Tina_Turner,24622,210982,2282,237886,78870
hdfs://spark-nn.eemcs.utwente.nl/user/s1934538/clickstream/clickstream-enwiki-2021-02.tsv.gz,Fantastic_Beasts:_The_Crimes_of_Grindelwald,46650,90089,1142,137881,83999
hdfs://spark-nn.eemcs.utwente.nl/user/s1934538/clickstream/clickstream-enwiki-2021-02.tsv.gz,Army_of_the_Dead,75475,97537,1841,174853,125816
hdfs://spark-nn.eemcs.utwente.nl/user/s1934538/clickstream/clickstream-enwiki-2021-02.tsv.gz,Vladimir_Putin,104892,280102,3821,388815,241437
hdfs://spark-nn.eemcs.utwente.nl/user/s1934538/clickstream/clickstream-enwiki-2021-02.tsv.gz,Tunnel,2967,10870,110,13947,3334
hdfs://spark-nn.eemcs.utwente.nl/user/s1934538/clickstream/clickstream-enwiki-2021-02.tsv.gz,YouTube,158464,1388531,11417,1558412,137973
hdfs://spark-nn.eemcs.utwente.nl/user/s1934538/clickstream/clickstream-enwiki-2021-02.tsv.gz,Elliot_Page,91429,348113,3368,442910,167148
hdfs://spark-nn.eemcs.utwente.nl/user/s1934538/clickstream/clickstream-enwiki-2021-02.tsv.gz,Kobe_Bryant,65610,478195,6172,549977,140434
hdfs://spark-nn.eemcs.utwente.nl/user/s1934538/clickstream/clickstream-enwiki-2021-02.tsv.gz,UEFA_Euro_2020,38499,173586,2186,214271,69696
hdfs://spark-nn.eemcs.utwente.nl/user/s1934538/clickstream/clickstream-enwiki-2021-02.tsv.gz,DMX_(rapper),14679,63631,518,78828,37277
hdfs://spark-nn.eemcs.utwente.nl/user/s1934538/clickstream/clickstream-enwiki-2021-02.tsv.gz,A_Quiet_Place_(film),29423,93772,901,124096,40235
hdfs://spark-nn.eemcs.utwente.nl/user/s1934538/clickstream/clickstream-enwiki-2021-02.tsv.gz,Joker_(2019_film),58621,193045,2537,254203,119822
hdfs://spark-nn.eemcs.utwente.nl/user/s1934538/clickstream/clickstream-enwiki-2021-02.tsv.gz,Ghislaine_Maxwell,59641,120562,649,180852,68426
hdfs://spark-nn.eemcs.utwente.nl/user/s1934538/clickstream/clickstream-enwiki-2021-02.tsv.gz,Shakira,33636,266667,2939,303242,137789
hdfs://spark-nn.eemcs.utwente.nl/user/s1934538/clickstream/clickstream-enwiki-2021-02.tsv.gz,Grimes_(musician),299146,255017,664,554827,139254
hdfs://spark-nn.eemcs.utwente.nl/user/s1934538/clickstream/clickstream-enwiki-2021-02.tsv.gz,NATO,48420,114675,1931,165026,64090
hdfs://spark-nn.eemcs.utwente.nl/user/s1934538/clickstream/clickstream-enwiki-2021-02.tsv.gz,Chernobyl_disaster,63644,346265,3157,413066,174368
hdfs://spark-nn.eemcs.utwente.nl/user/s1934538/clickstream/clickstream-enwiki-2021-02.tsv.gz,Carlos_Alcaraz,3480,10666,64,14210,2542
hdfs://spark-nn.eemcs.utwente.nl/user/s1934538/clickstream/clickstream-enwiki-2021-02.tsv.gz,The_Nun_(2018_film),24248,64342,326,88916,54170
hdfs://spark-nn.eemcs.utwente.nl/user/s1934538/clickstream/clickstream-enwiki-2021-02.tsv.gz,Matthew_Perry,71390,136538,712,208640,111135
hdfs://spark-nn.eemcs.utwente.nl/user/s1934538/clickstream/clickstream-enwiki-2021-02.tsv.gz,Area_51,13276,143064,9087,165427,42379
hdfs://spark-nn.eemcs.utwente.nl/user/s1934538/clickstream/clickstream-enwiki-2021-02.tsv.gz,Royal_Rumble_(2018),22765,13450,208,36423,26478
hdfs://spark-nn.eemcs.utwente.nl/user/s1934538/clickstream/clickstream-enwiki-2021-02.tsv.gz,Microsoft_Office,9118,2146975,888,2156981,22378
hdfs://spark-nn.eemcs.utwente.nl/user/s1934538/clickstream/clickstream-enwiki-2021-02.tsv.gz,Simple_Mail_Transfer_Protocol,4273,36088,177,40538,4110
hdfs://spark-nn.eemcs.utwente.nl/user/s1934538/clickstream/clickstream-enwiki-2021-02.tsv.gz,Keanu_Reeves,79837,458882,3010,541729,301168
hdfs://spark-nn.eemcs.utwente.nl/user/s1934538/clickstream/clickstream-enwiki-2021-02.tsv.gz,Donald_Glover,53489,282415,1518,337422,111405
hdfs://spark-nn.eemcs.utwente.nl/user/s1934538/clickstream/clickstream-enwiki-2021-02.tsv.gz,R._Kelly,34518,171945,1599,208062,93849
hdfs://spark-nn.eemcs.utwente.nl/user/s1934538/clickstream/clickstream-enwiki-2021-02.tsv.gz,Pelé,28876,219439,2362,250677,84659
hdfs://spark-nn.eemcs.utwente.nl/user/s1934538/clickstream/clickstream-enwiki-2021-02.tsv.gz,ICC_Men's_T20_World_Cup,7155,68444,213,75812,37958
hdfs://spark-nn.eemcs.utwente.nl/user/s1934538/clickstream/clickstream-enwiki-2021-02.tsv.gz,Betty_White,74097,344126,4281,422504,129976
hdfs://spark-nn.eemcs.utwente.nl/user/s1934538/clickstream/clickstream-enwiki-2021-02.tsv.gz,"Princess_Margaret,_Countess_of_Snowdon",209087,741650,4377,955114,496355
hdfs://spark-nn.eemcs.utwente.nl/user/s1934538/clickstream/clickstream-enwiki-2021-02.tsv.gz,1234,104,1412,12,1528,223
hdfs://spark-nn.eemcs.utwente.nl/user/s1934538/clickstream/clickstream-enwiki-2021-02.tsv.gz,Sidharth_Shukla,18891,48989,1053,68933,19736
hdfs://spark-nn.eemcs.utwente.nl/user/s1934538/clickstream/clickstream-enwiki-2021-02.tsv.gz,Avengers:_Endgame,210063,335535,5523,551121,350933
hdfs://spark-nn.eemcs.utwente.nl/user/s1934538/clickstream/clickstream-enwiki-2021-02.tsv.gz,Manti_Te'o,3197,31546,133,34876,4451
hdfs://spark-nn.eemcs.utwente.nl/user/s1934538/clickstream/clickstream-enwiki-2021-02.tsv.gz,Ray_Liotta,44522,63047,424,107993,37901
hdfs://spark-nn.eemcs.utwente.nl/user/s1934538/clickstream/clickstream-enwiki-2021-02.tsv.gz,Queen_(band),72203,246254,2925,321382,322818
hdfs://spark-nn.eemcs.utwente.nl/user/s1934538/clickstream/clickstream-enwiki-2021-02.tsv.gz,Tasuku_Honjo,1575,1289295,175,1291045,41854
hdfs://spark-nn.eemcs.utwente.nl/user/s1934538/clickstream/clickstream-enwiki-2021-02.tsv.gz,1917_(2019_film),28334,133108,2231,163673,91648
hdfs://spark-nn.eemcs.utwente.nl/user/s1934538/clickstream/clickstream-enwiki-2021-02.tsv.gz,Naomi_Osaka,186540,1711748,1784,1900072,534725
hdfs://spark-nn.eemcs.utwente.nl/user/s1934538/clickstream/clickstream-enwiki-2021-02.tsv.gz,Sushma_Swaraj,6936,26905,151,33992,8890
hdfs://spark-nn.eemcs.utwente.nl/user/s1934538/clickstream/clickstream-enwiki-2021-02.tsv.gz,Stranger_Things_(season_4),30847,150322,716,181885,110153
hdfs://spark-nn.eemcs.utwente.nl/user/s1934538/clickstream/clickstream-enwiki-2021-02.tsv.gz,Juneteenth,4131,78648,244,83023,6470
hdfs://spark-nn.eemcs.utwente.nl/user/s1934538/clickstream/clickstream-enwiki-2021-02.tsv.gz,Alexander_Hamilton,96278,325238,2449,423965,219239
hdfs://spark-nn.eemcs.utwente.nl/user/s1934538/clickstream/clickstream-enwiki-2021-02.tsv.gz,Elon_Musk,226130,2364401,18958,2609489,1624343
hdfs://spark-nn.eemcs.utwente.nl/user/s1934538/clickstream/clickstream-enwiki-2021-02.tsv.gz,Kamala_Harris,230898,633648,6996,871542,400839
hdfs://spark-nn.eemcs.utwente.nl/user/s1934538/clickstream/clickstream-enwiki-2021-02.tsv.gz,Brett_Kavanaugh,24821,34481,221,59523,18622
hdfs://spark-nn.eemcs.utwente.nl/user/s1934538/clickstream/clickstream-enwiki-2021-02.tsv.gz,The_Umbrella_Academy_(TV_series),34837,170652,2999,208488,128849
hdfs://spark-nn.eemcs.utwente.nl/user/s1934538/clickstream/clickstream-enwiki-2021-02.tsv.gz,WandaVision,502078,4752642,125840,5380560,2645257
hdfs://spark-nn.eemcs.utwente.nl/user/s1934538/clickstream/clickstream-enwiki-2021-02.tsv.gz,Priyanka_Chopra,156886,488557,1974,647417,236498
hdfs://spark-nn.eemcs.utwente.nl/user/s1934538/clickstream/clickstream-enwiki-2021-02.tsv.gz,HTTP_cookie,3158,412620,165,415943,25891
hdfs://spark-nn.eemcs.utwente.nl/user/s1934538/clickstream/clickstream-enwiki-2021-02.tsv.gz,List_of_Queen_of_the_South_episodes,15845,11138,398,27381,816
hdfs://spark-nn.eemcs.utwente.nl/user/s1934538/clickstream/clickstream-enwiki-2021-02.tsv.gz,Ted_Bundy,42779,449446,5550,497775,111056
hdfs://spark-nn.eemcs.utwente.nl/user/s1934538/clickstream/clickstream-enwiki-2021-02.tsv.gz,XXXTentacion,67896,436766,5969,510631,95369
hdfs://spark-nn.eemcs.utwente.nl/user/s1934538/clickstream/clickstream-enwiki-2021-02.tsv.gz,2020_Summer_Olympics,67517,125039,3891,196447,168068
hdfs://spark-nn.eemcs.utwente.nl/user/s1934538/clickstream/clickstream-enwiki-2021-02.tsv.gz,Star_Wars:_The_Rise_of_Skywalker,82364,86085,1817,170266,90484
hdfs://spark-nn.eemcs.utwente.nl/user/s1934538/clickstream/clickstream-enwiki-2021-02.tsv.gz,Stephen_Hawking,33593,426798,2472,462863,183679
hdfs://spark-nn.eemcs.utwente.nl/user/s1934538/clickstream/clickstream-enwiki-2021-02.tsv.gz,Saaho,15852,43463,121,59436,19783
hdfs://spark-nn.eemcs.utwente.nl/user/s1934538/clickstream/clickstream-enwiki-2021-02.tsv.gz,Zack_Snyder's_Justice_League,257682,730193,6919,994794,567962
hdfs://spark-nn.eemcs.utwente.nl/user/s1934538/clickstream/clickstream-enwiki-2021-02.tsv.gz,Israel,86408,242676,5621,334705,165101
hdfs://spark-nn.eemcs.utwente.nl/user/s1934538/clickstream/clickstream-enwiki-2021-02.tsv.gz,Cricket_World_Cup,8370,54627,187,63184,33471
hdfs://spark-nn.eemcs.utwente.nl/user/s1934538/clickstream/clickstream-enwiki-2021-02.tsv.gz,IPv4,11683,41225,146,53054,9449
hdfs://spark-nn.eemcs.utwente.nl/user/s1934538/clickstream/clickstream-enwiki-2021-02.tsv.gz,Tom_Brady,435291,4404847,72372,4912510,2277766
hdfs://spark-nn.eemcs.utwente.nl/user/s1934538/clickstream/clickstream-enwiki-2021-02.tsv.gz,Jason_Momoa,90156,255920,1407,347483,146814
hdfs://spark-nn.eemcs.utwente.nl/user/s1934538/clickstream/clickstream-enwiki-2021-02.tsv.gz,Irrfan_Khan,36715,80336,181,117232,41002
hdfs://spark-nn.eemcs.utwente.nl/user/s1934538/clickstream/clickstream-enwiki-2021-02.tsv.gz,Doctor_Strange_in_the_Multiverse_of_Madness,251460,237982,4353,493795,325232
hdfs://spark-nn.eemcs.utwente.nl/user/s1934538/clickstream/clickstream-enwiki-2021-02.tsv.gz,"Citizenship_(Amendment)_Act,_2019",4502,44943,23,49468,5149
hdfs://spark-nn.eemcs.utwente.nl/user/s1934538/clickstream/clickstream-enwiki-2021-02.tsv.gz,Nipsey_Hussle,33791,163428,1196,198415,61722
hdfs://spark-nn.eemcs.utwente.nl/user/s1934538/clickstream/clickstream-enwiki-2021-02.tsv.gz,Michael_Jordan,99870,651068,6542,757480,246658
hdfs://spark-nn.eemcs.utwente.nl/user/s1934538/clickstream/clickstream-enwiki-2021-02.tsv.gz,List_of_awards_and_nominations_received_by_Meryl_Streep,21416,13468,261,35145,13172
hdfs://spark-nn.eemcs.utwente.nl/user/s1934538/clickstream/clickstream-enwiki-2021-02.tsv.gz,Charles_Sobhraj,103740,396204,1443,501387,89472
hdfs://spark-nn.eemcs.utwente.nl/user/s1934538/clickstream/clickstream-enwiki-2021-02.tsv.gz,Death_of_Elisa_Lam,482808,3097616,9718,3590142,772956
hdfs://spark-nn.eemcs.utwente.nl/user/s1934538/clickstream/clickstream-enwiki-2021-02.tsv.gz,The_Queen's_Gambit_(miniseries),87480,785661,6896,880037,465208
hdfs://spark-nn.eemcs.utwente.nl/user/s1934538/clickstream/clickstream-enwiki-2021-02.tsv.gz,2018_FIFA_World_Cup,71732,85919,952,158603,97597
hdfs://spark-nn.eemcs.utwente.nl/user/s1934538/clickstream/clickstream-enwiki-2021-02.tsv.gz,Black_Widow_(2021_film),160244,157635,3303,321182,158401
hdfs://spark-nn.eemcs.utwente.nl/user/s1934538/clickstream/clickstream-enwiki-2021-02.tsv.gz,Joe_Biden,451890,943646,20098,1415634,747379
hdfs://spark-nn.eemcs.utwente.nl/user/s1934538/clickstream/clickstream-enwiki-2021-02.tsv.gz,A_Star_Is_Born_(2018_film),32364,172929,1024,206317,99685
hdfs://spark-nn.eemcs.utwente.nl/user/s1934538/clickstream/clickstream-enwiki-2021-02.tsv.gz,Amber_Heard,168389,285572,1909,455870,185386
hdfs://spark-nn.eemcs.utwente.nl/user/s1934538/clickstream/clickstream-enwiki-2021-02.tsv.gz,Deaths_in_2021,1527561,2117243,14202,3659006,2243941
hdfs://spark-nn.eemcs.utwente.nl/user/s1934538/clickstream/clickstream-enwiki-2021-02.tsv.gz,2018_Winter_Olympics,31993,23783,388,56164,47662
hdfs://spark-nn.eemcs.utwente.nl/user/s1934538/clickstream/clickstream-enwiki-2021-02.tsv.gz,2.0_(film),15958,29179,87,45224,13975
hdfs://spark-nn.eemcs.utwente.nl/user/s1934538/clickstream/clickstream-enwiki-2021-02.tsv.gz,Russo-Ukrainian_War,21143,28349,174,49666,29513
hdfs://spark-nn.eemcs.utwente.nl/user/s1934538/clickstream/clickstream-enwiki-2021-02.tsv.gz,List_of_James_Bond_films,51254,376686,671,428611,252432
hdfs://spark-nn.eemcs.utwente.nl/user/s1934538/clickstream/clickstream-enwiki-2021-02.tsv.gz,Cameron_Boyce,47401,202447,698,250546,68616
hdfs://spark-nn.eemcs.utwente.nl/user/s1934538/clickstream/clickstream-enwiki-2021-02.tsv.gz,Watts_family_murders,22562,234065,434,257061,54209
hdfs://spark-nn.eemcs.utwente.nl/user/s1934538/clickstream/clickstream-enwiki-2021-02.tsv.gz,Jeffrey_Dahmer,34721,321412,3729,359862,154437
hdfs://spark-nn.eemcs.utwente.nl/user/s1934538/clickstream/clickstream-enwiki-2021-02.tsv.gz,Adipurush,19109,2244,221,21574,7004
hdfs://spark-nn.eemcs.utwente.nl/user/s1934538/clickstream/clickstream-enwiki-2021-02.tsv.gz,Stan_Lee,70335,180810,1887,253032,88093
hdfs://spark-nn.eemcs.utwente.nl/user/s1934538/clickstream/clickstream-enwiki-2021-02.tsv.gz,Jeffrey_Epstein,41739,252274,2335,296348,127970
hdfs://spark-nn.eemcs.utwente.nl/user/s1934538/clickstream/clickstream-enwiki-2021-02.tsv.gz,Mortal_Kombat_(2021_film),119232,533531,10826,663589,1086371
hdfs://spark-nn.eemcs.utwente.nl/user/s1934538/clickstream/clickstream-enwiki-2021-02.tsv.gz,Rami_Malek,130913,425372,1376,557661,234289
hdfs://spark-nn.eemcs.utwente.nl/user/s1934538/clickstream/clickstream-enwiki-2021-02.tsv.gz,The_Mandalorian,129478,475773,9326,614577,455885
hdfs://spark-nn.eemcs.utwente.nl/user/s1934538/clickstream/clickstream-enwiki-2021-02.tsv.gz,The_Witcher_(TV_series),32408,163934,3384,199726,114757
hdfs://spark-nn.eemcs.utwente.nl/user/s1934538/clickstream/clickstream-enwiki-2021-02.tsv.gz,Meat_Loaf,24540,81614,902,107056,41216
hdfs://spark-nn.eemcs.utwente.nl/user/s1934538/clickstream/clickstream-enwiki-2021-02.tsv.gz,Jimmy_Hoffa,32912,151676,1211,185799,69374
hdfs://spark-nn.eemcs.utwente.nl/user/s1934538/clickstream/clickstream-enwiki-2021-02.tsv.gz,Fyre_Festival,10058,66786,534,77378,45019
hdfs://spark-nn.eemcs.utwente.nl/user/s1934538/clickstream/clickstream-enwiki-2021-02.tsv.gz,The_Falcon_and_the_Winter_Soldier,126288,299175,5451,430914,287245
hdfs://spark-nn.eemcs.utwente.nl/user/s1934538/clickstream/clickstream-enwiki-2021-02.tsv.gz,Gaza_Strip,17151,33280,215,50646,21016
hdfs://spark-nn.eemcs.utwente.nl/user/s1934538/clickstream/clickstream-enwiki-2021-02.tsv.gz,Brie_Larson,89210,212744,1634,303588,116999
hdfs://spark-nn.eemcs.utwente.nl/user/s1934538/clickstream/clickstream-enwiki-2021-02.tsv.gz,Mac_Miller,32066,181145,1518,214729,65725
hdfs://spark-nn.eemcs.utwente.nl/user/s1934538/clickstream/clickstream-enwiki-2021-02.tsv.gz,Cardi_B,50869,362160,6535,419564,147706
hdfs://spark-nn.eemcs.utwente.nl/user/s1934538/clickstream/clickstream-enwiki-2021-02.tsv.gz,Cristiano_Ronaldo,113174,837167,6155,956496,213627
hdfs://spark-nn.eemcs.utwente.nl/user/s1934538/clickstream/clickstream-enwiki-2021-02.tsv.gz,Critical_race_theory,7832,193920,1227,202979,39376
hdfs://spark-nn.eemcs.utwente.nl/user/s1934538/clickstream/clickstream-enwiki-2021-02.tsv.gz,Olivia_Newton-John,33861,156231,1590,191682,88778
hdfs://spark-nn.eemcs.utwente.nl/user/s1934538/clickstream/clickstream-enwiki-2021-02.tsv.gz,Jenna_Ortega,30339,35137,1949,67425,16505
hdfs://spark-nn.eemcs.utwente.nl/user/s1934538/clickstream/clickstream-enwiki-2021-02.tsv.gz,List_of_FIFA_World_Cup_finals,3027,57359,65,60451,18628
hdfs://spark-nn.eemcs.utwente.nl/user/s1934538/clickstream/clickstream-enwiki-2021-02.tsv.gz,Adele,23187,134463,1787,159437,53581
hdfs://spark-nn.eemcs.utwente.nl/user/s1934538/clickstream/clickstream-enwiki-2021-02.tsv.gz,Donald_Trump,416810,1336383,3853,1757046,813981
hdfs://spark-nn.eemcs.utwente.nl/user/s1934538/clickstream/clickstream-enwiki-2021-02.tsv.gz,Jimmy_Buffett,8078,39136,476,47690,18815
hdfs://spark-nn.eemcs.utwente.nl/user/s1934538/clickstream/clickstream-enwiki-2021-02.tsv.gz,Christopher_Scarver,59074,19304,32,78410,29632
hdfs://spark-nn.eemcs.utwente.nl/user/s1934538/clickstream/clickstream-enwiki-2021-02.tsv.gz,2023_Cricket_World_Cup,12972,23538,42,36552,11506
hdfs://spark-nn.eemcs.utwente.nl/user/s1934538/clickstream/clickstream-enwiki-2021-02.tsv.gz,Hamas,21291,26173,183,47647,19810
hdfs://spark-nn.eemcs.utwente.nl/user/s1934538/clickstream/clickstream-enwiki-2021-02.tsv.gz,Murder_of_Dee_Dee_Blanchard,14330,130687,495,145512,26758
hdfs://spark-nn.eemcs.utwente.nl/user/s1934538/clickstream/clickstream-enwiki-2021-02.tsv.gz,Central_Park_jogger_case,18170,69604,246,88020,13207
hdfs://spark-nn.eemcs.utwente.nl/user/s1934538/clickstream/clickstream-enwiki-2021-02.tsv.gz,It_Chapter_Two,28184,46620,511,75315,49456
hdfs://spark-nn.eemcs.utwente.nl/user/s1934538/clickstream/clickstream-enwiki-2021-02.tsv.gz,Article_370_of_the_Constitution_of_India,3065,43476,11,46552,3089
hdfs://spark-nn.eemcs.utwente.nl/user/s1934538/clickstream/clickstream-enwiki-2021-02.tsv.gz,Eternals_(film),215278,187666,1014,403958,415424
hdfs://spark-nn.eemcs.utwente.nl/user/s1934538/clickstream/clickstream-enwiki-2021-02.tsv.gz,Aquaman_(film),50474,146532,2389,199395,123651
hdfs://spark-nn.eemcs.utwente.nl/user/s1934538/clickstream/clickstream-enwiki-2021-02.tsv.gz,Elizabeth_II,687750,1234563,6198,1928511,1519415
hdfs://spark-nn.eemcs.utwente.nl/user/s1934538/clickstream/clickstream-enwiki-2021-02.tsv.gz,Chernobyl_(miniseries),19274,102302,1662,123238,122269
hdfs://spark-nn.eemcs.utwente.nl/user/s1934538/clickstream/clickstream-enwiki-2021-02.tsv.gz,Afghanistan,52982,125711,2164,180857,102909
hdfs://spark-nn.eemcs.utwente.nl/user/s1934538/clickstream/clickstream-enwiki-2021-02.tsv.gz,Bird_Box_(film),18344,76923,718,95985,30986
hdfs://spark-nn.eemcs.utwente.nl/user/s1934538/clickstream/clickstream-enwiki-2021-02.tsv.gz,Game_of_Thrones_(season_8),18591,46553,664,65808,25041
hdfs://spark-nn.eemcs.utwente.nl/user/s1934538/clickstream/clickstream-enwiki-2021-02.tsv.gz,Media,55,4055,323,4433,1562
hdfs://spark-nn.eemcs.utwente.nl/user/s1934538/clickstream/clickstream-enwiki-2021-02.tsv.gz,No_Time_to_Die,137954,112520,1877,252351,150583
hdfs://spark-nn.eemcs.utwente.nl/user/s1934538/clickstream/clickstream-enwiki-2021-02.tsv.gz,Puneeth_Rajkumar,10272,19555,235,30062,18003
hdfs://spark-nn.eemcs.utwente.nl/user/s1934538/clickstream/clickstream-enwiki-2021-02.tsv.gz,Sushant_Singh_Rajput,26999,114362,539,141900,60858
hdfs://spark-nn.eemcs.utwente.nl/user/s1934538/clickstream/clickstream-enwiki-2021-02.tsv.gz,Shooting_of_Breonna_Taylor,7341,106765,188,114294,9869
hdfs://spark-nn.eemcs.utwente.nl/user/s1934538/clickstream/clickstream-enwiki-2021-02.tsv.gz,Richard_Jewell,27222,187797,894,215913,76060
hdfs://spark-nn.eemcs.utwente.nl/user/s1934538/clickstream/clickstream-enwiki-2021-02.tsv.gz,JSON_Web_Token,845,26245,43,27133,1837
hdfs://spark-nn.eemcs.utwente.nl/user/s1934538/clickstream/clickstream-enwiki-2021-02.tsv.gz,United_States_Senate,126794,161510,5079,293383,144633
hdfs://spark-nn.eemcs.utwente.nl/user/s1934538/clickstream/clickstream-enwiki-2021-02.tsv.gz,Asia_Cup,1313,25829,152,27294,13369
hdfs://spark-nn.eemcs.utwente.nl/user/s1934538/clickstream/clickstream-enwiki-2021-02.tsv.gz,When_They_See_Us,17286,45781,294,63361,29594
hdfs://spark-nn.eemcs.utwente.nl/user/s1934538/clickstream/clickstream-enwiki-2021-02.tsv.gz,Stranger_Things,59783,236054,4940,300777,234903
hdfs://spark-nn.eemcs.utwente.nl/user/s1934538/clickstream/clickstream-enwiki-2021-02.tsv.gz,Croatia,40359,112604,1557,154520,57860
hdfs://spark-nn.eemcs.utwente.nl/user/s1934538/clickstream/clickstream-enwiki-2021-02.tsv.gz,Naya_Rivera,64202,115219,540,179961,69535
hdfs://spark-nn.eemcs.utwente.nl/user/s1934538/clickstream/clickstream-enwiki-2021-02.tsv.gz,Amy_Coney_Barrett,36305,50627,622,87554,29507
hdfs://spark-nn.eemcs.utwente.nl/user/s1934538/clickstream/clickstream-enwiki-2021-02.tsv.gz,Henry_V_of_England,80119,99272,410,179801,127929
hdfs://spark-nn.eemcs.utwente.nl/user/s1934538/clickstream/clickstream-enwiki-2021-02.tsv.gz,Michael_Bloomberg,40804,42134,370,83308,38232
hdfs://spark-nn.eemcs.utwente.nl/user/s1934538/clickstream/clickstream-enwiki-2021-02.tsv.gz,George_VI,482519,233936,872,717327,528928
hdfs://spark-nn.eemcs.utwente.nl/user/s1934538/clickstream/clickstream-enwiki-2021-02.tsv.gz,Shinzo_Abe,36745,30450,423,67618,42457
hdfs://spark-nn.eemcs.utwente.nl/user/s1934538/clickstream/clickstream-enwiki-2021-02.tsv.gz,Charles_III,121,250,40,411,258
hdfs://spark-nn.eemcs.utwente.nl/user/s1934538/clickstream/clickstream-enwiki-2021-02.tsv.gz,Hamilton_(musical),40889,277399,2240,320528,204789
hdfs://spark-nn.eemcs.utwente.nl/user/s1934538/clickstream/clickstream-enwiki-2021-02.tsv.gz,XXX:_Return_of_Xander_Cage,43684,529750,705,574139,85018
hdfs://spark-nn.eemcs.utwente.nl/user/s1934538/clickstream/clickstream-enwiki-2021-02.tsv.gz,"Diana,_Princess_of_Wales",233160,562860,5141,801161,465278
hdfs://spark-nn.eemcs.utwente.nl/user/s1934538/clickstream/clickstream-enwiki-2021-02.tsv.gz,Luke_Perry,46032,216656,796,263484,84939
hdfs://spark-nn.eemcs.utwente.nl/user/s1934538/clickstream/clickstream-enwiki-2021-02.tsv.gz,List_of_highest-grossing_Indian_films,41891,124664,299,166854,106500
hdfs://spark-nn.eemcs.utwente.nl/user/s1934538/clickstream/clickstream-enwiki-2021-02.tsv.gz,Burt_Reynolds,55545,207900,2092,265537,122443
hdfs://spark-nn.eemcs.utwente.nl/user/s1934538/clickstream/clickstream-enwiki-2021-02.tsv.gz,Notre-Dame_de_Paris,12863,79029,718,92610,21744
hdfs://spark-nn.eemcs.utwente.nl/user/s1934538/clickstream/clickstream-enwiki-2021-02.tsv.gz,The_Batman_(film),102340,109911,1798,214049,175895
hdfs://spark-nn.eemcs.utwente.nl/user/s1934538/clickstream/clickstream-enwiki-2021-02.tsv.gz,Avengers:_Infinity_War,100621,143688,2216,246525,154218
hdfs://spark-nn.eemcs.utwente.nl/user/s1934538/clickstream/clickstream-enwiki-2021-02.tsv.gz,Game_of_Thrones,96464,300930,7033,404427,251848
hdfs://spark-nn.eemcs.utwente.nl/user/s1934538/clickstream/clickstream-enwiki-2021-02.tsv.gz,COVID-19_pandemic_by_country_and_territory,196114,409118,9553,614785,417512
hdfs://spark-nn.eemcs.utwente.nl/user/s1934538/clickstream/clickstream-enwiki-2021-02.tsv.gz,Kate_Spade,30778,57554,343,88675,34154
hdfs://spark-nn.eemcs.utwente.nl/user/s1934538/clickstream/clickstream-enwiki-2021-02.tsv.gz,21_Savage,14875,57956,1059,73890,28168
hdfs://spark-nn.eemcs.utwente.nl/user/s1934538/clickstream/clickstream-enwiki-2021-02.tsv.gz,Chadwick_Boseman,93897,369237,2875,466009,137582
hdfs://spark-nn.eemcs.utwente.nl/user/s1934538/clickstream/clickstream-enwiki-2021-02.tsv.gz,Kylian_Mbappé,36792,364719,3033,404544,78102
hdfs://spark-nn.eemcs.utwente.nl/user/s1934538/clickstream/clickstream-enwiki-2021-02.tsv.gz,2020_United_States_presidential_election,267580,520306,15600,803486,790742
hdfs://spark-nn.eemcs.utwente.nl/user/s1934538/clickstream/clickstream-enwiki-2021-02.tsv.gz,Laal_Singh_Chaddha,22119,30130,76,52325,26510
hdfs://spark-nn.eemcs.utwente.nl/user/s1934538/clickstream/clickstream-enwiki-2021-02.tsv.gz,Cecil_Hotel_(Los_Angeles),221816,2694769,8106,2924691,903453
hdfs://spark-nn.eemcs.utwente.nl/user/s1934538/clickstream/clickstream-enwiki-2021-02.tsv.gz,Simone_Biles,22571,173564,1578,197713,53906
hdfs://spark-nn.eemcs.utwente.nl/user/s1934538/clickstream/clickstream-enwiki-2021-02.tsv.gz,Black_Panther_(film),107072,165879,3222,276173,166810
hdfs://spark-nn.eemcs.utwente.nl/user/s1934538/clickstream/clickstream-enwiki-2021-02.tsv.gz,Google_logo,1096,1471815,18,1472929,2541
hdfs://spark-nn.eemcs.utwente.nl/user/s1934538/clickstream/clickstream-enwiki-2021-02.tsv.gz,September_11_attacks,88960,266676,3054,358690,175981
hdfs://spark-nn.eemcs.utwente.nl/user/s1934538/clickstream/clickstream-enwiki-2021-02.tsv.gz,Greta_Thunberg,23541,497912,2292,523745,110820
hdfs://spark-nn.eemcs.utwente.nl/user/s1934538/clickstream/clickstream-enwiki-2021-02.tsv.gz,Godzilla_vs._Kong,139071,495668,7219,641958,262963
hdfs://spark-nn.eemcs.utwente.nl/user/s1934538/clickstream/clickstream-enwiki-2021-02.tsv.gz,Tonya_Harding,26668,125109,543,152320,40877
hdfs://spark-nn.eemcs.utwente.nl/user/s1934538/clickstream/clickstream-enwiki-2021-02.tsv.gz,The_Weeknd,209433,2544178,24851,2778462,800080
hdfs://spark-nn.eemcs.utwente.nl/user/s1934538/clickstream/clickstream-enwiki-2021-02.tsv.gz,Crazy_Rich_Asians_(film),33574,114701,3415,151690,150757
hdfs://spark-nn.eemcs.utwente.nl/user/s1934538/clickstream/clickstream-enwiki-2021-02.tsv.gz,The_Haunting_of_Bly_Manor,25659,112150,930,138739,67218
hdfs://spark-nn.eemcs.utwente.nl/user/s1934538/clickstream/clickstream-enwiki-2021-02.tsv.gz,Loki_(TV_series),92396,126771,1429,220596,98898
hdfs://spark-nn.eemcs.utwente.nl/user/s1934538/clickstream/clickstream-enwiki-2021-02.tsv.gz,Spider-Man:_No_Way_Home,125748,110720,1588,238056,137215
hdfs://spark-nn.eemcs.utwente.nl/user/s1934538/clickstream/clickstream-enwiki-2021-02.tsv.gz,Aaron_Hernandez,19489,356391,1998,377878,127171
hdfs://spark-nn.eemcs.utwente.nl/user/s1934538/clickstream/clickstream-enwiki-2021-05.tsv.gz,Nipsey_Hussle,46911,126779,1135,174825,50316
hdfs://spark-nn.eemcs.utwente.nl/user/s1934538/clickstream/clickstream-enwiki-2021-05.tsv.gz,Greta_Thunberg,10944,235925,2170,249039,58573
hdfs://spark-nn.eemcs.utwente.nl/user/s1934538/clickstream/clickstream-enwiki-2021-05.tsv.gz,Rihanna,99961,294254,4301,398516,190752
hdfs://spark-nn.eemcs.utwente.nl/user/s1934538/clickstream/clickstream-enwiki-2021-05.tsv.gz,Juice_Wrld,46563,306281,5540,358384,124989
hdfs://spark-nn.eemcs.utwente.nl/user/s1934538/clickstream/clickstream-enwiki-2021-05.tsv.gz,2.0_(film),21121,38607,62,59790,19801
hdfs://spark-nn.eemcs.utwente.nl/user/s1934538/clickstream/clickstream-enwiki-2021-05.tsv.gz,Jenna_Ortega,38928,100990,1785,141703,39483
hdfs://spark-nn.eemcs.utwente.nl/user/s1934538/clickstream/clickstream-enwiki-2021-05.tsv.gz,UEFA_Euro_2020,177909,1052268,26856,1257033,698913
hdfs://spark-nn.eemcs.utwente.nl/user/s1934538/clickstream/clickstream-enwiki-2021-05.tsv.gz,The_Kashmir_Files,3803,1060,180,5043,2072
hdfs://spark-nn.eemcs.utwente.nl/user/s1934538/clickstream/clickstream-enwiki-2021-05.tsv.gz,Eddie_Van_Halen,43847,86434,1108,131389,50727
hdfs://spark-nn.eemcs.utwente.nl/user/s1934538/clickstream/clickstream-enwiki-2021-05.tsv.gz,Michael_Jordan,109893,551727,6350,667970,239471
hdfs://spark-nn.eemcs.utwente.nl/user/s1934538/clickstream/clickstream-enwiki-2021-05.tsv.gz,Army_of_the_Dead,321496,2932503,59299,3313298,2880079
hdfs://spark-nn.eemcs.utwente.nl/user/s1934538/clickstream/clickstream-enwiki-2021-05.tsv.gz,Simone_Biles,20526,231585,2114,254225,99481
hdfs://spark-nn.eemcs.utwente.nl/user/s1934538/clickstream/clickstream-enwiki-2021-05.tsv.gz,Kelly_Preston,105318,185074,847,291239,86107
hdfs://spark-nn.eemcs.utwente.nl/user/s1934538/clickstream/clickstream-enwiki-2021-05.tsv.gz,The_Batman_(film),123307,114408,2403,240118,195992
hdfs://spark-nn.eemcs.utwente.nl/user/s1934538/clickstream/clickstream-enwiki-2021-05.tsv.gz,Jimmy_Buffett,12039,66898,771,79708,30856
hdfs://spark-nn.eemcs.utwente.nl/user/s1934538/clickstream/clickstream-enwiki-2021-05.tsv.gz,Pornhub,46469,294858,15249,356576,105239
hdfs://spark-nn.eemcs.utwente.nl/user/s1934538/clickstream/clickstream-enwiki-2021-05.tsv.gz,Ghislaine_Maxwell,84678,98513,521,183712,69178
hdfs://spark-nn.eemcs.utwente.nl/user/s1934538/clickstream/clickstream-enwiki-2021-05.tsv.gz,Shinzo_Abe,32788,31384,374,64546,40140
hdfs://spark-nn.eemcs.utwente.nl/user/s1934538/clickstream/clickstream-enwiki-2021-05.tsv.gz,United_States_Electoral_College,13745,37723,56,51524,8221
hdfs://spark-nn.eemcs.utwente.nl/user/s1934538/clickstream/clickstream-enwiki-2021-05.tsv.gz,WandaVision,75137,342855,6271,424263,235207
hdfs://spark-nn.eemcs.utwente.nl/user/s1934538/clickstream/clickstream-enwiki-2021-05.tsv.gz,Michael_Bloomberg,40804,50802,227,91833,37313
hdfs://spark-nn.eemcs.utwente.nl/user/s1934538/clickstream/clickstream-enwiki-2021-05.tsv.gz,Aaron_Carter,18755,125115,425,144295,32887
hdfs://spark-nn.eemcs.utwente.nl/user/s1934538/clickstream/clickstream-enwiki-2021-05.tsv.gz,Indian_Premier_League,24878,152663,468,178009,102910
hdfs://spark-nn.eemcs.utwente.nl/user/s1934538/clickstream/clickstream-enwiki-2021-05.tsv.gz,Betty_White,75494,267677,3388,346559,106729
hdfs://spark-nn.eemcs.utwente.nl/user/s1934538/clickstream/clickstream-enwiki-2021-05.tsv.gz,Watts_family_murders,22985,314524,740,338249,80073
hdfs://spark-nn.eemcs.utwente.nl/user/s1934538/clickstream/clickstream-enwiki-2021-05.tsv.gz,"Prince_Philip,_Duke_of_Edinburgh",265735,420098,6106,691939,431017
hdfs://spark-nn.eemcs.utwente.nl/user/s1934538/clickstream/clickstream-enwiki-2021-05.tsv.gz,Tenet_(film),119744,907515,13047,1040306,627774
hdfs://spark-nn.eemcs.utwente.nl/user/s1934538/clickstream/clickstream-enwiki-2021-05.tsv.gz,COVID-19_pandemic,489268,593173,2541,1084982,576358
hdfs://spark-nn.eemcs.utwente.nl/user/s1934538/clickstream/clickstream-enwiki-2021-05.tsv.gz,Hamas,483187,1920360,3752,2407299,964728
hdfs://spark-nn.eemcs.utwente.nl/user/s1934538/clickstream/clickstream-enwiki-2021-05.tsv.gz,Anthony_Bourdain,21804,230936,2065,254805,85292
hdfs://spark-nn.eemcs.utwente.nl/user/s1934538/clickstream/clickstream-enwiki-2021-05.tsv.gz,Amy_Coney_Barrett,29079,42975,299,72353,24899
hdfs://spark-nn.eemcs.utwente.nl/user/s1934538/clickstream/clickstream-enwiki-2021-05.tsv.gz,Chadwick_Boseman,85247,353024,2358,440629,131485
hdfs://spark-nn.eemcs.utwente.nl/user/s1934538/clickstream/clickstream-enwiki-2021-05.tsv.gz,Ant-Man_and_the_Wasp:_Quantumania,97086,32641,252,129979,100167
hdfs://spark-nn.eemcs.utwente.nl/user/s1934538/clickstream/clickstream-enwiki-2021-05.tsv.gz,Brie_Larson,78871,252643,2429,333943,139100
hdfs://spark-nn.eemcs.utwente.nl/user/s1934538/clickstream/clickstream-enwiki-2021-05.tsv.gz,Aretha_Franklin,38685,209743,2024,250452,116216
hdfs://spark-nn.eemcs.utwente.nl/user/s1934538/clickstream/clickstream-enwiki-2021-05.tsv.gz,Central_Park_jogger_case,16113,75791,458,92362,13079
hdfs://spark-nn.eemcs.utwente.nl/user/s1934538/clickstream/clickstream-enwiki-2021-05.tsv.gz,2020_United_States_presidential_election,237749,397842,11400,646991,616569
hdfs://spark-nn.eemcs.utwente.nl/user/s1934538/clickstream/clickstream-enwiki-2021-05.tsv.gz,Puneeth_Rajkumar,20713,49446,927,71086,52457
hdfs://spark-nn.eemcs.utwente.nl/user/s1934538/clickstream/clickstream-enwiki-2021-05.tsv.gz,Tunnel,4020,9568,151,13739,3953
hdfs://spark-nn.eemcs.utwente.nl/user/s1934538/clickstream/clickstream-enwiki-2021-05.tsv.gz,Doctor_Strange_in_the_Multiverse_of_Madness,149023,89871,906,239800,140355
hdfs://spark-nn.eemcs.utwente.nl/user/s1934538/clickstream/clickstream-enwiki-2021-05.tsv.gz,Kobe_Bryant_sexual_assault_case,8826,52468,53,61347,4527
hdfs://spark-nn.eemcs.utwente.nl/user/s1934538/clickstream/clickstream-enwiki-2021-05.tsv.gz,The_Sandman_(TV_series),29128,45386,472,74986,67910
hdfs://spark-nn.eemcs.utwente.nl/user/s1934538/clickstream/clickstream-enwiki-2021-05.tsv.gz,Roe_v._Wade,15540,159263,1220,176023,50254
hdfs://spark-nn.eemcs.utwente.nl/user/s1934538/clickstream/clickstream-enwiki-2021-05.tsv.gz,Dark_Phoenix_(film),52102,65263,941,118306,71532
hdfs://spark-nn.eemcs.utwente.nl/user/s1934538/clickstream/clickstream-enwiki-2021-05.tsv.gz,The_Irishman,57322,100111,1993,159426,133665
hdfs://spark-nn.eemcs.utwente.nl/user/s1934538/clickstream/clickstream-enwiki-2021-05.tsv.gz,John_McCain,43444,99051,1456,143951,71492
hdfs://spark-nn.eemcs.utwente.nl/user/s1934538/clickstream/clickstream-enwiki-2021-05.tsv.gz,List_of_FIFA_World_Cup_finals,4908,116360,93,121361,31520
hdfs://spark-nn.eemcs.utwente.nl/user/s1934538/clickstream/clickstream-enwiki-2021-05.tsv.gz,List_of_highest-grossing_Indian_films,70890,193012,302,264204,152807
hdfs://spark-nn.eemcs.utwente.nl/user/s1934538/clickstream/clickstream-enwiki-2021-05.tsv.gz,Fyre_Festival,9980,59468,408,69856,39560
hdfs://spark-nn.eemcs.utwente.nl/user/s1934538/clickstream/clickstream-enwiki-2021-05.tsv.gz,The_Witcher_(TV_series),39473,180147,3991,223611,127177
hdfs://spark-nn.eemcs.utwente.nl/user/s1934538/clickstream/clickstream-enwiki-2021-05.tsv.gz,YouTube,156215,619060,13967,789242,141185
hdfs://spark-nn.eemcs.utwente.nl/user/s1934538/clickstream/clickstream-enwiki-2021-05.tsv.gz,Pelé,37529,115746,1193,154468,50241
hdfs://spark-nn.eemcs.utwente.nl/user/s1934538/clickstream/clickstream-enwiki-2021-05.tsv.gz,Mötley_Crüe,51147,131020,1634,183801,206363
hdfs://spark-nn.eemcs.utwente.nl/user/s1934538/clickstream/clickstream-enwiki-2021-05.tsv.gz,Charles_Sobhraj,180393,800615,1763,982771,184686
hdfs://spark-nn.eemcs.utwente.nl/user/s1934538/clickstream/clickstream-enwiki-2021-05.tsv.gz,2020_Summer_Olympics,109957,314891,12995,437843,447879
hdfs://spark-nn.eemcs.utwente.nl/user/s1934538/clickstream/clickstream-enwiki-2021-05.tsv.gz,Cardi_B,47603,207021,4451,259075,97703
hdfs://spark-nn.eemcs.utwente.nl/user/s1934538/clickstream/clickstream-enwiki-2021-05.tsv.gz,Parasite_(2019_film),43569,234339,2380,280288,114801
hdfs://spark-nn.eemcs.utwente.nl/user/s1934538/clickstream/clickstream-enwiki-2021-05.tsv.gz,Death_of_Elisa_Lam,21349,129137,789,151275,36037
hdfs://spark-nn.eemcs.utwente.nl/user/s1934538/clickstream/clickstream-enwiki-2021-05.tsv.gz,Jeffrey_Epstein,74539,550281,3590,628410,265485
hdfs://spark-nn.eemcs.utwente.nl/user/s1934538/clickstream/clickstream-enwiki-2021-05.tsv.gz,The_Lion_King_(2019_film),45167,53574,602,99343,51812
hdfs://spark-nn.eemcs.utwente.nl/user/s1934538/clickstream/clickstream-enwiki-2021-05.tsv.gz,Stranger_Things_(season_4),45970,188291,1419,235680,138326
hdfs://spark-nn.eemcs.utwente.nl/user/s1934538/clickstream/clickstream-enwiki-2021-05.tsv.gz,Israel,605149,2350640,35713,2991502,1480522
hdfs://spark-nn.eemcs.utwente.nl/user/s1934538/clickstream/clickstream-enwiki-2021-05.tsv.gz,A_Quiet_Place_(film),123100,639106,6135,768341,276067
hdfs://spark-nn.eemcs.utwente.nl/user/s1934538/clickstream/clickstream-enwiki-2021-05.tsv.gz,Loki_(TV_series),69922,248892,6289,325103,158950
hdfs://spark-nn.eemcs.utwente.nl/user/s1934538/clickstream/clickstream-enwiki-2021-05.tsv.gz,Jason_Momoa,91956,275166,2448,369570,164507
hdfs://spark-nn.eemcs.utwente.nl/user/s1934538/clickstream/clickstream-enwiki-2021-05.tsv.gz,List_of_most_popular_websites,9747,35147,131,45025,17490
hdfs://spark-nn.eemcs.utwente.nl/user/s1934538/clickstream/clickstream-enwiki-2021-05.tsv.gz,Stan_Lee,56760,146984,1808,205552,69378
hdfs://spark-nn.eemcs.utwente.nl/user/s1934538/clickstream/clickstream-enwiki-2021-05.tsv.gz,Burt_Reynolds,64495,162034,1452,227981,110152
hdfs://spark-nn.eemcs.utwente.nl/user/s1934538/clickstream/clickstream-enwiki-2021-05.tsv.gz,XXXTentacion,66702,474696,6464,547862,101908
hdfs://spark-nn.eemcs.utwente.nl/user/s1934538/clickstream/clickstream-enwiki-2021-05.tsv.gz,Carlos_Alcaraz,3310,18138,103,21551,3955
hdfs://spark-nn.eemcs.utwente.nl/user/s1934538/clickstream/clickstream-enwiki-2021-05.tsv.gz,Simple_Mail_Transfer_Protocol,3734,31211,122,35067,4291
hdfs://spark-nn.eemcs.utwente.nl/user/s1934538/clickstream/clickstream-enwiki-2021-05.tsv.gz,RRR_(film),47955,83437,271,131663,80093
hdfs://spark-nn.eemcs.utwente.nl/user/s1934538/clickstream/clickstream-enwiki-2021-05.tsv.gz,2022_FIFA_World_Cup,88488,173078,2776,264342,142401
hdfs://spark-nn.eemcs.utwente.nl/user/s1934538/clickstream/clickstream-enwiki-2021-05.tsv.gz,List_of_James_Bond_films,80630,471448,911,552989,341877
hdfs://spark-nn.eemcs.utwente.nl/user/s1934538/clickstream/clickstream-enwiki-2021-05.tsv.gz,Jeffrey_Dahmer,35737,320087,4370,360194,155746
hdfs://spark-nn.eemcs.utwente.nl/user/s1934538/clickstream/clickstream-enwiki-2021-05.tsv.gz,Cleopatra,56762,3150034,2464,3209260,281363
hdfs://spark-nn.eemcs.utwente.nl/user/s1934538/clickstream/clickstream-enwiki-2021-05.tsv.gz,Priyanka_Chopra,134558,303831,4587,442976,160769
hdfs://spark-nn.eemcs.utwente.nl/user/s1934538/clickstream/clickstream-enwiki-2021-05.tsv.gz,Richard_Jewell,19434,94398,556,114388,40381
hdfs://spark-nn.eemcs.utwente.nl/user/s1934538/clickstream/clickstream-enwiki-2021-05.tsv.gz,Kylian_Mbappé,42373,193350,2337,238060,51559
hdfs://spark-nn.eemcs.utwente.nl/user/s1934538/clickstream/clickstream-enwiki-2021-05.tsv.gz,Coronavirus,23942,303841,5671,333454,87523
hdfs://spark-nn.eemcs.utwente.nl/user/s1934538/clickstream/clickstream-enwiki-2021-05.tsv.gz,Bonnie_and_Clyde,28058,284353,1922,314333,75017
hdfs://spark-nn.eemcs.utwente.nl/user/s1934538/clickstream/clickstream-enwiki-2021-05.tsv.gz,Article_370_of_the_Constitution_of_India,3420,36945,43,40408,3036
hdfs://spark-nn.eemcs.utwente.nl/user/s1934538/clickstream/clickstream-enwiki-2021-05.tsv.gz,Avengers:_Endgame,152882,247872,4297,405051,259631
hdfs://spark-nn.eemcs.utwente.nl/user/s1934538/clickstream/clickstream-enwiki-2021-05.tsv.gz,Louis_Tomlinson,35312,66246,765,102323,36094
hdfs://spark-nn.eemcs.utwente.nl/user/s1934538/clickstream/clickstream-enwiki-2021-05.tsv.gz,A_Star_Is_Born_(2018_film),34335,150135,1130,185600,90756
hdfs://spark-nn.eemcs.utwente.nl/user/s1934538/clickstream/clickstream-enwiki-2021-05.tsv.gz,Glass_(2019_film),74847,127878,1330,204055,77821
hdfs://spark-nn.eemcs.utwente.nl/user/s1934538/clickstream/clickstream-enwiki-2021-05.tsv.gz,Lisa_Marie_Presley,166606,95308,417,262331,137310
hdfs://spark-nn.eemcs.utwente.nl/user/s1934538/clickstream/clickstream-enwiki-2021-05.tsv.gz,Sushant_Singh_Rajput,37220,199268,1194,237682,98571
hdfs://spark-nn.eemcs.utwente.nl/user/s1934538/clickstream/clickstream-enwiki-2021-05.tsv.gz,Queen_(band),82593,273793,3890,360276,336707
hdfs://spark-nn.eemcs.utwente.nl/user/s1934538/clickstream/clickstream-enwiki-2021-05.tsv.gz,Aaron_Hernandez,11509,117425,575,129509,43534
hdfs://spark-nn.eemcs.utwente.nl/user/s1934538/clickstream/clickstream-enwiki-2021-05.tsv.gz,The_Haunting_of_Bly_Manor,26033,79291,593,105917,50385
hdfs://spark-nn.eemcs.utwente.nl/user/s1934538/clickstream/clickstream-enwiki-2021-05.tsv.gz,The_Queen's_Gambit_(miniseries),68853,309475,2996,381324,204135
hdfs://spark-nn.eemcs.utwente.nl/user/s1934538/clickstream/clickstream-enwiki-2021-05.tsv.gz,Cecil_Hotel_(Los_Angeles),10518,106334,559,117411,29111
hdfs://spark-nn.eemcs.utwente.nl/user/s1934538/clickstream/clickstream-enwiki-2021-05.tsv.gz,Shang-Chi_and_the_Legend_of_the_Ten_Rings,140533,121427,1727,263687,175250
hdfs://spark-nn.eemcs.utwente.nl/user/s1934538/clickstream/clickstream-enwiki-2021-05.tsv.gz,Gaza_Strip,412492,1524959,9807,1947258,744189
hdfs://spark-nn.eemcs.utwente.nl/user/s1934538/clickstream/clickstream-enwiki-2021-05.tsv.gz,Naya_Rivera,89175,140159,658,229992,92675
hdfs://spark-nn.eemcs.utwente.nl/user/s1934538/clickstream/clickstream-enwiki-2021-05.tsv.gz,QAnon,49837,374756,4216,428809,99893
hdfs://spark-nn.eemcs.utwente.nl/user/s1934538/clickstream/clickstream-enwiki-2021-05.tsv.gz,Johnny_Depp,163805,355196,2788,521789,398808
hdfs://spark-nn.eemcs.utwente.nl/user/s1934538/clickstream/clickstream-enwiki-2021-05.tsv.gz,Black_Widow_(2021_film),143622,232011,4994,380627,200244
hdfs://spark-nn.eemcs.utwente.nl/user/s1934538/clickstream/clickstream-enwiki-2021-05.tsv.gz,Valentine's_Day,3301,29317,239,32857,3429
hdfs://spark-nn.eemcs.utwente.nl/user/s1934538/clickstream/clickstream-enwiki-2021-05.tsv.gz,United_States_Senate,62124,57626,871,120621,60737
hdfs://spark-nn.eemcs.utwente.nl/user/s1934538/clickstream/clickstream-enwiki-2021-05.tsv.gz,Cook's_Country,460,2714,22,3196,861
hdfs://spark-nn.eemcs.utwente.nl/user/s1934538/clickstream/clickstream-enwiki-2021-05.tsv.gz,Qasem_Soleimani,19518,40877,199,60594,32059
hdfs://spark-nn.eemcs.utwente.nl/user/s1934538/clickstream/clickstream-enwiki-2021-05.tsv.gz,Kamala_Harris,134187,315018,3525,452730,224673
hdfs://spark-nn.eemcs.utwente.nl/user/s1934538/clickstream/clickstream-enwiki-2021-05.tsv.gz,Lionel_Messi,137129,582391,6693,726213,186534
hdfs://spark-nn.eemcs.utwente.nl/user/s1934538/clickstream/clickstream-enwiki-2021-05.tsv.gz,Darth_Vader,36943,80928,873,118744,69718
hdfs://spark-nn.eemcs.utwente.nl/user/s1934538/clickstream/clickstream-enwiki-2021-05.tsv.gz,Mortal_Kombat_(2021_film),130309,1090710,29474,1250493,1259370
hdfs://spark-nn.eemcs.utwente.nl/user/s1934538/clickstream/clickstream-enwiki-2021-05.tsv.gz,XXX:_Return_of_Xander_Cage,56796,540630,1219,598645,87395
hdfs://spark-nn.eemcs.utwente.nl/user/s1934538/clickstream/clickstream-enwiki-2021-05.tsv.gz,Sylvester_Stallone,117739,326727,2596,447062,331439
hdfs://spark-nn.eemcs.utwente.nl/user/s1934538/clickstream/clickstream-enwiki-2021-05.tsv.gz,Cristiano_Ronaldo,163316,1013666,7621,1184603,315343
hdfs://spark-nn.eemcs.utwente.nl/user/s1934538/clickstream/clickstream-enwiki-2021-05.tsv.gz,Thor:_Love_and_Thunder,220247,122754,1560,344561,285496
hdfs://spark-nn.eemcs.utwente.nl/user/s1934538/clickstream/clickstream-enwiki-2021-05.tsv.gz,Joaquin_Phoenix,136365,196571,1003,333939,206182
hdfs://spark-nn.eemcs.utwente.nl/user/s1934538/clickstream/clickstream-enwiki-2021-05.tsv.gz,Tina_Turner,35524,303147,3215,341886,128829
hdfs://spark-nn.eemcs.utwente.nl/user/s1934538/clickstream/clickstream-enwiki-2021-05.tsv.gz,Cameron_Boyce,44033,348401,1312,393746,100310
hdfs://spark-nn.eemcs.utwente.nl/user/s1934538/clickstream/clickstream-enwiki-2021-05.tsv.gz,Adipurush,41192,34165,872,76229,45464
hdfs://spark-nn.eemcs.utwente.nl/user/s1934538/clickstream/clickstream-enwiki-2021-05.tsv.gz,Google_logo,1173,3245008,14,3246195,1281
hdfs://spark-nn.eemcs.utwente.nl/user/s1934538/clickstream/clickstream-enwiki-2021-05.tsv.gz,Anna_Sorokin,6159,46401,6019,58579,16723
hdfs://spark-nn.eemcs.utwente.nl/user/s1934538/clickstream/clickstream-enwiki-2021-05.tsv.gz,Spanish_flu,52647,410718,3939,467304,98323
hdfs://spark-nn.eemcs.utwente.nl/user/s1934538/clickstream/clickstream-enwiki-2021-05.tsv.gz,Avicii,26479,250971,2051,279501,132363
hdfs://spark-nn.eemcs.utwente.nl/user/s1934538/clickstream/clickstream-enwiki-2021-05.tsv.gz,Captain_Marvel_(film),60156,141953,2104,204213,116534
hdfs://spark-nn.eemcs.utwente.nl/user/s1934538/clickstream/clickstream-enwiki-2021-05.tsv.gz,Kim_Jong-un,73952,185134,1946,261032,138498
hdfs://spark-nn.eemcs.utwente.nl/user/s1934538/clickstream/clickstream-enwiki-2021-05.tsv.gz,Zack_Snyder's_Justice_League,152107,395186,6980,554273,285376
hdfs://spark-nn.eemcs.utwente.nl/user/s1934538/clickstream/clickstream-enwiki-2021-05.tsv.gz,Donald_Glover,49328,175438,1279,226045,96236
hdfs://spark-nn.eemcs.utwente.nl/user/s1934538/clickstream/clickstream-enwiki-2021-05.tsv.gz,Black_Panther_(film),125068,204069,4750,333887,203309
hdfs://spark-nn.eemcs.utwente.nl/user/s1934538/clickstream/clickstream-enwiki-2021-05.tsv.gz,Bible,20701,3978107,2056,4000864,42345
hdfs://spark-nn.eemcs.utwente.nl/user/s1934538/clickstream/clickstream-enwiki-2021-05.tsv.gz,Lists_of_deaths_by_year,4521,214454,1337,220312,245267
hdfs://spark-nn.eemcs.utwente.nl/user/s1934538/clickstream/clickstream-enwiki-2021-05.tsv.gz,Afghanistan,77331,183348,3622,264301,151508
hdfs://spark-nn.eemcs.utwente.nl/user/s1934538/clickstream/clickstream-enwiki-2021-05.tsv.gz,HTTP_cookie,3433,339457,140,343030,25214
hdfs://spark-nn.eemcs.utwente.nl/user/s1934538/clickstream/clickstream-enwiki-2021-05.tsv.gz,Vivek_Ramaswamy,1007,7498,24,8529,1819
hdfs://spark-nn.eemcs.utwente.nl/user/s1934538/clickstream/clickstream-enwiki-2021-05.tsv.gz,Sidharth_Shukla,13747,38939,1044,53730,16014
hdfs://spark-nn.eemcs.utwente.nl/user/s1934538/clickstream/clickstream-enwiki-2021-05.tsv.gz,"Citizenship_(Amendment)_Act,_2019",6698,41144,124,47966,5695
hdfs://spark-nn.eemcs.utwente.nl/user/s1934538/clickstream/clickstream-enwiki-2021-05.tsv.gz,Olivia_Newton-John,34034,93327,2860,130221,55953
hdfs://spark-nn.eemcs.utwente.nl/user/s1934538/clickstream/clickstream-enwiki-2021-05.tsv.gz,Lance_Reddick,37493,45404,221,83118,16730
hdfs://spark-nn.eemcs.utwente.nl/user/s1934538/clickstream/clickstream-enwiki-2021-05.tsv.gz,"Princess_Margaret,_Countess_of_Snowdon",183110,587679,3783,774572,436019
hdfs://spark-nn.eemcs.utwente.nl/user/s1934538/clickstream/clickstream-enwiki-2021-05.tsv.gz,Freddie_Mercury,117606,780751,6458,904815,336313
hdfs://spark-nn.eemcs.utwente.nl/user/s1934538/clickstream/clickstream-enwiki-2021-05.tsv.gz,Deaths_in_2021,1584939,2470563,21665,4077167,2403798
hdfs://spark-nn.eemcs.utwente.nl/user/s1934538/clickstream/clickstream-enwiki-2021-05.tsv.gz,1917_(2019_film),31996,104305,2000,138301,76396
hdfs://spark-nn.eemcs.utwente.nl/user/s1934538/clickstream/clickstream-enwiki-2021-05.tsv.gz,Khabib_Nurmagomedov,95755,302119,2922,400796,215164
hdfs://spark-nn.eemcs.utwente.nl/user/s1934538/clickstream/clickstream-enwiki-2021-05.tsv.gz,David_Beckham,60760,298257,2389,361406,131424
hdfs://spark-nn.eemcs.utwente.nl/user/s1934538/clickstream/clickstream-enwiki-2021-05.tsv.gz,Rami_Malek,83117,207827,794,291738,122070
hdfs://spark-nn.eemcs.utwente.nl/user/s1934538/clickstream/clickstream-enwiki-2021-05.tsv.gz,21_Savage,21575,79003,1236,101814,42337
hdfs://spark-nn.eemcs.utwente.nl/user/s1934538/clickstream/clickstream-enwiki-2021-05.tsv.gz,Manti_Te'o,3866,15677,97,19640,2244
hdfs://spark-nn.eemcs.utwente.nl/user/s1934538/clickstream/clickstream-enwiki-2021-05.tsv.gz,George_VI,478898,233044,1188,713130,532015
hdfs://spark-nn.eemcs.utwente.nl/user/s1934538/clickstream/clickstream-enwiki-2021-05.tsv.gz,Elon_Musk,285246,3506755,32418,3824419,2308571
hdfs://spark-nn.eemcs.utwente.nl/user/s1934538/clickstream/clickstream-enwiki-2021-05.tsv.gz,Grimes_(musician),464074,402364,1582,868020,243282
hdfs://spark-nn.eemcs.utwente.nl/user/s1934538/clickstream/clickstream-enwiki-2021-05.tsv.gz,Black_Adam_(film),80025,29086,462,109573,96545
hdfs://spark-nn.eemcs.utwente.nl/user/s1934538/clickstream/clickstream-enwiki-2021-05.tsv.gz,Royal_Rumble_(2018),7472,4930,80,12482,9103
hdfs://spark-nn.eemcs.utwente.nl/user/s1934538/clickstream/clickstream-enwiki-2021-05.tsv.gz,Cricket_World_Cup,10015,83039,291,93345,51431
hdfs://spark-nn.eemcs.utwente.nl/user/s1934538/clickstream/clickstream-enwiki-2021-05.tsv.gz,Spider-Man:_Far_From_Home,90014,136029,2329,228372,138306
hdfs://spark-nn.eemcs.utwente.nl/user/s1934538/clickstream/clickstream-enwiki-2021-05.tsv.gz,It_Chapter_Two,37278,72843,1390,111511,78323
hdfs://spark-nn.eemcs.utwente.nl/user/s1934538/clickstream/clickstream-enwiki-2021-05.tsv.gz,Kate_Spade,26772,70389,407,97568,34932
hdfs://spark-nn.eemcs.utwente.nl/user/s1934538/clickstream/clickstream-enwiki-2021-05.tsv.gz,Juneteenth,4769,366910,1208,372887,24214
hdfs://spark-nn.eemcs.utwente.nl/user/s1934538/clickstream/clickstream-enwiki-2021-05.tsv.gz,Aquaman_(film),54358,113479,1814,169651,93779
hdfs://spark-nn.eemcs.utwente.nl/user/s1934538/clickstream/clickstream-enwiki-2021-06.tsv.gz,Olivia_Newton-John,27855,88068,1292,117215,53782
hdfs://spark-nn.eemcs.utwente.nl/user/s1934538/clickstream/clickstream-enwiki-2021-06.tsv.gz,Kenosha_unrest_shooting,6082,48703,301,55086,10191
hdfs://spark-nn.eemcs.utwente.nl/user/s1934538/clickstream/clickstream-enwiki-2021-06.tsv.gz,Deion_Sanders,7709,80527,652,88888,28875
hdfs://spark-nn.eemcs.utwente.nl/user/s1934538/clickstream/clickstream-enwiki-2021-06.tsv.gz,"Princess_Margaret,_Countess_of_Snowdon",117913,302717,2006,422636,231574
hdfs://spark-nn.eemcs.utwente.nl/user/s1934538/clickstream/clickstream-enwiki-2021-06.tsv.gz,Tonya_Harding,32609,176787,1076,210472,53513
hdfs://spark-nn.eemcs.utwente.nl/user/s1934538/clickstream/clickstream-enwiki-2021-06.tsv.gz,Joaquin_Phoenix,129964,178629,989,309582,186125
hdfs://spark-nn.eemcs.utwente.nl/user/s1934538/clickstream/clickstream-enwiki-2021-06.tsv.gz,QAnon,70639,450642,3307,524588,118256
hdfs://spark-nn.eemcs.utwente.nl/user/s1934538/clickstream/clickstream-enwiki-2021-06.tsv.gz,Mötley_Crüe,38365,114983,1677,155025,178645
hdfs://spark-nn.eemcs.utwente.nl/user/s1934538/clickstream/clickstream-enwiki-2021-06.tsv.gz,Mortal_Kombat_(2021_film),44701,222796,6946,274443,208053
hdfs://spark-nn.eemcs.utwente.nl/user/s1934538/clickstream/clickstream-enwiki-2021-06.tsv.gz,Wonder_Woman_1984,48431,196727,3813,248971,131285
hdfs://spark-nn.eemcs.utwente.nl/user/s1934538/clickstream/clickstream-enwiki-2021-06.tsv.gz,2023_Cricket_World_Cup,22415,38010,114,60539,21667
hdfs://spark-nn.eemcs.utwente.nl/user/s1934538/clickstream/clickstream-enwiki-2021-06.tsv.gz,Shakira,27757,182854,2041,212652,105273
hdfs://spark-nn.eemcs.utwente.nl/user/s1934538/clickstream/clickstream-enwiki-2021-06.tsv.gz,WandaVision,69509,300173,5636,375318,206268
hdfs://spark-nn.eemcs.utwente.nl/user/s1934538/clickstream/clickstream-enwiki-2021-06.tsv.gz,Brie_Larson,65742,184253,1673,251668,104974
hdfs://spark-nn.eemcs.utwente.nl/user/s1934538/clickstream/clickstream-enwiki-2021-06.tsv.gz,Star_Wars:_The_Rise_of_Skywalker,70835,57308,1576,129719,69305
hdfs://spark-nn.eemcs.utwente.nl/user/s1934538/clickstream/clickstream-enwiki-2021-06.tsv.gz,Avicii,23455,201303,1570,226328,108401
hdfs://spark-nn.eemcs.utwente.nl/user/s1934538/clickstream/clickstream-enwiki-2021-06.tsv.gz,Chernobyl_(miniseries),26632,114512,2373,143517,131309
hdfs://spark-nn.eemcs.utwente.nl/user/s1934538/clickstream/clickstream-enwiki-2021-06.tsv.gz,Chadwick_Boseman,56162,221325,1171,278658,81376
hdfs://spark-nn.eemcs.utwente.nl/user/s1934538/clickstream/clickstream-enwiki-2021-06.tsv.gz,Cristiano_Ronaldo,389201,2437058,17738,2843997,818884
hdfs://spark-nn.eemcs.utwente.nl/user/s1934538/clickstream/clickstream-enwiki-2021-06.tsv.gz,Spanish_flu,36550,236757,2724,276031,59440
hdfs://spark-nn.eemcs.utwente.nl/user/s1934538/clickstream/clickstream-enwiki-2021-06.tsv.gz,Stan_Lee,47774,123223,1458,172455,52874
hdfs://spark-nn.eemcs.utwente.nl/user/s1934538/clickstream/clickstream-enwiki-2021-06.tsv.gz,Charles_Sobhraj,62534,266239,620,329393,62276
hdfs://spark-nn.eemcs.utwente.nl/user/s1934538/clickstream/clickstream-enwiki-2021-06.tsv.gz,Kelly_Preston,84330,129317,854,214501,65419
hdfs://spark-nn.eemcs.utwente.nl/user/s1934538/clickstream/clickstream-enwiki-2021-06.tsv.gz,A_Star_Is_Born_(2018_film),31889,92692,727,125308,59738
hdfs://spark-nn.eemcs.utwente.nl/user/s1934538/clickstream/clickstream-enwiki-2021-06.tsv.gz,John_McCain,32987,61770,794,95551,48167
hdfs://spark-nn.eemcs.utwente.nl/user/s1934538/clickstream/clickstream-enwiki-2021-06.tsv.gz,Jason_Momoa,81313,248125,1508,330946,155522
hdfs://spark-nn.eemcs.utwente.nl/user/s1934538/clickstream/clickstream-enwiki-2021-06.tsv.gz,List_of_awards_and_nominations_received_by_Meryl_Streep,13710,11893,255,25858,11454
hdfs://spark-nn.eemcs.utwente.nl/user/s1934538/clickstream/clickstream-enwiki-2021-06.tsv.gz,Fyre_Festival,9590,57433,561,67584,42397
hdfs://spark-nn.eemcs.utwente.nl/user/s1934538/clickstream/clickstream-enwiki-2021-06.tsv.gz,Khabib_Nurmagomedov,78748,257018,2279,338045,181385
hdfs://spark-nn.eemcs.utwente.nl/user/s1934538/clickstream/clickstream-enwiki-2021-06.tsv.gz,Joe_Biden,246586,566357,11112,824055,425358
hdfs://spark-nn.eemcs.utwente.nl/user/s1934538/clickstream/clickstream-enwiki-2021-06.tsv.gz,David_Beckham,61383,299082,2155,362620,137433
hdfs://spark-nn.eemcs.utwente.nl/user/s1934538/clickstream/clickstream-enwiki-2021-06.tsv.gz,List_of_most_popular_websites,8810,38511,94,47415,17076
hdfs://spark-nn.eemcs.utwente.nl/user/s1934538/clickstream/clickstream-enwiki-2021-06.tsv.gz,1234,91,1092,18,1201,165
hdfs://spark-nn.eemcs.utwente.nl/user/s1934538/clickstream/clickstream-enwiki-2021-06.tsv.gz,Game_of_Thrones_(season_8),19245,43551,807,63603,25186
hdfs://spark-nn.eemcs.utwente.nl/user/s1934538/clickstream/clickstream-enwiki-2021-06.tsv.gz,Richard_Ramirez,24074,244433,1617,270124,84303
hdfs://spark-nn.eemcs.utwente.nl/user/s1934538/clickstream/clickstream-enwiki-2021-06.tsv.gz,United_States_Senate,52615,50924,831,104370,53520
hdfs://spark-nn.eemcs.utwente.nl/user/s1934538/clickstream/clickstream-enwiki-2021-06.tsv.gz,Qasem_Soleimani,13375,26982,151,40508,22429
hdfs://spark-nn.eemcs.utwente.nl/user/s1934538/clickstream/clickstream-enwiki-2021-06.tsv.gz,FIFA_World_Cup,212697,868848,14271,1095816,741364
hdfs://spark-nn.eemcs.utwente.nl/user/s1934538/clickstream/clickstream-enwiki-2021-06.tsv.gz,Darth_Vader,28190,58540,799,87529,57047
hdfs://spark-nn.eemcs.utwente.nl/user/s1934538/clickstream/clickstream-enwiki-2021-06.tsv.gz,K.G.F:_Chapter_2,25514,124671,525,150710,60930
hdfs://spark-nn.eemcs.utwente.nl/user/s1934538/clickstream/clickstream-enwiki-2021-06.tsv.gz,Jimmy_Buffett,10736,63541,777,75054,28658
hdfs://spark-nn.eemcs.utwente.nl/user/s1934538/clickstream/clickstream-enwiki-2021-06.tsv.gz,Naomi_Osaka,48144,713787,6102,768033,208196
hdfs://spark-nn.eemcs.utwente.nl/user/s1934538/clickstream/clickstream-enwiki-2021-06.tsv.gz,List_of_Queen_of_the_South_episodes,46951,31836,130,78917,2550
hdfs://spark-nn.eemcs.utwente.nl/user/s1934538/clickstream/clickstream-enwiki-2021-06.tsv.gz,Sylvester_Stallone,92455,283815,2690,378960,285322
hdfs://spark-nn.eemcs.utwente.nl/user/s1934538/clickstream/clickstream-enwiki-2021-06.tsv.gz,The_Mandalorian,63167,199729,3778,266674,189445
hdfs://spark-nn.eemcs.utwente.nl/user/s1934538/clickstream/clickstream-enwiki-2021-06.tsv.gz,Priyanka_Chopra,96936,242367,1250,340553,125375
hdfs://spark-nn.eemcs.utwente.nl/user/s1934538/clickstream/clickstream-enwiki-2021-06.tsv.gz,House_of_the_Dragon,28123,35471,378,63972,56177
hdfs://spark-nn.eemcs.utwente.nl/user/s1934538/clickstream/clickstream-enwiki-2021-06.tsv.gz,R._Kelly,31361,176521,1875,209757,95383
hdfs://spark-nn.eemcs.utwente.nl/user/s1934538/clickstream/clickstream-enwiki-2021-06.tsv.gz,Atal_Bihari_Vajpayee,31439,51863,109,83411,29835
hdfs://spark-nn.eemcs.utwente.nl/user/s1934538/clickstream/clickstream-enwiki-2021-06.tsv.gz,Simple_Mail_Transfer_Protocol,3457,30497,126,34080,3550
hdfs://spark-nn.eemcs.utwente.nl/user/s1934538/clickstream/clickstream-enwiki-2021-06.tsv.gz,Crazy_Rich_Asians_(film),46340,121699,1686,169725,154572
hdfs://spark-nn.eemcs.utwente.nl/user/s1934538/clickstream/clickstream-enwiki-2021-06.tsv.gz,Elizabeth_II,487722,873460,10237,1371419,945295
hdfs://spark-nn.eemcs.utwente.nl/user/s1934538/clickstream/clickstream-enwiki-2021-06.tsv.gz,List_of_FIFA_World_Cup_finals,19801,386252,623,406676,106510
hdfs://spark-nn.eemcs.utwente.nl/user/s1934538/clickstream/clickstream-enwiki-2021-06.tsv.gz,Nipsey_Hussle,22948,94041,748,117737,37289
hdfs://spark-nn.eemcs.utwente.nl/user/s1934538/clickstream/clickstream-enwiki-2021-06.tsv.gz,Kate_Spade,27222,103596,595,131413,50790
hdfs://spark-nn.eemcs.utwente.nl/user/s1934538/clickstream/clickstream-enwiki-2021-06.tsv.gz,Once_Upon_a_Time_in_Hollywood,104748,198179,4727,307654,301826
hdfs://spark-nn.eemcs.utwente.nl/user/s1934538/clickstream/clickstream-enwiki-2021-06.tsv.gz,Notre-Dame_de_Paris,11451,61229,653,73333,18160
hdfs://spark-nn.eemcs.utwente.nl/user/s1934538/clickstream/clickstream-enwiki-2021-06.tsv.gz,When_They_See_Us,15588,29954,221,45763,20787
hdfs://spark-nn.eemcs.utwente.nl/user/s1934538/clickstream/clickstream-enwiki-2021-06.tsv.gz,Carlos_Alcaraz,5980,18511,516,25007,4154
hdfs://spark-nn.eemcs.utwente.nl/user/s1934538/clickstream/clickstream-enwiki-2021-06.tsv.gz,Vladimir_Putin,110513,466098,6580,583191,335089
hdfs://spark-nn.eemcs.utwente.nl/user/s1934538/clickstream/clickstream-enwiki-2021-06.tsv.gz,Russo-Ukrainian_War,24644,39981,129,64754,37124
hdfs://spark-nn.eemcs.utwente.nl/user/s1934538/clickstream/clickstream-enwiki-2021-06.tsv.gz,Death_of_Elisa_Lam,19383,103138,403,122924,30987
hdfs://spark-nn.eemcs.utwente.nl/user/s1934538/clickstream/clickstream-enwiki-2021-06.tsv.gz,Watts_family_murders,24638,357593,1033,383264,97543
hdfs://spark-nn.eemcs.utwente.nl/user/s1934538/clickstream/clickstream-enwiki-2021-06.tsv.gz,Lionel_Messi,210219,956807,16174,1183200,314067
hdfs://spark-nn.eemcs.utwente.nl/user/s1934538/clickstream/clickstream-enwiki-2021-06.tsv.gz,Sridevi,38446,92914,707,132067,63818
hdfs://spark-nn.eemcs.utwente.nl/user/s1934538/clickstream/clickstream-enwiki-2021-06.tsv.gz,2.0_(film),23636,40317,885,64838,22266
hdfs://spark-nn.eemcs.utwente.nl/user/s1934538/clickstream/clickstream-enwiki-2021-06.tsv.gz,Bird_Box_(film),18859,86878,1238,106975,33990
hdfs://spark-nn.eemcs.utwente.nl/user/s1934538/clickstream/clickstream-enwiki-2021-06.tsv.gz,Aquaman_(film),47646,133833,2909,184388,113213
hdfs://spark-nn.eemcs.utwente.nl/user/s1934538/clickstream/clickstream-enwiki-2021-06.tsv.gz,Keanu_Reeves,91866,408900,3154,503920,293427
hdfs://spark-nn.eemcs.utwente.nl/user/s1934538/clickstream/clickstream-enwiki-2021-06.tsv.gz,Thor:_Love_and_Thunder,180435,133630,1846,315911,264575
hdfs://spark-nn.eemcs.utwente.nl/user/s1934538/clickstream/clickstream-enwiki-2021-06.tsv.gz,Lance_Reddick,33391,67688,602,101681,23773
hdfs://spark-nn.eemcs.utwente.nl/user/s1934538/clickstream/clickstream-enwiki-2021-06.tsv.gz,Cook's_Country,388,2176,29,2593,794
hdfs://spark-nn.eemcs.utwente.nl/user/s1934538/clickstream/clickstream-enwiki-2021-06.tsv.gz,Fantastic_Beasts:_The_Crimes_of_Grindelwald,47462,53283,719,101464,62926
hdfs://spark-nn.eemcs.utwente.nl/user/s1934538/clickstream/clickstream-enwiki-2021-06.tsv.gz,Michael_Bloomberg,36907,43186,278,80371,35478
hdfs://spark-nn.eemcs.utwente.nl/user/s1934538/clickstream/clickstream-enwiki-2021-06.tsv.gz,The_Falcon_and_the_Winter_Soldier,71084,277830,5045,353959,221605
hdfs://spark-nn.eemcs.utwente.nl/user/s1934538/clickstream/clickstream-enwiki-2021-06.tsv.gz,Godzilla_vs._Kong,99851,329348,8772,437971,203008
hdfs://spark-nn.eemcs.utwente.nl/user/s1934538/clickstream/clickstream-enwiki-2021-06.tsv.gz,List_of_highest-grossing_films,123639,265955,1506,391100,199810
hdfs://spark-nn.eemcs.utwente.nl/user/s1934538/clickstream/clickstream-enwiki-2021-06.tsv.gz,Israel,123013,377026,11829,511868,318929
hdfs://spark-nn.eemcs.utwente.nl/user/s1934538/clickstream/clickstream-enwiki-2021-06.tsv.gz,2020_United_States_presidential_election,188801,329473,9087,527361,505886
hdfs://spark-nn.eemcs.utwente.nl/user/s1934538/clickstream/clickstream-enwiki-2021-06.tsv.gz,Jenna_Ortega,32619,88652,1675,122946,23858
hdfs://spark-nn.eemcs.utwente.nl/user/s1934538/clickstream/clickstream-enwiki-2021-06.tsv.gz,Elon_Musk,138690,1093168,16625,1248483,682077
hdfs://spark-nn.eemcs.utwente.nl/user/s1934538/clickstream/clickstream-enwiki-2021-06.tsv.gz,George_H._W._Bush,132965,106804,949,240718,149312
hdfs://spark-nn.eemcs.utwente.nl/user/s1934538/clickstream/clickstream-enwiki-2021-06.tsv.gz,Juice_Wrld,34946,239439,4562,278947,100587
hdfs://spark-nn.eemcs.utwente.nl/user/s1934538/clickstream/clickstream-enwiki-2021-06.tsv.gz,Google_logo,1311,2705149,15,2706475,1391
hdfs://spark-nn.eemcs.utwente.nl/user/s1934538/clickstream/clickstream-enwiki-2021-06.tsv.gz,Salman_Rushdie,31691,69922,469,102082,42671
hdfs://spark-nn.eemcs.utwente.nl/user/s1934538/clickstream/clickstream-enwiki-2021-06.tsv.gz,William_Murdoch,581,1065,22,1668,321
hdfs://spark-nn.eemcs.utwente.nl/user/s1934538/clickstream/clickstream-enwiki-2021-06.tsv.gz,Afghanistan,69933,166442,3630,240005,140467
hdfs://spark-nn.eemcs.utwente.nl/user/s1934538/clickstream/clickstream-enwiki-2021-06.tsv.gz,Naya_Rivera,75884,173639,681,250204,95057
hdfs://spark-nn.eemcs.utwente.nl/user/s1934538/clickstream/clickstream-enwiki-2021-06.tsv.gz,Us_(2019_film),28924,137609,636,167169,53157
hdfs://spark-nn.eemcs.utwente.nl/user/s1934538/clickstream/clickstream-enwiki-2021-06.tsv.gz,Spider-Man:_Far_From_Home,77897,126891,2428,207216,130041
hdfs://spark-nn.eemcs.utwente.nl/user/s1934538/clickstream/clickstream-enwiki-2021-06.tsv.gz,Ruth_Bader_Ginsburg,18803,86755,631,106189,38948
hdfs://spark-nn.eemcs.utwente.nl/user/s1934538/clickstream/clickstream-enwiki-2021-06.tsv.gz,Cecil_Hotel_(Los_Angeles),8826,124439,406,133671,32403
hdfs://spark-nn.eemcs.utwente.nl/user/s1934538/clickstream/clickstream-enwiki-2021-06.tsv.gz,Tom_Brady,48031,204407,2206,254644,100319
hdfs://spark-nn.eemcs.utwente.nl/user/s1934538/clickstream/clickstream-enwiki-2021-06.tsv.gz,Aretha_Franklin,29389,143442,1508,174339,78900
hdfs://spark-nn.eemcs.utwente.nl/user/s1934538/clickstream/clickstream-enwiki-2021-06.tsv.gz,Black_Panther_(film),61123,131083,2836,195042,128525
hdfs://spark-nn.eemcs.utwente.nl/user/s1934538/clickstream/clickstream-enwiki-2021-06.tsv.gz,Parasite_(2019_film),35772,182833,1878,220483,91795
hdfs://spark-nn.eemcs.utwente.nl/user/s1934538/clickstream/clickstream-enwiki-2021-06.tsv.gz,Pornhub,47623,230800,14081,292504,91057
hdfs://spark-nn.eemcs.utwente.nl/user/s1934538/clickstream/clickstream-enwiki-2021-06.tsv.gz,Bible,16528,3377972,1972,3396472,33458
hdfs://spark-nn.eemcs.utwente.nl/user/s1934538/clickstream/clickstream-enwiki-2021-06.tsv.gz,George_VI,364791,148691,720,514202,382509
hdfs://spark-nn.eemcs.utwente.nl/user/s1934538/clickstream/clickstream-enwiki-2021-06.tsv.gz,The_Irishman,51714,93871,2006,147591,128201
hdfs://spark-nn.eemcs.utwente.nl/user/s1934538/clickstream/clickstream-enwiki-2021-06.tsv.gz,Hamilton_(musical),65507,218069,2121,285697,191457
hdfs://spark-nn.eemcs.utwente.nl/user/s1934538/clickstream/clickstream-enwiki-2021-06.tsv.gz,Main_Page,62539,171655581,4761730,176479850,34438608
hdfs://spark-nn.eemcs.utwente.nl/user/s1934538/clickstream/clickstream-enwiki-2021-06.tsv.gz,Cameron_Boyce,37002,223647,938,261587,70820
hdfs://spark-nn.eemcs.utwente.nl/user/s1934538/clickstream/clickstream-enwiki-2021-06.tsv.gz,John_Wick:_Chapter_4,18267,1053,156,19476,2868
hdfs://spark-nn.eemcs.utwente.nl/user/s1934538/clickstream/clickstream-enwiki-2021-06.tsv.gz,Bonnie_and_Clyde,26013,238105,1478,265596,64996
hdfs://spark-nn.eemcs.utwente.nl/user/s1934538/clickstream/clickstream-enwiki-2021-06.tsv.gz,Jimmy_Hoffa,30527,106689,943,138159,55029
hdfs://spark-nn.eemcs.utwente.nl/user/s1934538/clickstream/clickstream-enwiki-2021-06.tsv.gz,Roe_v._Wade,10785,58451,483,69719,22155
hdfs://spark-nn.eemcs.utwente.nl/user/s1934538/clickstream/clickstream-enwiki-2021-06.tsv.gz,Mac_Miller,31082,170361,1221,202664,62439
hdfs://spark-nn.eemcs.utwente.nl/user/s1934538/clickstream/clickstream-enwiki-2021-06.tsv.gz,2018_Asian_Games,12367,10922,129,23418,23330
hdfs://spark-nn.eemcs.utwente.nl/user/s1934538/clickstream/clickstream-enwiki-2021-06.tsv.gz,Stephen_Hawking,35574,446164,3020,484758,205707
hdfs://spark-nn.eemcs.utwente.nl/user/s1934538/clickstream/clickstream-enwiki-2021-06.tsv.gz,List_of_James_Bond_films,61939,342947,634,405520,259786
hdfs://spark-nn.eemcs.utwente.nl/user/s1934538/clickstream/clickstream-enwiki-2021-06.tsv.gz,The_Flash_(film),75610,72124,954,148688,127547
hdfs://spark-nn.eemcs.utwente.nl/user/s1934538/clickstream/clickstream-enwiki-2021-06.tsv.gz,Michael_Jordan,116193,501089,5160,622442,231401
hdfs://spark-nn.eemcs.utwente.nl/user/s1934538/clickstream/clickstream-enwiki-2021-06.tsv.gz,Zack_Snyder's_Justice_League,100676,209635,2551,312862,166627
hdfs://spark-nn.eemcs.utwente.nl/user/s1934538/clickstream/clickstream-enwiki-2021-06.tsv.gz,Hyphen-minus,824,6451675,19970,6472469,734
hdfs://spark-nn.eemcs.utwente.nl/user/s1934538/clickstream/clickstream-enwiki-2021-06.tsv.gz,The_Witcher_(TV_series),30564,153661,3962,188187,107587
hdfs://spark-nn.eemcs.utwente.nl/user/s1934538/clickstream/clickstream-enwiki-2021-06.tsv.gz,1917_(2019_film),23863,87378,1609,112850,65479
hdfs://spark-nn.eemcs.utwente.nl/user/s1934538/clickstream/clickstream-enwiki-2021-06.tsv.gz,Laal_Singh_Chaddha,45097,48040,22,93159,49324
hdfs://spark-nn.eemcs.utwente.nl/user/s1934538/clickstream/clickstream-enwiki-2021-06.tsv.gz,Royal_Rumble_(2018),6564,4225,69,10858,7822
hdfs://spark-nn.eemcs.utwente.nl/user/s1934538/clickstream/clickstream-enwiki-2021-06.tsv.gz,Jeffrey_Epstein,66583,291592,2923,361098,159754
hdfs://spark-nn.eemcs.utwente.nl/user/s1934538/clickstream/clickstream-enwiki-2021-06.tsv.gz,Taliban,41276,149207,1884,192367,132114
hdfs://spark-nn.eemcs.utwente.nl/user/s1934538/clickstream/clickstream-enwiki-2021-06.tsv.gz,Luke_Perry,44586,134398,814,179798,63651
hdfs://spark-nn.eemcs.utwente.nl/user/s1934538/clickstream/clickstream-enwiki-2021-06.tsv.gz,Anne_Heche,23477,46041,221,69739,23417
hdfs://spark-nn.eemcs.utwente.nl/user/s1934538/clickstream/clickstream-enwiki-2021-06.tsv.gz,Elliot_Page,84827,304518,2134,391479,144238
hdfs://spark-nn.eemcs.utwente.nl/user/s1934538/clickstream/clickstream-enwiki-2021-06.tsv.gz,Lists_of_deaths_by_year,2857,179974,822,183653,200118
hdfs://spark-nn.eemcs.utwente.nl/user/s1934538/clickstream/clickstream-enwiki-2021-06.tsv.gz,XHamster,7483,169813,5411,182707,24378
hdfs://spark-nn.eemcs.utwente.nl/user/s1934538/clickstream/clickstream-enwiki-2021-06.tsv.gz,Puneeth_Rajkumar,13400,27263,529,41192,28177
hdfs://spark-nn.eemcs.utwente.nl/user/s1934538/clickstream/clickstream-enwiki-2021-06.tsv.gz,Dennis_Nilsen,10896,58871,397,70164,19047
hdfs://spark-nn.eemcs.utwente.nl/user/s1934538/clickstream/clickstream-enwiki-2021-06.tsv.gz,Black_Widow_(2021_film),147611,532932,23933,704476,324227
hdfs://spark-nn.eemcs.utwente.nl/user/s1934538/clickstream/clickstream-enwiki-2021-06.tsv.gz,Kamala_Harris,109078,307394,3402,419874,198935
hdfs://spark-nn.eemcs.utwente.nl/user/s1934538/clickstream/clickstream-enwiki-2021-06.tsv.gz,Indian_Premier_League,12273,52618,127,65018,37151
hdfs://spark-nn.eemcs.utwente.nl/user/s1934538/clickstream/clickstream-enwiki-2021-06.tsv.gz,Matthew_Perry,180319,722345,4080,906744,454003
hdfs://spark-nn.eemcs.utwente.nl/user/s1934538/clickstream/clickstream-enwiki-2021-06.tsv.gz,War_(2019_film),18165,65523,256,83944,24224
hdfs://spark-nn.eemcs.utwente.nl/user/s1934538/clickstream/clickstream-enwiki-2021-06.tsv.gz,WrestleMania_34,13745,7010,133,20888,14295
hdfs://spark-nn.eemcs.utwente.nl/user/s1934538/clickstream/clickstream-enwiki-2021-06.tsv.gz,Brett_Kavanaugh,19601,28781,184,48566,17225
hdfs://spark-nn.eemcs.utwente.nl/user/s1934538/clickstream/clickstream-enwiki-2021-06.tsv.gz,Joe_Exotic,16297,91879,826,109002,31381
hdfs://spark-nn.eemcs.utwente.nl/user/s1934538/clickstream/clickstream-enwiki-2021-06.tsv.gz,COVID-19_pandemic,383078,505196,2257,890531,440020
hdfs://spark-nn.eemcs.utwente.nl/user/s1934538/clickstream/clickstream-enwiki-2021-06.tsv.gz,Cardi_B,59646,298484,5314,363444,136480
hdfs://spark-nn.eemcs.utwente.nl/user/s1934538/clickstream/clickstream-enwiki-2021-06.tsv.gz,Article_370_of_the_Constitution_of_India,3895,62299,47,66241,4413
hdfs://spark-nn.eemcs.utwente.nl/user/s1934538/clickstream/clickstream-enwiki-2021-06.tsv.gz,2020_Summer_Olympics,211915,679309,27344,918568,953096
hdfs://spark-nn.eemcs.utwente.nl/user/s1934538/clickstream/clickstream-enwiki-2021-06.tsv.gz,Stranger_Things_(season_4),39688,174247,1164,215099,115696
hdfs://spark-nn.eemcs.utwente.nl/user/s1934538/clickstream/clickstream-enwiki-2021-06.tsv.gz,United_States_Electoral_College,10854,30784,81,41719,6649
hdfs://spark-nn.eemcs.utwente.nl/user/s1934538/clickstream/clickstream-enwiki-2021-06.tsv.gz,Rami_Malek,71873,180436,806,253115,103137
hdfs://spark-nn.eemcs.utwente.nl/user/s1934538/clickstream/clickstream-enwiki-2021-06.tsv.gz,Venom_(2018_film),23807,90449,1262,115518,59894
hdfs://spark-nn.eemcs.utwente.nl/user/s1934538/clickstream/clickstream-enwiki-2021-06.tsv.gz,The_Umbrella_Academy_(TV_series),29985,140788,2697,173470,95594
hdfs://spark-nn.eemcs.utwente.nl/user/s1934538/clickstream/clickstream-enwiki-2021-06.tsv.gz,Kylian_Mbappé,78084,654604,6010,738698,149835
hdfs://spark-nn.eemcs.utwente.nl/user/s1934538/clickstream/clickstream-enwiki-2021-06.tsv.gz,Antifa_(United_States),12835,79067,365,92267,21498
hdfs://spark-nn.eemcs.utwente.nl/user/s1934538/clickstream/clickstream-enwiki-2021-06.tsv.gz,Aaron_Hernandez,12775,97480,443,110698,37081
hdfs://spark-nn.eemcs.utwente.nl/user/s1934538/clickstream/clickstream-enwiki-2021-06.tsv.gz,2018_FIFA_World_Cup,400280,734188,12792,1147260,534946
hdfs://spark-nn.eemcs.utwente.nl/user/s1934538/clickstream/clickstream-enwiki-2021-11.tsv.gz,Spanish_flu,31586,244052,3879,279517,62695
hdfs://spark-nn.eemcs.utwente.nl/user/s1934538/clickstream/clickstream-enwiki-2021-11.tsv.gz,United_States_Senate,49683,58295,852,108830,51765
hdfs://spark-nn.eemcs.utwente.nl/user/s1934538/clickstream/clickstream-enwiki-2021-11.tsv.gz,2.0_(film),27422,34763,79,62264,21272
hdfs://spark-nn.eemcs.utwente.nl/user/s1934538/clickstream/clickstream-enwiki-2021-11.tsv.gz,Michael_Jordan,79051,374020,4003,457074,158476
hdfs://spark-nn.eemcs.utwente.nl/user/s1934538/clickstream/clickstream-enwiki-2021-11.tsv.gz,Eternals_(film),582199,4075519,105625,4763343,4633346
hdfs://spark-nn.eemcs.utwente.nl/user/s1934538/clickstream/clickstream-enwiki-2021-11.tsv.gz,Venom_(2018_film),68217,252411,2488,323116,142684
hdfs://spark-nn.eemcs.utwente.nl/user/s1934538/clickstream/clickstream-enwiki-2021-11.tsv.gz,Jason_Momoa,97212,288488,2242,387942,171608
hdfs://spark-nn.eemcs.utwente.nl/user/s1934538/clickstream/clickstream-enwiki-2021-11.tsv.gz,Valentine's_Day,3531,38014,246,41791,3974
hdfs://spark-nn.eemcs.utwente.nl/user/s1934538/clickstream/clickstream-enwiki-2021-11.tsv.gz,Key_frame,453,5411,15,5879,320
hdfs://spark-nn.eemcs.utwente.nl/user/s1934538/clickstream/clickstream-enwiki-2021-11.tsv.gz,Ant-Man_and_the_Wasp:_Quantumania,96996,31329,234,128559,81031
hdfs://spark-nn.eemcs.utwente.nl/user/s1934538/clickstream/clickstream-enwiki-2021-11.tsv.gz,Chadwick_Boseman,57898,248826,1632,308356,81547
hdfs://spark-nn.eemcs.utwente.nl/user/s1934538/clickstream/clickstream-enwiki-2021-11.tsv.gz,Qasem_Soleimani,11662,16927,114,28703,15563
hdfs://spark-nn.eemcs.utwente.nl/user/s1934538/clickstream/clickstream-enwiki-2021-11.tsv.gz,"Prince_Philip,_Duke_of_Edinburgh",184010,198837,1997,384844,220776
hdfs://spark-nn.eemcs.utwente.nl/user/s1934538/clickstream/clickstream-enwiki-2021-11.tsv.gz,Khabib_Nurmagomedov,74201,217210,2600,294011,157727
hdfs://spark-nn.eemcs.utwente.nl/user/s1934538/clickstream/clickstream-enwiki-2021-11.tsv.gz,Ray_Liotta,38976,77363,716,117055,40589
hdfs://spark-nn.eemcs.utwente.nl/user/s1934538/clickstream/clickstream-enwiki-2021-11.tsv.gz,Avicii,20998,190972,1525,213495,66140
hdfs://spark-nn.eemcs.utwente.nl/user/s1934538/clickstream/clickstream-enwiki-2021-11.tsv.gz,Bob_Saget,16674,31562,386,48622,11575
hdfs://spark-nn.eemcs.utwente.nl/user/s1934538/clickstream/clickstream-enwiki-2021-11.tsv.gz,"Diana,_Princess_of_Wales",181172,496338,4618,682128,434530
hdfs://spark-nn.eemcs.utwente.nl/user/s1934538/clickstream/clickstream-enwiki-2021-11.tsv.gz,William_Murdoch,568,1260,14,1842,295
hdfs://spark-nn.eemcs.utwente.nl/user/s1934538/clickstream/clickstream-enwiki-2021-11.tsv.gz,Bible,15571,4260721,1830,4278122,33139
hdfs://spark-nn.eemcs.utwente.nl/user/s1934538/clickstream/clickstream-enwiki-2021-11.tsv.gz,Matthew_Perry,44556,101577,613,146746,77959
hdfs://spark-nn.eemcs.utwente.nl/user/s1934538/clickstream/clickstream-enwiki-2021-11.tsv.gz,Darth_Vader,24249,61046,583,85878,47644
hdfs://spark-nn.eemcs.utwente.nl/user/s1934538/clickstream/clickstream-enwiki-2021-11.tsv.gz,Rishi_Sunak,15221,58244,396,73861,31897
hdfs://spark-nn.eemcs.utwente.nl/user/s1934538/clickstream/clickstream-enwiki-2021-11.tsv.gz,Black_Widow_(2021_film),117764,339599,6758,464121,328018
hdfs://spark-nn.eemcs.utwente.nl/user/s1934538/clickstream/clickstream-enwiki-2021-11.tsv.gz,Don't_Look_Up_(2021_film),124124,259286,4596,388006,163967
hdfs://spark-nn.eemcs.utwente.nl/user/s1934538/clickstream/clickstream-enwiki-2021-11.tsv.gz,Luke_Perry,35120,119760,469,155349,57545
hdfs://spark-nn.eemcs.utwente.nl/user/s1934538/clickstream/clickstream-enwiki-2021-11.tsv.gz,Tasuku_Honjo,687,99922,37,100646,3369
hdfs://spark-nn.eemcs.utwente.nl/user/s1934538/clickstream/clickstream-enwiki-2021-11.tsv.gz,Jeffrey_Epstein,81798,375551,3184,460533,220495
hdfs://spark-nn.eemcs.utwente.nl/user/s1934538/clickstream/clickstream-enwiki-2021-11.tsv.gz,Cleopatra,78869,4505122,2991,4586982,400188
hdfs://spark-nn.eemcs.utwente.nl/user/s1934538/clickstream/clickstream-enwiki-2021-11.tsv.gz,Indian_Premier_League,30700,117724,247,148671,83856
hdfs://spark-nn.eemcs.utwente.nl/user/s1934538/clickstream/clickstream-enwiki-2021-11.tsv.gz,David_Beckham,38792,169427,1417,209636,72817
hdfs://spark-nn.eemcs.utwente.nl/user/s1934538/clickstream/clickstream-enwiki-2021-11.tsv.gz,Elliot_Page,63961,282926,1604,348491,141603
hdfs://spark-nn.eemcs.utwente.nl/user/s1934538/clickstream/clickstream-enwiki-2021-11.tsv.gz,Michael_Bloomberg,34224,33644,238,68106,30428
hdfs://spark-nn.eemcs.utwente.nl/user/s1934538/clickstream/clickstream-enwiki-2021-11.tsv.gz,List_of_awards_and_nominations_received_by_Meryl_Streep,9143,7426,144,16713,6696
hdfs://spark-nn.eemcs.utwente.nl/user/s1934538/clickstream/clickstream-enwiki-2021-11.tsv.gz,Wikipedia,209319,735587,1337,946243,268473
hdfs://spark-nn.eemcs.utwente.nl/user/s1934538/clickstream/clickstream-enwiki-2021-11.tsv.gz,Cardi_B,36025,284216,4163,324404,99882
hdfs://spark-nn.eemcs.utwente.nl/user/s1934538/clickstream/clickstream-enwiki-2021-11.tsv.gz,The_Umbrella_Academy_(TV_series),62878,100755,1982,165615,78065
hdfs://spark-nn.eemcs.utwente.nl/user/s1934538/clickstream/clickstream-enwiki-2021-11.tsv.gz,"Meghan,_Duchess_of_Sussex",76765,225505,1622,303892,166453
hdfs://spark-nn.eemcs.utwente.nl/user/s1934538/clickstream/clickstream-enwiki-2021-11.tsv.gz,Ruth_Bader_Ginsburg,15887,71016,570,87473,29491
hdfs://spark-nn.eemcs.utwente.nl/user/s1934538/clickstream/clickstream-enwiki-2021-11.tsv.gz,Taliban,36915,95912,1278,134105,78658
hdfs://spark-nn.eemcs.utwente.nl/user/s1934538/clickstream/clickstream-enwiki-2021-11.tsv.gz,Brett_Kavanaugh,18894,38461,281,57636,17620
hdfs://spark-nn.eemcs.utwente.nl/user/s1934538/clickstream/clickstream-enwiki-2021-11.tsv.gz,UEFA_Euro_2020,49168,90632,1992,141792,72671
hdfs://spark-nn.eemcs.utwente.nl/user/s1934538/clickstream/clickstream-enwiki-2021-11.tsv.gz,Anthony_Bourdain,17493,206396,1620,225509,68323
hdfs://spark-nn.eemcs.utwente.nl/user/s1934538/clickstream/clickstream-enwiki-2021-11.tsv.gz,Mulan_(2020_film),17961,49019,820,67800,38507
hdfs://spark-nn.eemcs.utwente.nl/user/s1934538/clickstream/clickstream-enwiki-2021-11.tsv.gz,Glass_(2019_film),33088,41171,344,74603,25466
hdfs://spark-nn.eemcs.utwente.nl/user/s1934538/clickstream/clickstream-enwiki-2021-11.tsv.gz,Donald_Trump,200312,409034,7386,616732,348582
hdfs://spark-nn.eemcs.utwente.nl/user/s1934538/clickstream/clickstream-enwiki-2021-11.tsv.gz,J._Robert_Oppenheimer,33464,151483,480,185427,65729
hdfs://spark-nn.eemcs.utwente.nl/user/s1934538/clickstream/clickstream-enwiki-2021-11.tsv.gz,Gaza_Strip,12200,23469,145,35814,12864
hdfs://spark-nn.eemcs.utwente.nl/user/s1934538/clickstream/clickstream-enwiki-2021-11.tsv.gz,Sinéad_O'Connor,15751,63151,536,79438,25222
hdfs://spark-nn.eemcs.utwente.nl/user/s1934538/clickstream/clickstream-enwiki-2021-11.tsv.gz,Tonya_Harding,23504,127748,774,152026,40731
hdfs://spark-nn.eemcs.utwente.nl/user/s1934538/clickstream/clickstream-enwiki-2021-11.tsv.gz,Chernobyl_(miniseries),22403,80815,1731,104949,92356
hdfs://spark-nn.eemcs.utwente.nl/user/s1934538/clickstream/clickstream-enwiki-2021-11.tsv.gz,RRR_(film),58244,323838,1356,383438,240007
hdfs://spark-nn.eemcs.utwente.nl/user/s1934538/clickstream/clickstream-enwiki-2021-11.tsv.gz,2016_United_States_presidential_election,109183,83356,1167,193706,164522
hdfs://spark-nn.eemcs.utwente.nl/user/s1934538/clickstream/clickstream-enwiki-2021-11.tsv.gz,Fyre_Festival,8496,50681,554,59731,36409
hdfs://spark-nn.eemcs.utwente.nl/user/s1934538/clickstream/clickstream-enwiki-2021-11.tsv.gz,Joe_Exotic,76724,492830,2694,572248,229953
hdfs://spark-nn.eemcs.utwente.nl/user/s1934538/clickstream/clickstream-enwiki-2021-11.tsv.gz,Simone_Biles,7427,40980,988,49395,13021
hdfs://spark-nn.eemcs.utwente.nl/user/s1934538/clickstream/clickstream-enwiki-2021-11.tsv.gz,Louis_Tomlinson,30190,63537,336,94063,23582
hdfs://spark-nn.eemcs.utwente.nl/user/s1934538/clickstream/clickstream-enwiki-2021-11.tsv.gz,Queen_(band),71781,240050,3773,315604,295836
hdfs://spark-nn.eemcs.utwente.nl/user/s1934538/clickstream/clickstream-enwiki-2021-11.tsv.gz,Central_Park_jogger_case,12199,76206,236,88641,9858
hdfs://spark-nn.eemcs.utwente.nl/user/s1934538/clickstream/clickstream-enwiki-2021-11.tsv.gz,Sushant_Singh_Rajput,23033,97776,270,121079,48534
hdfs://spark-nn.eemcs.utwente.nl/user/s1934538/clickstream/clickstream-enwiki-2021-11.tsv.gz,Guardians_of_the_Galaxy_Vol._3,106077,45352,657,152086,106150
hdfs://spark-nn.eemcs.utwente.nl/user/s1934538/clickstream/clickstream-enwiki-2021-11.tsv.gz,Spider-Man:_No_Way_Home,379369,1472000,36686,1888055,1083445
hdfs://spark-nn.eemcs.utwente.nl/user/s1934538/clickstream/clickstream-enwiki-2021-11.tsv.gz,JSON_Web_Token,707,27571,48,28326,2105
hdfs://spark-nn.eemcs.utwente.nl/user/s1934538/clickstream/clickstream-enwiki-2021-11.tsv.gz,Deadpool_2,49165,53040,1238,103443,73029
hdfs://spark-nn.eemcs.utwente.nl/user/s1934538/clickstream/clickstream-enwiki-2021-11.tsv.gz,List_of_highest-grossing_Indian_films,59918,197434,529,257881,138603
hdfs://spark-nn.eemcs.utwente.nl/user/s1934538/clickstream/clickstream-enwiki-2021-11.tsv.gz,XXXTentacion,78930,602184,5848,686962,114441
hdfs://spark-nn.eemcs.utwente.nl/user/s1934538/clickstream/clickstream-enwiki-2021-11.tsv.gz,Top_Gun:_Maverick,58410,78095,1722,138227,80900
hdfs://spark-nn.eemcs.utwente.nl/user/s1934538/clickstream/clickstream-enwiki-2021-11.tsv.gz,COVID-19_pandemic_by_country_and_territory,70589,197777,3505,271871,165109
hdfs://spark-nn.eemcs.utwente.nl/user/s1934538/clickstream/clickstream-enwiki-2021-11.tsv.gz,Laal_Singh_Chaddha,48915,86526,146,135587,77556
hdfs://spark-nn.eemcs.utwente.nl/user/s1934538/clickstream/clickstream-enwiki-2021-11.tsv.gz,"Citizenship_(Amendment)_Act,_2019",3344,25780,21,29145,3314
hdfs://spark-nn.eemcs.utwente.nl/user/s1934538/clickstream/clickstream-enwiki-2021-11.tsv.gz,Shang-Chi_and_the_Legend_of_the_Ten_Rings,401003,2007620,38245,2446868,2061707
hdfs://spark-nn.eemcs.utwente.nl/user/s1934538/clickstream/clickstream-enwiki-2021-11.tsv.gz,Lionel_Messi,129099,731522,7868,868489,189561
hdfs://spark-nn.eemcs.utwente.nl/user/s1934538/clickstream/clickstream-enwiki-2021-11.tsv.gz,The_Sandman_(TV_series),22051,30194,370,52615,38716
hdfs://spark-nn.eemcs.utwente.nl/user/s1934538/clickstream/clickstream-enwiki-2021-11.tsv.gz,Saaho,15607,36055,232,51894,18012
hdfs://spark-nn.eemcs.utwente.nl/user/s1934538/clickstream/clickstream-enwiki-2021-11.tsv.gz,Grimes_(musician),211715,164837,866,377418,105417
hdfs://spark-nn.eemcs.utwente.nl/user/s1934538/clickstream/clickstream-enwiki-2021-11.tsv.gz,List_of_James_Bond_films,184645,1102634,1334,1288613,784985
hdfs://spark-nn.eemcs.utwente.nl/user/s1934538/clickstream/clickstream-enwiki-2021-11.tsv.gz,Bonnie_and_Clyde,19241,164843,1326,185410,47243
hdfs://spark-nn.eemcs.utwente.nl/user/s1934538/clickstream/clickstream-enwiki-2021-11.tsv.gz,Deion_Sanders,14421,221384,1214,237019,56425
hdfs://spark-nn.eemcs.utwente.nl/user/s1934538/clickstream/clickstream-enwiki-2021-11.tsv.gz,Henry_V_of_England,130281,226176,718,357175,254634
hdfs://spark-nn.eemcs.utwente.nl/user/s1934538/clickstream/clickstream-enwiki-2021-11.tsv.gz,Israel,70508,213935,4558,289001,137132
hdfs://spark-nn.eemcs.utwente.nl/user/s1934538/clickstream/clickstream-enwiki-2021-11.tsv.gz,Joe_Biden,195641,546678,10902,753221,343785
hdfs://spark-nn.eemcs.utwente.nl/user/s1934538/clickstream/clickstream-enwiki-2021-11.tsv.gz,Olivia_Newton-John,23306,79383,1207,103896,45511
hdfs://spark-nn.eemcs.utwente.nl/user/s1934538/clickstream/clickstream-enwiki-2021-11.tsv.gz,No_Time_to_Die,377264,1981187,39134,2397585,1617785
hdfs://spark-nn.eemcs.utwente.nl/user/s1934538/clickstream/clickstream-enwiki-2021-11.tsv.gz,List_of_FIFA_World_Cup_finals,2638,62528,50,65216,17303
hdfs://spark-nn.eemcs.utwente.nl/user/s1934538/clickstream/clickstream-enwiki-2021-11.tsv.gz,The_Lion_King_(2019_film),35369,42317,503,78189,39255
hdfs://spark-nn.eemcs.utwente.nl/user/s1934538/clickstream/clickstream-enwiki-2021-11.tsv.gz,COVID-19_pandemic,278271,345315,1807,625393,283578
hdfs://spark-nn.eemcs.utwente.nl/user/s1934538/clickstream/clickstream-enwiki-2021-11.tsv.gz,Fantastic_Beasts:_The_Crimes_of_Grindelwald,53961,65494,783,120238,71626
hdfs://spark-nn.eemcs.utwente.nl/user/s1934538/clickstream/clickstream-enwiki-2021-11.tsv.gz,Kamala_Harris,92817,316472,3439,412728,173381
hdfs://spark-nn.eemcs.utwente.nl/user/s1934538/clickstream/clickstream-enwiki-2021-11.tsv.gz,Aretha_Franklin,32128,247233,1695,281056,127047
hdfs://spark-nn.eemcs.utwente.nl/user/s1934538/clickstream/clickstream-enwiki-2021-11.tsv.gz,Charles_III,99,196,68,363,318
hdfs://spark-nn.eemcs.utwente.nl/user/s1934538/clickstream/clickstream-enwiki-2021-11.tsv.gz,The_Haunting_of_Bly_Manor,48025,95813,1094,144932,74206
hdfs://spark-nn.eemcs.utwente.nl/user/s1934538/clickstream/clickstream-enwiki-2021-11.tsv.gz,Cameron_Boyce,28554,163210,577,192341,49619
hdfs://spark-nn.eemcs.utwente.nl/user/s1934538/clickstream/clickstream-enwiki-2021-11.tsv.gz,Grover,1434,4787,69,6290,1350
hdfs://spark-nn.eemcs.utwente.nl/user/s1934538/clickstream/clickstream-enwiki-2021-11.tsv.gz,2023_Cricket_World_Cup,56633,274844,269,331746,76178
hdfs://spark-nn.eemcs.utwente.nl/user/s1934538/clickstream/clickstream-enwiki-2021-11.tsv.gz,Croatia,41956,119124,1910,162990,59038
hdfs://spark-nn.eemcs.utwente.nl/user/s1934538/clickstream/clickstream-enwiki-2021-11.tsv.gz,Stranger_Things_(season_3),28460,44330,635,73425,38874
hdfs://spark-nn.eemcs.utwente.nl/user/s1934538/clickstream/clickstream-enwiki-2021-11.tsv.gz,K.G.F:_Chapter_2,27340,88928,334,116602,45348
hdfs://spark-nn.eemcs.utwente.nl/user/s1934538/clickstream/clickstream-enwiki-2021-11.tsv.gz,George_H._W._Bush,121267,94205,686,216158,128322
hdfs://spark-nn.eemcs.utwente.nl/user/s1934538/clickstream/clickstream-enwiki-2021-11.tsv.gz,Army_of_the_Dead,240515,459997,4044,704556,419838
hdfs://spark-nn.eemcs.utwente.nl/user/s1934538/clickstream/clickstream-enwiki-2021-11.tsv.gz,Google_logo,635,24551,121,25307,914
hdfs://spark-nn.eemcs.utwente.nl/user/s1934538/clickstream/clickstream-enwiki-2021-11.tsv.gz,Once_Upon_a_Time_in_Hollywood,94005,146822,2423,243250,220366
hdfs://spark-nn.eemcs.utwente.nl/user/s1934538/clickstream/clickstream-enwiki-2021-11.tsv.gz,Game_of_Thrones_(season_8),14675,36657,611,51943,18260
hdfs://spark-nn.eemcs.utwente.nl/user/s1934538/clickstream/clickstream-enwiki-2021-11.tsv.gz,The_Irishman,49372,89369,2069,140810,120339
hdfs://spark-nn.eemcs.utwente.nl/user/s1934538/clickstream/clickstream-enwiki-2021-11.tsv.gz,Avengers:_Endgame,114241,171020,3105,288366,165358
hdfs://spark-nn.eemcs.utwente.nl/user/s1934538/clickstream/clickstream-enwiki-2021-11.tsv.gz,Anne_Heche,25752,59454,354,85560,28014
hdfs://spark-nn.eemcs.utwente.nl/user/s1934538/clickstream/clickstream-enwiki-2021-11.tsv.gz,XHamster,11204,249793,5957,266954,26717
hdfs://spark-nn.eemcs.utwente.nl/user/s1934538/clickstream/clickstream-enwiki-2021-11.tsv.gz,Stan_Lee,51246,194181,1179,246606,57942
hdfs://spark-nn.eemcs.utwente.nl/user/s1934538/clickstream/clickstream-enwiki-2021-11.tsv.gz,List_of_Marvel_Cinematic_Universe_films,397550,726036,2814,1126400,698243
hdfs://spark-nn.eemcs.utwente.nl/user/s1934538/clickstream/clickstream-enwiki-2021-11.tsv.gz,Cook's_Country,443,2276,21,2740,820
hdfs://spark-nn.eemcs.utwente.nl/user/s1934538/clickstream/clickstream-enwiki-2021-11.tsv.gz,Donald_Glover,38569,105063,754,144386,59055
hdfs://spark-nn.eemcs.utwente.nl/user/s1934538/clickstream/clickstream-enwiki-2021-11.tsv.gz,Watts_family_murders,10736,121544,308,132588,32092
hdfs://spark-nn.eemcs.utwente.nl/user/s1934538/clickstream/clickstream-enwiki-2021-11.tsv.gz,Eddie_Van_Halen,33982,63681,670,98333,37829
hdfs://spark-nn.eemcs.utwente.nl/user/s1934538/clickstream/clickstream-enwiki-2021-11.tsv.gz,Shinzo_Abe,30672,26947,276,57895,30426
hdfs://spark-nn.eemcs.utwente.nl/user/s1934538/clickstream/clickstream-enwiki-2021-11.tsv.gz,Puneeth_Rajkumar,107868,1006081,12791,1126740,593333
hdfs://spark-nn.eemcs.utwente.nl/user/s1934538/clickstream/clickstream-enwiki-2021-11.tsv.gz,Amy_Coney_Barrett,20387,28003,199,48589,17718
hdfs://spark-nn.eemcs.utwente.nl/user/s1934538/clickstream/clickstream-enwiki-2021-11.tsv.gz,The_Kashmir_Files,5289,7889,11,13189,5886
hdfs://spark-nn.eemcs.utwente.nl/user/s1934538/clickstream/clickstream-enwiki-2021-11.tsv.gz,Mac_Miller,35830,193783,1499,231112,68110
hdfs://spark-nn.eemcs.utwente.nl/user/s1934538/clickstream/clickstream-enwiki-2021-11.tsv.gz,Stephen_Hawking,26835,341633,2291,370759,135618
hdfs://spark-nn.eemcs.utwente.nl/user/s1934538/clickstream/clickstream-enwiki-2021-11.tsv.gz,Irrfan_Khan,31794,53468,78,85340,32159
hdfs://spark-nn.eemcs.utwente.nl/user/s1934538/clickstream/clickstream-enwiki-2021-11.tsv.gz,List_of_highest-grossing_films,118233,242591,1385,362209,191572
hdfs://spark-nn.eemcs.utwente.nl/user/s1934538/clickstream/clickstream-enwiki-2021-11.tsv.gz,Captain_Marvel_(film),50044,91807,1572,143423,74880
hdfs://spark-nn.eemcs.utwente.nl/user/s1934538/clickstream/clickstream-enwiki-2021-11.tsv.gz,Coronavirus,15646,124722,2910,143278,42882
hdfs://spark-nn.eemcs.utwente.nl/user/s1934538/clickstream/clickstream-enwiki-2021-11.tsv.gz,Vladimir_Putin,81017,206277,3317,290611,175923
hdfs://spark-nn.eemcs.utwente.nl/user/s1934538/clickstream/clickstream-enwiki-2021-11.tsv.gz,Parasite_(2019_film),31361,192279,2526,226166,91860
hdfs://spark-nn.eemcs.utwente.nl/user/s1934538/clickstream/clickstream-enwiki-2021-11.tsv.gz,Richard_Ramirez,17930,180958,1269,200157,48659
hdfs://spark-nn.eemcs.utwente.nl/user/s1934538/clickstream/clickstream-enwiki-2021-11.tsv.gz,Shakira,19525,144868,1749,166142,73143
hdfs://spark-nn.eemcs.utwente.nl/user/s1934538/clickstream/clickstream-enwiki-2021-11.tsv.gz,ICC_Men's_T20_World_Cup,139826,1702746,5760,1848332,599112
hdfs://spark-nn.eemcs.utwente.nl/user/s1934538/clickstream/clickstream-enwiki-2021-11.tsv.gz,Adipurush,48801,26238,14,75053,55863
hdfs://spark-nn.eemcs.utwente.nl/user/s1934538/clickstream/clickstream-enwiki-2021-11.tsv.gz,Rami_Malek,120896,356019,1588,478503,199926
hdfs://spark-nn.eemcs.utwente.nl/user/s1934538/clickstream/clickstream-enwiki-2021-11.tsv.gz,WrestleMania_34,11842,5640,103,17585,11473
hdfs://spark-nn.eemcs.utwente.nl/user/s1934538/clickstream/clickstream-enwiki-2021-11.tsv.gz,The_Matrix_Resurrections,153791,239762,7041,400594,291443
hdfs://spark-nn.eemcs.utwente.nl/user/s1934538/clickstream/clickstream-enwiki-2021-11.tsv.gz,Amber_Heard,108462,139829,756,249047,100876
hdfs://spark-nn.eemcs.utwente.nl/user/s1934538/clickstream/clickstream-enwiki-2021-11.tsv.gz,Stranger_Things,87904,286395,6540,380839,320756
hdfs://spark-nn.eemcs.utwente.nl/user/s1934538/clickstream/clickstream-enwiki-2021-11.tsv.gz,Game_of_Thrones,71933,252709,6954,331596,220046
hdfs://spark-nn.eemcs.utwente.nl/user/s1934538/clickstream/clickstream-enwiki-2021-11.tsv.gz,Adele,161221,2806780,30294,2998295,1076122
hdfs://spark-nn.eemcs.utwente.nl/user/s1934538/clickstream/clickstream-enwiki-2021-11.tsv.gz,QAnon,46346,348512,8887,403745,98811
hdfs://spark-nn.eemcs.utwente.nl/user/s1934538/clickstream/clickstream-enwiki-2021-11.tsv.gz,Loki_(TV_series),45480,156119,3236,204835,113771
hdfs://spark-nn.eemcs.utwente.nl/user/s1934538/clickstream/clickstream-enwiki-2021-11.tsv.gz,Joker_(2019_film),48928,164749,2384,216061,99104
hdfs://spark-nn.eemcs.utwente.nl/user/s1934538/clickstream/clickstream-enwiki-2021-11.tsv.gz,Betty_White,45344,337886,4305,387535,127072
hdfs://spark-nn.eemcs.utwente.nl/user/s1934538/clickstream/clickstream-enwiki-2021-11.tsv.gz,Godzilla_vs._Kong,59250,86294,1852,147396,71626
hdfs://spark-nn.eemcs.utwente.nl/user/s1934538/clickstream/clickstream-enwiki-2021-11.tsv.gz,The_Last_of_Us_(TV_series),23848,37253,253,61354,47982
hdfs://spark-nn.eemcs.utwente.nl/user/s1934538/clickstream/clickstream-enwiki-2021-11.tsv.gz,The_Weeknd,68966,209587,2600,281153,118340
hdfs://spark-nn.eemcs.utwente.nl/user/s1934538/clickstream/clickstream-enwiki-2021-11.tsv.gz,Lists_of_deaths_by_year,2933,131524,734,135191,147045
hdfs://spark-nn.eemcs.utwente.nl/user/s1934538/clickstream/clickstream-enwiki-2021-11.tsv.gz,Hamas,19260,34364,366,53990,22106
hdfs://spark-nn.eemcs.utwente.nl/user/s1934538/clickstream/clickstream-enwiki-2021-11.tsv.gz,Joaquin_Phoenix,126322,180709,1664,308695,190772
hdfs://spark-nn.eemcs.utwente.nl/user/s1934538/clickstream/clickstream-enwiki-2021-11.tsv.gz,Black_Adam_(film),75186,38044,576,113806,81078
hdfs://spark-nn.eemcs.utwente.nl/user/s1934538/clickstream/clickstream-enwiki-2021-11.tsv.gz,Chernobyl_disaster,50721,265267,3206,319194,136102
hdfs://spark-nn.eemcs.utwente.nl/user/s1934538/clickstream/clickstream-enwiki-2021-11.tsv.gz,Afghanistan,142589,285610,7815,436014,322238
hdfs://spark-nn.eemcs.utwente.nl/user/s1934538/clickstream/clickstream-enwiki-2021-11.tsv.gz,Anna_Sorokin,14446,134911,286,149643,44120
hdfs://spark-nn.eemcs.utwente.nl/user/s1934538/clickstream/clickstream-enwiki-2021-11.tsv.gz,Mötley_Crüe,33407,88308,1210,122925,137049
hdfs://spark-nn.eemcs.utwente.nl/user/s1934538/clickstream/clickstream-enwiki-2021-11.tsv.gz,NATO,47347,121239,2802,171388,67038
hdfs://spark-nn.eemcs.utwente.nl/user/s1934538/clickstream/clickstream-enwiki-2021-11.tsv.gz,Kenosha_unrest_shooting,72679,5676987,49585,5799251,986380
hdfs://spark-nn.eemcs.utwente.nl/user/s1934538/clickstream/clickstream-enwiki-2021-12.tsv.gz,Brett_Kavanaugh,20609,35677,301,56587,18009
hdfs://spark-nn.eemcs.utwente.nl/user/s1934538/clickstream/clickstream-enwiki-2021-12.tsv.gz,Louis_Tomlinson,24554,50631,408,75593,20123
hdfs://spark-nn.eemcs.utwente.nl/user/s1934538/clickstream/clickstream-enwiki-2021-12.tsv.gz,Kobe_Bryant_sexual_assault_case,4932,44087,117,49136,2704
hdfs://spark-nn.eemcs.utwente.nl/user/s1934538/clickstream/clickstream-enwiki-2021-12.tsv.gz,"Princess_Margaret,_Countess_of_Snowdon",92345,197026,1444,290815,162184
hdfs://spark-nn.eemcs.utwente.nl/user/s1934538/clickstream/clickstream-enwiki-2021-12.tsv.gz,Kylian_Mbappé,26953,202807,2025,231785,44383
hdfs://spark-nn.eemcs.utwente.nl/user/s1934538/clickstream/clickstream-enwiki-2021-12.tsv.gz,Grimes_(musician),194466,189167,1729,385362,124157
hdfs://spark-nn.eemcs.utwente.nl/user/s1934538/clickstream/clickstream-enwiki-2021-12.tsv.gz,Murder_of_Dee_Dee_Blanchard,13914,122667,453,137034,25671
hdfs://spark-nn.eemcs.utwente.nl/user/s1934538/clickstream/clickstream-enwiki-2021-12.tsv.gz,Bridgerton,41519,143743,4343,189605,128232
hdfs://spark-nn.eemcs.utwente.nl/user/s1934538/clickstream/clickstream-enwiki-2021-12.tsv.gz,Laal_Singh_Chaddha,52350,82698,881,135929,73252
hdfs://spark-nn.eemcs.utwente.nl/user/s1934538/clickstream/clickstream-enwiki-2021-12.tsv.gz,2018_Asian_Games,8082,7055,75,15212,14342
hdfs://spark-nn.eemcs.utwente.nl/user/s1934538/clickstream/clickstream-enwiki-2021-12.tsv.gz,Burt_Reynolds,45481,110159,1082,156722,70641
hdfs://spark-nn.eemcs.utwente.nl/user/s1934538/clickstream/clickstream-enwiki-2021-12.tsv.gz,Russo-Ukrainian_War,55775,182630,1080,239485,138345
hdfs://spark-nn.eemcs.utwente.nl/user/s1934538/clickstream/clickstream-enwiki-2021-12.tsv.gz,Taliban,41546,88532,3112,133190,83173
hdfs://spark-nn.eemcs.utwente.nl/user/s1934538/clickstream/clickstream-enwiki-2021-12.tsv.gz,Microsoft_Office,7094,1379621,778,1387493,17404
hdfs://spark-nn.eemcs.utwente.nl/user/s1934538/clickstream/clickstream-enwiki-2021-12.tsv.gz,Tasuku_Honjo,933,723921,240,725094,23757
hdfs://spark-nn.eemcs.utwente.nl/user/s1934538/clickstream/clickstream-enwiki-2021-12.tsv.gz,The_Matrix_Resurrections,835807,3357055,108512,4301374,2120409
hdfs://spark-nn.eemcs.utwente.nl/user/s1934538/clickstream/clickstream-enwiki-2021-12.tsv.gz,Article_370_of_the_Constitution_of_India,2208,36165,20,38393,2248
hdfs://spark-nn.eemcs.utwente.nl/user/s1934538/clickstream/clickstream-enwiki-2021-12.tsv.gz,UEFA_Euro_2020,38144,72940,1432,112516,57953
hdfs://spark-nn.eemcs.utwente.nl/user/s1934538/clickstream/clickstream-enwiki-2021-12.tsv.gz,Afghanistan,154970,251342,5845,412157,286414
hdfs://spark-nn.eemcs.utwente.nl/user/s1934538/clickstream/clickstream-enwiki-2021-12.tsv.gz,Brie_Larson,66588,154736,1181,222505,90498
hdfs://spark-nn.eemcs.utwente.nl/user/s1934538/clickstream/clickstream-enwiki-2021-12.tsv.gz,Fyre_Festival,7628,45389,397,53414,32296
hdfs://spark-nn.eemcs.utwente.nl/user/s1934538/clickstream/clickstream-enwiki-2021-12.tsv.gz,Jimmy_Buffett,8026,43452,667,52145,18736
hdfs://spark-nn.eemcs.utwente.nl/user/s1934538/clickstream/clickstream-enwiki-2021-12.tsv.gz,Sinéad_O'Connor,19474,75777,601,95852,29616
hdfs://spark-nn.eemcs.utwente.nl/user/s1934538/clickstream/clickstream-enwiki-2021-12.tsv.gz,Qasem_Soleimani,10761,27792,103,38656,19292
hdfs://spark-nn.eemcs.utwente.nl/user/s1934538/clickstream/clickstream-enwiki-2021-12.tsv.gz,Sidharth_Shukla,13241,86994,121,100356,20598
hdfs://spark-nn.eemcs.utwente.nl/user/s1934538/clickstream/clickstream-enwiki-2021-12.tsv.gz,2020_United_States_presidential_election,135646,185312,4835,325793,317173
hdfs://spark-nn.eemcs.utwente.nl/user/s1934538/clickstream/clickstream-enwiki-2021-12.tsv.gz,FIFA_World_Cup,40482,177967,2776,221225,134049
hdfs://spark-nn.eemcs.utwente.nl/user/s1934538/clickstream/clickstream-enwiki-2021-12.tsv.gz,Spider-Man:_Far_From_Home,480565,693156,12673,1186394,612001
hdfs://spark-nn.eemcs.utwente.nl/user/s1934538/clickstream/clickstream-enwiki-2021-12.tsv.gz,Aretha_Franklin,33590,252754,1839,288183,124424
hdfs://spark-nn.eemcs.utwente.nl/user/s1934538/clickstream/clickstream-enwiki-2021-12.tsv.gz,Parasite_(2019_film),34949,167503,2082,204534,88670
hdfs://spark-nn.eemcs.utwente.nl/user/s1934538/clickstream/clickstream-enwiki-2021-12.tsv.gz,YouTube,120741,2314954,10304,2445999,127755
hdfs://spark-nn.eemcs.utwente.nl/user/s1934538/clickstream/clickstream-enwiki-2021-12.tsv.gz,Charles_III,83,131,43,257,268
hdfs://spark-nn.eemcs.utwente.nl/user/s1934538/clickstream/clickstream-enwiki-2021-12.tsv.gz,Sridevi,30236,67300,171,97707,43302
hdfs://spark-nn.eemcs.utwente.nl/user/s1934538/clickstream/clickstream-enwiki-2021-12.tsv.gz,Coronavirus,28281,163810,3722,195813,66334
hdfs://spark-nn.eemcs.utwente.nl/user/s1934538/clickstream/clickstream-enwiki-2021-12.tsv.gz,Henry_V_of_England,97700,131716,470,229886,161618
hdfs://spark-nn.eemcs.utwente.nl/user/s1934538/clickstream/clickstream-enwiki-2021-12.tsv.gz,Area_51,13393,117552,1051,131996,37152
hdfs://spark-nn.eemcs.utwente.nl/user/s1934538/clickstream/clickstream-enwiki-2021-12.tsv.gz,Luke_Perry,30227,153681,918,184826,71262
hdfs://spark-nn.eemcs.utwente.nl/user/s1934538/clickstream/clickstream-enwiki-2021-12.tsv.gz,Game_of_Thrones_(season_8),14600,40932,502,56034,19278
hdfs://spark-nn.eemcs.utwente.nl/user/s1934538/clickstream/clickstream-enwiki-2021-12.tsv.gz,Joe_Exotic,32429,149512,856,182797,69494
hdfs://spark-nn.eemcs.utwente.nl/user/s1934538/clickstream/clickstream-enwiki-2021-12.tsv.gz,The_Weeknd,58780,179001,2237,240018,102231
hdfs://spark-nn.eemcs.utwente.nl/user/s1934538/clickstream/clickstream-enwiki-2021-12.tsv.gz,The_Kashmir_Files,10838,25074,38,35950,19044
hdfs://spark-nn.eemcs.utwente.nl/user/s1934538/clickstream/clickstream-enwiki-2021-12.tsv.gz,Donald_Glover,46738,109417,647,156802,61731
hdfs://spark-nn.eemcs.utwente.nl/user/s1934538/clickstream/clickstream-enwiki-2021-12.tsv.gz,Elliot_Page,64351,296453,1802,362606,140172
hdfs://spark-nn.eemcs.utwente.nl/user/s1934538/clickstream/clickstream-enwiki-2021-12.tsv.gz,September_11_attacks,72593,189959,2886,265438,130968
hdfs://spark-nn.eemcs.utwente.nl/user/s1934538/clickstream/clickstream-enwiki-2021-12.tsv.gz,Loki_(TV_series),67781,202544,4199,274524,150925
hdfs://spark-nn.eemcs.utwente.nl/user/s1934538/clickstream/clickstream-enwiki-2021-12.tsv.gz,Wonder_Woman_1984,43639,87326,1926,132891,67077
hdfs://spark-nn.eemcs.utwente.nl/user/s1934538/clickstream/clickstream-enwiki-2021-12.tsv.gz,Joaquin_Phoenix,128049,168056,1057,297162,176601
hdfs://spark-nn.eemcs.utwente.nl/user/s1934538/clickstream/clickstream-enwiki-2021-12.tsv.gz,Avicii,19747,248092,1743,269582,85361
hdfs://spark-nn.eemcs.utwente.nl/user/s1934538/clickstream/clickstream-enwiki-2021-12.tsv.gz,Ted_Bundy,39019,401403,4086,444508,104126
hdfs://spark-nn.eemcs.utwente.nl/user/s1934538/clickstream/clickstream-enwiki-2021-12.tsv.gz,Tina_Turner,26844,264440,2379,293663,92020
hdfs://spark-nn.eemcs.utwente.nl/user/s1934538/clickstream/clickstream-enwiki-2021-12.tsv.gz,List_of_Queen_of_the_South_episodes,7392,5342,243,12977,297
hdfs://spark-nn.eemcs.utwente.nl/user/s1934538/clickstream/clickstream-enwiki-2021-12.tsv.gz,List_of_awards_and_nominations_received_by_Meryl_Streep,14873,10494,180,25547,10004
hdfs://spark-nn.eemcs.utwente.nl/user/s1934538/clickstream/clickstream-enwiki-2021-12.tsv.gz,Lists_of_deaths_by_year,3016,132070,990,136076,152649
hdfs://spark-nn.eemcs.utwente.nl/user/s1934538/clickstream/clickstream-enwiki-2021-12.tsv.gz,Richard_Jewell,13112,65376,325,78813,26646
hdfs://spark-nn.eemcs.utwente.nl/user/s1934538/clickstream/clickstream-enwiki-2021-12.tsv.gz,Shinzo_Abe,21885,24663,261,46809,17440
hdfs://spark-nn.eemcs.utwente.nl/user/s1934538/clickstream/clickstream-enwiki-2021-12.tsv.gz,Gaza_Strip,14195,30698,167,45060,16820
hdfs://spark-nn.eemcs.utwente.nl/user/s1934538/clickstream/clickstream-enwiki-2021-12.tsv.gz,Carlos_Alcaraz,806,4033,36,4875,1378
hdfs://spark-nn.eemcs.utwente.nl/user/s1934538/clickstream/clickstream-enwiki-2021-12.tsv.gz,Main_Page,57647,143954532,4834398,148846577,32114441
hdfs://spark-nn.eemcs.utwente.nl/user/s1934538/clickstream/clickstream-enwiki-2021-12.tsv.gz,List_of_FIFA_World_Cup_finals,1924,46112,29,48065,13123
hdfs://spark-nn.eemcs.utwente.nl/user/s1934538/clickstream/clickstream-enwiki-2021-12.tsv.gz,Rishi_Sunak,39886,102967,623,143476,61208
hdfs://spark-nn.eemcs.utwente.nl/user/s1934538/clickstream/clickstream-enwiki-2021-12.tsv.gz,XXXTentacion,104400,678250,6140,788790,121781
hdfs://spark-nn.eemcs.utwente.nl/user/s1934538/clickstream/clickstream-enwiki-2021-12.tsv.gz,Cook's_Country,348,2020,21,2389,653
hdfs://spark-nn.eemcs.utwente.nl/user/s1934538/clickstream/clickstream-enwiki-2021-12.tsv.gz,Aquaman_(film),31591,66016,1246,98853,52938
hdfs://spark-nn.eemcs.utwente.nl/user/s1934538/clickstream/clickstream-enwiki-2021-12.tsv.gz,It_Chapter_Two,22276,38963,380,61619,38777
hdfs://spark-nn.eemcs.utwente.nl/user/s1934538/clickstream/clickstream-enwiki-2021-12.tsv.gz,Valentine's_Day,3603,47327,316,51246,4784
hdfs://spark-nn.eemcs.utwente.nl/user/s1934538/clickstream/clickstream-enwiki-2021-12.tsv.gz,XHamster,7857,408884,6302,423043,35917
hdfs://spark-nn.eemcs.utwente.nl/user/s1934538/clickstream/clickstream-enwiki-2021-12.tsv.gz,COVID-19_pandemic,318643,374188,2050,694881,337632
hdfs://spark-nn.eemcs.utwente.nl/user/s1934538/clickstream/clickstream-enwiki-2021-12.tsv.gz,John_McCain,25917,54235,764,80916,37872
hdfs://spark-nn.eemcs.utwente.nl/user/s1934538/clickstream/clickstream-enwiki-2021-12.tsv.gz,21_Savage,11708,53383,494,65585,23517
hdfs://spark-nn.eemcs.utwente.nl/user/s1934538/clickstream/clickstream-enwiki-2021-12.tsv.gz,Bonnie_and_Clyde,18799,184851,1240,204890,51486
hdfs://spark-nn.eemcs.utwente.nl/user/s1934538/clickstream/clickstream-enwiki-2021-12.tsv.gz,George_VI,318422,131005,736,450163,327548
hdfs://spark-nn.eemcs.utwente.nl/user/s1934538/clickstream/clickstream-enwiki-2021-12.tsv.gz,Sylvester_Stallone,88826,226591,2256,317673,215657
hdfs://spark-nn.eemcs.utwente.nl/user/s1934538/clickstream/clickstream-enwiki-2021-12.tsv.gz,Tunnel,9013,9020,103,18136,4023
hdfs://spark-nn.eemcs.utwente.nl/user/s1934538/clickstream/clickstream-enwiki-2021-12.tsv.gz,Puneeth_Rajkumar,20833,114011,997,135841,58481
hdfs://spark-nn.eemcs.utwente.nl/user/s1934538/clickstream/clickstream-enwiki-2021-12.tsv.gz,Spider-Man:_No_Way_Home,1588045,9531896,220985,11340926,6326177
hdfs://spark-nn.eemcs.utwente.nl/user/s1934538/clickstream/clickstream-enwiki-2021-12.tsv.gz,When_They_See_Us,12456,24808,120,37384,16484
hdfs://spark-nn.eemcs.utwente.nl/user/s1934538/clickstream/clickstream-enwiki-2021-12.tsv.gz,Crazy_Rich_Asians_(film),41027,89785,1391,132203,113333
hdfs://spark-nn.eemcs.utwente.nl/user/s1934538/clickstream/clickstream-enwiki-2021-12.tsv.gz,Media,30,3661,249,3940,1366
hdfs://spark-nn.eemcs.utwente.nl/user/s1934538/clickstream/clickstream-enwiki-2021-12.tsv.gz,Aaron_Carter,18606,91777,695,111078,51786
hdfs://spark-nn.eemcs.utwente.nl/user/s1934538/clickstream/clickstream-enwiki-2021-12.tsv.gz,The_Shape_of_Water,33493,62132,798,96423,44064
hdfs://spark-nn.eemcs.utwente.nl/user/s1934538/clickstream/clickstream-enwiki-2021-12.tsv.gz,2016_United_States_presidential_election,94348,72030,869,167247,143214
hdfs://spark-nn.eemcs.utwente.nl/user/s1934538/clickstream/clickstream-enwiki-2021-12.tsv.gz,Bob_Saget,15838,23959,202,39999,8414
hdfs://spark-nn.eemcs.utwente.nl/user/s1934538/clickstream/clickstream-enwiki-2021-12.tsv.gz,List_of_highest-grossing_films,245053,625039,2537,872629,389792
hdfs://spark-nn.eemcs.utwente.nl/user/s1934538/clickstream/clickstream-enwiki-2021-12.tsv.gz,Simone_Biles,11646,71911,781,84338,24230
hdfs://spark-nn.eemcs.utwente.nl/user/s1934538/clickstream/clickstream-enwiki-2021-12.tsv.gz,Army_of_the_Dead,64216,113027,1501,178744,105959
hdfs://spark-nn.eemcs.utwente.nl/user/s1934538/clickstream/clickstream-enwiki-2021-12.tsv.gz,Game_of_Thrones,66919,265967,7476,340362,223759
hdfs://spark-nn.eemcs.utwente.nl/user/s1934538/clickstream/clickstream-enwiki-2021-12.tsv.gz,Amy_Coney_Barrett,25376,55116,621,81113,26877
hdfs://spark-nn.eemcs.utwente.nl/user/s1934538/clickstream/clickstream-enwiki-2021-12.tsv.gz,Cardi_B,33432,217285,3353,254070,84680
hdfs://spark-nn.eemcs.utwente.nl/user/s1934538/clickstream/clickstream-enwiki-2021-12.tsv.gz,The_Umbrella_Academy_(TV_series),35947,99011,1821,136779,66138
hdfs://spark-nn.eemcs.utwente.nl/user/s1934538/clickstream/clickstream-enwiki-2021-12.tsv.gz,Adele,62422,676430,8606,747458,278865
hdfs://spark-nn.eemcs.utwente.nl/user/s1934538/clickstream/clickstream-enwiki-2021-12.tsv.gz,Stephen_Hawking,28753,343132,2076,373961,131575
hdfs://spark-nn.eemcs.utwente.nl/user/s1934538/clickstream/clickstream-enwiki-2021-12.tsv.gz,Kim_Jong-un,78042,235116,1814,314972,166414
hdfs://spark-nn.eemcs.utwente.nl/user/s1934538/clickstream/clickstream-enwiki-2021-12.tsv.gz,Bird_Box_(film),22896,97343,1078,121317,39396
hdfs://spark-nn.eemcs.utwente.nl/user/s1934538/clickstream/clickstream-enwiki-2021-12.tsv.gz,Avengers:_Endgame,213949,296260,4111,514320,297282
hdfs://spark-nn.eemcs.utwente.nl/user/s1934538/clickstream/clickstream-enwiki-2021-12.tsv.gz,Vikram_(2022_film),33008,20682,122,53812,31688
hdfs://spark-nn.eemcs.utwente.nl/user/s1934538/clickstream/clickstream-enwiki-2021-12.tsv.gz,Black_Adam_(film),76234,49260,872,126366,87513
hdfs://spark-nn.eemcs.utwente.nl/user/s1934538/clickstream/clickstream-enwiki-2021-12.tsv.gz,Watts_family_murders,11012,151519,384,162915,42230
hdfs://spark-nn.eemcs.utwente.nl/user/s1934538/clickstream/clickstream-enwiki-2021-12.tsv.gz,2.0_(film),33139,40129,100,73368,22778
hdfs://spark-nn.eemcs.utwente.nl/user/s1934538/clickstream/clickstream-enwiki-2021-12.tsv.gz,Stranger_Things,57122,192762,4074,253958,177144
hdfs://spark-nn.eemcs.utwente.nl/user/s1934538/clickstream/clickstream-enwiki-2021-12.tsv.gz,WandaVision,89689,215018,3924,308631,158259
hdfs://spark-nn.eemcs.utwente.nl/user/s1934538/clickstream/clickstream-enwiki-2021-12.tsv.gz,The_Lion_King_(2019_film),49136,51964,685,101785,45805
hdfs://spark-nn.eemcs.utwente.nl/user/s1934538/clickstream/clickstream-enwiki-2021-12.tsv.gz,Cricket_World_Cup,18464,92554,403,111421,65571
hdfs://spark-nn.eemcs.utwente.nl/user/s1934538/clickstream/clickstream-enwiki-2021-12.tsv.gz,Spanish_flu,41899,458654,4976,505529,109678
hdfs://spark-nn.eemcs.utwente.nl/user/s1934538/clickstream/clickstream-enwiki-2021-12.tsv.gz,The_Flash_(film),71587,49276,888,121751,83136
hdfs://spark-nn.eemcs.utwente.nl/user/s1934538/clickstream/clickstream-enwiki-2021-12.tsv.gz,List_of_James_Bond_films,112763,802988,1397,917148,505398
hdfs://spark-nn.eemcs.utwente.nl/user/s1934538/clickstream/clickstream-enwiki-2021-12.tsv.gz,Cameron_Boyce,21048,131624,444,153116,39435
hdfs://spark-nn.eemcs.utwente.nl/user/s1934538/clickstream/clickstream-enwiki-2021-12.tsv.gz,Everything_Everywhere_All_at_Once,27350,91115,1434,119899,70171
hdfs://spark-nn.eemcs.utwente.nl/user/s1934538/clickstream/clickstream-enwiki-2021-12.tsv.gz,Emma_Raducanu,11912,126779,965,139656,29666
hdfs://spark-nn.eemcs.utwente.nl/user/s1934538/clickstream/clickstream-enwiki-2021-12.tsv.gz,Vladimir_Putin,101993,342157,4789,448939,269495
hdfs://spark-nn.eemcs.utwente.nl/user/s1934538/clickstream/clickstream-enwiki-2021-12.tsv.gz,Chernobyl_disaster,52000,284533,3020,339553,147413
hdfs://spark-nn.eemcs.utwente.nl/user/s1934538/clickstream/clickstream-enwiki-2021-12.tsv.gz,R._Kelly,25254,139307,1940,166501,84171
hdfs://spark-nn.eemcs.utwente.nl/user/s1934538/clickstream/clickstream-enwiki-2021-12.tsv.gz,NATO,57308,226578,4753,288639,114917
hdfs://spark-nn.eemcs.utwente.nl/user/s1934538/clickstream/clickstream-enwiki-2021-12.tsv.gz,Ruth_Bader_Ginsburg,17953,74633,662,93248,32198
hdfs://spark-nn.eemcs.utwente.nl/user/s1934538/clickstream/clickstream-enwiki-2021-12.tsv.gz,Anthony_Bourdain,21373,211924,1739,235036,70175
hdfs://spark-nn.eemcs.utwente.nl/user/s1934538/clickstream/clickstream-enwiki-2021-12.tsv.gz,Dark_Phoenix_(film),50017,42103,465,92585,48454
hdfs://spark-nn.eemcs.utwente.nl/user/s1934538/clickstream/clickstream-enwiki-2021-12.tsv.gz,Naomi_Osaka,16030,44100,297,60427,15285
hdfs://spark-nn.eemcs.utwente.nl/user/s1934538/clickstream/clickstream-enwiki-2021-12.tsv.gz,2018_Winter_Olympics,26205,25057,339,51601,37315
hdfs://spark-nn.eemcs.utwente.nl/user/s1934538/clickstream/clickstream-enwiki-2021-12.tsv.gz,Manti_Te'o,6484,32777,134,39395,4691
hdfs://spark-nn.eemcs.utwente.nl/user/s1934538/clickstream/clickstream-enwiki-2021-12.tsv.gz,IPv4,8968,37238,112,46318,7586
hdfs://spark-nn.eemcs.utwente.nl/user/s1934538/clickstream/clickstream-enwiki-2021-12.tsv.gz,Cristiano_Ronaldo,135104,1038956,9049,1183109,254608
hdfs://spark-nn.eemcs.utwente.nl/user/s1934538/clickstream/clickstream-enwiki-2021-12.tsv.gz,Ponniyin_Selvan:_I,69734,61485,595,131814,115578
hdfs://spark-nn.eemcs.utwente.nl/user/s1934538/clickstream/clickstream-enwiki-2021-12.tsv.gz,War_(2019_film),21660,42980,47,64687,19333
hdfs://spark-nn.eemcs.utwente.nl/user/s1934538/clickstream/clickstream-enwiki-2021-12.tsv.gz,Juneteenth,4716,61182,287,66185,5036
hdfs://spark-nn.eemcs.utwente.nl/user/s1934538/clickstream/clickstream-enwiki-2021-12.tsv.gz,Guardians_of_the_Galaxy_Vol._3,112800,41909,362,155071,98015
hdfs://spark-nn.eemcs.utwente.nl/user/s1934538/clickstream/clickstream-enwiki-2021-12.tsv.gz,"Prince_Philip,_Duke_of_Edinburgh",187650,232532,2758,422940,232589
hdfs://spark-nn.eemcs.utwente.nl/user/s1934538/clickstream/clickstream-enwiki-2021-12.tsv.gz,Elizabeth_II,447106,800878,13116,1261100,867231
hdfs://spark-nn.eemcs.utwente.nl/user/s1934538/clickstream/clickstream-enwiki-2021-12.tsv.gz,Mulan_(2020_film),17926,45172,711,63809,36695
hdfs://spark-nn.eemcs.utwente.nl/user/s1934538/clickstream/clickstream-enwiki-2021-12.tsv.gz,Jenna_Ortega,40373,44609,701,85683,20525
hdfs://spark-nn.eemcs.utwente.nl/user/s1934538/clickstream/clickstream-enwiki-2021-12.tsv.gz,Dennis_Nilsen,8110,53947,320,62377,15266
hdfs://spark-nn.eemcs.utwente.nl/user/s1934538/clickstream/clickstream-enwiki-2021-12.tsv.gz,David_Beckham,45571,191486,1190,238247,91651
hdfs://spark-nn.eemcs.utwente.nl/user/s1934538/clickstream/clickstream-enwiki-2021-12.tsv.gz,Zack_Snyder's_Justice_League,79098,104093,1405,184596,90626
hdfs://spark-nn.eemcs.utwente.nl/user/s1934538/clickstream/clickstream-enwiki-2021-12.tsv.gz,Jason_Momoa,88459,229920,1553,319932,135571
hdfs://spark-nn.eemcs.utwente.nl/user/s1934538/clickstream/clickstream-enwiki-2021-12.tsv.gz,Priyanka_Chopra,229141,431649,1525,662315,215418
hdfs://spark-nn.eemcs.utwente.nl/user/s1934538/clickstream/clickstream-enwiki-2021-12.tsv.gz,List_of_highest-grossing_Indian_films,79544,328545,2303,410392,212336
hdfs://spark-nn.eemcs.utwente.nl/user/s1934538/clickstream/clickstream-enwiki-2021-12.tsv.gz,Tonya_Harding,16322,78176,565,95063,24712
hdfs://spark-nn.eemcs.utwente.nl/user/s1934538/clickstream/clickstream-enwiki-2021-12.tsv.gz,Kobe_Bryant,50894,313743,3407,368044,104570
hdfs://spark-nn.eemcs.utwente.nl/user/s1934538/clickstream/clickstream-enwiki-2021-12.tsv.gz,Ghislaine_Maxwell,200002,1274145,11889,1486036,745614
hdfs://spark-nn.eemcs.utwente.nl/user/s1934538/clickstream/clickstream-enwiki-2021-12.tsv.gz,Notre-Dame_de_Paris,13167,89166,895,103228,20824
hdfs://spark-nn.eemcs.utwente.nl/user/s1934538/clickstream/clickstream-enwiki-2021-12.tsv.gz,The_Sandman_(TV_series),21276,27943,299,49518,35834
hdfs://spark-nn.eemcs.utwente.nl/user/s1934538/clickstream/clickstream-enwiki-2021-12.tsv.gz,Michael_Jordan,75430,379969,3884,459283,148698
hdfs://spark-nn.eemcs.utwente.nl/user/s1934538/clickstream/clickstream-enwiki-2021-12.tsv.gz,Black_Widow_(2021_film),134291,338849,6261,479401,323103
hdfs://spark-nn.eemcs.utwente.nl/user/s1934538/clickstream/clickstream-enwiki-2021-12.tsv.gz,Deaths_in_2022,3653,13702,321,17676,1175
hdfs://spark-nn.eemcs.utwente.nl/user/s1934538/clickstream/clickstream-enwiki-2021-12.tsv.gz,Nipsey_Hussle,21778,79080,886,101744,31928
hdfs://spark-nn.eemcs.utwente.nl/user/s1934538/clickstream/clickstream-enwiki-2021-12.tsv.gz,Anne_Heche,22791,48207,207,71205,22713
hdfs://spark-nn.eemcs.utwente.nl/user/s1934538/clickstream/clickstream-enwiki-2021-12.tsv.gz,Us_(2019_film),20029,39999,183,60211,20648
hdfs://spark-nn.eemcs.utwente.nl/user/s1934538/clickstream/clickstream-enwiki-2021-12.tsv.gz,Don't_Look_Up_(2021_film),338814,3440082,64028,3842924,1989902
hdfs://spark-nn.eemcs.utwente.nl/user/s1934538/clickstream/clickstream-enwiki-2021-12.tsv.gz,Stranger_Things_(season_3),16015,28456,303,44774,22300
hdfs://spark-nn.eemcs.utwente.nl/user/s1934538/clickstream/clickstream-enwiki-2021-12.tsv.gz,Fantastic_Beasts:_The_Crimes_of_Grindelwald,128449,130024,1830,260303,159734
hdfs://spark-nn.eemcs.utwente.nl/user/s1934538/clickstream/clickstream-enwiki-2021-12.tsv.gz,JSON_Web_Token,636,25199,36,25871,1760
hdfs://spark-nn.eemcs.utwente.nl/user/s1934538/clickstream/clickstream-enwiki-2021-12.tsv.gz,Chernobyl_(miniseries),20594,80939,1496,103029,92456
hdfs://spark-nn.eemcs.utwente.nl/user/s1934538/clickstream/clickstream-enwiki-2021-12.tsv.gz,Saaho,27739,55890,279,83908,27238
hdfs://spark-nn.eemcs.utwente.nl/user/s1934538/clickstream/clickstream-enwiki-2021-12.tsv.gz,Antifa_(United_States),8158,47301,177,55636,11340
hdfs://spark-nn.eemcs.utwente.nl/user/s1934538/clickstream/clickstream-enwiki-2021-12.tsv.gz,XXX:_Return_of_Xander_Cage,73048,643250,1326,717624,87512
hdfs://spark-nn.eemcs.utwente.nl/user/s1934538/clickstream/clickstream-enwiki-2021-12.tsv.gz,Rihanna,77794,394178,4825,476797,237702
hdfs://spark-nn.eemcs.utwente.nl/user/s1934538/clickstream/clickstream-enwiki-2021-12.tsv.gz,Kenosha_unrest_shooting,10265,330317,5513,346095,53963
hdfs://spark-nn.eemcs.utwente.nl/user/s1934538/clickstream/clickstream-enwiki-2021-12.tsv.gz,Eternals_(film),295950,691810,14164,1001924,632305
hdfs://spark-nn.eemcs.utwente.nl/user/s1934538/clickstream/clickstream-enwiki-2021-12.tsv.gz,A_Star_Is_Born_(2018_film),36090,161875,1509,199474,100769
hdfs://spark-nn.eemcs.utwente.nl/user/s1934538/clickstream/clickstream-enwiki-2021-12.tsv.gz,John_Wick:_Chapter_4,114684,122457,4096,241237,139882
hdfs://spark-nn.eemcs.utwente.nl/user/s1934538/clickstream/clickstream-enwiki-2021-12.tsv.gz,Death_of_Elisa_Lam,11839,72007,237,84083,21169
hdfs://spark-nn.eemcs.utwente.nl/user/s1934538/clickstream/clickstream-enwiki-2021-12.tsv.gz,Cecil_Hotel_(Los_Angeles),6118,60129,171,66418,16101
hdfs://spark-nn.eemcs.utwente.nl/user/s1934538/clickstream/clickstream-enwiki-2021-12.tsv.gz,Richard_Ramirez,16721,191329,1366,209416,48469
hdfs://spark-nn.eemcs.utwente.nl/user/s1934538/clickstream/clickstream-enwiki-2021-12.tsv.gz,Hamilton_(musical),41158,230791,1925,273874,158824
hdfs://spark-nn.eemcs.utwente.nl/user/s1934538/clickstream/clickstream-enwiki-2021-12.tsv.gz,No_Time_to_Die,290935,1035528,24563,1351026,846673
hdfs://spark-nn.eemcs.utwente.nl/user/s1934538/clickstream/clickstream-enwiki-2021-12.tsv.gz,2023_Cricket_World_Cup,18171,35341,85,53597,14729
hdfs://spark-nn.eemcs.utwente.nl/user/s1934538/clickstream/clickstream-enwiki-2021-12.tsv.gz,Cleopatra,63234,4611709,2392,4677335,358191
hdfs://spark-nn.eemcs.utwente.nl/user/s1934538/clickstream/clickstream-enwiki-2021-12.tsv.gz,Tenet_(film),67664,148789,1983,218436,110745
hdfs://spark-nn.eemcs.utwente.nl/user/s1934538/clickstream/clickstream-enwiki-2021-12.tsv.gz,"Diana,_Princess_of_Wales",140048,341623,3166,484837,296130
hdfs://spark-nn.eemcs.utwente.nl/user/s1934538/clickstream/clickstream-enwiki-2021-12.tsv.gz,Jimmy_Hoffa,27228,115501,1010,143739,54213
hdfs://spark-nn.eemcs.utwente.nl/user/s1934538/clickstream/clickstream-enwiki-2021-12.tsv.gz,Godzilla_vs._Kong,69534,148310,3032,220876,122494
hdfs://spark-nn.eemcs.utwente.nl/user/s1934538/clickstream/clickstream-enwiki-2021-12.tsv.gz,Deadpool_2,51600,58781,1363,111744,77704
hdfs://spark-nn.eemcs.utwente.nl/user/s1934538/clickstream/clickstream-enwiki-2021-12.tsv.gz,WrestleMania_34,11294,6559,105,17958,11240
hdfs://spark-nn.eemcs.utwente.nl/user/s1934538/clickstream/clickstream-enwiki-2021-12.tsv.gz,Joker_(2019_film),52474,188955,2260,243689,111435
hdfs://spark-nn.eemcs.utwente.nl/user/s1934538/clickstream/clickstream-enwiki-2021-12.tsv.gz,Venom_(2018_film),95360,321708,3264,420332,214420
hdfs://spark-nn.eemcs.utwente.nl/user/s1934538/clickstream/clickstream-enwiki-2021-12.tsv.gz,Aaron_Hernandez,12971,137656,926,151553,55264
hdfs://spark-nn.eemcs.utwente.nl/user/s1934538/clickstream/clickstream-enwiki-2021-12.tsv.gz,1234,34,1206,36,1276,193
hdfs://spark-nn.eemcs.utwente.nl/user/s1934538/clickstream/clickstream-enwiki-2021-12.tsv.gz,RRR_(film),112559,755112,3120,870791,516335
hdfs://spark-nn.eemcs.utwente.nl/user/s1934538/clickstream/clickstream-enwiki-2021-12.tsv.gz,Naya_Rivera,46918,72481,690,120089,45319
hdfs://spark-nn.eemcs.utwente.nl/user/s1934538/clickstream/clickstream-enwiki-2021-12.tsv.gz,Ray_Liotta,34736,65191,544,100471,33891
hdfs://spark-nn.eemcs.utwente.nl/user/s1934538/clickstream/clickstream-enwiki-2022-03.tsv.gz,List_of_Marvel_Cinematic_Universe_films,225375,607610,6948,839933,469885
hdfs://spark-nn.eemcs.utwente.nl/user/s1934538/clickstream/clickstream-enwiki-2022-03.tsv.gz,Bird_Box_(film),19184,51812,583,71579,27181
hdfs://spark-nn.eemcs.utwente.nl/user/s1934538/clickstream/clickstream-enwiki-2022-03.tsv.gz,Kenosha_unrest_shooting,6461,75946,757,83164,13118
hdfs://spark-nn.eemcs.utwente.nl/user/s1934538/clickstream/clickstream-enwiki-2022-03.tsv.gz,Main_Page,89438,153647463,5776558,159513459,38374457
hdfs://spark-nn.eemcs.utwente.nl/user/s1934538/clickstream/clickstream-enwiki-2022-03.tsv.gz,List_of_highest-grossing_films,186821,403084,2395,592300,255981
hdfs://spark-nn.eemcs.utwente.nl/user/s1934538/clickstream/clickstream-enwiki-2022-03.tsv.gz,Avengers:_Infinity_War,50817,68113,1217,120147,63989
hdfs://spark-nn.eemcs.utwente.nl/user/s1934538/clickstream/clickstream-enwiki-2022-03.tsv.gz,Chadwick_Boseman,58989,266728,1225,326942,87991
hdfs://spark-nn.eemcs.utwente.nl/user/s1934538/clickstream/clickstream-enwiki-2022-03.tsv.gz,Priyanka_Chopra,77770,196830,672,275272,99426
hdfs://spark-nn.eemcs.utwente.nl/user/s1934538/clickstream/clickstream-enwiki-2022-03.tsv.gz,Black_Panther_(film),45446,97935,2150,145531,86629
hdfs://spark-nn.eemcs.utwente.nl/user/s1934538/clickstream/clickstream-enwiki-2022-03.tsv.gz,Keanu_Reeves,80624,408956,3330,492910,292167
hdfs://spark-nn.eemcs.utwente.nl/user/s1934538/clickstream/clickstream-enwiki-2022-03.tsv.gz,2018_Asian_Games,8818,6819,73,15710,16068
hdfs://spark-nn.eemcs.utwente.nl/user/s1934538/clickstream/clickstream-enwiki-2022-03.tsv.gz,Deaths_in_2022,1583190,2357855,19447,3960492,2449385
hdfs://spark-nn.eemcs.utwente.nl/user/s1934538/clickstream/clickstream-enwiki-2022-03.tsv.gz,Asia_Cup,2561,25387,53,28001,20400
hdfs://spark-nn.eemcs.utwente.nl/user/s1934538/clickstream/clickstream-enwiki-2022-03.tsv.gz,"Diana,_Princess_of_Wales",131387,353580,3187,488154,299178
hdfs://spark-nn.eemcs.utwente.nl/user/s1934538/clickstream/clickstream-enwiki-2022-03.tsv.gz,Stranger_Things_(season_4),24165,199829,1409,225403,104784
hdfs://spark-nn.eemcs.utwente.nl/user/s1934538/clickstream/clickstream-enwiki-2022-03.tsv.gz,Bonnie_and_Clyde,21735,168103,1728,191566,52398
hdfs://spark-nn.eemcs.utwente.nl/user/s1934538/clickstream/clickstream-enwiki-2022-03.tsv.gz,The_Suicide_Squad_(film),114469,139537,2917,256923,179290
hdfs://spark-nn.eemcs.utwente.nl/user/s1934538/clickstream/clickstream-enwiki-2022-03.tsv.gz,Crazy_Rich_Asians_(film),25934,68360,1181,95475,80859
hdfs://spark-nn.eemcs.utwente.nl/user/s1934538/clickstream/clickstream-enwiki-2022-03.tsv.gz,Sushma_Swaraj,9654,24442,55,34151,9266
hdfs://spark-nn.eemcs.utwente.nl/user/s1934538/clickstream/clickstream-enwiki-2022-03.tsv.gz,George_VI,325578,140428,728,466734,338550
hdfs://spark-nn.eemcs.utwente.nl/user/s1934538/clickstream/clickstream-enwiki-2022-03.tsv.gz,RRR_(film),218972,3565567,17711,3802250,1434348
hdfs://spark-nn.eemcs.utwente.nl/user/s1934538/clickstream/clickstream-enwiki-2022-03.tsv.gz,Cameron_Boyce,25498,134356,516,160370,42010
hdfs://spark-nn.eemcs.utwente.nl/user/s1934538/clickstream/clickstream-enwiki-2022-03.tsv.gz,Lance_Reddick,24395,34001,204,58600,13751
hdfs://spark-nn.eemcs.utwente.nl/user/s1934538/clickstream/clickstream-enwiki-2022-03.tsv.gz,Ukraine,696979,4693128,134993,5525100,2544069
hdfs://spark-nn.eemcs.utwente.nl/user/s1934538/clickstream/clickstream-enwiki-2022-03.tsv.gz,Captain_Marvel_(film),31978,91387,1525,124890,58734
hdfs://spark-nn.eemcs.utwente.nl/user/s1934538/clickstream/clickstream-enwiki-2022-03.tsv.gz,21_Savage,12048,55455,505,68008,22792
hdfs://spark-nn.eemcs.utwente.nl/user/s1934538/clickstream/clickstream-enwiki-2022-03.tsv.gz,Death_of_Elisa_Lam,15394,82423,360,98177,27463
hdfs://spark-nn.eemcs.utwente.nl/user/s1934538/clickstream/clickstream-enwiki-2022-03.tsv.gz,The_Sandman_(TV_series),25552,22736,280,48568,35285
hdfs://spark-nn.eemcs.utwente.nl/user/s1934538/clickstream/clickstream-enwiki-2022-03.tsv.gz,Parasite_(2019_film),35361,146846,2027,184234,76705
hdfs://spark-nn.eemcs.utwente.nl/user/s1934538/clickstream/clickstream-enwiki-2022-03.tsv.gz,Joe_Biden,257003,824308,13743,1095054,527200
hdfs://spark-nn.eemcs.utwente.nl/user/s1934538/clickstream/clickstream-enwiki-2022-03.tsv.gz,Mortal_Kombat_(2021_film),21560,56790,968,79318,69320
hdfs://spark-nn.eemcs.utwente.nl/user/s1934538/clickstream/clickstream-enwiki-2022-03.tsv.gz,Donald_Glover,51883,188072,1644,241599,104663
hdfs://spark-nn.eemcs.utwente.nl/user/s1934538/clickstream/clickstream-enwiki-2022-03.tsv.gz,Deion_Sanders,10497,151190,983,162670,48180
hdfs://spark-nn.eemcs.utwente.nl/user/s1934538/clickstream/clickstream-enwiki-2022-03.tsv.gz,2020_Summer_Olympics,50511,56198,1792,108501,95279
hdfs://spark-nn.eemcs.utwente.nl/user/s1934538/clickstream/clickstream-enwiki-2022-03.tsv.gz,Zack_Snyder's_Justice_League,118067,148744,2534,269345,143846
hdfs://spark-nn.eemcs.utwente.nl/user/s1934538/clickstream/clickstream-enwiki-2022-03.tsv.gz,Shang-Chi_and_the_Legend_of_the_Ten_Rings,75743,158175,2844,236762,148697
hdfs://spark-nn.eemcs.utwente.nl/user/s1934538/clickstream/clickstream-enwiki-2022-03.tsv.gz,Carlos_Alcaraz,11003,101270,615,112888,28745
hdfs://spark-nn.eemcs.utwente.nl/user/s1934538/clickstream/clickstream-enwiki-2022-03.tsv.gz,List_of_highest-grossing_Indian_films,98835,666233,8151,773219,377507
hdfs://spark-nn.eemcs.utwente.nl/user/s1934538/clickstream/clickstream-enwiki-2022-03.tsv.gz,Israel,107083,281333,7552,395968,196163
hdfs://spark-nn.eemcs.utwente.nl/user/s1934538/clickstream/clickstream-enwiki-2022-03.tsv.gz,Emma_Raducanu,14519,110192,857,125568,24789
hdfs://spark-nn.eemcs.utwente.nl/user/s1934538/clickstream/clickstream-enwiki-2022-03.tsv.gz,List_of_Queen_of_the_South_episodes,27490,13527,149,41166,1003
hdfs://spark-nn.eemcs.utwente.nl/user/s1934538/clickstream/clickstream-enwiki-2022-03.tsv.gz,The_Last_of_Us_(TV_series),28585,39806,217,68608,51751
hdfs://spark-nn.eemcs.utwente.nl/user/s1934538/clickstream/clickstream-enwiki-2022-03.tsv.gz,Avicii,20328,183470,1645,205443,62847
hdfs://spark-nn.eemcs.utwente.nl/user/s1934538/clickstream/clickstream-enwiki-2022-03.tsv.gz,Burt_Reynolds,51663,131884,1422,184969,89741
hdfs://spark-nn.eemcs.utwente.nl/user/s1934538/clickstream/clickstream-enwiki-2022-03.tsv.gz,Luke_Perry,40026,129533,762,170321,65371
hdfs://spark-nn.eemcs.utwente.nl/user/s1934538/clickstream/clickstream-enwiki-2022-03.tsv.gz,YouTube,136031,2804521,11288,2951840,125957
hdfs://spark-nn.eemcs.utwente.nl/user/s1934538/clickstream/clickstream-enwiki-2022-03.tsv.gz,Thor:_Love_and_Thunder,165482,138300,3695,307477,189772
hdfs://spark-nn.eemcs.utwente.nl/user/s1934538/clickstream/clickstream-enwiki-2022-03.tsv.gz,Cardi_B,30981,183106,3293,217380,69028
hdfs://spark-nn.eemcs.utwente.nl/user/s1934538/clickstream/clickstream-enwiki-2022-03.tsv.gz,Charles_Sobhraj,11375,51275,162,62812,11614
hdfs://spark-nn.eemcs.utwente.nl/user/s1934538/clickstream/clickstream-enwiki-2022-03.tsv.gz,Lists_of_deaths_by_year,3174,274271,896,278341,302715
hdfs://spark-nn.eemcs.utwente.nl/user/s1934538/clickstream/clickstream-enwiki-2022-03.tsv.gz,Ant-Man_and_the_Wasp:_Quantumania,62867,23959,236,87062,54537
hdfs://spark-nn.eemcs.utwente.nl/user/s1934538/clickstream/clickstream-enwiki-2022-03.tsv.gz,Russo-Ukrainian_War,801524,3602625,60961,4465110,2241239
hdfs://spark-nn.eemcs.utwente.nl/user/s1934538/clickstream/clickstream-enwiki-2022-03.tsv.gz,Grover,1414,5448,54,6916,1749
hdfs://spark-nn.eemcs.utwente.nl/user/s1934538/clickstream/clickstream-enwiki-2022-03.tsv.gz,Meat_Loaf,23902,109742,2992,136636,49781
hdfs://spark-nn.eemcs.utwente.nl/user/s1934538/clickstream/clickstream-enwiki-2022-03.tsv.gz,Aretha_Franklin,28028,242173,2013,272214,101613
hdfs://spark-nn.eemcs.utwente.nl/user/s1934538/clickstream/clickstream-enwiki-2022-03.tsv.gz,Google_logo,585,23325,19,23929,781
hdfs://spark-nn.eemcs.utwente.nl/user/s1934538/clickstream/clickstream-enwiki-2022-03.tsv.gz,Ruth_Bader_Ginsburg,35041,147797,1426,184264,59611
hdfs://spark-nn.eemcs.utwente.nl/user/s1934538/clickstream/clickstream-enwiki-2022-03.tsv.gz,Jurassic_World_Dominion,74362,90652,2654,167668,105538
hdfs://spark-nn.eemcs.utwente.nl/user/s1934538/clickstream/clickstream-enwiki-2022-03.tsv.gz,House_of_the_Dragon,32032,104334,1628,137994,98392
hdfs://spark-nn.eemcs.utwente.nl/user/s1934538/clickstream/clickstream-enwiki-2022-03.tsv.gz,Shinzo_Abe,31178,37908,332,69418,38486
hdfs://spark-nn.eemcs.utwente.nl/user/s1934538/clickstream/clickstream-enwiki-2022-03.tsv.gz,William_Murdoch,478,1231,18,1727,227
hdfs://spark-nn.eemcs.utwente.nl/user/s1934538/clickstream/clickstream-enwiki-2022-03.tsv.gz,Elizabeth_II,431592,736674,6993,1175259,798518
hdfs://spark-nn.eemcs.utwente.nl/user/s1934538/clickstream/clickstream-enwiki-2022-03.tsv.gz,Chernobyl_(miniseries),38947,184578,2864,226389,203544
hdfs://spark-nn.eemcs.utwente.nl/user/s1934538/clickstream/clickstream-enwiki-2022-03.tsv.gz,Wonder_Woman_1984,46351,63082,1485,110918,54279
hdfs://spark-nn.eemcs.utwente.nl/user/s1934538/clickstream/clickstream-enwiki-2022-03.tsv.gz,Jason_Momoa,225625,450069,3701,679395,233868
hdfs://spark-nn.eemcs.utwente.nl/user/s1934538/clickstream/clickstream-enwiki-2022-03.tsv.gz,WandaVision,43459,103080,1953,148492,75366
hdfs://spark-nn.eemcs.utwente.nl/user/s1934538/clickstream/clickstream-enwiki-2022-03.tsv.gz,Central_Park_jogger_case,12421,53565,185,66171,9149
hdfs://spark-nn.eemcs.utwente.nl/user/s1934538/clickstream/clickstream-enwiki-2022-03.tsv.gz,David_Beckham,39949,161255,1327,202531,77182
hdfs://spark-nn.eemcs.utwente.nl/user/s1934538/clickstream/clickstream-enwiki-2022-03.tsv.gz,2018_FIFA_World_Cup,141182,154697,1874,297753,176553
hdfs://spark-nn.eemcs.utwente.nl/user/s1934538/clickstream/clickstream-enwiki-2022-03.tsv.gz,Oppenheimer_(film),181618,140890,2533,325041,368933
hdfs://spark-nn.eemcs.utwente.nl/user/s1934538/clickstream/clickstream-enwiki-2022-03.tsv.gz,Tina_Turner,23337,240433,2891,266661,77748
hdfs://spark-nn.eemcs.utwente.nl/user/s1934538/clickstream/clickstream-enwiki-2022-03.tsv.gz,1917_(2019_film),21419,72663,1579,95661,51356
hdfs://spark-nn.eemcs.utwente.nl/user/s1934538/clickstream/clickstream-enwiki-2022-03.tsv.gz,Lisa_Marie_Presley,132937,69622,278,202837,120554
hdfs://spark-nn.eemcs.utwente.nl/user/s1934538/clickstream/clickstream-enwiki-2022-03.tsv.gz,Kobe_Bryant,84041,351999,10787,446827,139524
hdfs://spark-nn.eemcs.utwente.nl/user/s1934538/clickstream/clickstream-enwiki-2022-03.tsv.gz,Aaron_Hernandez,7619,84319,605,92543,31522
hdfs://spark-nn.eemcs.utwente.nl/user/s1934538/clickstream/clickstream-enwiki-2022-03.tsv.gz,Game_of_Thrones_(season_8),15041,38306,794,54141,21012
hdfs://spark-nn.eemcs.utwente.nl/user/s1934538/clickstream/clickstream-enwiki-2022-03.tsv.gz,Joaquin_Phoenix,137965,198269,1581,337815,220645
hdfs://spark-nn.eemcs.utwente.nl/user/s1934538/clickstream/clickstream-enwiki-2022-03.tsv.gz,Everything_Everywhere_All_at_Once,58957,302467,4742,366166,138228
hdfs://spark-nn.eemcs.utwente.nl/user/s1934538/clickstream/clickstream-enwiki-2022-03.tsv.gz,"Prince_Philip,_Duke_of_Edinburgh",158915,199715,2481,361111,204954
hdfs://spark-nn.eemcs.utwente.nl/user/s1934538/clickstream/clickstream-enwiki-2022-03.tsv.gz,Us_(2019_film),30162,61006,336,91504,33127
hdfs://spark-nn.eemcs.utwente.nl/user/s1934538/clickstream/clickstream-enwiki-2022-03.tsv.gz,Dune_(2021_film),261283,878475,8817,1148575,770377
hdfs://spark-nn.eemcs.utwente.nl/user/s1934538/clickstream/clickstream-enwiki-2022-03.tsv.gz,Kobe_Bryant_sexual_assault_case,9492,31558,413,41463,4615
hdfs://spark-nn.eemcs.utwente.nl/user/s1934538/clickstream/clickstream-enwiki-2022-03.tsv.gz,Black_Adam_(film),86799,73107,1409,161315,101057
hdfs://spark-nn.eemcs.utwente.nl/user/s1934538/clickstream/clickstream-enwiki-2022-03.tsv.gz,Betty_White,48910,152009,2732,203651,57520
hdfs://spark-nn.eemcs.utwente.nl/user/s1934538/clickstream/clickstream-enwiki-2022-03.tsv.gz,Amy_Coney_Barrett,55271,143451,1811,200533,60003
hdfs://spark-nn.eemcs.utwente.nl/user/s1934538/clickstream/clickstream-enwiki-2022-03.tsv.gz,Sylvester_Stallone,86567,234297,2848,323712,225094
hdfs://spark-nn.eemcs.utwente.nl/user/s1934538/clickstream/clickstream-enwiki-2022-03.tsv.gz,The_Falcon_and_the_Winter_Soldier,29021,55078,1165,85264,50656
hdfs://spark-nn.eemcs.utwente.nl/user/s1934538/clickstream/clickstream-enwiki-2022-03.tsv.gz,List_of_FIFA_World_Cup_finals,5196,84979,118,90293,23844
hdfs://spark-nn.eemcs.utwente.nl/user/s1934538/clickstream/clickstream-enwiki-2022-03.tsv.gz,Michael_Jordan,101984,515115,5918,623017,201649
hdfs://spark-nn.eemcs.utwente.nl/user/s1934538/clickstream/clickstream-enwiki-2022-03.tsv.gz,Fantastic_Beasts:_The_Crimes_of_Grindelwald,102486,93569,1578,197633,124687
hdfs://spark-nn.eemcs.utwente.nl/user/s1934538/clickstream/clickstream-enwiki-2022-03.tsv.gz,Wikipedia,244466,1011029,1732,1257227,420701
hdfs://spark-nn.eemcs.utwente.nl/user/s1934538/clickstream/clickstream-enwiki-2022-03.tsv.gz,2016_United_States_presidential_election,94663,83236,1179,179078,138587
hdfs://spark-nn.eemcs.utwente.nl/user/s1934538/clickstream/clickstream-enwiki-2022-03.tsv.gz,Mulan_(2020_film),18419,43605,756,62780,32866
hdfs://spark-nn.eemcs.utwente.nl/user/s1934538/clickstream/clickstream-enwiki-2022-03.tsv.gz,Juneteenth,5509,65680,261,71450,4788
hdfs://spark-nn.eemcs.utwente.nl/user/s1934538/clickstream/clickstream-enwiki-2022-03.tsv.gz,Area_51,17531,125810,1306,144647,44713
hdfs://spark-nn.eemcs.utwente.nl/user/s1934538/clickstream/clickstream-enwiki-2022-03.tsv.gz,Saaho,45913,75185,317,121415,34018
hdfs://spark-nn.eemcs.utwente.nl/user/s1934538/clickstream/clickstream-enwiki-2022-03.tsv.gz,The_Haunting_of_Bly_Manor,18458,37149,371,55978,29296
hdfs://spark-nn.eemcs.utwente.nl/user/s1934538/clickstream/clickstream-enwiki-2022-03.tsv.gz,"Citizenship_(Amendment)_Act,_2019",5560,24216,30,29806,3711
hdfs://spark-nn.eemcs.utwente.nl/user/s1934538/clickstream/clickstream-enwiki-2022-03.tsv.gz,Spider-Man:_No_Way_Home,315811,1294041,36097,1645949,883151
hdfs://spark-nn.eemcs.utwente.nl/user/s1934538/clickstream/clickstream-enwiki-2022-03.tsv.gz,Kamala_Harris,101123,364900,3617,469640,181774
hdfs://spark-nn.eemcs.utwente.nl/user/s1934538/clickstream/clickstream-enwiki-2022-03.tsv.gz,Elon_Musk,120710,1738543,17878,1877131,1177539
hdfs://spark-nn.eemcs.utwente.nl/user/s1934538/clickstream/clickstream-enwiki-2022-03.tsv.gz,Michael_Bloomberg,26746,28183,137,55066,23350
hdfs://spark-nn.eemcs.utwente.nl/user/s1934538/clickstream/clickstream-enwiki-2022-03.tsv.gz,Sridevi,32843,78638,251,111732,54772
hdfs://spark-nn.eemcs.utwente.nl/user/s1934538/clickstream/clickstream-enwiki-2022-03.tsv.gz,Salman_Rushdie,25349,56839,340,82528,32942
hdfs://spark-nn.eemcs.utwente.nl/user/s1934538/clickstream/clickstream-enwiki-2022-03.tsv.gz,Cook's_Country,404,1934,16,2354,646
hdfs://spark-nn.eemcs.utwente.nl/user/s1934538/clickstream/clickstream-enwiki-2022-03.tsv.gz,Henry_V_of_England,90343,105354,409,196106,142682
hdfs://spark-nn.eemcs.utwente.nl/user/s1934538/clickstream/clickstream-enwiki-2022-03.tsv.gz,Louis_Tomlinson,25268,49590,214,75072,22458
hdfs://spark-nn.eemcs.utwente.nl/user/s1934538/clickstream/clickstream-enwiki-2022-03.tsv.gz,Bridgerton,208375,1528815,40022,1777212,1948814
hdfs://spark-nn.eemcs.utwente.nl/user/s1934538/clickstream/clickstream-enwiki-2022-03.tsv.gz,The_Flash_(film),135115,125752,3013,263880,156942
hdfs://spark-nn.eemcs.utwente.nl/user/s1934538/clickstream/clickstream-enwiki-2022-03.tsv.gz,Sinéad_O'Connor,17255,96316,876,114447,35860
hdfs://spark-nn.eemcs.utwente.nl/user/s1934538/clickstream/clickstream-enwiki-2022-03.tsv.gz,Microsoft_Office,7814,2462494,820,2471128,18893
hdfs://spark-nn.eemcs.utwente.nl/user/s1934538/clickstream/clickstream-enwiki-2022-03.tsv.gz,Queen_(band),49820,175149,2836,227805,208946
hdfs://spark-nn.eemcs.utwente.nl/user/s1934538/clickstream/clickstream-enwiki-2022-03.tsv.gz,Richard_Ramirez,17215,174275,42198,233688,76053
hdfs://spark-nn.eemcs.utwente.nl/user/s1934538/clickstream/clickstream-enwiki-2022-03.tsv.gz,Kelly_Preston,85703,105050,540,191293,56342
hdfs://spark-nn.eemcs.utwente.nl/user/s1934538/clickstream/clickstream-enwiki-2022-03.tsv.gz,HTTP_cookie,3184,305608,123,308915,21413
hdfs://spark-nn.eemcs.utwente.nl/user/s1934538/clickstream/clickstream-enwiki-2022-03.tsv.gz,Anna_Sorokin,411997,3835693,14317,4262007,1656544
hdfs://spark-nn.eemcs.utwente.nl/user/s1934538/clickstream/clickstream-enwiki-2022-03.tsv.gz,September_11_attacks,93510,240146,4128,337784,188982
hdfs://spark-nn.eemcs.utwente.nl/user/s1934538/clickstream/clickstream-enwiki-2022-03.tsv.gz,WrestleMania_34,47990,22948,211,71149,46629
hdfs://spark-nn.eemcs.utwente.nl/user/s1934538/clickstream/clickstream-enwiki-2022-03.tsv.gz,Avengers:_Endgame,94413,156499,2689,253601,137574
hdfs://spark-nn.eemcs.utwente.nl/user/s1934538/clickstream/clickstream-enwiki-2022-03.tsv.gz,2022_FIFA_World_Cup,308609,1219970,36119,1564698,1022860
hdfs://spark-nn.eemcs.utwente.nl/user/s1934538/clickstream/clickstream-enwiki-2022-03.tsv.gz,Khabib_Nurmagomedov,72511,294502,2944,369957,214034
hdfs://spark-nn.eemcs.utwente.nl/user/s1934538/clickstream/clickstream-enwiki-2022-03.tsv.gz,XXX:_Return_of_Xander_Cage,78998,1408163,1256,1488417,139370
hdfs://spark-nn.eemcs.utwente.nl/user/s1934538/clickstream/clickstream-enwiki-2022-03.tsv.gz,2020_United_States_presidential_election,126436,187373,4787,318596,277767
hdfs://spark-nn.eemcs.utwente.nl/user/s1934538/clickstream/clickstream-enwiki-2022-03.tsv.gz,Hyphen-minus,970,7488488,22912,7512370,751
hdfs://spark-nn.eemcs.utwente.nl/user/s1934538/clickstream/clickstream-enwiki-2022-03.tsv.gz,Black_Panther:_Wakanda_Forever,114250,76685,3944,194879,149648
hdfs://spark-nn.eemcs.utwente.nl/user/s1934538/clickstream/clickstream-enwiki-2022-03.tsv.gz,Hamas,30185,33866,261,64312,26489
hdfs://spark-nn.eemcs.utwente.nl/user/s1934538/clickstream/clickstream-enwiki-2022-03.tsv.gz,Laal_Singh_Chaddha,43948,59145,633,103726,56517
hdfs://spark-nn.eemcs.utwente.nl/user/s1934538/clickstream/clickstream-enwiki-2022-03.tsv.gz,Venom_(2018_film),32781,115858,1335,149974,67819
hdfs://spark-nn.eemcs.utwente.nl/user/s1934538/clickstream/clickstream-enwiki-2022-03.tsv.gz,Fyre_Festival,19463,185358,1161,205982,103716
hdfs://spark-nn.eemcs.utwente.nl/user/s1934538/clickstream/clickstream-enwiki-2022-03.tsv.gz,Matthew_Perry,46663,107348,899,154910,98773
hdfs://spark-nn.eemcs.utwente.nl/user/s1934538/clickstream/clickstream-enwiki-2022-03.tsv.gz,Joker_(2019_film),79945,240866,3596,324407,155509
hdfs://spark-nn.eemcs.utwente.nl/user/s1934538/clickstream/clickstream-enwiki-2022-03.tsv.gz,Anthony_Bourdain,25078,227973,2132,255183,81474
hdfs://spark-nn.eemcs.utwente.nl/user/s1934538/clickstream/clickstream-enwiki-2022-03.tsv.gz,Sidharth_Shukla,8262,42772,156,51190,11274
hdfs://spark-nn.eemcs.utwente.nl/user/s1934538/clickstream/clickstream-enwiki-2022-03.tsv.gz,"Princess_Margaret,_Countess_of_Snowdon",80141,180023,1534,261698,150721
hdfs://spark-nn.eemcs.utwente.nl/user/s1934538/clickstream/clickstream-enwiki-2022-03.tsv.gz,Brett_Kavanaugh,42471,87849,958,131278,42700
hdfs://spark-nn.eemcs.utwente.nl/user/s1934538/clickstream/clickstream-enwiki-2022-03.tsv.gz,Simone_Biles,10636,83090,689,94415,25370
hdfs://spark-nn.eemcs.utwente.nl/user/s1934538/clickstream/clickstream-enwiki-2022-03.tsv.gz,Nipsey_Hussle,22516,96149,746,119411,37732
hdfs://spark-nn.eemcs.utwente.nl/user/s1934538/clickstream/clickstream-enwiki-2022-03.tsv.gz,Loki_(TV_series),36945,91567,2171,130683,70609
hdfs://spark-nn.eemcs.utwente.nl/user/s1934538/clickstream/clickstream-enwiki-2022-03.tsv.gz,Bob_Saget,35308,208046,3166,246520,52758
hdfs://spark-nn.eemcs.utwente.nl/user/s1934538/clickstream/clickstream-enwiki-2022-03.tsv.gz,Adele,30167,252417,3132,285716,101623
hdfs://spark-nn.eemcs.utwente.nl/user/s1934538/clickstream/clickstream-enwiki-2022-03.tsv.gz,Kylian_Mbappé,37073,240950,2581,280604,58051
hdfs://spark-nn.eemcs.utwente.nl/user/s1934538/clickstream/clickstream-enwiki-2022-03.tsv.gz,Richard_Jewell,12323,60889,336,73548,27574
hdfs://spark-nn.eemcs.utwente.nl/user/s1934538/clickstream/clickstream-enwiki-2022-03.tsv.gz,Jimmy_Hoffa,25531,130600,1615,157746,60990
hdfs://spark-nn.eemcs.utwente.nl/user/s1934538/clickstream/clickstream-enwiki-2022-03.tsv.gz,Kim_Jong-un,82814,208436,3581,294831,157198
hdfs://spark-nn.eemcs.utwente.nl/user/s1934538/clickstream/clickstream-enwiki-2022-03.tsv.gz,Greta_Thunberg,9229,137510,1251,147990,28608
hdfs://spark-nn.eemcs.utwente.nl/user/s1934538/clickstream/clickstream-enwiki-2022-03.tsv.gz,Cleopatra,56856,3423787,2544,3483187,286676
hdfs://spark-nn.eemcs.utwente.nl/user/s1934538/clickstream/clickstream-enwiki-2022-03.tsv.gz,Ghislaine_Maxwell,39606,85581,411,125598,43810
hdfs://spark-nn.eemcs.utwente.nl/user/s1934538/clickstream/clickstream-enwiki-2022-03.tsv.gz,John_McCain,31325,80620,842,112787,49447
hdfs://spark-nn.eemcs.utwente.nl/user/s1934538/clickstream/clickstream-enwiki-2022-03.tsv.gz,K.G.F:_Chapter_2,71221,433059,2940,507220,235372
hdfs://spark-nn.eemcs.utwente.nl/user/s1934538/clickstream/clickstream-enwiki-2022-03.tsv.gz,Cricket_World_Cup,21883,131009,736,153628,134584
hdfs://spark-nn.eemcs.utwente.nl/user/s1934538/clickstream/clickstream-enwiki-2022-03.tsv.gz,COVID-19_pandemic_by_country_and_territory,44022,111461,2375,157858,88264
hdfs://spark-nn.eemcs.utwente.nl/user/s1934538/clickstream/clickstream-enwiki-2022-03.tsv.gz,Pelé,32607,120947,1205,154759,52681
hdfs://spark-nn.eemcs.utwente.nl/user/s1934538/clickstream/clickstream-enwiki-2022-03.tsv.gz,Tunnel,4066,7770,92,11928,3507
hdfs://spark-nn.eemcs.utwente.nl/user/s1934538/clickstream/clickstream-enwiki-2022-03.tsv.gz,Tenet_(film),99657,162896,1994,264547,122724
hdfs://spark-nn.eemcs.utwente.nl/user/s1934538/clickstream/clickstream-enwiki-2022-03.tsv.gz,Anne_Heche,24500,40452,380,65332,22152
hdfs://spark-nn.eemcs.utwente.nl/user/s1934538/clickstream/clickstream-enwiki-2022-03.tsv.gz,Ted_Bundy,33886,278842,4136,316864,76204
hdfs://spark-nn.eemcs.utwente.nl/user/s1934538/clickstream/clickstream-enwiki-2022-03.tsv.gz,Ponniyin_Selvan:_I,78254,176516,1644,256414,269625
hdfs://spark-nn.eemcs.utwente.nl/user/s1934538/clickstream/clickstream-enwiki-2022-03.tsv.gz,Cristiano_Ronaldo,131927,1034503,8040,1174470,267885
hdfs://spark-nn.eemcs.utwente.nl/user/s1934538/clickstream/clickstream-enwiki-2022-03.tsv.gz,The_Matrix_Resurrections,93541,194223,5513,293277,139454
hdfs://spark-nn.eemcs.utwente.nl/user/s1934538/clickstream/clickstream-enwiki-2022-03.tsv.gz,No_Time_to_Die,152339,400248,6563,559150,353970
hdfs://spark-nn.eemcs.utwente.nl/user/s1934538/clickstream/clickstream-enwiki-2022-03.tsv.gz,Squid_Game,30661,201140,5439,237240,127740
hdfs://spark-nn.eemcs.utwente.nl/user/s1934538/clickstream/clickstream-enwiki-2022-03.tsv.gz,Taliban,57301,84082,1886,143269,99537
hdfs://spark-nn.eemcs.utwente.nl/user/s1934538/clickstream/clickstream-enwiki-2023-09.tsv.gz,Stranger_Things,54119,243515,4183,301817,213220
hdfs://spark-nn.eemcs.utwente.nl/user/s1934538/clickstream/clickstream-enwiki-2023-09.tsv.gz,Priyanka_Chopra,199722,476758,1064,677544,224659
hdfs://spark-nn.eemcs.utwente.nl/user/s1934538/clickstream/clickstream-enwiki-2023-09.tsv.gz,Key_frame,603,2739,10,3352,227
hdfs://spark-nn.eemcs.utwente.nl/user/s1934538/clickstream/clickstream-enwiki-2023-09.tsv.gz,List_of_Queen_of_the_South_episodes,4332,3458,20,7810,184
hdfs://spark-nn.eemcs.utwente.nl/user/s1934538/clickstream/clickstream-enwiki-2023-09.tsv.gz,Death_of_Elisa_Lam,7635,46775,150,54560,17698
hdfs://spark-nn.eemcs.utwente.nl/user/s1934538/clickstream/clickstream-enwiki-2023-09.tsv.gz,XXXTentacion,40237,997274,4598,1042109,74653
hdfs://spark-nn.eemcs.utwente.nl/user/s1934538/clickstream/clickstream-enwiki-2023-09.tsv.gz,List_of_James_Bond_films,48587,284261,1171,334019,218765
hdfs://spark-nn.eemcs.utwente.nl/user/s1934538/clickstream/clickstream-enwiki-2023-09.tsv.gz,Pelé,31049,162143,1322,194514,62475
hdfs://spark-nn.eemcs.utwente.nl/user/s1934538/clickstream/clickstream-enwiki-2023-09.tsv.gz,The_Sandman_(TV_series),32975,60408,929,94312,53717
hdfs://spark-nn.eemcs.utwente.nl/user/s1934538/clickstream/clickstream-enwiki-2023-09.tsv.gz,Indian_Premier_League,17949,102627,197,120773,36282
hdfs://spark-nn.eemcs.utwente.nl/user/s1934538/clickstream/clickstream-enwiki-2023-09.tsv.gz,JSON_Web_Token,633,21171,58,21862,1745
hdfs://spark-nn.eemcs.utwente.nl/user/s1934538/clickstream/clickstream-enwiki-2023-09.tsv.gz,When_They_See_Us,12564,22049,162,34775,13871
hdfs://spark-nn.eemcs.utwente.nl/user/s1934538/clickstream/clickstream-enwiki-2023-09.tsv.gz,XHamster,6067,491699,5395,503161,40488
hdfs://spark-nn.eemcs.utwente.nl/user/s1934538/clickstream/clickstream-enwiki-2023-09.tsv.gz,Nipsey_Hussle,19370,62691,387,82448,27161
hdfs://spark-nn.eemcs.utwente.nl/user/s1934538/clickstream/clickstream-enwiki-2023-09.tsv.gz,List_of_highest-grossing_Indian_films,608764,1900111,22042,2530917,1147704
hdfs://spark-nn.eemcs.utwente.nl/user/s1934538/clickstream/clickstream-enwiki-2023-09.tsv.gz,Amy_Coney_Barrett,19494,21001,111,40606,13290
hdfs://spark-nn.eemcs.utwente.nl/user/s1934538/clickstream/clickstream-enwiki-2023-09.tsv.gz,Jason_Momoa,71153,313835,1468,386456,163598
hdfs://spark-nn.eemcs.utwente.nl/user/s1934538/clickstream/clickstream-enwiki-2023-09.tsv.gz,Elizabeth_II,283915,532849,6244,823008,466013
hdfs://spark-nn.eemcs.utwente.nl/user/s1934538/clickstream/clickstream-enwiki-2023-09.tsv.gz,NATO,61706,171856,4801,238363,107719
hdfs://spark-nn.eemcs.utwente.nl/user/s1934538/clickstream/clickstream-enwiki-2023-09.tsv.gz,Jawan_(film),591036,12940309,61638,13592983,4254268
hdfs://spark-nn.eemcs.utwente.nl/user/s1934538/clickstream/clickstream-enwiki-2023-09.tsv.gz,2016_United_States_presidential_election,115352,74892,1057,191301,174745
hdfs://spark-nn.eemcs.utwente.nl/user/s1934538/clickstream/clickstream-enwiki-2023-09.tsv.gz,Once_Upon_a_Time_in_Hollywood,86348,128178,1491,216017,211564
hdfs://spark-nn.eemcs.utwente.nl/user/s1934538/clickstream/clickstream-enwiki-2023-09.tsv.gz,Cristiano_Ronaldo,144166,1239403,6508,1390077,310415
hdfs://spark-nn.eemcs.utwente.nl/user/s1934538/clickstream/clickstream-enwiki-2023-09.tsv.gz,"Prince_Philip,_Duke_of_Edinburgh",104319,95947,890,201156,125251
hdfs://spark-nn.eemcs.utwente.nl/user/s1934538/clickstream/clickstream-enwiki-2023-09.tsv.gz,Loki_(TV_series),28743,80667,2950,112360,63626
hdfs://spark-nn.eemcs.utwente.nl/user/s1934538/clickstream/clickstream-enwiki-2023-09.tsv.gz,Aaron_Carter,32214,101206,687,134107,85300
hdfs://spark-nn.eemcs.utwente.nl/user/s1934538/clickstream/clickstream-enwiki-2023-09.tsv.gz,2020_Summer_Olympics,64130,57927,978,123035,109204
hdfs://spark-nn.eemcs.utwente.nl/user/s1934538/clickstream/clickstream-enwiki-2023-09.tsv.gz,Grover,1063,6362,38,7463,1293
hdfs://spark-nn.eemcs.utwente.nl/user/s1934538/clickstream/clickstream-enwiki-2023-09.tsv.gz,Hamas,23991,19594,188,43773,27026
hdfs://spark-nn.eemcs.utwente.nl/user/s1934538/clickstream/clickstream-enwiki-2023-09.tsv.gz,Shakira,30924,452054,3857,486835,206240
hdfs://spark-nn.eemcs.utwente.nl/user/s1934538/clickstream/clickstream-enwiki-2023-09.tsv.gz,Lance_Reddick,71661,146959,596,219216,56555
hdfs://spark-nn.eemcs.utwente.nl/user/s1934538/clickstream/clickstream-enwiki-2023-09.tsv.gz,Louis_Tomlinson,25268,43632,446,69346,18419
hdfs://spark-nn.eemcs.utwente.nl/user/s1934538/clickstream/clickstream-enwiki-2023-09.tsv.gz,Keanu_Reeves,98799,540593,3660,643052,391308
hdfs://spark-nn.eemcs.utwente.nl/user/s1934538/clickstream/clickstream-enwiki-2023-09.tsv.gz,XXX:_Return_of_Xander_Cage,56310,3387460,1209,3444979,161108
hdfs://spark-nn.eemcs.utwente.nl/user/s1934538/clickstream/clickstream-enwiki-2023-09.tsv.gz,Cardi_B,39893,258529,2900,301322,93718
hdfs://spark-nn.eemcs.utwente.nl/user/s1934538/clickstream/clickstream-enwiki-2023-09.tsv.gz,Puneeth_Rajkumar,38195,115307,92,153594,56404
hdfs://spark-nn.eemcs.utwente.nl/user/s1934538/clickstream/clickstream-enwiki-2023-09.tsv.gz,The_Haunting_of_Bly_Manor,29668,50988,439,81095,45611
hdfs://spark-nn.eemcs.utwente.nl/user/s1934538/clickstream/clickstream-enwiki-2023-09.tsv.gz,Olivia_Newton-John,30816,137244,1226,169286,72585
hdfs://spark-nn.eemcs.utwente.nl/user/s1934538/clickstream/clickstream-enwiki-2023-09.tsv.gz,Kobe_Bryant_sexual_assault_case,7835,36853,38,44726,4173
hdfs://spark-nn.eemcs.utwente.nl/user/s1934538/clickstream/clickstream-enwiki-2023-09.tsv.gz,It_Chapter_Two,28493,42772,421,71686,46993
hdfs://spark-nn.eemcs.utwente.nl/user/s1934538/clickstream/clickstream-enwiki-2023-09.tsv.gz,John_Wick:_Chapter_4,77493,243939,5212,326644,220729
hdfs://spark-nn.eemcs.utwente.nl/user/s1934538/clickstream/clickstream-enwiki-2023-09.tsv.gz,Main_Page,74128,130128333,4459164,134661625,30942473
hdfs://spark-nn.eemcs.utwente.nl/user/s1934538/clickstream/clickstream-enwiki-2023-09.tsv.gz,The_Lion_King_(2019_film),39051,89488,815,129354,48382
hdfs://spark-nn.eemcs.utwente.nl/user/s1934538/clickstream/clickstream-enwiki-2023-09.tsv.gz,Russo-Ukrainian_War,90943,357525,2316,450784,297524
hdfs://spark-nn.eemcs.utwente.nl/user/s1934538/clickstream/clickstream-enwiki-2023-09.tsv.gz,David_Beckham,60882,221957,1303,284142,112529
hdfs://spark-nn.eemcs.utwente.nl/user/s1934538/clickstream/clickstream-enwiki-2023-09.tsv.gz,XNXX,10585,1018382,9399,1038366,51861
hdfs://spark-nn.eemcs.utwente.nl/user/s1934538/clickstream/clickstream-enwiki-2023-09.tsv.gz,Aretha_Franklin,20551,92686,736,113973,52890
hdfs://spark-nn.eemcs.utwente.nl/user/s1934538/clickstream/clickstream-enwiki-2023-09.tsv.gz,Atal_Bihari_Vajpayee,39242,57577,55,96874,35560
hdfs://spark-nn.eemcs.utwente.nl/user/s1934538/clickstream/clickstream-enwiki-2023-09.tsv.gz,Cook's_Country,327,1809,33,2169,446
hdfs://spark-nn.eemcs.utwente.nl/user/s1934538/clickstream/clickstream-enwiki-2023-09.tsv.gz,2023_Asia_Cup,118017,8489205,2251,8609473,188740
hdfs://spark-nn.eemcs.utwente.nl/user/s1934538/clickstream/clickstream-enwiki-2023-09.tsv.gz,Charles_III,345154,227781,4094,577029,378532
hdfs://spark-nn.eemcs.utwente.nl/user/s1934538/clickstream/clickstream-enwiki-2023-09.tsv.gz,Spider-Man:_No_Way_Home,63617,109070,1135,173822,70726
hdfs://spark-nn.eemcs.utwente.nl/user/s1934538/clickstream/clickstream-enwiki-2023-09.tsv.gz,No_Time_to_Die,75254,103156,1455,179865,95878
hdfs://spark-nn.eemcs.utwente.nl/user/s1934538/clickstream/clickstream-enwiki-2023-09.tsv.gz,COVID-19_pandemic,77281,189239,5124,271644,85986
hdfs://spark-nn.eemcs.utwente.nl/user/s1934538/clickstream/clickstream-enwiki-2023-09.tsv.gz,Matthew_Perry,41620,142543,867,185030,87338
hdfs://spark-nn.eemcs.utwente.nl/user/s1934538/clickstream/clickstream-enwiki-2023-09.tsv.gz,Watts_family_murders,5530,189575,346,195451,45492
hdfs://spark-nn.eemcs.utwente.nl/user/s1934538/clickstream/clickstream-enwiki-2023-09.tsv.gz,Vladimir_Putin,104183,296313,3760,404256,244419
hdfs://spark-nn.eemcs.utwente.nl/user/s1934538/clickstream/clickstream-enwiki-2023-09.tsv.gz,Rihanna,67986,343012,3067,414065,206585
hdfs://spark-nn.eemcs.utwente.nl/user/s1934538/clickstream/clickstream-enwiki-2023-09.tsv.gz,Sinéad_O'Connor,22861,265883,5441,294185,92337
hdfs://spark-nn.eemcs.utwente.nl/user/s1934538/clickstream/clickstream-enwiki-2023-09.tsv.gz,Tonya_Harding,23311,95239,449,118999,31720
hdfs://spark-nn.eemcs.utwente.nl/user/s1934538/clickstream/clickstream-enwiki-2023-09.tsv.gz,Salaar:_Part_1_–_Ceasefire,46039,489581,2828,538448,143388
hdfs://spark-nn.eemcs.utwente.nl/user/s1934538/clickstream/clickstream-enwiki-2023-09.tsv.gz,R._Kelly,36039,139968,1584,177591,102448
hdfs://spark-nn.eemcs.utwente.nl/user/s1934538/clickstream/clickstream-enwiki-2023-09.tsv.gz,The_Batman_(film),79706,218187,3629,301522,168321
hdfs://spark-nn.eemcs.utwente.nl/user/s1934538/clickstream/clickstream-enwiki-2023-09.tsv.gz,Crazy_Rich_Asians_(film),20850,54384,544,75778,55500
hdfs://spark-nn.eemcs.utwente.nl/user/s1934538/clickstream/clickstream-enwiki-2023-09.tsv.gz,Juice_Wrld,24742,118039,1527,144308,57402
hdfs://spark-nn.eemcs.utwente.nl/user/s1934538/clickstream/clickstream-enwiki-2023-09.tsv.gz,Jeffrey_Epstein,47445,208625,1674,257744,123369
hdfs://spark-nn.eemcs.utwente.nl/user/s1934538/clickstream/clickstream-enwiki-2023-09.tsv.gz,Avengers:_Endgame,61291,115011,1601,177903,80575
hdfs://spark-nn.eemcs.utwente.nl/user/s1934538/clickstream/clickstream-enwiki-2023-09.tsv.gz,Ukraine,79988,293384,7003,380375,174408
hdfs://spark-nn.eemcs.utwente.nl/user/s1934538/clickstream/clickstream-enwiki-2023-09.tsv.gz,Jenna_Ortega,76644,384967,4359,465970,133696
hdfs://spark-nn.eemcs.utwente.nl/user/s1934538/clickstream/clickstream-enwiki-2023-09.tsv.gz,Eternals_(film),38893,75377,825,115095,72946
hdfs://spark-nn.eemcs.utwente.nl/user/s1934538/clickstream/clickstream-enwiki-2023-09.tsv.gz,Deadpool_2,29900,39287,423,69610,42632
hdfs://spark-nn.eemcs.utwente.nl/user/s1934538/clickstream/clickstream-enwiki-2023-09.tsv.gz,"Princess_Margaret,_Countess_of_Snowdon",60404,110400,791,171595,100659
hdfs://spark-nn.eemcs.utwente.nl/user/s1934538/clickstream/clickstream-enwiki-2023-09.tsv.gz,Lists_of_deaths_by_year,18570,178116,654,197340,210181
hdfs://spark-nn.eemcs.utwente.nl/user/s1934538/clickstream/clickstream-enwiki-2023-09.tsv.gz,Aquaman_(film),39933,129826,1884,171643,86277
hdfs://spark-nn.eemcs.utwente.nl/user/s1934538/clickstream/clickstream-enwiki-2023-09.tsv.gz,Cleopatra,73340,5561642,2273,5637255,456013
hdfs://spark-nn.eemcs.utwente.nl/user/s1934538/clickstream/clickstream-enwiki-2023-09.tsv.gz,Wonder_Woman_1984,25704,68853,989,95546,47453
hdfs://spark-nn.eemcs.utwente.nl/user/s1934538/clickstream/clickstream-enwiki-2023-09.tsv.gz,Ted_Bundy,26649,311267,3635,341551,83956
hdfs://spark-nn.eemcs.utwente.nl/user/s1934538/clickstream/clickstream-enwiki-2023-09.tsv.gz,Saaho,35705,44157,132,79994,20384
hdfs://spark-nn.eemcs.utwente.nl/user/s1934538/clickstream/clickstream-enwiki-2023-09.tsv.gz,John_McCain,41832,108553,1274,151659,85269
hdfs://spark-nn.eemcs.utwente.nl/user/s1934538/clickstream/clickstream-enwiki-2023-09.tsv.gz,Joaquin_Phoenix,136353,194167,1082,331602,220447
hdfs://spark-nn.eemcs.utwente.nl/user/s1934538/clickstream/clickstream-enwiki-2023-09.tsv.gz,Queen_(band),46339,148527,2544,197410,193752
hdfs://spark-nn.eemcs.utwente.nl/user/s1934538/clickstream/clickstream-enwiki-2023-09.tsv.gz,Meat_Loaf,24813,109047,1168,135028,49066
hdfs://spark-nn.eemcs.utwente.nl/user/s1934538/clickstream/clickstream-enwiki-2023-09.tsv.gz,Lionel_Messi,122889,1061554,8483,1192926,261245
hdfs://spark-nn.eemcs.utwente.nl/user/s1934538/clickstream/clickstream-enwiki-2023-09.tsv.gz,Kate_Spade,27719,55499,339,83557,28937
hdfs://spark-nn.eemcs.utwente.nl/user/s1934538/clickstream/clickstream-enwiki-2023-09.tsv.gz,ChatGPT,17694,2091888,3303,2112885,111618
hdfs://spark-nn.eemcs.utwente.nl/user/s1934538/clickstream/clickstream-enwiki-2023-09.tsv.gz,Simone_Biles,16906,109163,745,126814,50105
hdfs://spark-nn.eemcs.utwente.nl/user/s1934538/clickstream/clickstream-enwiki-2023-09.tsv.gz,Valentine's_Day,3196,35295,117,38608,3033
hdfs://spark-nn.eemcs.utwente.nl/user/s1934538/clickstream/clickstream-enwiki-2023-09.tsv.gz,21_Savage,16276,70909,539,87724,28935
hdfs://spark-nn.eemcs.utwente.nl/user/s1934538/clickstream/clickstream-enwiki-2023-09.tsv.gz,Salman_Rushdie,25874,75870,567,102311,58169
hdfs://spark-nn.eemcs.utwente.nl/user/s1934538/clickstream/clickstream-enwiki-2023-09.tsv.gz,Barbie_(film),343944,1252738,28348,1625030,1300110
hdfs://spark-nn.eemcs.utwente.nl/user/s1934538/clickstream/clickstream-enwiki-2023-09.tsv.gz,Qasem_Soleimani,12124,22327,66,34517,21237
hdfs://spark-nn.eemcs.utwente.nl/user/s1934538/clickstream/clickstream-enwiki-2023-09.tsv.gz,Burt_Reynolds,58822,138078,1175,198075,102771
hdfs://spark-nn.eemcs.utwente.nl/user/s1934538/clickstream/clickstream-enwiki-2023-09.tsv.gz,Sidharth_Shukla,7500,61770,269,69539,12799
hdfs://spark-nn.eemcs.utwente.nl/user/s1934538/clickstream/clickstream-enwiki-2023-09.tsv.gz,YouTube,127431,5715096,11468,5853995,116723
hdfs://spark-nn.eemcs.utwente.nl/user/s1934538/clickstream/clickstream-enwiki-2023-09.tsv.gz,Pornhub,54177,433692,12417,500286,73407
hdfs://spark-nn.eemcs.utwente.nl/user/s1934538/clickstream/clickstream-enwiki-2023-09.tsv.gz,Avicii,17871,205851,1327,225049,63801
hdfs://spark-nn.eemcs.utwente.nl/user/s1934538/clickstream/clickstream-enwiki-2023-09.tsv.gz,Black_Panther_(film),22485,79777,1025,103287,45583
hdfs://spark-nn.eemcs.utwente.nl/user/s1934538/clickstream/clickstream-enwiki-2023-09.tsv.gz,Bridgerton,29861,95307,1489,126657,90307
hdfs://spark-nn.eemcs.utwente.nl/user/s1934538/clickstream/clickstream-enwiki-2023-09.tsv.gz,Army_of_the_Dead,31534,30223,282,62039,30899
hdfs://spark-nn.eemcs.utwente.nl/user/s1934538/clickstream/clickstream-enwiki-2023-09.tsv.gz,2018_Winter_Olympics,10236,8738,53,19027,12089
hdfs://spark-nn.eemcs.utwente.nl/user/s1934538/clickstream/clickstream-enwiki-2023-09.tsv.gz,Cecil_Hotel_(Los_Angeles),5982,30789,80,36851,9381
hdfs://spark-nn.eemcs.utwente.nl/user/s1934538/clickstream/clickstream-enwiki-2023-09.tsv.gz,Charles_Sobhraj,8241,36705,70,45016,11093
hdfs://spark-nn.eemcs.utwente.nl/user/s1934538/clickstream/clickstream-enwiki-2023-09.tsv.gz,Johnny_Depp,117314,369148,3189,489651,320713
hdfs://spark-nn.eemcs.utwente.nl/user/s1934538/clickstream/clickstream-enwiki-2023-09.tsv.gz,Shinzo_Abe,41507,82819,4209,128535,90044
hdfs://spark-nn.eemcs.utwente.nl/user/s1934538/clickstream/clickstream-enwiki-2023-09.tsv.gz,Jeffrey_Dahmer,29751,453373,6288,489412,194702
hdfs://spark-nn.eemcs.utwente.nl/user/s1934538/clickstream/clickstream-enwiki-2023-09.tsv.gz,Croatia,52220,186779,1999,240998,75156
hdfs://spark-nn.eemcs.utwente.nl/user/s1934538/clickstream/clickstream-enwiki-2023-09.tsv.gz,The_Kerala_Story,36124,106860,8172,151156,27511
hdfs://spark-nn.eemcs.utwente.nl/user/s1934538/clickstream/clickstream-enwiki-2023-09.tsv.gz,Pathaan_(film),314011,672742,3647,990400,245267
hdfs://spark-nn.eemcs.utwente.nl/user/s1934538/clickstream/clickstream-enwiki-2023-09.tsv.gz,Deion_Sanders,191020,3880523,20944,4092487,1245359
hdfs://spark-nn.eemcs.utwente.nl/user/s1934538/clickstream/clickstream-enwiki-2023-09.tsv.gz,Parasite_(2019_film),21537,138499,1040,161076,61746
hdfs://spark-nn.eemcs.utwente.nl/user/s1934538/clickstream/clickstream-enwiki-2023-09.tsv.gz,Bible,20312,107299,1427,129038,36119
hdfs://spark-nn.eemcs.utwente.nl/user/s1934538/clickstream/clickstream-enwiki-2023-09.tsv.gz,Area_51,14428,108509,902,123839,38446
hdfs://spark-nn.eemcs.utwente.nl/user/s1934538/clickstream/clickstream-enwiki-2023-09.tsv.gz,Captain_Marvel_(film),23458,46268,637,70363,28650
hdfs://spark-nn.eemcs.utwente.nl/user/s1934538/clickstream/clickstream-enwiki-2023-09.tsv.gz,Jurassic_World_Dominion,50247,87041,776,138064,79985
hdfs://spark-nn.eemcs.utwente.nl/user/s1934538/clickstream/clickstream-enwiki-2023-09.tsv.gz,Oppenheimer_(film),329061,1880760,32039,2241860,1412496
hdfs://spark-nn.eemcs.utwente.nl/user/s1934538/clickstream/clickstream-enwiki-2023-09.tsv.gz,Black_Widow_(2021_film),25120,68341,4339,97800,36022
hdfs://spark-nn.eemcs.utwente.nl/user/s1934538/clickstream/clickstream-enwiki-2023-09.tsv.gz,Mac_Miller,24104,182790,1232,208126,60193
hdfs://spark-nn.eemcs.utwente.nl/user/s1934538/clickstream/clickstream-enwiki-2023-09.tsv.gz,Elliot_Page,51395,186399,1052,238846,110710
hdfs://spark-nn.eemcs.utwente.nl/user/s1934538/clickstream/clickstream-enwiki-2023-09.tsv.gz,Joe_Exotic,23178,68723,295,92196,43859
hdfs://spark-nn.eemcs.utwente.nl/user/s1934538/clickstream/clickstream-enwiki-2023-09.tsv.gz,Dark_Phoenix_(film),36806,32643,253,69702,35909
hdfs://spark-nn.eemcs.utwente.nl/user/s1934538/clickstream/clickstream-enwiki-2023-09.tsv.gz,Kamala_Harris,81311,200030,1579,282920,132443
hdfs://spark-nn.eemcs.utwente.nl/user/s1934538/clickstream/clickstream-enwiki-2023-09.tsv.gz,Hyphen-minus,765,6250204,20605,6271574,898
hdfs://spark-nn.eemcs.utwente.nl/user/s1934538/clickstream/clickstream-enwiki-2023-09.tsv.gz,Henry_V_of_England,73415,75364,464,149243,103632
hdfs://spark-nn.eemcs.utwente.nl/user/s1934538/clickstream/clickstream-enwiki-2023-09.tsv.gz,FIFA_World_Cup,56670,268346,3366,328382,145383
hdfs://spark-nn.eemcs.utwente.nl/user/s1934538/clickstream/clickstream-enwiki-2023-09.tsv.gz,The_Kashmir_Files,20232,38222,1483,59937,21297
hdfs://spark-nn.eemcs.utwente.nl/user/s1934538/clickstream/clickstream-enwiki-2023-09.tsv.gz,Naomi_Osaka,45131,292368,1138,338637,108476
hdfs://spark-nn.eemcs.utwente.nl/user/s1934538/clickstream/clickstream-enwiki-2023-09.tsv.gz,Hamilton_(musical),21668,148318,1225,171211,99785
hdfs://spark-nn.eemcs.utwente.nl/user/s1934538/clickstream/clickstream-enwiki-2023-09.tsv.gz,2.0_(film),63277,55828,165,119270,25497
hdfs://spark-nn.eemcs.utwente.nl/user/s1934538/clickstream/clickstream-enwiki-2023-09.tsv.gz,The_Mandalorian,64780,136743,3100,204623,147287
hdfs://spark-nn.eemcs.utwente.nl/user/s1934538/clickstream/clickstream-enwiki-2023-09.tsv.gz,Doctor_Strange_in_the_Multiverse_of_Madness,42211,77426,1145,120782,51284
hdfs://spark-nn.eemcs.utwente.nl/user/s1934538/clickstream/clickstream-enwiki-2023-09.tsv.gz,Google_logo,4224,34033,71,38328,7289
hdfs://spark-nn.eemcs.utwente.nl/user/s1934538/clickstream/clickstream-enwiki-2023-09.tsv.gz,"Diana,_Princess_of_Wales",122228,267940,2615,392783,218528
hdfs://spark-nn.eemcs.utwente.nl/user/s1934538/clickstream/clickstream-enwiki-2023-09.tsv.gz,Volodymyr_Zelenskyy,73959,200977,1906,276842,144658
hdfs://spark-nn.eemcs.utwente.nl/user/s1934538/clickstream/clickstream-enwiki-2023-09.tsv.gz,William_Murdoch,548,1231,11,1790,250
hdfs://spark-nn.eemcs.utwente.nl/user/s1934538/clickstream/clickstream-enwiki-2023-09.tsv.gz,Venom_(2018_film),12625,50956,526,64107,25843
hdfs://spark-nn.eemcs.utwente.nl/user/s1934538/clickstream/clickstream-enwiki-2023-09.tsv.gz,Spider-Man:_Far_From_Home,27140,35379,255,62774,23623
hdfs://spark-nn.eemcs.utwente.nl/user/s1934538/clickstream/clickstream-enwiki-2023-09.tsv.gz,2023_Cricket_World_Cup,111729,1670601,3163,1785493,362705
hdfs://spark-nn.eemcs.utwente.nl/user/s1934538/clickstream/clickstream-enwiki-2023-09.tsv.gz,Wikipedia,242339,1497766,922,1741027,687563
hdfs://spark-nn.eemcs.utwente.nl/user/s1934538/clickstream/clickstream-enwiki-2023-09.tsv.gz,Dennis_Nilsen,9232,48838,254,58324,14770
hdfs://spark-nn.eemcs.utwente.nl/user/s1934538/clickstream/clickstream-enwiki-2023-09.tsv.gz,Anthony_Bourdain,22193,208591,1989,232773,102083
hdfs://spark-nn.eemcs.utwente.nl/user/s1934538/clickstream/clickstream-enwiki-2023-09.tsv.gz,United_States_Electoral_College,15127,32599,121,47847,9434
hdfs://spark-nn.eemcs.utwente.nl/user/s1934538/clickstream/clickstream-enwiki-2023-09.tsv.gz,2022_FIFA_World_Cup,122699,180494,2338,305531,181196
hdfs://spark-nn.eemcs.utwente.nl/user/s1934538/clickstream/clickstream-enwiki-2023-09.tsv.gz,Mötley_Crüe,23538,74170,1023,98731,116085
hdfs://spark-nn.eemcs.utwente.nl/user/s1934538/clickstream/clickstream-enwiki-2023-09.tsv.gz,Taliban,53803,74201,1446,129450,98790
hdfs://spark-nn.eemcs.utwente.nl/user/s1934538/clickstream/clickstream-enwiki-2023-09.tsv.gz,Alexander_Hamilton,57369,161904,1208,220481,120836
hdfs://spark-nn.eemcs.utwente.nl/user/s1934538/clickstream/clickstream-enwiki-2023-09.tsv.gz,Critical_race_theory,13685,79970,420,94075,10753
hdfs://spark-nn.eemcs.utwente.nl/user/s1934538/clickstream/clickstream-enwiki-2023-09.tsv.gz,The_Super_Mario_Bros._Movie,93971,301666,3108,398745,138888
hdfs://spark-nn.eemcs.utwente.nl/user/s1934538/clickstream/clickstream-enwiki-2023-09.tsv.gz,Irrfan_Khan,26524,83253,177,109954,36201
hdfs://spark-nn.eemcs.utwente.nl/user/s1934538/clickstream/clickstream-enwiki-2023-09.tsv.gz,Stephen_Hawking,22812,290069,1741,314622,119462
hdfs://spark-nn.eemcs.utwente.nl/user/s1934538/clickstream/clickstream-enwiki-2023-09.tsv.gz,Leave_the_World_Behind_(film),15782,15297,181,31260,11270
hdfs://spark-nn.eemcs.utwente.nl/user/s1934538/clickstream/clickstream-enwiki-2023-09.tsv.gz,Simple_Mail_Transfer_Protocol,2388,24585,120,27093,2517
hdfs://spark-nn.eemcs.utwente.nl/user/s1934538/clickstream/clickstream-enwiki-2023-09.tsv.gz,Squid_Game,20602,153652,1917,176171,81602
hdfs://spark-nn.eemcs.utwente.nl/user/s1934538/clickstream/clickstream-enwiki-2023-09.tsv.gz,Emma_Raducanu,23314,110712,565,134591,29994
hdfs://spark-nn.eemcs.utwente.nl/user/s1934538/clickstream/clickstream-enwiki-2023-09.tsv.gz,Juneteenth,7213,37794,104,45111,4499
hdfs://spark-nn.eemcs.utwente.nl/user/s1934538/clickstream/clickstream-enwiki-2023-09.tsv.gz,The_Idol_(TV_series),40587,73675,822,115084,65070
hdfs://spark-nn.eemcs.utwente.nl/user/s1934538/clickstream/clickstream-enwiki-2023-09.tsv.gz,Jimmy_Hoffa,27326,101824,760,129910,49521
hdfs://spark-nn.eemcs.utwente.nl/user/s1934538/clickstream/clickstream-enwiki-2023-09.tsv.gz,The_Flash_(film),75421,530615,7990,614026,285879
hdfs://spark-nn.eemcs.utwente.nl/user/s1934538/clickstream/clickstream-enwiki-2023-09.tsv.gz,Notre-Dame_de_Paris,13944,78492,810,93246,20252
hdfs://spark-nn.eemcs.utwente.nl/user/s1934538/clickstream/clickstream-enwiki-2023-09.tsv.gz,Sridevi,40101,103165,187,143453,57791
hdfs://spark-nn.eemcs.utwente.nl/user/s1934538/clickstream/clickstream-enwiki-2023-09.tsv.gz,COVID-19_pandemic_by_country_and_territory,5014,16518,342,21874,8814
hdfs://spark-nn.eemcs.utwente.nl/user/s1934538/clickstream/clickstream-enwiki-2023-09.tsv.gz,Saltburn_(film),54847,133307,1954,190108,105051
hdfs://spark-nn.eemcs.utwente.nl/user/s1934538/clickstream/clickstream-enwiki-2023-09.tsv.gz,Naya_Rivera,42044,46271,261,88576,41138
hdfs://spark-nn.eemcs.utwente.nl/user/s1934538/clickstream/clickstream-enwiki-2023-09.tsv.gz,The_Nun_(2018_film),154457,702264,4645,861366,448243
hdfs://spark-nn.eemcs.utwente.nl/user/s1934538/clickstream/clickstream-enwiki-2023-09.tsv.gz,Zack_Snyder's_Justice_League,41775,57048,578,99401,45486
hdfs://spark-nn.eemcs.utwente.nl/user/s1934538/clickstream/clickstream-enwiki-2023-09.tsv.gz,Dunki_(film),165489,198759,683,364931,190106
hdfs://spark-nn.eemcs.utwente.nl/user/s1934538/clickstream/clickstream-enwiki-2023-09.tsv.gz,Vikram_(2022_film),85543,186087,946,272576,90129
hdfs://spark-nn.eemcs.utwente.nl/user/s1934538/clickstream/clickstream-enwiki-2023-09.tsv.gz,The_Weeknd,61290,198291,1626,261207,111696
hdfs://spark-nn.eemcs.utwente.nl/user/s1934538/clickstream/clickstream-enwiki-2023-09.tsv.gz,Israel,86143,245284,4390,335817,168779
hdfs://spark-nn.eemcs.utwente.nl/user/s1934538/clickstream/clickstream-enwiki-2023-09.tsv.gz,Guardians_of_the_Galaxy_Vol._3,87670,377387,5507,470564,253313
hdfs://spark-nn.eemcs.utwente.nl/user/s1934538/clickstream/clickstream-enwiki-2023-09.tsv.gz,Sushma_Swaraj,11896,30592,49,42537,10548
hdfs://spark-nn.eemcs.utwente.nl/user/s1934538/clickstream/clickstream-enwiki-2023-09.tsv.gz,Fyre_Festival,10229,68882,619,79730,39336
hdfs://spark-nn.eemcs.utwente.nl/user/s1934538/clickstream/clickstream-enwiki-2023-09.tsv.gz,The_Falcon_and_the_Winter_Soldier,12367,19250,300,31917,17165
hdfs://spark-nn.eemcs.utwente.nl/user/s1934538/clickstream/clickstream-enwiki-2023-09.tsv.gz,Bob_Saget,27257,79033,668,106958,22061
hdfs://spark-nn.eemcs.utwente.nl/user/s1934538/clickstream/clickstream-enwiki-2023-09.tsv.gz,Joker_(2019_film),57887,190553,1737,250177,124984
hdfs://spark-nn.eemcs.utwente.nl/user/s1934538/clickstream/clickstream-enwiki-2023-09.tsv.gz,Tenet_(film),71831,151614,1427,224872,110335
hdfs://spark-nn.eemcs.utwente.nl/user/s1934538/clickstream/clickstream-enwiki-2023-09.tsv.gz,Black_Adam_(film),36608,105532,1285,143425,64951
hdfs://spark-nn.eemcs.utwente.nl/user/s1934538/clickstream/clickstream-enwiki-2023-12.tsv.gz,Captain_Marvel_(film),35636,83481,878,119995,49411
hdfs://spark-nn.eemcs.utwente.nl/user/s1934538/clickstream/clickstream-enwiki-2023-12.tsv.gz,Simple_Mail_Transfer_Protocol,2230,23362,95,25687,2393
hdfs://spark-nn.eemcs.utwente.nl/user/s1934538/clickstream/clickstream-enwiki-2023-12.tsv.gz,Coronavirus,5925,44068,341,50334,10834
hdfs://spark-nn.eemcs.utwente.nl/user/s1934538/clickstream/clickstream-enwiki-2023-12.tsv.gz,Sushant_Singh_Rajput,22379,97959,131,120469,56134
hdfs://spark-nn.eemcs.utwente.nl/user/s1934538/clickstream/clickstream-enwiki-2023-12.tsv.gz,1234,57,4007,26,4090,458
hdfs://spark-nn.eemcs.utwente.nl/user/s1934538/clickstream/clickstream-enwiki-2023-12.tsv.gz,Cardi_B,33032,256441,2363,291836,81980
hdfs://spark-nn.eemcs.utwente.nl/user/s1934538/clickstream/clickstream-enwiki-2023-12.tsv.gz,Hyphen-minus,894,16322385,14288,16337567,894
hdfs://spark-nn.eemcs.utwente.nl/user/s1934538/clickstream/clickstream-enwiki-2023-12.tsv.gz,The_Haunting_of_Bly_Manor,20968,44588,403,65959,35744
hdfs://spark-nn.eemcs.utwente.nl/user/s1934538/clickstream/clickstream-enwiki-2023-12.tsv.gz,Khabib_Nurmagomedov,45522,153730,940,200192,107263
hdfs://spark-nn.eemcs.utwente.nl/user/s1934538/clickstream/clickstream-enwiki-2023-12.tsv.gz,Mulan_(2020_film),15325,37601,240,53166,26458
hdfs://spark-nn.eemcs.utwente.nl/user/s1934538/clickstream/clickstream-enwiki-2023-12.tsv.gz,Game_of_Thrones,75430,369709,4606,449745,215138
hdfs://spark-nn.eemcs.utwente.nl/user/s1934538/clickstream/clickstream-enwiki-2023-12.tsv.gz,Emma_Raducanu,4434,46300,251,50985,7544
hdfs://spark-nn.eemcs.utwente.nl/user/s1934538/clickstream/clickstream-enwiki-2023-12.tsv.gz,2023_Indian_Premier_League,19050,54677,129,73856,24991
hdfs://spark-nn.eemcs.utwente.nl/user/s1934538/clickstream/clickstream-enwiki-2023-12.tsv.gz,Valentine's_Day,4364,90261,235,94860,5421
hdfs://spark-nn.eemcs.utwente.nl/user/s1934538/clickstream/clickstream-enwiki-2023-12.tsv.gz,Matthew_Perry,85711,784570,10817,881098,395552
hdfs://spark-nn.eemcs.utwente.nl/user/s1934538/clickstream/clickstream-enwiki-2023-12.tsv.gz,Kenosha_unrest_shooting,9588,21359,40,30987,8044
hdfs://spark-nn.eemcs.utwente.nl/user/s1934538/clickstream/clickstream-enwiki-2023-12.tsv.gz,Christopher_Scarver,74853,35554,23,110430,40527
hdfs://spark-nn.eemcs.utwente.nl/user/s1934538/clickstream/clickstream-enwiki-2023-12.tsv.gz,Vikram_(2022_film),56897,113687,212,170796,55238
hdfs://spark-nn.eemcs.utwente.nl/user/s1934538/clickstream/clickstream-enwiki-2023-12.tsv.gz,Salman_Rushdie,40980,81642,488,123110,67972
hdfs://spark-nn.eemcs.utwente.nl/user/s1934538/clickstream/clickstream-enwiki-2023-12.tsv.gz,Line_shaft,369,666,10,1045,118
hdfs://spark-nn.eemcs.utwente.nl/user/s1934538/clickstream/clickstream-enwiki-2023-12.tsv.gz,Black_Panther:_Wakanda_Forever,45486,73068,950,119504,70744
hdfs://spark-nn.eemcs.utwente.nl/user/s1934538/clickstream/clickstream-enwiki-2023-12.tsv.gz,Black_Widow_(2021_film),32435,86641,769,119845,47794
hdfs://spark-nn.eemcs.utwente.nl/user/s1934538/clickstream/clickstream-enwiki-2023-12.tsv.gz,XHamster,9781,1270439,6201,1286421,32933
hdfs://spark-nn.eemcs.utwente.nl/user/s1934538/clickstream/clickstream-enwiki-2023-12.tsv.gz,The_Matrix_Resurrections,53457,69052,852,123361,54895
hdfs://spark-nn.eemcs.utwente.nl/user/s1934538/clickstream/clickstream-enwiki-2023-12.tsv.gz,Top_Gun:_Maverick,99705,248935,3650,352290,265711
hdfs://spark-nn.eemcs.utwente.nl/user/s1934538/clickstream/clickstream-enwiki-2023-12.tsv.gz,QAnon,65216,93949,504,159669,51693
hdfs://spark-nn.eemcs.utwente.nl/user/s1934538/clickstream/clickstream-enwiki-2023-12.tsv.gz,Zack_Snyder's_Justice_League,61426,81047,483,142956,57110
hdfs://spark-nn.eemcs.utwente.nl/user/s1934538/clickstream/clickstream-enwiki-2023-12.tsv.gz,A_Star_Is_Born_(2018_film),31114,87956,608,119678,56774
hdfs://spark-nn.eemcs.utwente.nl/user/s1934538/clickstream/clickstream-enwiki-2023-12.tsv.gz,Elon_Musk,112713,991603,9583,1113899,689015
hdfs://spark-nn.eemcs.utwente.nl/user/s1934538/clickstream/clickstream-enwiki-2023-12.tsv.gz,Jeffrey_Dahmer,38326,467792,4427,510545,221817
hdfs://spark-nn.eemcs.utwente.nl/user/s1934538/clickstream/clickstream-enwiki-2023-12.tsv.gz,Sinéad_O'Connor,48942,378360,4301,431603,123133
hdfs://spark-nn.eemcs.utwente.nl/user/s1934538/clickstream/clickstream-enwiki-2023-12.tsv.gz,Central_Park_jogger_case,9490,45010,135,54635,14838
hdfs://spark-nn.eemcs.utwente.nl/user/s1934538/clickstream/clickstream-enwiki-2023-12.tsv.gz,2018_FIFA_World_Cup,54022,38737,388,93147,70058
hdfs://spark-nn.eemcs.utwente.nl/user/s1934538/clickstream/clickstream-enwiki-2023-12.tsv.gz,Keanu_Reeves,85618,474636,3586,563840,335565
hdfs://spark-nn.eemcs.utwente.nl/user/s1934538/clickstream/clickstream-enwiki-2023-12.tsv.gz,YouTube,125654,7103243,13471,7242368,115818
hdfs://spark-nn.eemcs.utwente.nl/user/s1934538/clickstream/clickstream-enwiki-2023-12.tsv.gz,Darth_Vader,25516,58899,494,84909,53584
hdfs://spark-nn.eemcs.utwente.nl/user/s1934538/clickstream/clickstream-enwiki-2023-12.tsv.gz,1917_(2019_film),19303,79599,1044,99946,53545
hdfs://spark-nn.eemcs.utwente.nl/user/s1934538/clickstream/clickstream-enwiki-2023-12.tsv.gz,Bridgerton,34561,129730,2069,166360,116703
hdfs://spark-nn.eemcs.utwente.nl/user/s1934538/clickstream/clickstream-enwiki-2023-12.tsv.gz,XXX:_Return_of_Xander_Cage,60124,1376283,1599,1438006,80970
hdfs://spark-nn.eemcs.utwente.nl/user/s1934538/clickstream/clickstream-enwiki-2023-12.tsv.gz,Donald_Glover,51517,134797,966,187280,77900
hdfs://spark-nn.eemcs.utwente.nl/user/s1934538/clickstream/clickstream-enwiki-2023-12.tsv.gz,Richard_Ramirez,18005,148674,1069,167748,63663
hdfs://spark-nn.eemcs.utwente.nl/user/s1934538/clickstream/clickstream-enwiki-2023-12.tsv.gz,Hamilton_(musical),23630,154997,1253,179880,105278
hdfs://spark-nn.eemcs.utwente.nl/user/s1934538/clickstream/clickstream-enwiki-2023-12.tsv.gz,Naomi_Osaka,11201,55345,351,66897,20405
hdfs://spark-nn.eemcs.utwente.nl/user/s1934538/clickstream/clickstream-enwiki-2023-12.tsv.gz,Brett_Kavanaugh,19409,23160,118,42687,16620
hdfs://spark-nn.eemcs.utwente.nl/user/s1934538/clickstream/clickstream-enwiki-2023-12.tsv.gz,Russo-Ukrainian_War,77803,353824,3166,434793,281292
hdfs://spark-nn.eemcs.utwente.nl/user/s1934538/clickstream/clickstream-enwiki-2023-12.tsv.gz,Google_logo,1679,54675,57,56411,1826
hdfs://spark-nn.eemcs.utwente.nl/user/s1934538/clickstream/clickstream-enwiki-2023-12.tsv.gz,Lionel_Messi,98209,706234,4569,809012,173824
hdfs://spark-nn.eemcs.utwente.nl/user/s1934538/clickstream/clickstream-enwiki-2023-12.tsv.gz,Spider-Man:_No_Way_Home,77557,147933,1649,227139,96254
hdfs://spark-nn.eemcs.utwente.nl/user/s1934538/clickstream/clickstream-enwiki-2023-12.tsv.gz,"Diana,_Princess_of_Wales",334689,736804,6386,1077879,690394
hdfs://spark-nn.eemcs.utwente.nl/user/s1934538/clickstream/clickstream-enwiki-2023-12.tsv.gz,Brie_Larson,87327,263641,1569,352537,148454
hdfs://spark-nn.eemcs.utwente.nl/user/s1934538/clickstream/clickstream-enwiki-2023-12.tsv.gz,John_McCain,35254,58341,650,94245,52531
hdfs://spark-nn.eemcs.utwente.nl/user/s1934538/clickstream/clickstream-enwiki-2023-12.tsv.gz,Black_Panther_(film),26844,73952,766,101562,45869
hdfs://spark-nn.eemcs.utwente.nl/user/s1934538/clickstream/clickstream-enwiki-2023-12.tsv.gz,R._Kelly,33820,144870,1255,179945,104113
hdfs://spark-nn.eemcs.utwente.nl/user/s1934538/clickstream/clickstream-enwiki-2023-12.tsv.gz,The_Weeknd,51316,221698,1728,274742,116586
hdfs://spark-nn.eemcs.utwente.nl/user/s1934538/clickstream/clickstream-enwiki-2023-12.tsv.gz,Sylvester_Stallone,107039,416511,2817,526367,399206
hdfs://spark-nn.eemcs.utwente.nl/user/s1934538/clickstream/clickstream-enwiki-2023-12.tsv.gz,Volodymyr_Zelenskyy,57409,131525,1190,190124,92389
hdfs://spark-nn.eemcs.utwente.nl/user/s1934538/clickstream/clickstream-enwiki-2023-12.tsv.gz,Avengers:_Endgame,70222,121883,1628,193733,92913
hdfs://spark-nn.eemcs.utwente.nl/user/s1934538/clickstream/clickstream-enwiki-2023-12.tsv.gz,Article_370_of_the_Constitution_of_India,3974,241128,185,245287,11102
hdfs://spark-nn.eemcs.utwente.nl/user/s1934538/clickstream/clickstream-enwiki-2023-12.tsv.gz,Taliban,35432,56231,1381,93044,73127
hdfs://spark-nn.eemcs.utwente.nl/user/s1934538/clickstream/clickstream-enwiki-2023-12.tsv.gz,The_Idol_(TV_series),33987,54581,683,89251,48448
hdfs://spark-nn.eemcs.utwente.nl/user/s1934538/clickstream/clickstream-enwiki-2023-12.tsv.gz,Us_(2019_film),25330,72112,360,97802,30190
hdfs://spark-nn.eemcs.utwente.nl/user/s1934538/clickstream/clickstream-enwiki-2023-12.tsv.gz,The_Super_Mario_Bros._Movie,97766,306783,4327,408876,243884
hdfs://spark-nn.eemcs.utwente.nl/user/s1934538/clickstream/clickstream-enwiki-2023-12.tsv.gz,Mission:_Impossible_–_Dead_Reckoning_Part_One,119720,284140,5011,408871,261874
hdfs://spark-nn.eemcs.utwente.nl/user/s1934538/clickstream/clickstream-enwiki-2023-12.tsv.gz,Pathaan_(film),133044,276411,1403,410858,83945
hdfs://spark-nn.eemcs.utwente.nl/user/s1934538/clickstream/clickstream-enwiki-2023-12.tsv.gz,Spider-Man:_Far_From_Home,35288,42820,334,78442,33366
hdfs://spark-nn.eemcs.utwente.nl/user/s1934538/clickstream/clickstream-enwiki-2023-12.tsv.gz,Richard_Jewell,8289,44131,159,52579,17280
hdfs://spark-nn.eemcs.utwente.nl/user/s1934538/clickstream/clickstream-enwiki-2023-12.tsv.gz,Doctor_Strange_in_the_Multiverse_of_Madness,53694,86643,1123,141460,60011
hdfs://spark-nn.eemcs.utwente.nl/user/s1934538/clickstream/clickstream-enwiki-2023-12.tsv.gz,2016_United_States_presidential_election,119156,82453,1113,202722,180280
hdfs://spark-nn.eemcs.utwente.nl/user/s1934538/clickstream/clickstream-enwiki-2023-12.tsv.gz,Kelly_Preston,131119,188131,535,319785,95714
hdfs://spark-nn.eemcs.utwente.nl/user/s1934538/clickstream/clickstream-enwiki-2023-12.tsv.gz,War_(2019_film),48425,57930,145,106500,26454
hdfs://spark-nn.eemcs.utwente.nl/user/s1934538/clickstream/clickstream-enwiki-2023-12.tsv.gz,Chadwick_Boseman,37112,122788,656,160556,46433
hdfs://spark-nn.eemcs.utwente.nl/user/s1934538/clickstream/clickstream-enwiki-2023-12.tsv.gz,Alexander_Hamilton,60750,165540,9007,235297,131811
hdfs://spark-nn.eemcs.utwente.nl/user/s1934538/clickstream/clickstream-enwiki-2023-12.tsv.gz,Tunnel,4498,9450,131,14079,3511
hdfs://spark-nn.eemcs.utwente.nl/user/s1934538/clickstream/clickstream-enwiki-2023-12.tsv.gz,Juice_Wrld,29361,235436,1905,266702,96505
hdfs://spark-nn.eemcs.utwente.nl/user/s1934538/clickstream/clickstream-enwiki-2023-12.tsv.gz,Fyre_Festival,5655,42097,594,48346,27180
hdfs://spark-nn.eemcs.utwente.nl/user/s1934538/clickstream/clickstream-enwiki-2023-12.tsv.gz,Dunki_(film),236703,5194197,24746,5455646,1070180
hdfs://spark-nn.eemcs.utwente.nl/user/s1934538/clickstream/clickstream-enwiki-2023-12.tsv.gz,Deadpool_2,39346,61535,775,101656,69016
hdfs://spark-nn.eemcs.utwente.nl/user/s1934538/clickstream/clickstream-enwiki-2023-12.tsv.gz,XNXX,13290,1348160,8245,1369695,81758
hdfs://spark-nn.eemcs.utwente.nl/user/s1934538/clickstream/clickstream-enwiki-2023-12.tsv.gz,United_States_Senate,49668,54966,924,105558,45183
hdfs://spark-nn.eemcs.utwente.nl/user/s1934538/clickstream/clickstream-enwiki-2023-12.tsv.gz,Vladimir_Putin,108028,372087,5478,485593,273924
hdfs://spark-nn.eemcs.utwente.nl/user/s1934538/clickstream/clickstream-enwiki-2023-12.tsv.gz,Cameron_Boyce,22791,113492,394,136677,36054
hdfs://spark-nn.eemcs.utwente.nl/user/s1934538/clickstream/clickstream-enwiki-2023-12.tsv.gz,George_H._W._Bush,162269,118385,1207,281861,175701
hdfs://spark-nn.eemcs.utwente.nl/user/s1934538/clickstream/clickstream-enwiki-2023-12.tsv.gz,Once_Upon_a_Time_in_Hollywood,100952,171291,2325,274568,284926
hdfs://spark-nn.eemcs.utwente.nl/user/s1934538/clickstream/clickstream-enwiki-2023-12.tsv.gz,Pelé,30859,171720,1771,204350,68603
hdfs://spark-nn.eemcs.utwente.nl/user/s1934538/clickstream/clickstream-enwiki-2023-12.tsv.gz,Charles_III,698106,532697,4265,1235068,894535
hdfs://spark-nn.eemcs.utwente.nl/user/s1934538/clickstream/clickstream-enwiki-2023-12.tsv.gz,Bipin_Rawat,13905,33138,51,47094,20920
hdfs://spark-nn.eemcs.utwente.nl/user/s1934538/clickstream/clickstream-enwiki-2023-12.tsv.gz,Rihanna,60779,262172,1962,324913,183444
hdfs://spark-nn.eemcs.utwente.nl/user/s1934538/clickstream/clickstream-enwiki-2023-12.tsv.gz,Mac_Miller,22818,139530,1005,163353,46486
hdfs://spark-nn.eemcs.utwente.nl/user/s1934538/clickstream/clickstream-enwiki-2023-12.tsv.gz,Atal_Bihari_Vajpayee,57044,185306,355,242705,82386
hdfs://spark-nn.eemcs.utwente.nl/user/s1934538/clickstream/clickstream-enwiki-2023-12.tsv.gz,ICC_Men's_T20_World_Cup,48958,267121,1039,317118,68259
hdfs://spark-nn.eemcs.utwente.nl/user/s1934538/clickstream/clickstream-enwiki-2023-12.tsv.gz,Antifa_(United_States),8937,45091,140,54168,9760
hdfs://spark-nn.eemcs.utwente.nl/user/s1934538/clickstream/clickstream-enwiki-2023-12.tsv.gz,Stranger_Things_(season_3),8132,14980,111,23223,12774
hdfs://spark-nn.eemcs.utwente.nl/user/s1934538/clickstream/clickstream-enwiki-2023-12.tsv.gz,Oppenheimer_(film),256263,1243931,27573,1527767,1506417
hdfs://spark-nn.eemcs.utwente.nl/user/s1934538/clickstream/clickstream-enwiki-2023-12.tsv.gz,Anthony_Bourdain,25223,276975,2027,304225,133861
hdfs://spark-nn.eemcs.utwente.nl/user/s1934538/clickstream/clickstream-enwiki-2023-12.tsv.gz,When_They_See_Us,11039,17062,95,28196,13029
hdfs://spark-nn.eemcs.utwente.nl/user/s1934538/clickstream/clickstream-enwiki-2023-12.tsv.gz,The_Kerala_Story,15556,88238,1122,104916,17818
hdfs://spark-nn.eemcs.utwente.nl/user/s1934538/clickstream/clickstream-enwiki-2023-12.tsv.gz,Afghanistan,102211,181780,5136,289127,207562
hdfs://spark-nn.eemcs.utwente.nl/user/s1934538/clickstream/clickstream-enwiki-2023-12.tsv.gz,2018_Winter_Olympics,11504,10492,83,22079,13937
hdfs://spark-nn.eemcs.utwente.nl/user/s1934538/clickstream/clickstream-enwiki-2023-12.tsv.gz,Dark_Phoenix_(film),35380,31662,257,67299,35358
hdfs://spark-nn.eemcs.utwente.nl/user/s1934538/clickstream/clickstream-enwiki-2023-12.tsv.gz,David_Beckham,64060,564168,2845,631073,255708
hdfs://spark-nn.eemcs.utwente.nl/user/s1934538/clickstream/clickstream-enwiki-2023-12.tsv.gz,Saltburn_(film),242986,4369195,27531,4639712,2134969
hdfs://spark-nn.eemcs.utwente.nl/user/s1934538/clickstream/clickstream-enwiki-2023-12.tsv.gz,Manti_Te'o,5354,38312,138,43804,6122
hdfs://spark-nn.eemcs.utwente.nl/user/s1934538/clickstream/clickstream-enwiki-2023-12.tsv.gz,The_Kashmir_Files,14458,28141,273,42872,14416
hdfs://spark-nn.eemcs.utwente.nl/user/s1934538/clickstream/clickstream-enwiki-2023-12.tsv.gz,William_Murdoch,592,1125,16,1733,337
hdfs://spark-nn.eemcs.utwente.nl/user/s1934538/clickstream/clickstream-enwiki-2023-12.tsv.gz,Eddie_Van_Halen,47538,92377,777,140692,59630
hdfs://spark-nn.eemcs.utwente.nl/user/s1934538/clickstream/clickstream-enwiki-2023-12.tsv.gz,NATO,58207,170919,4183,233309,102051
hdfs://spark-nn.eemcs.utwente.nl/user/s1934538/clickstream/clickstream-enwiki-2023-12.tsv.gz,Joe_Exotic,16557,55447,215,72219,33368
hdfs://spark-nn.eemcs.utwente.nl/user/s1934538/clickstream/clickstream-enwiki-2023-12.tsv.gz,XXXTentacion,49534,4176938,5039,4231511,170045
hdfs://spark-nn.eemcs.utwente.nl/user/s1934538/clickstream/clickstream-enwiki-2023-12.tsv.gz,2023_Asia_Cup,7662,40905,246,48813,8551
hdfs://spark-nn.eemcs.utwente.nl/user/s1934538/clickstream/clickstream-enwiki-2023-12.tsv.gz,Salaar:_Part_1_–_Ceasefire,252910,6894092,63065,7210067,1951579
hdfs://spark-nn.eemcs.utwente.nl/user/s1934538/clickstream/clickstream-enwiki-2023-12.tsv.gz,Area_51,13820,103907,796,118523,38292
hdfs://spark-nn.eemcs.utwente.nl/user/s1934538/clickstream/clickstream-enwiki-2023-12.tsv.gz,Animal_(2023_film),573411,13624579,50722,14248712,4368060
hdfs://spark-nn.eemcs.utwente.nl/user/s1934538/clickstream/clickstream-enwiki-2023-12.tsv.gz,Saaho,57389,78182,295,135866,31115
hdfs://spark-nn.eemcs.utwente.nl/user/s1934538/clickstream/clickstream-enwiki-2023-12.tsv.gz,Louis_Tomlinson,24272,39423,123,63818,16863
hdfs://spark-nn.eemcs.utwente.nl/user/s1934538/clickstream/clickstream-enwiki-2023-12.tsv.gz,The_Mandalorian,38215,107660,2809,148684,95577
hdfs://spark-nn.eemcs.utwente.nl/user/s1934538/clickstream/clickstream-enwiki-2023-12.tsv.gz,The_Nun_(2018_film),19464,71709,331,91504,42006
hdfs://spark-nn.eemcs.utwente.nl/user/s1934538/clickstream/clickstream-enwiki-2023-12.tsv.gz,Glass_(2019_film),36801,43747,234,80782,25652
hdfs://spark-nn.eemcs.utwente.nl/user/s1934538/clickstream/clickstream-enwiki-2023-12.tsv.gz,List_of_FIFA_World_Cup_finals,3453,68432,35,71920,19482
hdfs://spark-nn.eemcs.utwente.nl/user/s1934538/clickstream/clickstream-enwiki-2023-12.tsv.gz,HTTP_cookie,2207,276279,138,278624,24683
hdfs://spark-nn.eemcs.utwente.nl/user/s1934538/clickstream/clickstream-enwiki-2023-12.tsv.gz,House_of_the_Dragon,57697,306805,5571,370073,201537
hdfs://spark-nn.eemcs.utwente.nl/user/s1934538/clickstream/clickstream-enwiki-2023-12.tsv.gz,Ray_Liotta,67625,191760,1581,260966,105745
hdfs://spark-nn.eemcs.utwente.nl/user/s1934538/clickstream/clickstream-enwiki-2023-12.tsv.gz,The_Witcher_(TV_series),25087,209272,2917,237276,133264
hdfs://spark-nn.eemcs.utwente.nl/user/s1934538/clickstream/clickstream-enwiki-2023-12.tsv.gz,Game_of_Thrones_(season_8),12632,53718,302,66652,19742
hdfs://spark-nn.eemcs.utwente.nl/user/s1934538/clickstream/clickstream-enwiki-2023-12.tsv.gz,Kantara_(film),41333,142271,468,184072,61901
hdfs://spark-nn.eemcs.utwente.nl/user/s1934538/clickstream/clickstream-enwiki-2023-12.tsv.gz,List_of_James_Bond_films,76936,515090,1710,593736,377142
hdfs://spark-nn.eemcs.utwente.nl/user/s1934538/clickstream/clickstream-enwiki-2023-12.tsv.gz,Jeffrey_Epstein,68445,537084,2680,608209,294141
hdfs://spark-nn.eemcs.utwente.nl/user/s1934538/clickstream/clickstream-enwiki-2023-12.tsv.gz,The_Suicide_Squad_(film),73874,137680,1388,212942,139268
hdfs://spark-nn.eemcs.utwente.nl/user/s1934538/clickstream/clickstream-enwiki-2023-12.tsv.gz,Anne_Heche,42699,132826,827,176352,63948
hdfs://spark-nn.eemcs.utwente.nl/user/s1934538/clickstream/clickstream-enwiki-2023-12.tsv.gz,Michael_Bloomberg,35225,33495,177,68897,33073
hdfs://spark-nn.eemcs.utwente.nl/user/s1934538/clickstream/clickstream-enwiki-2023-12.tsv.gz,J._Robert_Oppenheimer,280746,1640523,25592,1946861,1025814
hdfs://spark-nn.eemcs.utwente.nl/user/s1934538/clickstream/clickstream-enwiki-2023-12.tsv.gz,Aaron_Hernandez,17806,146077,717,164600,63312
hdfs://spark-nn.eemcs.utwente.nl/user/s1934538/clickstream/clickstream-enwiki-2023-12.tsv.gz,Bird_Box_(film),12695,58319,497,71511,30046
hdfs://spark-nn.eemcs.utwente.nl/user/s1934538/clickstream/clickstream-enwiki-2023-12.tsv.gz,Stranger_Things,53218,252603,4423,310244,210303
hdfs://spark-nn.eemcs.utwente.nl/user/s1934538/clickstream/clickstream-enwiki-2023-12.tsv.gz,Brahmāstra:_Part_One_–_Shiva,91483,120330,273,212086,46521
hdfs://spark-nn.eemcs.utwente.nl/user/s1934538/clickstream/clickstream-enwiki-2023-12.tsv.gz,United_States_Electoral_College,16599,51754,150,68503,11839
hdfs://spark-nn.eemcs.utwente.nl/user/s1934538/clickstream/clickstream-enwiki-2023-12.tsv.gz,Cleopatra,65963,4510108,1706,4577777,407774
hdfs://spark-nn.eemcs.utwente.nl/user/s1934538/clickstream/clickstream-enwiki-2023-12.tsv.gz,"Prince_Philip,_Duke_of_Edinburgh",315107,340330,2246,657683,411986
hdfs://spark-nn.eemcs.utwente.nl/user/s1934538/clickstream/clickstream-enwiki-2023-12.tsv.gz,Squid_Game,37955,436335,4102,478392,214260
hdfs://spark-nn.eemcs.utwente.nl/user/s1934538/clickstream/clickstream-enwiki-2023-12.tsv.gz,Hamas,160141,416192,7600,583933,373538
hdfs://spark-nn.eemcs.utwente.nl/user/s1934538/clickstream/clickstream-enwiki-2023-12.tsv.gz,Lisa_Marie_Presley,290909,320569,2344,613822,344822
hdfs://spark-nn.eemcs.utwente.nl/user/s1934538/clickstream/clickstream-enwiki-2023-12.tsv.gz,"Princess_Margaret,_Countess_of_Snowdon",258866,1694410,11846,1965122,901002
hdfs://spark-nn.eemcs.utwente.nl/user/s1934538/clickstream/clickstream-enwiki-2023-12.tsv.gz,Shang-Chi_and_the_Legend_of_the_Ten_Rings,37398,71097,642,109137,57435
hdfs://spark-nn.eemcs.utwente.nl/user/s1934538/clickstream/clickstream-enwiki-2023-12.tsv.gz,Kamala_Harris,70250,142782,1451,214483,101636
hdfs://spark-nn.eemcs.utwente.nl/user/s1934538/clickstream/clickstream-enwiki-2023-12.tsv.gz,Betty_White,43737,117626,1159,162522,44726
hdfs://spark-nn.eemcs.utwente.nl/user/s1934538/clickstream/clickstream-enwiki-2023-12.tsv.gz,Leave_the_World_Behind_(film),357503,5917121,40984,6315608,2247428
hdfs://spark-nn.eemcs.utwente.nl/user/s1934538/clickstream/clickstream-enwiki-2023-12.tsv.gz,Ruth_Bader_Ginsburg,19853,93466,450,113769,31987
hdfs://spark-nn.eemcs.utwente.nl/user/s1934538/clickstream/clickstream-enwiki-2023-12.tsv.gz,The_Lion_King_(2019_film),43170,132831,935,176936,98200
hdfs://spark-nn.eemcs.utwente.nl/user/s1934538/clickstream/clickstream-enwiki-2023-12.tsv.gz,Star_Wars:_The_Rise_of_Skywalker,67585,47699,1079,116363,65993
hdfs://spark-nn.eemcs.utwente.nl/user/s1934538/clickstream/clickstream-enwiki-2023-12.tsv.gz,JSON_Web_Token,585,21348,38,21971,1597
hdfs://spark-nn.eemcs.utwente.nl/user/s1934538/clickstream/clickstream-enwiki-2023-12.tsv.gz,Stan_Lee,34613,84166,703,119482,41461
hdfs://spark-nn.eemcs.utwente.nl/user/s1934538/clickstream/clickstream-enwiki-2023-12.tsv.gz,Roe_v._Wade,15776,78013,637,94426,32792
hdfs://spark-nn.eemcs.utwente.nl/user/s1934538/clickstream/clickstream-enwiki-2023-12.tsv.gz,Carlos_Alcaraz,10381,39166,164,49711,12491
hdfs://spark-nn.eemcs.utwente.nl/user/s1934538/clickstream/clickstream-enwiki-2023-12.tsv.gz,Stephen_Hawking,22507,295334,2936,320777,119203
hdfs://spark-nn.eemcs.utwente.nl/user/s1934538/clickstream/clickstream-enwiki-2023-12.tsv.gz,Everything_Everywhere_All_at_Once,84592,313881,3525,401998,187682
hdfs://spark-nn.eemcs.utwente.nl/user/s1934538/clickstream/clickstream-enwiki-2023-12.tsv.gz,Elliot_Page,59241,171557,978,231776,122078
hdfs://spark-nn.eemcs.utwente.nl/user/s1934538/clickstream/clickstream-enwiki-2023-12.tsv.gz,Greta_Thunberg,16212,151876,1138,169226,35423
hdfs://spark-nn.eemcs.utwente.nl/user/s1934538/clickstream/clickstream-enwiki-2023-12.tsv.gz,ChatGPT,18553,2017863,4167,2040583,109528
hdfs://spark-nn.eemcs.utwente.nl/user/s1934538/clickstream/clickstream-enwiki-2023-12.tsv.gz,Media,26,11291,193,11510,884
hdfs://spark-nn.eemcs.utwente.nl/user/s1934538/clickstream/clickstream-enwiki-2023-12.tsv.gz,2018_Asian_Games,3356,3217,116,6689,4222
hdfs://spark-nn.eemcs.utwente.nl/user/s1934538/clickstream/clickstream-enwiki-2023-12.tsv.gz,The_Irishman,58526,96694,1083,156303,128113
hdfs://spark-nn.eemcs.utwente.nl/user/s1934538/clickstream/clickstream-enwiki-2023-12.tsv.gz,Tonya_Harding,24489,99595,427,124511,34088
hdfs://spark-nn.eemcs.utwente.nl/user/s1934538/clickstream/clickstream-enwiki-2023-12.tsv.gz,Tom_Brady,81635,375528,3561,460724,209012
hdfs://spark-nn.eemcs.utwente.nl/user/s1934538/clickstream/clickstream-enwiki-2023-12.tsv.gz,Barbie_(film),219421,714217,18592,952230,987571
hdfs://spark-nn.eemcs.utwente.nl/user/s1934538/clickstream/clickstream-enwiki-2023-12.tsv.gz,Deion_Sanders,34283,261942,1581,297806,84670
hdfs://spark-nn.eemcs.utwente.nl/user/s1934538/clickstream/clickstream-enwiki-2023-12.tsv.gz,2023_Israel–Hamas_war,667372,1273910,11165,1952447,1074651
hdfs://spark-nn.eemcs.utwente.nl/user/s1934538/clickstream/clickstream-enwiki-2023-12.tsv.gz,"Meghan,_Duchess_of_Sussex",123808,309648,1274,434730,239507
hdfs://spark-nn.eemcs.utwente.nl/user/s1934538/clickstream/clickstream-enwiki-2023-12.tsv.gz,Kobe_Bryant_sexual_assault_case,6959,34592,28,41579,4668
hdfs://spark-nn.eemcs.utwente.nl/user/s1934538/clickstream/clickstream-enwiki-2023-12.tsv.gz,Loki_(TV_series),38156,141379,2823,182358,119939
hdfs://spark-nn.eemcs.utwente.nl/user/s1934538/clickstream/clickstream-enwiki-2023-12.tsv.gz,Avatar:_The_Way_of_Water,82933,204097,3571,290601,136298
hdfs://spark-nn.eemcs.utwente.nl/user/s1934538/clickstream/clickstream-enwiki-2018-05.tsv.gz,List_of_awards_and_nominations_received_by_Meryl_Streep,9888,8411,121,18420,5548
hdfs://spark-nn.eemcs.utwente.nl/user/s1934538/clickstream/clickstream-enwiki-2018-05.tsv.gz,Cristiano_Ronaldo,145081,1190958,6998,1343037,258963
hdfs://spark-nn.eemcs.utwente.nl/user/s1934538/clickstream/clickstream-enwiki-2018-05.tsv.gz,Cameron_Boyce,11329,43834,116,55279,9335
hdfs://spark-nn.eemcs.utwente.nl/user/s1934538/clickstream/clickstream-enwiki-2018-05.tsv.gz,Rishi_Sunak,2262,2254,12,4528,737
hdfs://spark-nn.eemcs.utwente.nl/user/s1934538/clickstream/clickstream-enwiki-2018-05.tsv.gz,Chernobyl_(miniseries),2217,3507,12,5736,2179
hdfs://spark-nn.eemcs.utwente.nl/user/s1934538/clickstream/clickstream-enwiki-2018-05.tsv.gz,Eddie_Van_Halen,25826,41816,405,68047,24820
hdfs://spark-nn.eemcs.utwente.nl/user/s1934538/clickstream/clickstream-enwiki-2018-05.tsv.gz,Kobe_Bryant,47710,356443,2534,406687,96058
hdfs://spark-nn.eemcs.utwente.nl/user/s1934538/clickstream/clickstream-enwiki-2018-05.tsv.gz,2020_Summer_Olympics,30789,72166,820,103775,44969
hdfs://spark-nn.eemcs.utwente.nl/user/s1934538/clickstream/clickstream-enwiki-2018-05.tsv.gz,Kelly_Preston,57232,58839,198,116269,29255
hdfs://spark-nn.eemcs.utwente.nl/user/s1934538/clickstream/clickstream-enwiki-2018-05.tsv.gz,Article_370_of_the_Constitution_of_India,4431,34059,26,38516,2691
hdfs://spark-nn.eemcs.utwente.nl/user/s1934538/clickstream/clickstream-enwiki-2018-05.tsv.gz,Aaron_Hernandez,6269,114233,444,120946,28595
hdfs://spark-nn.eemcs.utwente.nl/user/s1934538/clickstream/clickstream-enwiki-2018-05.tsv.gz,Atal_Bihari_Vajpayee,40059,124984,175,165218,43348
hdfs://spark-nn.eemcs.utwente.nl/user/s1934538/clickstream/clickstream-enwiki-2018-05.tsv.gz,Asia_Cup,4697,13707,84,18488,6436
hdfs://spark-nn.eemcs.utwente.nl/user/s1934538/clickstream/clickstream-enwiki-2018-05.tsv.gz,Exo_(band),30138,1957357,902,1988397,185433
hdfs://spark-nn.eemcs.utwente.nl/user/s1934538/clickstream/clickstream-enwiki-2018-05.tsv.gz,Hyphen-minus,6119,51038701,8282511,59327331,1026
hdfs://spark-nn.eemcs.utwente.nl/user/s1934538/clickstream/clickstream-enwiki-2018-05.tsv.gz,Bipin_Rawat,5613,19290,10,24913,6654
hdfs://spark-nn.eemcs.utwente.nl/user/s1934538/clickstream/clickstream-enwiki-2018-05.tsv.gz,Hamilton_(musical),30535,338661,1819,371015,161580
hdfs://spark-nn.eemcs.utwente.nl/user/s1934538/clickstream/clickstream-enwiki-2018-05.tsv.gz,Priyanka_Chopra,71194,792230,4963,868387,165914
hdfs://spark-nn.eemcs.utwente.nl/user/s1934538/clickstream/clickstream-enwiki-2018-05.tsv.gz,Main_Page,19452,454346275,3251838,457617565,33001929
hdfs://spark-nn.eemcs.utwente.nl/user/s1934538/clickstream/clickstream-enwiki-2018-05.tsv.gz,Afghanistan,42573,157155,2119,201847,109941
hdfs://spark-nn.eemcs.utwente.nl/user/s1934538/clickstream/clickstream-enwiki-2018-05.tsv.gz,Ted_Bundy,34335,297732,4214,336281,70038
hdfs://spark-nn.eemcs.utwente.nl/user/s1934538/clickstream/clickstream-enwiki-2018-05.tsv.gz,Jeffrey_Dahmer,26659,395331,5896,427886,142427
hdfs://spark-nn.eemcs.utwente.nl/user/s1934538/clickstream/clickstream-enwiki-2018-05.tsv.gz,Crazy_Rich_Asians_(film),39632,74862,642,115136,112948
hdfs://spark-nn.eemcs.utwente.nl/user/s1934538/clickstream/clickstream-enwiki-2018-05.tsv.gz,Tom_Brady,27510,165608,1311,194429,53571
hdfs://spark-nn.eemcs.utwente.nl/user/s1934538/clickstream/clickstream-enwiki-2018-05.tsv.gz,Simple_Mail_Transfer_Protocol,5563,47782,161,53506,6233
hdfs://spark-nn.eemcs.utwente.nl/user/s1934538/clickstream/clickstream-enwiki-2018-05.tsv.gz,List_of_Marvel_Cinematic_Universe_films,372343,3130361,5158,3507862,1087786
hdfs://spark-nn.eemcs.utwente.nl/user/s1934538/clickstream/clickstream-enwiki-2018-05.tsv.gz,2018_FIFA_World_Cup,291997,1727912,33160,2053069,1198102
hdfs://spark-nn.eemcs.utwente.nl/user/s1934538/clickstream/clickstream-enwiki-2018-05.tsv.gz,Rihanna,57483,393822,3991,455296,155822
hdfs://spark-nn.eemcs.utwente.nl/user/s1934538/clickstream/clickstream-enwiki-2018-05.tsv.gz,Wikipedia,41678,471564,1296,514538,199417
hdfs://spark-nn.eemcs.utwente.nl/user/s1934538/clickstream/clickstream-enwiki-2018-05.tsv.gz,Stranger_Things,44312,368534,7968,420814,230067
hdfs://spark-nn.eemcs.utwente.nl/user/s1934538/clickstream/clickstream-enwiki-2018-05.tsv.gz,Elizabeth_II,1724119,3331195,7754,5063068,3870945
hdfs://spark-nn.eemcs.utwente.nl/user/s1934538/clickstream/clickstream-enwiki-2018-05.tsv.gz,September_11_attacks,64690,343157,2358,410205,146288
hdfs://spark-nn.eemcs.utwente.nl/user/s1934538/clickstream/clickstream-enwiki-2018-05.tsv.gz,List_of_James_Bond_films,16936,188410,229,205575,78020
hdfs://spark-nn.eemcs.utwente.nl/user/s1934538/clickstream/clickstream-enwiki-2018-05.tsv.gz,2018_Winter_Olympics,20557,69595,756,90908,35143
hdfs://spark-nn.eemcs.utwente.nl/user/s1934538/clickstream/clickstream-enwiki-2018-05.tsv.gz,J._Robert_Oppenheimer,15719,74478,221,90418,24558
hdfs://spark-nn.eemcs.utwente.nl/user/s1934538/clickstream/clickstream-enwiki-2018-05.tsv.gz,A_Quiet_Place_(film),67704,954250,10488,1032442,275761
hdfs://spark-nn.eemcs.utwente.nl/user/s1934538/clickstream/clickstream-enwiki-2018-05.tsv.gz,Richard_Jewell,1890,13233,61,15184,3122
hdfs://spark-nn.eemcs.utwente.nl/user/s1934538/clickstream/clickstream-enwiki-2018-05.tsv.gz,Simone_Biles,7182,39197,149,46528,8685
hdfs://spark-nn.eemcs.utwente.nl/user/s1934538/clickstream/clickstream-enwiki-2018-05.tsv.gz,George_H._W._Bush,108234,230579,1581,340394,146544
hdfs://spark-nn.eemcs.utwente.nl/user/s1934538/clickstream/clickstream-enwiki-2018-05.tsv.gz,Ruth_Bader_Ginsburg,24429,201170,1069,226668,71248
hdfs://spark-nn.eemcs.utwente.nl/user/s1934538/clickstream/clickstream-enwiki-2018-05.tsv.gz,Bible,13810,92599,1496,107905,31000
hdfs://spark-nn.eemcs.utwente.nl/user/s1934538/clickstream/clickstream-enwiki-2018-05.tsv.gz,QAnon,7326,73608,313,81247,14950
hdfs://spark-nn.eemcs.utwente.nl/user/s1934538/clickstream/clickstream-enwiki-2018-05.tsv.gz,Israel,122041,709666,12592,844299,338318
hdfs://spark-nn.eemcs.utwente.nl/user/s1934538/clickstream/clickstream-enwiki-2018-05.tsv.gz,Keanu_Reeves,67603,471125,3203,541931,281574
hdfs://spark-nn.eemcs.utwente.nl/user/s1934538/clickstream/clickstream-enwiki-2018-05.tsv.gz,Sylvester_Stallone,76372,380493,2444,459309,230478
hdfs://spark-nn.eemcs.utwente.nl/user/s1934538/clickstream/clickstream-enwiki-2018-05.tsv.gz,Bob_Saget,14474,43128,264,57866,9448
hdfs://spark-nn.eemcs.utwente.nl/user/s1934538/clickstream/clickstream-enwiki-2018-05.tsv.gz,Kobe_Bryant_sexual_assault_case,3053,25056,25,28134,2522
hdfs://spark-nn.eemcs.utwente.nl/user/s1934538/clickstream/clickstream-enwiki-2018-05.tsv.gz,21_Savage,34440,130175,2045,166660,52100
hdfs://spark-nn.eemcs.utwente.nl/user/s1934538/clickstream/clickstream-enwiki-2018-05.tsv.gz,Richard_Ramirez,15398,145988,1012,162398,31141
hdfs://spark-nn.eemcs.utwente.nl/user/s1934538/clickstream/clickstream-enwiki-2018-05.tsv.gz,Dark_Phoenix_(film),236320,153172,1012,390504,239710
hdfs://spark-nn.eemcs.utwente.nl/user/s1934538/clickstream/clickstream-enwiki-2018-05.tsv.gz,Game_of_Thrones,75150,456346,12196,543692,306709
hdfs://spark-nn.eemcs.utwente.nl/user/s1934538/clickstream/clickstream-enwiki-2018-05.tsv.gz,Irrfan_Khan,26805,92138,553,119496,56217
hdfs://spark-nn.eemcs.utwente.nl/user/s1934538/clickstream/clickstream-enwiki-2018-05.tsv.gz,Khabib_Nurmagomedov,19655,78828,726,99209,37909
hdfs://spark-nn.eemcs.utwente.nl/user/s1934538/clickstream/clickstream-enwiki-2018-05.tsv.gz,Qasem_Soleimani,4935,17131,105,22171,10026
hdfs://spark-nn.eemcs.utwente.nl/user/s1934538/clickstream/clickstream-enwiki-2018-05.tsv.gz,Naomi_Osaka,1490,21796,128,23414,3782
hdfs://spark-nn.eemcs.utwente.nl/user/s1934538/clickstream/clickstream-enwiki-2018-05.tsv.gz,Michael_Jordan,99056,882332,7003,988391,262074
hdfs://spark-nn.eemcs.utwente.nl/user/s1934538/clickstream/clickstream-enwiki-2018-05.tsv.gz,Sridevi,29487,177335,1007,207829,51981
hdfs://spark-nn.eemcs.utwente.nl/user/s1934538/clickstream/clickstream-enwiki-2018-05.tsv.gz,Burt_Reynolds,30691,133278,958,164927,55089
hdfs://spark-nn.eemcs.utwente.nl/user/s1934538/clickstream/clickstream-enwiki-2018-05.tsv.gz,Betty_White,39349,315268,1825,356442,52752
hdfs://spark-nn.eemcs.utwente.nl/user/s1934538/clickstream/clickstream-enwiki-2018-05.tsv.gz,Meat_Loaf,15636,73270,696,89602,28300
hdfs://spark-nn.eemcs.utwente.nl/user/s1934538/clickstream/clickstream-enwiki-2018-05.tsv.gz,Bird_Box_(film),9707,4762,114,14583,5535
hdfs://spark-nn.eemcs.utwente.nl/user/s1934538/clickstream/clickstream-enwiki-2018-05.tsv.gz,"Diana,_Princess_of_Wales",977155,3153222,13269,4143646,2452605
hdfs://spark-nn.eemcs.utwente.nl/user/s1934538/clickstream/clickstream-enwiki-2018-05.tsv.gz,Puneeth_Rajkumar,8719,19319,23,28061,12165
hdfs://spark-nn.eemcs.utwente.nl/user/s1934538/clickstream/clickstream-enwiki-2018-05.tsv.gz,Avicii,43432,1066311,15616,1125359,181221
hdfs://spark-nn.eemcs.utwente.nl/user/s1934538/clickstream/clickstream-enwiki-2018-05.tsv.gz,State_of_Palestine,101260,198476,321,300057,129653
hdfs://spark-nn.eemcs.utwente.nl/user/s1934538/clickstream/clickstream-enwiki-2018-05.tsv.gz,Anthony_Bourdain,24016,149695,1201,174912,47339
hdfs://spark-nn.eemcs.utwente.nl/user/s1934538/clickstream/clickstream-enwiki-2018-05.tsv.gz,Bonnie_and_Clyde,14977,196217,1116,212310,38625
hdfs://spark-nn.eemcs.utwente.nl/user/s1934538/clickstream/clickstream-enwiki-2018-05.tsv.gz,Juneteenth,4923,226455,340,231718,15634
hdfs://spark-nn.eemcs.utwente.nl/user/s1934538/clickstream/clickstream-enwiki-2018-05.tsv.gz,List_of_most_popular_websites,20416,126437,103,146956,58776
hdfs://spark-nn.eemcs.utwente.nl/user/s1934538/clickstream/clickstream-enwiki-2018-05.tsv.gz,Aaron_Carter,12807,38529,2555,53891,14534
hdfs://spark-nn.eemcs.utwente.nl/user/s1934538/clickstream/clickstream-enwiki-2018-05.tsv.gz,Pornhub,35815,293610,9268,338693,58994
hdfs://spark-nn.eemcs.utwente.nl/user/s1934538/clickstream/clickstream-enwiki-2018-05.tsv.gz,Matthew_Perry,47581,158972,2015,208568,84568
hdfs://spark-nn.eemcs.utwente.nl/user/s1934538/clickstream/clickstream-enwiki-2018-05.tsv.gz,Kamala_Harris,14961,136821,926,152708,43025
hdfs://spark-nn.eemcs.utwente.nl/user/s1934538/clickstream/clickstream-enwiki-2018-05.tsv.gz,Jenna_Ortega,6505,19459,123,26087,3151
hdfs://spark-nn.eemcs.utwente.nl/user/s1934538/clickstream/clickstream-enwiki-2018-05.tsv.gz,Cricket_World_Cup,7451,86016,374,93841,27852
hdfs://spark-nn.eemcs.utwente.nl/user/s1934538/clickstream/clickstream-enwiki-2018-05.tsv.gz,Alexander_Hamilton,61057,337251,1888,400196,141258
hdfs://spark-nn.eemcs.utwente.nl/user/s1934538/clickstream/clickstream-enwiki-2018-05.tsv.gz,Tina_Turner,12630,177349,1623,191602,42467
hdfs://spark-nn.eemcs.utwente.nl/user/s1934538/clickstream/clickstream-enwiki-2018-05.tsv.gz,Chadwick_Boseman,240888,610180,4266,855334,238898
hdfs://spark-nn.eemcs.utwente.nl/user/s1934538/clickstream/clickstream-enwiki-2018-05.tsv.gz,Venom_(2018_film),77980,316972,4342,399294,172887
hdfs://spark-nn.eemcs.utwente.nl/user/s1934538/clickstream/clickstream-enwiki-2018-05.tsv.gz,HTTP_cookie,5813,322894,182,328889,22508
hdfs://spark-nn.eemcs.utwente.nl/user/s1934538/clickstream/clickstream-enwiki-2018-05.tsv.gz,Prince_Harry,1512433,5396133,71603,6980169,700724
hdfs://spark-nn.eemcs.utwente.nl/user/s1934538/clickstream/clickstream-enwiki-2018-05.tsv.gz,Nipsey_Hussle,9361,35250,138,44749,16551
hdfs://spark-nn.eemcs.utwente.nl/user/s1934538/clickstream/clickstream-enwiki-2018-05.tsv.gz,Deadpool_2,619445,4145248,105835,4870528,3707218
hdfs://spark-nn.eemcs.utwente.nl/user/s1934538/clickstream/clickstream-enwiki-2018-05.tsv.gz,Saaho,36378,69893,476,106747,69441
hdfs://spark-nn.eemcs.utwente.nl/user/s1934538/clickstream/clickstream-enwiki-2018-05.tsv.gz,Microsoft_Office,8734,83590,563,92887,22100
hdfs://spark-nn.eemcs.utwente.nl/user/s1934538/clickstream/clickstream-enwiki-2018-05.tsv.gz,Michael_Bloomberg,32142,55104,271,87517,35760
hdfs://spark-nn.eemcs.utwente.nl/user/s1934538/clickstream/clickstream-enwiki-2018-05.tsv.gz,IPv4,12727,53727,197,66651,11491
hdfs://spark-nn.eemcs.utwente.nl/user/s1934538/clickstream/clickstream-enwiki-2018-05.tsv.gz,Central_Park_jogger_case,3196,29553,109,32858,3406
hdfs://spark-nn.eemcs.utwente.nl/user/s1934538/clickstream/clickstream-enwiki-2018-05.tsv.gz,The_Shape_of_Water,36492,234329,3626,274447,114489
hdfs://spark-nn.eemcs.utwente.nl/user/s1934538/clickstream/clickstream-enwiki-2018-05.tsv.gz,Cecil_Hotel_(Los_Angeles),4104,17477,41,21622,6976
hdfs://spark-nn.eemcs.utwente.nl/user/s1934538/clickstream/clickstream-enwiki-2018-05.tsv.gz,Manti_Te'o,3009,12054,68,15131,338
hdfs://spark-nn.eemcs.utwente.nl/user/s1934538/clickstream/clickstream-enwiki-2018-05.tsv.gz,Lionel_Messi,97177,825717,7693,930587,174298
hdfs://spark-nn.eemcs.utwente.nl/user/s1934538/clickstream/clickstream-enwiki-2018-05.tsv.gz,Joe_Biden,23902,86293,1166,111361,32620
hdfs://spark-nn.eemcs.utwente.nl/user/s1934538/clickstream/clickstream-enwiki-2018-05.tsv.gz,Charles_Sobhraj,2542,17456,62,20060,2604
hdfs://spark-nn.eemcs.utwente.nl/user/s1934538/clickstream/clickstream-enwiki-2018-05.tsv.gz,XXX_(franchise),34697,1803260,906,1838863,304798
hdfs://spark-nn.eemcs.utwente.nl/user/s1934538/clickstream/clickstream-enwiki-2018-05.tsv.gz,Vladimir_Putin,59879,313332,3373,376584,152629
hdfs://spark-nn.eemcs.utwente.nl/user/s1934538/clickstream/clickstream-enwiki-2018-05.tsv.gz,Cleopatra,35980,194954,1721,232655,76162
hdfs://spark-nn.eemcs.utwente.nl/user/s1934538/clickstream/clickstream-enwiki-2018-05.tsv.gz,Lisa_Marie_Presley,99754,84442,157,184353,78377
hdfs://spark-nn.eemcs.utwente.nl/user/s1934538/clickstream/clickstream-enwiki-2018-05.tsv.gz,Croatia,38318,163268,2206,203792,60147
hdfs://spark-nn.eemcs.utwente.nl/user/s1934538/clickstream/clickstream-enwiki-2018-05.tsv.gz,Cardi_B,56934,1232431,10332,1299697,340733
hdfs://spark-nn.eemcs.utwente.nl/user/s1934538/clickstream/clickstream-enwiki-2018-05.tsv.gz,Jason_Momoa,80000,342698,1516,424214,162688
hdfs://spark-nn.eemcs.utwente.nl/user/s1934538/clickstream/clickstream-enwiki-2018-05.tsv.gz,Amber_Heard,94942,154042,776,249760,101658
hdfs://spark-nn.eemcs.utwente.nl/user/s1934538/clickstream/clickstream-enwiki-2018-05.tsv.gz,Sushant_Singh_Rajput,17859,60893,379,79131,36703
hdfs://spark-nn.eemcs.utwente.nl/user/s1934538/clickstream/clickstream-enwiki-2018-05.tsv.gz,Jeffrey_Epstein,24206,36324,134,60664,12860
hdfs://spark-nn.eemcs.utwente.nl/user/s1934538/clickstream/clickstream-enwiki-2018-05.tsv.gz,Death_of_Elisa_Lam,10465,68482,300,79247,17453
hdfs://spark-nn.eemcs.utwente.nl/user/s1934538/clickstream/clickstream-enwiki-2018-05.tsv.gz,Naya_Rivera,16602,46137,61,62800,8930
hdfs://spark-nn.eemcs.utwente.nl/user/s1934538/clickstream/clickstream-enwiki-2018-08.tsv.gz,Black_Panther_(film),93286,325240,6687,425213,261595
hdfs://spark-nn.eemcs.utwente.nl/user/s1934538/clickstream/clickstream-enwiki-2018-08.tsv.gz,Stranger_Things,55748,395102,8918,459768,309298
hdfs://spark-nn.eemcs.utwente.nl/user/s1934538/clickstream/clickstream-enwiki-2018-08.tsv.gz,Lionel_Messi,58137,471748,5086,534971,109292
hdfs://spark-nn.eemcs.utwente.nl/user/s1934538/clickstream/clickstream-enwiki-2018-08.tsv.gz,Chadwick_Boseman,64726,126435,976,192137,50670
hdfs://spark-nn.eemcs.utwente.nl/user/s1934538/clickstream/clickstream-enwiki-2018-08.tsv.gz,Aaron_Carter,14949,42861,237,58047,15865
hdfs://spark-nn.eemcs.utwente.nl/user/s1934538/clickstream/clickstream-enwiki-2018-08.tsv.gz,Luke_Perry,30392,50484,336,81212,13225
hdfs://spark-nn.eemcs.utwente.nl/user/s1934538/clickstream/clickstream-enwiki-2018-08.tsv.gz,Eddie_Van_Halen,32965,44791,369,78125,30927
hdfs://spark-nn.eemcs.utwente.nl/user/s1934538/clickstream/clickstream-enwiki-2018-08.tsv.gz,Amber_Heard,101323,148867,733,250923,122029
hdfs://spark-nn.eemcs.utwente.nl/user/s1934538/clickstream/clickstream-enwiki-2018-08.tsv.gz,Adele,22272,174499,2080,198851,59022
hdfs://spark-nn.eemcs.utwente.nl/user/s1934538/clickstream/clickstream-enwiki-2018-08.tsv.gz,Afghanistan,46007,146148,2266,194421,122454
hdfs://spark-nn.eemcs.utwente.nl/user/s1934538/clickstream/clickstream-enwiki-2018-08.tsv.gz,Vladimir_Putin,58699,238881,2604,300184,134491
hdfs://spark-nn.eemcs.utwente.nl/user/s1934538/clickstream/clickstream-enwiki-2018-08.tsv.gz,Antifa_(United_States),21616,392201,1336,415153,50652
hdfs://spark-nn.eemcs.utwente.nl/user/s1934538/clickstream/clickstream-enwiki-2018-08.tsv.gz,Naomi_Osaka,1515,35389,263,37167,5765
hdfs://spark-nn.eemcs.utwente.nl/user/s1934538/clickstream/clickstream-enwiki-2018-08.tsv.gz,Michael_Jordan,43239,328020,2942,374201,108574
hdfs://spark-nn.eemcs.utwente.nl/user/s1934538/clickstream/clickstream-enwiki-2018-08.tsv.gz,Ukraine,40051,141066,2928,184045,76855
hdfs://spark-nn.eemcs.utwente.nl/user/s1934538/clickstream/clickstream-enwiki-2018-08.tsv.gz,State_of_Palestine,39822,66070,236,106128,47156
hdfs://spark-nn.eemcs.utwente.nl/user/s1934538/clickstream/clickstream-enwiki-2018-08.tsv.gz,List_of_awards_and_nominations_received_by_Meryl_Streep,17230,12068,75,29373,9992
hdfs://spark-nn.eemcs.utwente.nl/user/s1934538/clickstream/clickstream-enwiki-2018-08.tsv.gz,Grover,1222,8135,128,9485,1508
hdfs://spark-nn.eemcs.utwente.nl/user/s1934538/clickstream/clickstream-enwiki-2018-08.tsv.gz,UEFA_Euro_2020,23137,102021,836,125994,40174
hdfs://spark-nn.eemcs.utwente.nl/user/s1934538/clickstream/clickstream-enwiki-2018-08.tsv.gz,Tina_Turner,17742,271887,2889,292518,68720
hdfs://spark-nn.eemcs.utwente.nl/user/s1934538/clickstream/clickstream-enwiki-2018-08.tsv.gz,Shakira,13988,283060,2334,299382,119638
hdfs://spark-nn.eemcs.utwente.nl/user/s1934538/clickstream/clickstream-enwiki-2018-08.tsv.gz,XHamster,7599,5404469,2048,5414116,27330
hdfs://spark-nn.eemcs.utwente.nl/user/s1934538/clickstream/clickstream-enwiki-2018-08.tsv.gz,Game_of_Thrones,86262,485509,12671,584442,389395
hdfs://spark-nn.eemcs.utwente.nl/user/s1934538/clickstream/clickstream-enwiki-2018-08.tsv.gz,Alexander_Hamilton,63648,320859,1845,386352,152557
hdfs://spark-nn.eemcs.utwente.nl/user/s1934538/clickstream/clickstream-enwiki-2018-08.tsv.gz,21_Savage,34027,97250,1211,132488,44394
hdfs://spark-nn.eemcs.utwente.nl/user/s1934538/clickstream/clickstream-enwiki-2018-08.tsv.gz,Once_Upon_a_Time_in_Hollywood,169804,154092,3993,327889,364723
hdfs://spark-nn.eemcs.utwente.nl/user/s1934538/clickstream/clickstream-enwiki-2018-08.tsv.gz,Louis_Tomlinson,31879,3250931,261,3283071,13019
hdfs://spark-nn.eemcs.utwente.nl/user/s1934538/clickstream/clickstream-enwiki-2018-08.tsv.gz,2018_Winter_Olympics,39239,69990,519,109748,46206
hdfs://spark-nn.eemcs.utwente.nl/user/s1934538/clickstream/clickstream-enwiki-2018-08.tsv.gz,Asia_Cup,13517,59436,280,73233,24868
hdfs://spark-nn.eemcs.utwente.nl/user/s1934538/clickstream/clickstream-enwiki-2018-08.tsv.gz,Salman_Rushdie,21387,73852,437,95676,41663
hdfs://spark-nn.eemcs.utwente.nl/user/s1934538/clickstream/clickstream-enwiki-2018-08.tsv.gz,Cecil_Hotel_(Los_Angeles),5467,19977,269,25713,8788
hdfs://spark-nn.eemcs.utwente.nl/user/s1934538/clickstream/clickstream-enwiki-2018-08.tsv.gz,Joaquin_Phoenix,106986,161558,1117,269661,191854
hdfs://spark-nn.eemcs.utwente.nl/user/s1934538/clickstream/clickstream-enwiki-2018-08.tsv.gz,George_H._W._Bush,130731,186288,1209,318228,154079
hdfs://spark-nn.eemcs.utwente.nl/user/s1934538/clickstream/clickstream-enwiki-2018-08.tsv.gz,Simple_Mail_Transfer_Protocol,4817,36702,132,41651,5102
hdfs://spark-nn.eemcs.utwente.nl/user/s1934538/clickstream/clickstream-enwiki-2018-08.tsv.gz,Jeffrey_Epstein,8898,58336,167,67401,16827
hdfs://spark-nn.eemcs.utwente.nl/user/s1934538/clickstream/clickstream-enwiki-2018-08.tsv.gz,Aaron_Hernandez,12624,157266,924,170814,52962
hdfs://spark-nn.eemcs.utwente.nl/user/s1934538/clickstream/clickstream-enwiki-2018-08.tsv.gz,Hamilton_(musical),30646,292210,1891,324747,166805
hdfs://spark-nn.eemcs.utwente.nl/user/s1934538/clickstream/clickstream-enwiki-2018-08.tsv.gz,Coronavirus,585,5861,16,6462,864
hdfs://spark-nn.eemcs.utwente.nl/user/s1934538/clickstream/clickstream-enwiki-2018-08.tsv.gz,NATO,33648,140669,2103,176420,86097
hdfs://spark-nn.eemcs.utwente.nl/user/s1934538/clickstream/clickstream-enwiki-2018-08.tsv.gz,United_States_Senate,75061,81364,1232,157657,72274
hdfs://spark-nn.eemcs.utwente.nl/user/s1934538/clickstream/clickstream-enwiki-2018-08.tsv.gz,Queen_(band),55285,209714,3100,268099,241604
hdfs://spark-nn.eemcs.utwente.nl/user/s1934538/clickstream/clickstream-enwiki-2018-08.tsv.gz,Israel,64266,285369,4467,354102,150345
hdfs://spark-nn.eemcs.utwente.nl/user/s1934538/clickstream/clickstream-enwiki-2018-08.tsv.gz,List_of_Marvel_Cinematic_Universe_films,158392,1159947,2495,1320834,440925
hdfs://spark-nn.eemcs.utwente.nl/user/s1934538/clickstream/clickstream-enwiki-2018-08.tsv.gz,Hyphen-minus,6612,73238152,9005940,82250704,906
hdfs://spark-nn.eemcs.utwente.nl/user/s1934538/clickstream/clickstream-enwiki-2018-08.tsv.gz,Sushant_Singh_Rajput,22843,70032,336,93211,53693
hdfs://spark-nn.eemcs.utwente.nl/user/s1934538/clickstream/clickstream-enwiki-2018-08.tsv.gz,The_Irishman_(2019_film),63674,53593,387,117654,95504
hdfs://spark-nn.eemcs.utwente.nl/user/s1934538/clickstream/clickstream-enwiki-2018-08.tsv.gz,Saaho,41266,49698,832,91796,68161
hdfs://spark-nn.eemcs.utwente.nl/user/s1934538/clickstream/clickstream-enwiki-2018-08.tsv.gz,The_Lion_King_(2019_film),59889,68838,621,129348,116137
hdfs://spark-nn.eemcs.utwente.nl/user/s1934538/clickstream/clickstream-enwiki-2018-08.tsv.gz,2018_FIFA_World_Cup,106018,1567464,5381,1678863,284220
hdfs://spark-nn.eemcs.utwente.nl/user/s1934538/clickstream/clickstream-enwiki-2018-08.tsv.gz,Mulan_(2020_film),33567,11447,496,45510,61956
hdfs://spark-nn.eemcs.utwente.nl/user/s1934538/clickstream/clickstream-enwiki-2018-08.tsv.gz,Exo_(band),25796,1065843,906,1092545,204898
hdfs://spark-nn.eemcs.utwente.nl/user/s1934538/clickstream/clickstream-enwiki-2018-08.tsv.gz,Central_Park_jogger_case,6142,60568,355,67065,8555
hdfs://spark-nn.eemcs.utwente.nl/user/s1934538/clickstream/clickstream-enwiki-2018-08.tsv.gz,Bible,15459,92983,1625,110067,32222
hdfs://spark-nn.eemcs.utwente.nl/user/s1934538/clickstream/clickstream-enwiki-2018-08.tsv.gz,Tonya_Harding,46077,314777,1338,362192,82157
hdfs://spark-nn.eemcs.utwente.nl/user/s1934538/clickstream/clickstream-enwiki-2018-08.tsv.gz,J._Robert_Oppenheimer,18280,73484,254,92018,29111
hdfs://spark-nn.eemcs.utwente.nl/user/s1934538/clickstream/clickstream-enwiki-2018-08.tsv.gz,Puneeth_Rajkumar,10113,22131,27,32271,15456
hdfs://spark-nn.eemcs.utwente.nl/user/s1934538/clickstream/clickstream-enwiki-2018-08.tsv.gz,Khabib_Nurmagomedov,69499,481647,2967,554113,254561
hdfs://spark-nn.eemcs.utwente.nl/user/s1934538/clickstream/clickstream-enwiki-2018-08.tsv.gz,Sushma_Swaraj,6265,41159,58,47482,10404
hdfs://spark-nn.eemcs.utwente.nl/user/s1934538/clickstream/clickstream-enwiki-2018-08.tsv.gz,"Princess_Margaret,_Countess_of_Snowdon",134010,472743,2991,609744,343948
hdfs://spark-nn.eemcs.utwente.nl/user/s1934538/clickstream/clickstream-enwiki-2018-08.tsv.gz,Valentine's_Day,2495,32304,166,34965,507
hdfs://spark-nn.eemcs.utwente.nl/user/s1934538/clickstream/clickstream-enwiki-2018-08.tsv.gz,Keanu_Reeves,81285,611834,8006,701125,326577
hdfs://spark-nn.eemcs.utwente.nl/user/s1934538/clickstream/clickstream-enwiki-2018-08.tsv.gz,Kim_Jong-un,29095,117023,1052,147170,61624
hdfs://spark-nn.eemcs.utwente.nl/user/s1934538/clickstream/clickstream-enwiki-2018-08.tsv.gz,Nipsey_Hussle,12586,32345,116,45047,18692
hdfs://spark-nn.eemcs.utwente.nl/user/s1934538/clickstream/clickstream-enwiki-2018-08.tsv.gz,Anne_Heche,27540,45410,235,73185,20280
hdfs://spark-nn.eemcs.utwente.nl/user/s1934538/clickstream/clickstream-enwiki-2018-08.tsv.gz,Spider-Man:_Far_From_Home,196529,147099,1438,345066,202312
hdfs://spark-nn.eemcs.utwente.nl/user/s1934538/clickstream/clickstream-enwiki-2018-08.tsv.gz,Captain_Marvel_(film),214824,420223,3324,638371,391964
hdfs://spark-nn.eemcs.utwente.nl/user/s1934538/clickstream/clickstream-enwiki-2018-08.tsv.gz,Johnny_Depp,94493,324379,2814,421686,253932
hdfs://spark-nn.eemcs.utwente.nl/user/s1934538/clickstream/clickstream-enwiki-2018-08.tsv.gz,Aretha_Franklin,186851,5910199,149767,6246817,1954297
hdfs://spark-nn.eemcs.utwente.nl/user/s1934538/clickstream/clickstream-enwiki-2018-08.tsv.gz,Kelly_Preston,62177,46044,160,108381,28594
hdfs://spark-nn.eemcs.utwente.nl/user/s1934538/clickstream/clickstream-enwiki-2018-08.tsv.gz,William_Murdoch,694,1434,14,2142,345
hdfs://spark-nn.eemcs.utwente.nl/user/s1934538/clickstream/clickstream-enwiki-2018-08.tsv.gz,Sylvester_Stallone,69636,311497,2140,383273,227591
hdfs://spark-nn.eemcs.utwente.nl/user/s1934538/clickstream/clickstream-enwiki-2018-08.tsv.gz,Indian_Premier_League,9654,37210,61,46925,23066
hdfs://spark-nn.eemcs.utwente.nl/user/s1934538/clickstream/clickstream-enwiki-2018-08.tsv.gz,Gaza_Strip,12173,42267,837,55277,19627
hdfs://spark-nn.eemcs.utwente.nl/user/s1934538/clickstream/clickstream-enwiki-2018-08.tsv.gz,Jason_Momoa,119305,563055,2171,684531,258011
hdfs://spark-nn.eemcs.utwente.nl/user/s1934538/clickstream/clickstream-enwiki-2018-08.tsv.gz,Deadpool_2,180094,878615,23706,1082415,981597
hdfs://spark-nn.eemcs.utwente.nl/user/s1934538/clickstream/clickstream-enwiki-2018-08.tsv.gz,Avicii,22518,276662,3185,302365,66798
hdfs://spark-nn.eemcs.utwente.nl/user/s1934538/clickstream/clickstream-enwiki-2018-08.tsv.gz,Bonnie_and_Clyde,14147,157334,1113,172594,35924
hdfs://spark-nn.eemcs.utwente.nl/user/s1934538/clickstream/clickstream-enwiki-2018-08.tsv.gz,QAnon,9474,742271,5889,757634,196072
hdfs://spark-nn.eemcs.utwente.nl/user/s1934538/clickstream/clickstream-enwiki-2018-08.tsv.gz,Spanish_flu,14094,70983,828,85905,17459
hdfs://spark-nn.eemcs.utwente.nl/user/s1934538/clickstream/clickstream-enwiki-2018-08.tsv.gz,Cook's_Country,146,2792,25,2963,30
hdfs://spark-nn.eemcs.utwente.nl/user/s1934538/clickstream/clickstream-enwiki-2018-08.tsv.gz,List_of_most_popular_websites,18784,110122,143,129049,51687
hdfs://spark-nn.eemcs.utwente.nl/user/s1934538/clickstream/clickstream-enwiki-2018-08.tsv.gz,A_Quiet_Place_(film),49072,536274,5480,590826,163880
hdfs://spark-nn.eemcs.utwente.nl/user/s1934538/clickstream/clickstream-enwiki-2018-08.tsv.gz,Key_frame,584,4814,13,5411,510
hdfs://spark-nn.eemcs.utwente.nl/user/s1934538/clickstream/clickstream-enwiki-2018-08.tsv.gz,YouTube,109437,769437,7384,886258,126397
hdfs://spark-nn.eemcs.utwente.nl/user/s1934538/clickstream/clickstream-enwiki-2018-08.tsv.gz,JSON_Web_Token,1044,19988,32,21064,1727
hdfs://spark-nn.eemcs.utwente.nl/user/s1934538/clickstream/clickstream-enwiki-2018-08.tsv.gz,Brie_Larson,196252,204107,1233,401592,138989
hdfs://spark-nn.eemcs.utwente.nl/user/s1934538/clickstream/clickstream-enwiki-2018-08.tsv.gz,Line_shaft,674,1145,45,1864,97
hdfs://spark-nn.eemcs.utwente.nl/user/s1934538/clickstream/clickstream-enwiki-2018-08.tsv.gz,Freddie_Mercury,100300,629812,4906,735018,250058
hdfs://spark-nn.eemcs.utwente.nl/user/s1934538/clickstream/clickstream-enwiki-2018-08.tsv.gz,Jimmy_Hoffa,21910,84698,760,107368,36205
hdfs://spark-nn.eemcs.utwente.nl/user/s1934538/clickstream/clickstream-enwiki-2018-08.tsv.gz,Kate_Spade,21013,79273,899,101185,29101
hdfs://spark-nn.eemcs.utwente.nl/user/s1934538/clickstream/clickstream-enwiki-2018-08.tsv.gz,Roe_v._Wade,9126,88463,619,98208,23300
hdfs://spark-nn.eemcs.utwente.nl/user/s1934538/clickstream/clickstream-enwiki-2018-08.tsv.gz,Deion_Sanders,11838,80847,456,93141,23353
hdfs://spark-nn.eemcs.utwente.nl/user/s1934538/clickstream/clickstream-enwiki-2018-08.tsv.gz,Death_of_Elisa_Lam,7008,71858,4439,83305,20238
hdfs://spark-nn.eemcs.utwente.nl/user/s1934538/clickstream/clickstream-enwiki-2018-08.tsv.gz,Jeffrey_Dahmer,29271,530722,4274,564267,216610
hdfs://spark-nn.eemcs.utwente.nl/user/s1934538/clickstream/clickstream-enwiki-2018-08.tsv.gz,Game_of_Thrones_(season_8),54830,390973,1239,447042,143269
hdfs://spark-nn.eemcs.utwente.nl/user/s1934538/clickstream/clickstream-enwiki-2018-08.tsv.gz,Ruth_Bader_Ginsburg,35395,355760,1959,393114,136083
hdfs://spark-nn.eemcs.utwente.nl/user/s1934538/clickstream/clickstream-enwiki-2018-08.tsv.gz,Burt_Reynolds,49520,154679,1399,205598,70482
hdfs://spark-nn.eemcs.utwente.nl/user/s1934538/clickstream/clickstream-enwiki-2018-08.tsv.gz,Olivia_Newton-John,22774,117594,1002,141370,55438
hdfs://spark-nn.eemcs.utwente.nl/user/s1934538/clickstream/clickstream-enwiki-2018-08.tsv.gz,Charles_III,102,388,60,550,370
hdfs://spark-nn.eemcs.utwente.nl/user/s1934538/clickstream/clickstream-enwiki-2018-08.tsv.gz,Fantastic_Beasts:_The_Crimes_of_Grindelwald,77591,90619,1158,169368,101498
hdfs://spark-nn.eemcs.utwente.nl/user/s1934538/clickstream/clickstream-enwiki-2018-08.tsv.gz,Matthew_Perry,65357,228934,1049,295340,144875
hdfs://spark-nn.eemcs.utwente.nl/user/s1934538/clickstream/clickstream-enwiki-2018-08.tsv.gz,September_11_attacks,79197,338509,3063,420769,191537
hdfs://spark-nn.eemcs.utwente.nl/user/s1934538/clickstream/clickstream-enwiki-2018-08.tsv.gz,Crazy_Rich_Asians_(film),370339,2148895,30396,2549630,2696933
hdfs://spark-nn.eemcs.utwente.nl/user/s1934538/clickstream/clickstream-enwiki-2018-08.tsv.gz,Glass_(2019_film),85878,103201,1124,190203,99209
hdfs://spark-nn.eemcs.utwente.nl/user/s1934538/clickstream/clickstream-enwiki-2018-08.tsv.gz,Brett_Kavanaugh,10799,70498,911,82208,27820
hdfs://spark-nn.eemcs.utwente.nl/user/s1934538/clickstream/clickstream-enwiki-2018-08.tsv.gz,Kobe_Bryant_sexual_assault_case,3118,26549,13,29680,3194
hdfs://spark-nn.eemcs.utwente.nl/user/s1934538/clickstream/clickstream-enwiki-2018-08.tsv.gz,FIFA_World_Cup,38633,174354,2274,215261,137831
hdfs://spark-nn.eemcs.utwente.nl/user/s1934538/clickstream/clickstream-enwiki-2018-08.tsv.gz,The_Nun_(2018_film),74452,583707,9293,667452,347697
hdfs://spark-nn.eemcs.utwente.nl/user/s1934538/clickstream/clickstream-enwiki-2018-08.tsv.gz,List_of_James_Bond_films,23592,262446,443,286481,127763
hdfs://spark-nn.eemcs.utwente.nl/user/s1934538/clickstream/clickstream-enwiki-2018-08.tsv.gz,Irrfan_Khan,35907,104060,438,140405,68703
hdfs://spark-nn.eemcs.utwente.nl/user/s1934538/clickstream/clickstream-enwiki-2018-08.tsv.gz,Elon_Musk,118788,1080339,9822,1208949,709029
hdfs://spark-nn.eemcs.utwente.nl/user/s1934538/clickstream/clickstream-enwiki-2018-08.tsv.gz,Cardi_B,79823,1150393,12404,1242620,334043
hdfs://spark-nn.eemcs.utwente.nl/user/s1934538/clickstream/clickstream-enwiki-2018-08.tsv.gz,Croatia,42706,194437,2779,239922,76565
hdfs://spark-nn.eemcs.utwente.nl/user/s1934538/clickstream/clickstream-enwiki-2018-08.tsv.gz,Juneteenth,1735,18105,52,19892,1979
hdfs://spark-nn.eemcs.utwente.nl/user/s1934538/clickstream/clickstream-enwiki-2018-08.tsv.gz,Ray_Liotta,33986,397901,1779,433666,82986
hdfs://spark-nn.eemcs.utwente.nl/user/s1934538/clickstream/clickstream-enwiki-2018-08.tsv.gz,Charles_Sobhraj,3083,44069,182,47334,6348
hdfs://spark-nn.eemcs.utwente.nl/user/s1934538/clickstream/clickstream-enwiki-2018-08.tsv.gz,Lists_of_deaths_by_year,7421,123151,218,130790,123179
hdfs://spark-nn.eemcs.utwente.nl/user/s1934538/clickstream/clickstream-enwiki-2018-08.tsv.gz,Atal_Bihari_Vajpayee,88443,3864657,51130,4004230,519779
hdfs://spark-nn.eemcs.utwente.nl/user/s1934538/clickstream/clickstream-enwiki-2018-08.tsv.gz,Taliban,22731,106952,7272,136955,58316
hdfs://spark-nn.eemcs.utwente.nl/user/s1934538/clickstream/clickstream-enwiki-2018-09.tsv.gz,List_of_Marvel_Cinematic_Universe_films,120958,826083,2267,949308,308833
hdfs://spark-nn.eemcs.utwente.nl/user/s1934538/clickstream/clickstream-enwiki-2018-09.tsv.gz,Coronavirus,769,6412,31,7212,1094
hdfs://spark-nn.eemcs.utwente.nl/user/s1934538/clickstream/clickstream-enwiki-2018-09.tsv.gz,2.0_(film),62233,360292,2096,424621,172440
hdfs://spark-nn.eemcs.utwente.nl/user/s1934538/clickstream/clickstream-enwiki-2018-09.tsv.gz,Wonder_Woman_1984,90824,57361,654,148839,85154
hdfs://spark-nn.eemcs.utwente.nl/user/s1934538/clickstream/clickstream-enwiki-2018-09.tsv.gz,Jeffrey_Epstein,8748,28411,101,37260,10262
hdfs://spark-nn.eemcs.utwente.nl/user/s1934538/clickstream/clickstream-enwiki-2018-09.tsv.gz,J._Robert_Oppenheimer,15675,67595,219,83489,25666
hdfs://spark-nn.eemcs.utwente.nl/user/s1934538/clickstream/clickstream-enwiki-2018-09.tsv.gz,Asia_Cup,62404,885206,4757,952367,285208
hdfs://spark-nn.eemcs.utwente.nl/user/s1934538/clickstream/clickstream-enwiki-2018-09.tsv.gz,Fantastic_Beasts:_The_Crimes_of_Grindelwald,110690,188900,6217,305807,198091
hdfs://spark-nn.eemcs.utwente.nl/user/s1934538/clickstream/clickstream-enwiki-2018-09.tsv.gz,Cleopatra,42091,190876,2060,235027,91767
hdfs://spark-nn.eemcs.utwente.nl/user/s1934538/clickstream/clickstream-enwiki-2018-09.tsv.gz,R._Kelly,22998,90464,725,114187,51057
hdfs://spark-nn.eemcs.utwente.nl/user/s1934538/clickstream/clickstream-enwiki-2018-09.tsv.gz,Cook's_Country,143,3675,28,3846,41
hdfs://spark-nn.eemcs.utwente.nl/user/s1934538/clickstream/clickstream-enwiki-2018-09.tsv.gz,Chernobyl_disaster,25550,224138,1304,250992,65617
hdfs://spark-nn.eemcs.utwente.nl/user/s1934538/clickstream/clickstream-enwiki-2018-09.tsv.gz,Murder_of_Dee_Dee_Blanchard,4481,64475,111,69067,11320
hdfs://spark-nn.eemcs.utwente.nl/user/s1934538/clickstream/clickstream-enwiki-2018-09.tsv.gz,Henry_V_of_England,33974,26273,126,60373,36783
hdfs://spark-nn.eemcs.utwente.nl/user/s1934538/clickstream/clickstream-enwiki-2018-09.tsv.gz,Simone_Biles,8002,38706,1575,48283,14229
hdfs://spark-nn.eemcs.utwente.nl/user/s1934538/clickstream/clickstream-enwiki-2018-09.tsv.gz,Hyphen-minus,6784,125071348,8504875,133583007,828
hdfs://spark-nn.eemcs.utwente.nl/user/s1934538/clickstream/clickstream-enwiki-2018-09.tsv.gz,Juice_Wrld,12654,120458,2232,135344,34254
hdfs://spark-nn.eemcs.utwente.nl/user/s1934538/clickstream/clickstream-enwiki-2018-09.tsv.gz,Sushant_Singh_Rajput,20875,59857,155,80887,43984
hdfs://spark-nn.eemcs.utwente.nl/user/s1934538/clickstream/clickstream-enwiki-2018-09.tsv.gz,Irrfan_Khan,29978,75610,632,106220,45534
hdfs://spark-nn.eemcs.utwente.nl/user/s1934538/clickstream/clickstream-enwiki-2018-09.tsv.gz,Kelly_Preston,57743,46462,161,104366,28666
hdfs://spark-nn.eemcs.utwente.nl/user/s1934538/clickstream/clickstream-enwiki-2018-09.tsv.gz,Naya_Rivera,20180,30046,573,50799,9297
hdfs://spark-nn.eemcs.utwente.nl/user/s1934538/clickstream/clickstream-enwiki-2018-09.tsv.gz,Meat_Loaf,17906,84880,874,103660,33275
hdfs://spark-nn.eemcs.utwente.nl/user/s1934538/clickstream/clickstream-enwiki-2018-09.tsv.gz,Sushma_Swaraj,3684,35853,78,39615,8587
hdfs://spark-nn.eemcs.utwente.nl/user/s1934538/clickstream/clickstream-enwiki-2018-09.tsv.gz,Lionel_Messi,53768,511177,5784,570729,110492
hdfs://spark-nn.eemcs.utwente.nl/user/s1934538/clickstream/clickstream-enwiki-2018-09.tsv.gz,Lists_of_deaths_by_year,7649,111776,226,119651,111245
hdfs://spark-nn.eemcs.utwente.nl/user/s1934538/clickstream/clickstream-enwiki-2018-09.tsv.gz,The_Lion_King_(2019_film),58199,58914,524,117637,100597
hdfs://spark-nn.eemcs.utwente.nl/user/s1934538/clickstream/clickstream-enwiki-2018-09.tsv.gz,Spanish_flu,17731,116029,1639,135399,27030
hdfs://spark-nn.eemcs.utwente.nl/user/s1934538/clickstream/clickstream-enwiki-2018-09.tsv.gz,Indian_Premier_League,10639,39682,34,50355,23545
hdfs://spark-nn.eemcs.utwente.nl/user/s1934538/clickstream/clickstream-enwiki-2018-09.tsv.gz,WrestleMania_34,32474,37182,494,70150,46107
hdfs://spark-nn.eemcs.utwente.nl/user/s1934538/clickstream/clickstream-enwiki-2018-09.tsv.gz,Lance_Reddick,19548,20467,86,40101,7609
hdfs://spark-nn.eemcs.utwente.nl/user/s1934538/clickstream/clickstream-enwiki-2018-09.tsv.gz,List_of_awards_and_nominations_received_by_Meryl_Streep,12809,10889,70,23768,7235
hdfs://spark-nn.eemcs.utwente.nl/user/s1934538/clickstream/clickstream-enwiki-2018-09.tsv.gz,List_of_James_Bond_films,16476,230424,357,247257,99244
hdfs://spark-nn.eemcs.utwente.nl/user/s1934538/clickstream/clickstream-enwiki-2018-09.tsv.gz,Tina_Turner,14882,208198,1633,224713,55537
hdfs://spark-nn.eemcs.utwente.nl/user/s1934538/clickstream/clickstream-enwiki-2018-09.tsv.gz,Brie_Larson,193750,464309,4538,662597,251899
hdfs://spark-nn.eemcs.utwente.nl/user/s1934538/clickstream/clickstream-enwiki-2018-09.tsv.gz,2018_Asian_Games,91976,584718,12593,689287,423809
hdfs://spark-nn.eemcs.utwente.nl/user/s1934538/clickstream/clickstream-enwiki-2018-09.tsv.gz,Puneeth_Rajkumar,9717,21827,189,31733,14872
hdfs://spark-nn.eemcs.utwente.nl/user/s1934538/clickstream/clickstream-enwiki-2018-09.tsv.gz,The_Nun_(2018_film),261299,3007769,34156,3303224,1916481
hdfs://spark-nn.eemcs.utwente.nl/user/s1934538/clickstream/clickstream-enwiki-2018-09.tsv.gz,Ukraine,38062,135800,2813,176675,80450
hdfs://spark-nn.eemcs.utwente.nl/user/s1934538/clickstream/clickstream-enwiki-2018-09.tsv.gz,Atal_Bihari_Vajpayee,18043,227106,454,245603,30818
hdfs://spark-nn.eemcs.utwente.nl/user/s1934538/clickstream/clickstream-enwiki-2018-09.tsv.gz,Death_of_Elisa_Lam,8154,66663,261,75078,17469
hdfs://spark-nn.eemcs.utwente.nl/user/s1934538/clickstream/clickstream-enwiki-2018-09.tsv.gz,Media,57,15553,408,16018,2805
hdfs://spark-nn.eemcs.utwente.nl/user/s1934538/clickstream/clickstream-enwiki-2018-09.tsv.gz,Christopher_Scarver,86351,29570,12,115933,36164
hdfs://spark-nn.eemcs.utwente.nl/user/s1934538/clickstream/clickstream-enwiki-2018-09.tsv.gz,Key_frame,585,5808,12,6405,588
hdfs://spark-nn.eemcs.utwente.nl/user/s1934538/clickstream/clickstream-enwiki-2018-09.tsv.gz,Kobe_Bryant_sexual_assault_case,2598,23433,16,26047,2642
hdfs://spark-nn.eemcs.utwente.nl/user/s1934538/clickstream/clickstream-enwiki-2018-09.tsv.gz,Simple_Mail_Transfer_Protocol,4636,43696,161,48493,5482
hdfs://spark-nn.eemcs.utwente.nl/user/s1934538/clickstream/clickstream-enwiki-2018-09.tsv.gz,Afghanistan,42519,169813,2124,214456,126163
hdfs://spark-nn.eemcs.utwente.nl/user/s1934538/clickstream/clickstream-enwiki-2018-09.tsv.gz,Croatia,34027,147982,2115,184124,62587
hdfs://spark-nn.eemcs.utwente.nl/user/s1934538/clickstream/clickstream-enwiki-2018-09.tsv.gz,Glass_(2019_film),73654,73809,718,148181,72987
hdfs://spark-nn.eemcs.utwente.nl/user/s1934538/clickstream/clickstream-enwiki-2018-09.tsv.gz,Darth_Vader,20793,2453839,691,2475323,48508
hdfs://spark-nn.eemcs.utwente.nl/user/s1934538/clickstream/clickstream-enwiki-2018-09.tsv.gz,Kobe_Bryant,20874,152817,1199,174890,40256
hdfs://spark-nn.eemcs.utwente.nl/user/s1934538/clickstream/clickstream-enwiki-2018-09.tsv.gz,Hamas,12244,29446,251,41941,13723
hdfs://spark-nn.eemcs.utwente.nl/user/s1934538/clickstream/clickstream-enwiki-2018-09.tsv.gz,NATO,33467,120653,1881,156001,68570
hdfs://spark-nn.eemcs.utwente.nl/user/s1934538/clickstream/clickstream-enwiki-2018-09.tsv.gz,Charles_Sobhraj,3224,39534,156,42914,5855
hdfs://spark-nn.eemcs.utwente.nl/user/s1934538/clickstream/clickstream-enwiki-2018-09.tsv.gz,List_of_highest-grossing_Indian_films,55642,270592,1689,327923,154697
hdfs://spark-nn.eemcs.utwente.nl/user/s1934538/clickstream/clickstream-enwiki-2018-09.tsv.gz,Jimmy_Buffett,6782,45088,445,52315,16330
hdfs://spark-nn.eemcs.utwente.nl/user/s1934538/clickstream/clickstream-enwiki-2018-09.tsv.gz,Rihanna,57256,331792,21686,410734,176913
hdfs://spark-nn.eemcs.utwente.nl/user/s1934538/clickstream/clickstream-enwiki-2018-09.tsv.gz,September_11_attacks,169459,1986959,30556,2186974,846522
hdfs://spark-nn.eemcs.utwente.nl/user/s1934538/clickstream/clickstream-enwiki-2018-09.tsv.gz,Freddie_Mercury,119513,842081,6924,968518,335073
hdfs://spark-nn.eemcs.utwente.nl/user/s1934538/clickstream/clickstream-enwiki-2018-09.tsv.gz,Aquaman_(film),84424,93705,5183,183312,90299
hdfs://spark-nn.eemcs.utwente.nl/user/s1934538/clickstream/clickstream-enwiki-2018-09.tsv.gz,List_of_FIFA_World_Cup_finals,1448,60756,54,62258,12240
hdfs://spark-nn.eemcs.utwente.nl/user/s1934538/clickstream/clickstream-enwiki-2018-09.tsv.gz,The_Irishman,65,370,21,456,453
hdfs://spark-nn.eemcs.utwente.nl/user/s1934538/clickstream/clickstream-enwiki-2018-09.tsv.gz,Jeffrey_Dahmer,30250,542884,4369,577503,213756
hdfs://spark-nn.eemcs.utwente.nl/user/s1934538/clickstream/clickstream-enwiki-2018-09.tsv.gz,Khabib_Nurmagomedov,89017,649959,3775,742751,358824
hdfs://spark-nn.eemcs.utwente.nl/user/s1934538/clickstream/clickstream-enwiki-2018-09.tsv.gz,The_Shape_of_Water,34558,222766,5267,262591,137611
hdfs://spark-nn.eemcs.utwente.nl/user/s1934538/clickstream/clickstream-enwiki-2018-09.tsv.gz,George_H._W._Bush,136361,206810,1290,344461,159047
hdfs://spark-nn.eemcs.utwente.nl/user/s1934538/clickstream/clickstream-enwiki-2018-09.tsv.gz,Amy_Coney_Barrett,9221,108311,789,118321,19069
hdfs://spark-nn.eemcs.utwente.nl/user/s1934538/clickstream/clickstream-enwiki-2018-09.tsv.gz,Tom_Brady,63327,390287,3777,457391,135930
hdfs://spark-nn.eemcs.utwente.nl/user/s1934538/clickstream/clickstream-enwiki-2018-09.tsv.gz,Stranger_Things,71785,386350,3375,461510,286929
hdfs://spark-nn.eemcs.utwente.nl/user/s1934538/clickstream/clickstream-enwiki-2018-09.tsv.gz,Juneteenth,1880,16718,39,18637,1889
hdfs://spark-nn.eemcs.utwente.nl/user/s1934538/clickstream/clickstream-enwiki-2018-09.tsv.gz,Keanu_Reeves,72558,480763,3039,556360,253795
hdfs://spark-nn.eemcs.utwente.nl/user/s1934538/clickstream/clickstream-enwiki-2018-09.tsv.gz,Exo_(band),23174,298408,875,322457,171359
hdfs://spark-nn.eemcs.utwente.nl/user/s1934538/clickstream/clickstream-enwiki-2018-09.tsv.gz,Article_370_of_the_Constitution_of_India,7680,51695,28,59403,4101
hdfs://spark-nn.eemcs.utwente.nl/user/s1934538/clickstream/clickstream-enwiki-2018-09.tsv.gz,Olivia_Newton-John,22923,229656,2353,254932,98042
hdfs://spark-nn.eemcs.utwente.nl/user/s1934538/clickstream/clickstream-enwiki-2018-09.tsv.gz,Crazy_Rich_Asians_(film),216878,1519168,16872,1752918,1814700
hdfs://spark-nn.eemcs.utwente.nl/user/s1934538/clickstream/clickstream-enwiki-2018-09.tsv.gz,Qasem_Soleimani,2457,6144,27,8628,3843
hdfs://spark-nn.eemcs.utwente.nl/user/s1934538/clickstream/clickstream-enwiki-2018-09.tsv.gz,Louis_Tomlinson,72387,344559,960,417906,41393
hdfs://spark-nn.eemcs.utwente.nl/user/s1934538/clickstream/clickstream-enwiki-2018-09.tsv.gz,"Diana,_Princess_of_Wales",87837,235760,2342,325939,163910
hdfs://spark-nn.eemcs.utwente.nl/user/s1934538/clickstream/clickstream-enwiki-2018-09.tsv.gz,Us_(2019_film),23022,9533,50,32605,17662
hdfs://spark-nn.eemcs.utwente.nl/user/s1934538/clickstream/clickstream-enwiki-2018-09.tsv.gz,UEFA_Euro_2020,56721,178577,1572,236870,75285
hdfs://spark-nn.eemcs.utwente.nl/user/s1934538/clickstream/clickstream-enwiki-2018-09.tsv.gz,Bible,16252,94073,1627,111952,32186
hdfs://spark-nn.eemcs.utwente.nl/user/s1934538/clickstream/clickstream-enwiki-2018-09.tsv.gz,Jimmy_Hoffa,19599,107738,601,127938,36373
hdfs://spark-nn.eemcs.utwente.nl/user/s1934538/clickstream/clickstream-enwiki-2018-09.tsv.gz,United_States_Senate,105280,147733,5195,258208,118540
hdfs://spark-nn.eemcs.utwente.nl/user/s1934538/clickstream/clickstream-enwiki-2018-09.tsv.gz,Aaron_Carter,11693,31766,242,43701,12860
hdfs://spark-nn.eemcs.utwente.nl/user/s1934538/clickstream/clickstream-enwiki-2018-09.tsv.gz,QAnon,6482,233184,895,240561,61175
hdfs://spark-nn.eemcs.utwente.nl/user/s1934538/clickstream/clickstream-enwiki-2018-09.tsv.gz,Nipsey_Hussle,21051,26404,97,47552,15761
hdfs://spark-nn.eemcs.utwente.nl/user/s1934538/clickstream/clickstream-enwiki-2018-09.tsv.gz,Game_of_Thrones_(season_8),52323,342546,1066,395935,123310
hdfs://spark-nn.eemcs.utwente.nl/user/s1934538/clickstream/clickstream-enwiki-2018-09.tsv.gz,Deadpool_2,117507,432767,11566,561840,494824
hdfs://spark-nn.eemcs.utwente.nl/user/s1934538/clickstream/clickstream-enwiki-2018-09.tsv.gz,Stephen_Hawking,23842,385926,2899,412667,123862
hdfs://spark-nn.eemcs.utwente.nl/user/s1934538/clickstream/clickstream-enwiki-2018-09.tsv.gz,Game_of_Thrones,91317,460680,12986,564983,366708
hdfs://spark-nn.eemcs.utwente.nl/user/s1934538/clickstream/clickstream-enwiki-2018-09.tsv.gz,The_Irishman_(2019_film),51103,41019,2491,94613,73653
hdfs://spark-nn.eemcs.utwente.nl/user/s1934538/clickstream/clickstream-enwiki-2018-09.tsv.gz,Luke_Perry,22390,44806,1677,68873,10713
hdfs://spark-nn.eemcs.utwente.nl/user/s1934538/clickstream/clickstream-enwiki-2018-09.tsv.gz,Dennis_Nilsen,4948,24901,145,29994,5714
hdfs://spark-nn.eemcs.utwente.nl/user/s1934538/clickstream/clickstream-enwiki-2018-09.tsv.gz,"Princess_Margaret,_Countess_of_Snowdon",114256,469970,3338,587564,327078
hdfs://spark-nn.eemcs.utwente.nl/user/s1934538/clickstream/clickstream-enwiki-2018-09.tsv.gz,Tonya_Harding,33611,217023,944,251578,52020
hdfs://spark-nn.eemcs.utwente.nl/user/s1934538/clickstream/clickstream-enwiki-2018-09.tsv.gz,Salman_Rushdie,35765,71621,421,107807,43825
hdfs://spark-nn.eemcs.utwente.nl/user/s1934538/clickstream/clickstream-enwiki-2018-09.tsv.gz,Critical_race_theory,1767,17506,56,19329,3285
hdfs://spark-nn.eemcs.utwente.nl/user/s1934538/clickstream/clickstream-enwiki-2018-09.tsv.gz,Shakira,11822,223699,1906,237427,87989
hdfs://spark-nn.eemcs.utwente.nl/user/s1934538/clickstream/clickstream-enwiki-2018-09.tsv.gz,JSON_Web_Token,953,19475,18,20446,1857
hdfs://spark-nn.eemcs.utwente.nl/user/s1934538/clickstream/clickstream-enwiki-2018-09.tsv.gz,List_of_highest-grossing_films,151482,408102,1937,561521,228626
hdfs://spark-nn.eemcs.utwente.nl/user/s1934538/clickstream/clickstream-enwiki-2018-09.tsv.gz,Avengers:_Infinity_War,236825,717801,19491,974117,709265
hdfs://spark-nn.eemcs.utwente.nl/user/s1934538/clickstream/clickstream-enwiki-2018-09.tsv.gz,Adele,20452,159961,2092,182505,53577
hdfs://spark-nn.eemcs.utwente.nl/user/s1934538/clickstream/clickstream-enwiki-2018-09.tsv.gz,Donald_Trump,218943,1122620,12011,1353574,574345
hdfs://spark-nn.eemcs.utwente.nl/user/s1934538/clickstream/clickstream-enwiki-2018-09.tsv.gz,Black_Panther_(film),97877,452091,8344,558312,418633
hdfs://spark-nn.eemcs.utwente.nl/user/s1934538/clickstream/clickstream-enwiki-2018-09.tsv.gz,George_VI,275016,204650,622,480288,320814
hdfs://spark-nn.eemcs.utwente.nl/user/s1934538/clickstream/clickstream-enwiki-2018-09.tsv.gz,21_Savage,20036,66425,4115,90576,31827
hdfs://spark-nn.eemcs.utwente.nl/user/s1934538/clickstream/clickstream-enwiki-2018-09.tsv.gz,2018_Winter_Olympics,27298,63542,427,91267,35675
hdfs://spark-nn.eemcs.utwente.nl/user/s1934538/clickstream/clickstream-enwiki-2018-09.tsv.gz,1234,56,1765,10,1831,150
hdfs://spark-nn.eemcs.utwente.nl/user/s1934538/clickstream/clickstream-enwiki-2018-09.tsv.gz,Sridevi,22990,96474,561,120025,38033
hdfs://spark-nn.eemcs.utwente.nl/user/s1934538/clickstream/clickstream-enwiki-2018-09.tsv.gz,Vladimir_Putin,52463,207985,2564,263012,119680
hdfs://spark-nn.eemcs.utwente.nl/user/s1934538/clickstream/clickstream-enwiki-2018-09.tsv.gz,Burt_Reynolds,215763,4656847,86582,4959192,1799893
hdfs://spark-nn.eemcs.utwente.nl/user/s1934538/clickstream/clickstream-enwiki-2018-09.tsv.gz,Line_shaft,570,1010,33,1613,164
hdfs://spark-nn.eemcs.utwente.nl/user/s1934538/clickstream/clickstream-enwiki-2018-09.tsv.gz,DMX_(rapper),21612,76377,421,98410,36425
hdfs://spark-nn.eemcs.utwente.nl/user/s1934538/clickstream/clickstream-enwiki-2018-09.tsv.gz,XHamster,7136,4574397,1997,4583530,24487
hdfs://spark-nn.eemcs.utwente.nl/user/s1934538/clickstream/clickstream-enwiki-2018-09.tsv.gz,Mac_Miller,218564,5662325,62662,5943551,1230672
hdfs://spark-nn.eemcs.utwente.nl/user/s1934538/clickstream/clickstream-enwiki-2018-09.tsv.gz,Naomi_Osaka,54530,3421138,19770,3495438,449333
hdfs://spark-nn.eemcs.utwente.nl/user/s1934538/clickstream/clickstream-enwiki-2018-09.tsv.gz,United_States_Electoral_College,17280,78504,527,96311,1066
hdfs://spark-nn.eemcs.utwente.nl/user/s1934538/clickstream/clickstream-enwiki-2018-09.tsv.gz,Aretha_Franklin,41668,802146,7986,851800,213368
hdfs://spark-nn.eemcs.utwente.nl/user/s1934538/clickstream/clickstream-enwiki-2018-09.tsv.gz,Brett_Kavanaugh,244061,3543055,37686,3824802,1279738
hdfs://spark-nn.eemcs.utwente.nl/user/s1934538/clickstream/clickstream-enwiki-2018-09.tsv.gz,Microsoft_Office,10117,89780,723,100620,23591
hdfs://spark-nn.eemcs.utwente.nl/user/s1934538/clickstream/clickstream-enwiki-2018-09.tsv.gz,Cecil_Hotel_(Los_Angeles),6672,24722,16,31410,10096
hdfs://spark-nn.eemcs.utwente.nl/user/s1934538/clickstream/clickstream-enwiki-2018-09.tsv.gz,Ted_Bundy,36490,341234,3773,381497,81649
hdfs://spark-nn.eemcs.utwente.nl/user/s1934538/clickstream/clickstream-enwiki-2018-09.tsv.gz,Cristiano_Ronaldo,110539,820332,5437,936308,186977
hdfs://spark-nn.eemcs.utwente.nl/user/s1934538/clickstream/clickstream-enwiki-2018-09.tsv.gz,Eddie_Van_Halen,27671,44384,309,72364,28734
hdfs://spark-nn.eemcs.utwente.nl/user/s1934538/clickstream/clickstream-enwiki-2019-01.tsv.gz,Naomi_Osaka,38336,1293336,7038,1338710,200427
hdfs://spark-nn.eemcs.utwente.nl/user/s1934538/clickstream/clickstream-enwiki-2019-01.tsv.gz,HTTP_cookie,26487,371060,169,397716,69052
hdfs://spark-nn.eemcs.utwente.nl/user/s1934538/clickstream/clickstream-enwiki-2019-01.tsv.gz,XXXTentacion,184326,745159,11759,941244,239076
hdfs://spark-nn.eemcs.utwente.nl/user/s1934538/clickstream/clickstream-enwiki-2019-01.tsv.gz,Joker_(2019_film),113470,146730,1156,261356,175995
hdfs://spark-nn.eemcs.utwente.nl/user/s1934538/clickstream/clickstream-enwiki-2019-01.tsv.gz,Gaza_Strip,14018,35488,271,49777,18543
hdfs://spark-nn.eemcs.utwente.nl/user/s1934538/clickstream/clickstream-enwiki-2019-01.tsv.gz,Kobe_Bryant,38222,256434,2107,296763,73484
hdfs://spark-nn.eemcs.utwente.nl/user/s1934538/clickstream/clickstream-enwiki-2019-01.tsv.gz,Betty_White,59827,535260,5871,600958,147248
hdfs://spark-nn.eemcs.utwente.nl/user/s1934538/clickstream/clickstream-enwiki-2019-01.tsv.gz,Simone_Biles,18804,61907,325,81036,20586
hdfs://spark-nn.eemcs.utwente.nl/user/s1934538/clickstream/clickstream-enwiki-2019-01.tsv.gz,Media,60,36190,395,36645,2752
hdfs://spark-nn.eemcs.utwente.nl/user/s1934538/clickstream/clickstream-enwiki-2019-01.tsv.gz,Spider-Man:_Far_From_Home,270459,701489,18120,990068,910684
hdfs://spark-nn.eemcs.utwente.nl/user/s1934538/clickstream/clickstream-enwiki-2019-01.tsv.gz,Richard_Jewell,3859,21482,126,25467,6498
hdfs://spark-nn.eemcs.utwente.nl/user/s1934538/clickstream/clickstream-enwiki-2019-01.tsv.gz,The_Witcher_(TV_series),18139,40994,343,59476,31617
hdfs://spark-nn.eemcs.utwente.nl/user/s1934538/clickstream/clickstream-enwiki-2019-01.tsv.gz,The_Lion_King_(2019_film),64934,130762,1633,197329,166893
hdfs://spark-nn.eemcs.utwente.nl/user/s1934538/clickstream/clickstream-enwiki-2019-01.tsv.gz,Cricket_World_Cup,13912,139711,1366,154989,91785
hdfs://spark-nn.eemcs.utwente.nl/user/s1934538/clickstream/clickstream-enwiki-2019-01.tsv.gz,Lance_Reddick,21139,25051,99,46289,12290
hdfs://spark-nn.eemcs.utwente.nl/user/s1934538/clickstream/clickstream-enwiki-2019-01.tsv.gz,Godzilla_vs._Kong,56304,18845,78,75227,57333
hdfs://spark-nn.eemcs.utwente.nl/user/s1934538/clickstream/clickstream-enwiki-2019-01.tsv.gz,Stan_Lee,85196,320154,3510,408860,123046
hdfs://spark-nn.eemcs.utwente.nl/user/s1934538/clickstream/clickstream-enwiki-2019-01.tsv.gz,A_Star_Is_Born_(2018_film),176136,1206852,13259,1396247,713275
hdfs://spark-nn.eemcs.utwente.nl/user/s1934538/clickstream/clickstream-enwiki-2019-01.tsv.gz,Murder_of_Dee_Dee_Blanchard,12684,271230,495,284409,47259
hdfs://spark-nn.eemcs.utwente.nl/user/s1934538/clickstream/clickstream-enwiki-2019-01.tsv.gz,Wikipedia,46752,603039,1205,650996,241115
hdfs://spark-nn.eemcs.utwente.nl/user/s1934538/clickstream/clickstream-enwiki-2019-01.tsv.gz,The_Irishman,69,309,98,476,685
hdfs://spark-nn.eemcs.utwente.nl/user/s1934538/clickstream/clickstream-enwiki-2019-01.tsv.gz,Kobe_Bryant_sexual_assault_case,3681,26384,30,30095,3526
hdfs://spark-nn.eemcs.utwente.nl/user/s1934538/clickstream/clickstream-enwiki-2019-01.tsv.gz,Adele,26537,189119,2227,217883,67653
hdfs://spark-nn.eemcs.utwente.nl/user/s1934538/clickstream/clickstream-enwiki-2019-01.tsv.gz,Fantastic_Beasts:_The_Crimes_of_Grindelwald,136031,383792,7593,527416,262861
hdfs://spark-nn.eemcs.utwente.nl/user/s1934538/clickstream/clickstream-enwiki-2019-01.tsv.gz,Stranger_Things,54689,346961,9625,411275,295896
hdfs://spark-nn.eemcs.utwente.nl/user/s1934538/clickstream/clickstream-enwiki-2019-01.tsv.gz,Rami_Malek,243011,1698401,12342,1953754,833022
hdfs://spark-nn.eemcs.utwente.nl/user/s1934538/clickstream/clickstream-enwiki-2019-01.tsv.gz,Critical_race_theory,1725,12890,31,14646,3212
hdfs://spark-nn.eemcs.utwente.nl/user/s1934538/clickstream/clickstream-enwiki-2019-01.tsv.gz,Brie_Larson,148131,266513,2041,416685,163163
hdfs://spark-nn.eemcs.utwente.nl/user/s1934538/clickstream/clickstream-enwiki-2019-01.tsv.gz,Coronavirus,857,17035,72,17964,1952
hdfs://spark-nn.eemcs.utwente.nl/user/s1934538/clickstream/clickstream-enwiki-2019-01.tsv.gz,Cleopatra,48967,267445,3281,319693,131451
hdfs://spark-nn.eemcs.utwente.nl/user/s1934538/clickstream/clickstream-enwiki-2019-01.tsv.gz,Avicii,31259,704906,3991,740156,171900
hdfs://spark-nn.eemcs.utwente.nl/user/s1934538/clickstream/clickstream-enwiki-2019-01.tsv.gz,Kim_Jong-un,48069,170582,1522,220173,119675
hdfs://spark-nn.eemcs.utwente.nl/user/s1934538/clickstream/clickstream-enwiki-2019-01.tsv.gz,Chernobyl_disaster,32866,245335,1473,279674,81112
hdfs://spark-nn.eemcs.utwente.nl/user/s1934538/clickstream/clickstream-enwiki-2019-01.tsv.gz,Cristiano_Ronaldo,157708,896501,5351,1059560,204337
hdfs://spark-nn.eemcs.utwente.nl/user/s1934538/clickstream/clickstream-enwiki-2019-01.tsv.gz,George_VI,454825,226086,922,681833,472748
hdfs://spark-nn.eemcs.utwente.nl/user/s1934538/clickstream/clickstream-enwiki-2019-01.tsv.gz,Kelly_Preston,87619,58245,175,146039,41121
hdfs://spark-nn.eemcs.utwente.nl/user/s1934538/clickstream/clickstream-enwiki-2019-01.tsv.gz,Deion_Sanders,17348,255194,1705,274247,75560
hdfs://spark-nn.eemcs.utwente.nl/user/s1934538/clickstream/clickstream-enwiki-2019-01.tsv.gz,Johnny_Depp,139396,310852,2685,452933,293231
hdfs://spark-nn.eemcs.utwente.nl/user/s1934538/clickstream/clickstream-enwiki-2019-01.tsv.gz,Tina_Turner,22588,470133,4762,497483,95352
hdfs://spark-nn.eemcs.utwente.nl/user/s1934538/clickstream/clickstream-enwiki-2019-01.tsv.gz,Top_Gun:_Maverick,84404,45404,331,130139,99219
hdfs://spark-nn.eemcs.utwente.nl/user/s1934538/clickstream/clickstream-enwiki-2019-01.tsv.gz,Ukraine,44641,147642,3246,195529,86583
hdfs://spark-nn.eemcs.utwente.nl/user/s1934538/clickstream/clickstream-enwiki-2019-01.tsv.gz,Spanish_flu,25425,116004,1042,142471,31086
hdfs://spark-nn.eemcs.utwente.nl/user/s1934538/clickstream/clickstream-enwiki-2019-01.tsv.gz,Richard_Ramirez,12711,231493,2409,246613,53256
hdfs://spark-nn.eemcs.utwente.nl/user/s1934538/clickstream/clickstream-enwiki-2019-01.tsv.gz,The_Umbrella_Academy_(TV_series),36142,66692,1395,104229,69586
hdfs://spark-nn.eemcs.utwente.nl/user/s1934538/clickstream/clickstream-enwiki-2019-01.tsv.gz,Juice_Wrld,21979,124898,1125,148002,39675
hdfs://spark-nn.eemcs.utwente.nl/user/s1934538/clickstream/clickstream-enwiki-2019-01.tsv.gz,Tunnel,4765,11832,195,16792,4515
hdfs://spark-nn.eemcs.utwente.nl/user/s1934538/clickstream/clickstream-enwiki-2019-01.tsv.gz,Matthew_Perry,88472,248190,741,337403,144821
hdfs://spark-nn.eemcs.utwente.nl/user/s1934538/clickstream/clickstream-enwiki-2019-01.tsv.gz,J._Robert_Oppenheimer,18434,92464,674,111572,37037
hdfs://spark-nn.eemcs.utwente.nl/user/s1934538/clickstream/clickstream-enwiki-2019-01.tsv.gz,Avengers:_Endgame,520362,570982,15892,1107236,721487
hdfs://spark-nn.eemcs.utwente.nl/user/s1934538/clickstream/clickstream-enwiki-2019-01.tsv.gz,Israel,76036,289364,5540,370940,173469
hdfs://spark-nn.eemcs.utwente.nl/user/s1934538/clickstream/clickstream-enwiki-2019-01.tsv.gz,Ted_Bundy,115831,7073324,62392,7251547,1779680
hdfs://spark-nn.eemcs.utwente.nl/user/s1934538/clickstream/clickstream-enwiki-2019-01.tsv.gz,Death_of_Elisa_Lam,7494,69747,349,77590,20288
hdfs://spark-nn.eemcs.utwente.nl/user/s1934538/clickstream/clickstream-enwiki-2019-01.tsv.gz,2016_United_States_presidential_election,118195,240002,2623,360820,240051
hdfs://spark-nn.eemcs.utwente.nl/user/s1934538/clickstream/clickstream-enwiki-2019-01.tsv.gz,Bible,18684,93385,1768,113837,41501
hdfs://spark-nn.eemcs.utwente.nl/user/s1934538/clickstream/clickstream-enwiki-2019-01.tsv.gz,Meat_Loaf,18321,77235,703,96259,34342
hdfs://spark-nn.eemcs.utwente.nl/user/s1934538/clickstream/clickstream-enwiki-2019-01.tsv.gz,2020_United_States_presidential_election,129535,431238,9772,570545,492389
hdfs://spark-nn.eemcs.utwente.nl/user/s1934538/clickstream/clickstream-enwiki-2019-01.tsv.gz,Avengers:_Infinity_War,241095,585766,14300,841161,669993
hdfs://spark-nn.eemcs.utwente.nl/user/s1934538/clickstream/clickstream-enwiki-2019-01.tsv.gz,United_States_Electoral_College,25878,113785,2167,141830,17540
hdfs://spark-nn.eemcs.utwente.nl/user/s1934538/clickstream/clickstream-enwiki-2019-01.tsv.gz,Bonnie_and_Clyde,16734,159225,1135,177094,40766
hdfs://spark-nn.eemcs.utwente.nl/user/s1934538/clickstream/clickstream-enwiki-2019-01.tsv.gz,Manti_Te'o,7165,40668,165,47998,2199
hdfs://spark-nn.eemcs.utwente.nl/user/s1934538/clickstream/clickstream-enwiki-2019-01.tsv.gz,Alexander_Hamilton,93337,402454,2893,498684,213755
hdfs://spark-nn.eemcs.utwente.nl/user/s1934538/clickstream/clickstream-enwiki-2019-01.tsv.gz,Aquaman_(film),293757,2281939,59065,2634761,1394656
hdfs://spark-nn.eemcs.utwente.nl/user/s1934538/clickstream/clickstream-enwiki-2019-01.tsv.gz,Aaron_Hernandez,20721,131833,764,153318,49978
hdfs://spark-nn.eemcs.utwente.nl/user/s1934538/clickstream/clickstream-enwiki-2019-01.tsv.gz,Stephen_Hawking,50547,662030,4805,717382,289101
hdfs://spark-nn.eemcs.utwente.nl/user/s1934538/clickstream/clickstream-enwiki-2019-01.tsv.gz,Afghanistan,51346,166221,2947,220514,135299
hdfs://spark-nn.eemcs.utwente.nl/user/s1934538/clickstream/clickstream-enwiki-2019-01.tsv.gz,Cook's_Country,332,3184,21,3537,39
hdfs://spark-nn.eemcs.utwente.nl/user/s1934538/clickstream/clickstream-enwiki-2019-01.tsv.gz,Google_logo,1066,22805,12,23883,2504
hdfs://spark-nn.eemcs.utwente.nl/user/s1934538/clickstream/clickstream-enwiki-2019-01.tsv.gz,Brett_Kavanaugh,41386,87406,720,129512,43415
hdfs://spark-nn.eemcs.utwente.nl/user/s1934538/clickstream/clickstream-enwiki-2019-01.tsv.gz,Mac_Miller,74098,373066,3352,450516,121656
hdfs://spark-nn.eemcs.utwente.nl/user/s1934538/clickstream/clickstream-enwiki-2019-01.tsv.gz,Hamilton_(musical),51806,377105,2640,431551,236514
hdfs://spark-nn.eemcs.utwente.nl/user/s1934538/clickstream/clickstream-enwiki-2019-01.tsv.gz,Pornhub,40711,373036,10644,424391,75220
hdfs://spark-nn.eemcs.utwente.nl/user/s1934538/clickstream/clickstream-enwiki-2019-01.tsv.gz,2.0_(film),88310,713202,6109,807621,171508
hdfs://spark-nn.eemcs.utwente.nl/user/s1934538/clickstream/clickstream-enwiki-2019-01.tsv.gz,DMX_(rapper),20972,154321,702,175995,56722
hdfs://spark-nn.eemcs.utwente.nl/user/s1934538/clickstream/clickstream-enwiki-2019-01.tsv.gz,NATO,40651,150566,2500,193717,65174
hdfs://spark-nn.eemcs.utwente.nl/user/s1934538/clickstream/clickstream-enwiki-2019-01.tsv.gz,"Princess_Margaret,_Countess_of_Snowdon",139793,403820,2673,546286,331096
hdfs://spark-nn.eemcs.utwente.nl/user/s1934538/clickstream/clickstream-enwiki-2019-01.tsv.gz,Donald_Glover,84951,319520,2674,407145,124491
hdfs://spark-nn.eemcs.utwente.nl/user/s1934538/clickstream/clickstream-enwiki-2019-01.tsv.gz,Lionel_Messi,64023,531702,6571,602296,126385
hdfs://spark-nn.eemcs.utwente.nl/user/s1934538/clickstream/clickstream-enwiki-2019-01.tsv.gz,September_11_attacks,74796,328046,2715,405557,172712
hdfs://spark-nn.eemcs.utwente.nl/user/s1934538/clickstream/clickstream-enwiki-2019-01.tsv.gz,Jimmy_Hoffa,27161,89998,772,117931,40783
hdfs://spark-nn.eemcs.utwente.nl/user/s1934538/clickstream/clickstream-enwiki-2019-01.tsv.gz,Venom_(2018_film),81810,547568,10389,639767,337430
hdfs://spark-nn.eemcs.utwente.nl/user/s1934538/clickstream/clickstream-enwiki-2019-01.tsv.gz,Cardi_B,58066,833764,9719,901549,312387
hdfs://spark-nn.eemcs.utwente.nl/user/s1934538/clickstream/clickstream-enwiki-2019-01.tsv.gz,Kamala_Harris,97017,3241664,26550,3365231,1233781
hdfs://spark-nn.eemcs.utwente.nl/user/s1934538/clickstream/clickstream-enwiki-2019-01.tsv.gz,Area_51,21340,224166,1475,246981,65642
hdfs://spark-nn.eemcs.utwente.nl/user/s1934538/clickstream/clickstream-enwiki-2019-01.tsv.gz,Jeffrey_Epstein,7523,62007,281,69811,21304
hdfs://spark-nn.eemcs.utwente.nl/user/s1934538/clickstream/clickstream-enwiki-2019-01.tsv.gz,Sylvester_Stallone,91434,413456,2604,507494,318512
hdfs://spark-nn.eemcs.utwente.nl/user/s1934538/clickstream/clickstream-enwiki-2019-01.tsv.gz,Aaron_Carter,18531,37708,197,56436,16196
hdfs://spark-nn.eemcs.utwente.nl/user/s1934538/clickstream/clickstream-enwiki-2019-01.tsv.gz,List_of_FIFA_World_Cup_finals,1566,43440,46,45052,11409
hdfs://spark-nn.eemcs.utwente.nl/user/s1934538/clickstream/clickstream-enwiki-2019-01.tsv.gz,Jeffrey_Dahmer,57619,701077,8918,767614,328027
hdfs://spark-nn.eemcs.utwente.nl/user/s1934538/clickstream/clickstream-enwiki-2019-01.tsv.gz,2020_Summer_Olympics,50821,128265,1969,181055,119293
hdfs://spark-nn.eemcs.utwente.nl/user/s1934538/clickstream/clickstream-enwiki-2019-01.tsv.gz,Burt_Reynolds,52349,215463,2043,269855,101160
hdfs://spark-nn.eemcs.utwente.nl/user/s1934538/clickstream/clickstream-enwiki-2019-01.tsv.gz,Juneteenth,3421,28264,64,31749,3578
hdfs://spark-nn.eemcs.utwente.nl/user/s1934538/clickstream/clickstream-enwiki-2019-01.tsv.gz,State_of_Palestine,45879,83073,126,129078,58325
hdfs://spark-nn.eemcs.utwente.nl/user/s1934538/clickstream/clickstream-enwiki-2019-01.tsv.gz,Luke_Perry,32166,69448,725,102339,17729
hdfs://spark-nn.eemcs.utwente.nl/user/s1934538/clickstream/clickstream-enwiki-2019-01.tsv.gz,Sushant_Singh_Rajput,47123,106133,268,153524,96107
hdfs://spark-nn.eemcs.utwente.nl/user/s1934538/clickstream/clickstream-enwiki-2019-01.tsv.gz,Priyanka_Chopra,134875,481430,2420,618725,263711
hdfs://spark-nn.eemcs.utwente.nl/user/s1934538/clickstream/clickstream-enwiki-2019-01.tsv.gz,Amy_Coney_Barrett,3276,41852,444,45572,7769
hdfs://spark-nn.eemcs.utwente.nl/user/s1934538/clickstream/clickstream-enwiki-2019-01.tsv.gz,Main_Page,36594,510224155,4520716,514781465,35831912
hdfs://spark-nn.eemcs.utwente.nl/user/s1934538/clickstream/clickstream-enwiki-2019-01.tsv.gz,Ruth_Bader_Ginsburg,99364,1048074,6798,1154236,405625
hdfs://spark-nn.eemcs.utwente.nl/user/s1934538/clickstream/clickstream-enwiki-2019-01.tsv.gz,Black_Panther_(film),130866,371057,10869,512792,331890
hdfs://spark-nn.eemcs.utwente.nl/user/s1934538/clickstream/clickstream-enwiki-2019-01.tsv.gz,2018_Asian_Games,11409,54478,368,66255,26604
hdfs://spark-nn.eemcs.utwente.nl/user/s1934538/clickstream/clickstream-enwiki-2019-01.tsv.gz,Line_shaft,635,1081,45,1761,131
hdfs://spark-nn.eemcs.utwente.nl/user/s1934538/clickstream/clickstream-enwiki-2019-01.tsv.gz,Bird_Box_(film),429013,2768778,73263,3271054,1468404
hdfs://spark-nn.eemcs.utwente.nl/user/s1934538/clickstream/clickstream-enwiki-2019-01.tsv.gz,Chernobyl_(miniseries),3184,16820,39,20043,6667
hdfs://spark-nn.eemcs.utwente.nl/user/s1934538/clickstream/clickstream-enwiki-2019-01.tsv.gz,The_Irishman_(2019_film),70888,97855,1612,170355,136039
hdfs://spark-nn.eemcs.utwente.nl/user/s1934538/clickstream/clickstream-enwiki-2019-01.tsv.gz,Charles_Sobhraj,3787,32995,112,36894,6150
hdfs://spark-nn.eemcs.utwente.nl/user/s1934538/clickstream/clickstream-enwiki-2019-01.tsv.gz,Naya_Rivera,25015,33895,319,59229,11761
hdfs://spark-nn.eemcs.utwente.nl/user/s1934538/clickstream/clickstream-enwiki-2019-01.tsv.gz,XXX:_Return_of_Xander_Cage,49643,124567,1270,175480,79125
hdfs://spark-nn.eemcs.utwente.nl/user/s1934538/clickstream/clickstream-enwiki-2019-01.tsv.gz,Once_Upon_a_Time_in_Hollywood,200527,152783,1964,355274,390634
hdfs://spark-nn.eemcs.utwente.nl/user/s1934538/clickstream/clickstream-enwiki-2019-01.tsv.gz,The_Nun_(2018_film),38912,204993,2090,245995,156839
hdfs://spark-nn.eemcs.utwente.nl/user/s1934538/clickstream/clickstream-enwiki-2019-01.tsv.gz,Darth_Vader,23279,921641,1157,946077,64189
hdfs://spark-nn.eemcs.utwente.nl/user/s1934538/clickstream/clickstream-enwiki-2019-01.tsv.gz,Wonder_Woman_1984,115819,56681,640,173140,101390
hdfs://spark-nn.eemcs.utwente.nl/user/s1934538/clickstream/clickstream-enwiki-2019-01.tsv.gz,Joaquin_Phoenix,156218,165449,1089,322756,228440
hdfs://spark-nn.eemcs.utwente.nl/user/s1934538/clickstream/clickstream-enwiki-2019-01.tsv.gz,List_of_highest-grossing_Indian_films,167077,774808,2814,944699,429486
hdfs://spark-nn.eemcs.utwente.nl/user/s1934538/clickstream/clickstream-enwiki-2019-01.tsv.gz,RRR_(film),54161,39620,623,94404,33510
hdfs://spark-nn.eemcs.utwente.nl/user/s1934538/clickstream/clickstream-enwiki-2019-01.tsv.gz,Eddie_Van_Halen,39674,66157,633,106464,41222
hdfs://spark-nn.eemcs.utwente.nl/user/s1934538/clickstream/clickstream-enwiki-2019-01.tsv.gz,Atal_Bihari_Vajpayee,31214,98637,99,129950,27613
hdfs://spark-nn.eemcs.utwente.nl/user/s1934538/clickstream/clickstream-enwiki-2019-01.tsv.gz,Freddie_Mercury,472069,3215988,19965,3708022,1441453
hdfs://spark-nn.eemcs.utwente.nl/user/s1934538/clickstream/clickstream-enwiki-2019-01.tsv.gz,QAnon,4931,144493,613,150037,36524
hdfs://spark-nn.eemcs.utwente.nl/user/s1934538/clickstream/clickstream-enwiki-2019-01.tsv.gz,R._Kelly,260658,3419261,26428,3706347,1776688
hdfs://spark-nn.eemcs.utwente.nl/user/s1934538/clickstream/clickstream-enwiki-2019-11.tsv.gz,Asia_Cup,1136,13313,74,14523,7510
hdfs://spark-nn.eemcs.utwente.nl/user/s1934538/clickstream/clickstream-enwiki-2019-11.tsv.gz,Area_51,11522,186940,1046,199508,31209
hdfs://spark-nn.eemcs.utwente.nl/user/s1934538/clickstream/clickstream-enwiki-2019-11.tsv.gz,Avicii,19567,204291,1652,225510,100735
hdfs://spark-nn.eemcs.utwente.nl/user/s1934538/clickstream/clickstream-enwiki-2019-11.tsv.gz,Sinéad_O'Connor,14221,74743,688,89652,24726
hdfs://spark-nn.eemcs.utwente.nl/user/s1934538/clickstream/clickstream-enwiki-2019-11.tsv.gz,"Diana,_Princess_of_Wales",309416,391789,3772,704977,416504
hdfs://spark-nn.eemcs.utwente.nl/user/s1934538/clickstream/clickstream-enwiki-2019-11.tsv.gz,Jeffrey_Epstein,116824,2734574,12665,2864063,790801
hdfs://spark-nn.eemcs.utwente.nl/user/s1934538/clickstream/clickstream-enwiki-2019-11.tsv.gz,Naomi_Osaka,11721,25104,118,36943,8078
hdfs://spark-nn.eemcs.utwente.nl/user/s1934538/clickstream/clickstream-enwiki-2019-11.tsv.gz,Chernobyl_(miniseries),26448,154318,3252,184018,162831
hdfs://spark-nn.eemcs.utwente.nl/user/s1934538/clickstream/clickstream-enwiki-2019-11.tsv.gz,State_of_Palestine,39430,107563,168,147161,60435
hdfs://spark-nn.eemcs.utwente.nl/user/s1934538/clickstream/clickstream-enwiki-2019-11.tsv.gz,DMX_(rapper),13212,55072,427,68711,30289
hdfs://spark-nn.eemcs.utwente.nl/user/s1934538/clickstream/clickstream-enwiki-2019-11.tsv.gz,Elon_Musk,109731,1016266,7095,1133092,653003
hdfs://spark-nn.eemcs.utwente.nl/user/s1934538/clickstream/clickstream-enwiki-2019-11.tsv.gz,September_11_attacks,75276,325070,2194,402540,150629
hdfs://spark-nn.eemcs.utwente.nl/user/s1934538/clickstream/clickstream-enwiki-2019-11.tsv.gz,JSON_Web_Token,935,24049,38,25022,2078
hdfs://spark-nn.eemcs.utwente.nl/user/s1934538/clickstream/clickstream-enwiki-2019-11.tsv.gz,HTTP_cookie,7441,283881,95,291417,38253
hdfs://spark-nn.eemcs.utwente.nl/user/s1934538/clickstream/clickstream-enwiki-2019-11.tsv.gz,Sylvester_Stallone,90862,304360,2101,397323,282121
hdfs://spark-nn.eemcs.utwente.nl/user/s1934538/clickstream/clickstream-enwiki-2019-11.tsv.gz,Simone_Biles,10602,83150,594,94346,21012
hdfs://spark-nn.eemcs.utwente.nl/user/s1934538/clickstream/clickstream-enwiki-2019-11.tsv.gz,Fantastic_Beasts:_The_Crimes_of_Grindelwald,70564,157604,1941,230109,127220
hdfs://spark-nn.eemcs.utwente.nl/user/s1934538/clickstream/clickstream-enwiki-2019-11.tsv.gz,Glass_(2019_film),70508,242200,1874,314582,108628
hdfs://spark-nn.eemcs.utwente.nl/user/s1934538/clickstream/clickstream-enwiki-2019-11.tsv.gz,"Meghan,_Duchess_of_Sussex",133730,229802,1739,365271,215712
hdfs://spark-nn.eemcs.utwente.nl/user/s1934538/clickstream/clickstream-enwiki-2019-11.tsv.gz,Aaron_Carter,23289,122600,938,146827,47284
hdfs://spark-nn.eemcs.utwente.nl/user/s1934538/clickstream/clickstream-enwiki-2019-11.tsv.gz,Burt_Reynolds,48665,136847,1229,186741,75016
hdfs://spark-nn.eemcs.utwente.nl/user/s1934538/clickstream/clickstream-enwiki-2019-11.tsv.gz,Ghislaine_Maxwell,121828,285260,2144,409232,177440
hdfs://spark-nn.eemcs.utwente.nl/user/s1934538/clickstream/clickstream-enwiki-2019-11.tsv.gz,Pornhub,36946,338555,13041,388542,70948
hdfs://spark-nn.eemcs.utwente.nl/user/s1934538/clickstream/clickstream-enwiki-2019-11.tsv.gz,Vladimir_Putin,75634,194108,2647,272389,163012
hdfs://spark-nn.eemcs.utwente.nl/user/s1934538/clickstream/clickstream-enwiki-2019-11.tsv.gz,Meat_Loaf,21818,77333,919,100070,34120
hdfs://spark-nn.eemcs.utwente.nl/user/s1934538/clickstream/clickstream-enwiki-2019-11.tsv.gz,Cecil_Hotel_(Los_Angeles),5955,21740,36,27731,11658
hdfs://spark-nn.eemcs.utwente.nl/user/s1934538/clickstream/clickstream-enwiki-2019-11.tsv.gz,George_VI,850162,414922,1894,1266978,955711
hdfs://spark-nn.eemcs.utwente.nl/user/s1934538/clickstream/clickstream-enwiki-2019-11.tsv.gz,Antifa_(United_States),7465,95818,217,103500,15477
hdfs://spark-nn.eemcs.utwente.nl/user/s1934538/clickstream/clickstream-enwiki-2019-11.tsv.gz,Shakira,22040,175176,1956,199172,92307
hdfs://spark-nn.eemcs.utwente.nl/user/s1934538/clickstream/clickstream-enwiki-2019-11.tsv.gz,List_of_highest-grossing_Indian_films,85943,435749,1749,523441,257309
hdfs://spark-nn.eemcs.utwente.nl/user/s1934538/clickstream/clickstream-enwiki-2019-11.tsv.gz,Kylian_Mbappé,24158,144352,1749,170259,31320
hdfs://spark-nn.eemcs.utwente.nl/user/s1934538/clickstream/clickstream-enwiki-2019-11.tsv.gz,WrestleMania_34,19716,11289,365,31370,20765
hdfs://spark-nn.eemcs.utwente.nl/user/s1934538/clickstream/clickstream-enwiki-2019-11.tsv.gz,Ray_Liotta,45222,66420,580,112222,37062
hdfs://spark-nn.eemcs.utwente.nl/user/s1934538/clickstream/clickstream-enwiki-2019-11.tsv.gz,Media,69,332097,316,332482,1797
hdfs://spark-nn.eemcs.utwente.nl/user/s1934538/clickstream/clickstream-enwiki-2019-11.tsv.gz,Charles_Sobhraj,4281,20861,64,25206,5647
hdfs://spark-nn.eemcs.utwente.nl/user/s1934538/clickstream/clickstream-enwiki-2019-11.tsv.gz,Amber_Heard,110739,142782,1006,254527,116235
hdfs://spark-nn.eemcs.utwente.nl/user/s1934538/clickstream/clickstream-enwiki-2019-11.tsv.gz,Ted_Bundy,39203,479720,4377,523300,116983
hdfs://spark-nn.eemcs.utwente.nl/user/s1934538/clickstream/clickstream-enwiki-2019-11.tsv.gz,Gaza_Strip,18714,62967,1082,82763,28005
hdfs://spark-nn.eemcs.utwente.nl/user/s1934538/clickstream/clickstream-enwiki-2019-11.tsv.gz,A_Quiet_Place_(film),38925,144466,1123,184514,55996
hdfs://spark-nn.eemcs.utwente.nl/user/s1934538/clickstream/clickstream-enwiki-2019-11.tsv.gz,2018_Asian_Games,11033,19851,155,31039,20591
hdfs://spark-nn.eemcs.utwente.nl/user/s1934538/clickstream/clickstream-enwiki-2019-11.tsv.gz,Tenet_(film),99295,82982,700,182977,148911
hdfs://spark-nn.eemcs.utwente.nl/user/s1934538/clickstream/clickstream-enwiki-2019-11.tsv.gz,Deion_Sanders,13234,179214,860,193308,49484
hdfs://spark-nn.eemcs.utwente.nl/user/s1934538/clickstream/clickstream-enwiki-2019-11.tsv.gz,Mac_Miller,33228,158694,1347,193269,60509
hdfs://spark-nn.eemcs.utwente.nl/user/s1934538/clickstream/clickstream-enwiki-2019-11.tsv.gz,When_They_See_Us,27286,128157,681,156124,84070
hdfs://spark-nn.eemcs.utwente.nl/user/s1934538/clickstream/clickstream-enwiki-2019-11.tsv.gz,Deaths_in_2019,1119512,2007642,8153,3135307,1697198
hdfs://spark-nn.eemcs.utwente.nl/user/s1934538/clickstream/clickstream-enwiki-2019-11.tsv.gz,Richard_Ramirez,25820,248342,1646,275808,86035
hdfs://spark-nn.eemcs.utwente.nl/user/s1934538/clickstream/clickstream-enwiki-2019-11.tsv.gz,Deadpool_2,61780,95662,2586,160028,89979
hdfs://spark-nn.eemcs.utwente.nl/user/s1934538/clickstream/clickstream-enwiki-2019-11.tsv.gz,Game_of_Thrones,71742,243475,8083,323300,202582
hdfs://spark-nn.eemcs.utwente.nl/user/s1934538/clickstream/clickstream-enwiki-2019-11.tsv.gz,Kelly_Preston,72699,42971,181,115851,32560
hdfs://spark-nn.eemcs.utwente.nl/user/s1934538/clickstream/clickstream-enwiki-2019-11.tsv.gz,FIFA_World_Cup,35768,153384,2526,191678,131268
hdfs://spark-nn.eemcs.utwente.nl/user/s1934538/clickstream/clickstream-enwiki-2019-11.tsv.gz,The_Nun_(2018_film),24654,79288,506,104448,62921
hdfs://spark-nn.eemcs.utwente.nl/user/s1934538/clickstream/clickstream-enwiki-2019-11.tsv.gz,Eddie_Van_Halen,27852,49470,553,77875,37491
hdfs://spark-nn.eemcs.utwente.nl/user/s1934538/clickstream/clickstream-enwiki-2019-11.tsv.gz,Cristiano_Ronaldo,119388,708888,6580,834856,185436
hdfs://spark-nn.eemcs.utwente.nl/user/s1934538/clickstream/clickstream-enwiki-2019-11.tsv.gz,Rihanna,63789,217866,3256,284911,144950
hdfs://spark-nn.eemcs.utwente.nl/user/s1934538/clickstream/clickstream-enwiki-2019-11.tsv.gz,Hamilton_(musical),34949,259196,1524,295669,141785
hdfs://spark-nn.eemcs.utwente.nl/user/s1934538/clickstream/clickstream-enwiki-2019-11.tsv.gz,Sridevi,26279,113281,231,139791,41667
hdfs://spark-nn.eemcs.utwente.nl/user/s1934538/clickstream/clickstream-enwiki-2019-11.tsv.gz,2022_FIFA_World_Cup,61166,142066,4174,207406,105362
hdfs://spark-nn.eemcs.utwente.nl/user/s1934538/clickstream/clickstream-enwiki-2019-11.tsv.gz,Key_frame,589,6138,16,6743,465
hdfs://spark-nn.eemcs.utwente.nl/user/s1934538/clickstream/clickstream-enwiki-2019-11.tsv.gz,Mortal_Kombat_(2021_film),20961,34192,246,55399,97463
hdfs://spark-nn.eemcs.utwente.nl/user/s1934538/clickstream/clickstream-enwiki-2019-11.tsv.gz,Grover,2396,8682,75,11153,2530
hdfs://spark-nn.eemcs.utwente.nl/user/s1934538/clickstream/clickstream-enwiki-2019-11.tsv.gz,Article_370_of_the_Constitution_of_India,7205,265164,166,272535,19595
hdfs://spark-nn.eemcs.utwente.nl/user/s1934538/clickstream/clickstream-enwiki-2019-11.tsv.gz,John_McCain,37717,90762,869,129348,60561
hdfs://spark-nn.eemcs.utwente.nl/user/s1934538/clickstream/clickstream-enwiki-2019-11.tsv.gz,Louis_Tomlinson,43395,84644,634,128673,25158
hdfs://spark-nn.eemcs.utwente.nl/user/s1934538/clickstream/clickstream-enwiki-2019-11.tsv.gz,Atal_Bihari_Vajpayee,26479,57544,69,84092,20785
hdfs://spark-nn.eemcs.utwente.nl/user/s1934538/clickstream/clickstream-enwiki-2019-11.tsv.gz,R._Kelly,35499,261034,2855,299388,118196
hdfs://spark-nn.eemcs.utwente.nl/user/s1934538/clickstream/clickstream-enwiki-2019-11.tsv.gz,Exo_(band),25268,178063,603,203934,155545
hdfs://spark-nn.eemcs.utwente.nl/user/s1934538/clickstream/clickstream-enwiki-2019-11.tsv.gz,The_Umbrella_Academy_(TV_series),24541,126390,1655,152586,75506
hdfs://spark-nn.eemcs.utwente.nl/user/s1934538/clickstream/clickstream-enwiki-2019-11.tsv.gz,Spider-Man:_Far_From_Home,106813,259767,4280,370860,204837
hdfs://spark-nn.eemcs.utwente.nl/user/s1934538/clickstream/clickstream-enwiki-2019-11.tsv.gz,Critical_race_theory,2368,21133,37,23538,4370
hdfs://spark-nn.eemcs.utwente.nl/user/s1934538/clickstream/clickstream-enwiki-2019-11.tsv.gz,Godzilla_vs._Kong,66555,68229,1512,136296,78651
hdfs://spark-nn.eemcs.utwente.nl/user/s1934538/clickstream/clickstream-enwiki-2019-11.tsv.gz,Stranger_Things,60589,352378,6770,419737,325329
hdfs://spark-nn.eemcs.utwente.nl/user/s1934538/clickstream/clickstream-enwiki-2019-11.tsv.gz,Cameron_Boyce,52859,294090,1245,348194,94964
hdfs://spark-nn.eemcs.utwente.nl/user/s1934538/clickstream/clickstream-enwiki-2019-11.tsv.gz,Ruth_Bader_Ginsburg,29121,200166,1524,230811,77462
hdfs://spark-nn.eemcs.utwente.nl/user/s1934538/clickstream/clickstream-enwiki-2019-11.tsv.gz,Olivia_Newton-John,31617,135465,1398,168480,71273
hdfs://spark-nn.eemcs.utwente.nl/user/s1934538/clickstream/clickstream-enwiki-2019-11.tsv.gz,Once_Upon_a_Time_in_Hollywood,157157,651711,12878,821746,856129
hdfs://spark-nn.eemcs.utwente.nl/user/s1934538/clickstream/clickstream-enwiki-2019-11.tsv.gz,Spanish_flu,28019,84295,736,113050,28010
hdfs://spark-nn.eemcs.utwente.nl/user/s1934538/clickstream/clickstream-enwiki-2019-11.tsv.gz,Naya_Rivera,29923,39080,116,69119,12936
hdfs://spark-nn.eemcs.utwente.nl/user/s1934538/clickstream/clickstream-enwiki-2019-11.tsv.gz,List_of_FIFA_World_Cup_finals,2115,43668,97,45880,12161
hdfs://spark-nn.eemcs.utwente.nl/user/s1934538/clickstream/clickstream-enwiki-2019-11.tsv.gz,Black_Panther_(film),50535,116579,2315,169429,99757
hdfs://spark-nn.eemcs.utwente.nl/user/s1934538/clickstream/clickstream-enwiki-2019-11.tsv.gz,Manti_Te'o,8705,91189,461,100355,10405
hdfs://spark-nn.eemcs.utwente.nl/user/s1934538/clickstream/clickstream-enwiki-2019-11.tsv.gz,List_of_awards_and_nominations_received_by_Meryl_Streep,11170,3811777,245,3823192,6704
hdfs://spark-nn.eemcs.utwente.nl/user/s1934538/clickstream/clickstream-enwiki-2019-11.tsv.gz,No_Time_to_Die,141727,141172,2298,285197,234257
hdfs://spark-nn.eemcs.utwente.nl/user/s1934538/clickstream/clickstream-enwiki-2019-11.tsv.gz,Matthew_Perry,78810,266799,1223,346832,185077
hdfs://spark-nn.eemcs.utwente.nl/user/s1934538/clickstream/clickstream-enwiki-2019-11.tsv.gz,Royal_Rumble_(2018),8410,4777,66,13253,9501
hdfs://spark-nn.eemcs.utwente.nl/user/s1934538/clickstream/clickstream-enwiki-2019-11.tsv.gz,2020_Summer_Olympics,61255,202298,4804,268357,237165
hdfs://spark-nn.eemcs.utwente.nl/user/s1934538/clickstream/clickstream-enwiki-2019-11.tsv.gz,Betty_White,45340,428390,3420,477150,89957
hdfs://spark-nn.eemcs.utwente.nl/user/s1934538/clickstream/clickstream-enwiki-2019-11.tsv.gz,2016_United_States_presidential_election,118848,346592,4372,469812,282745
hdfs://spark-nn.eemcs.utwente.nl/user/s1934538/clickstream/clickstream-enwiki-2019-11.tsv.gz,The_Witcher_(TV_series),36441,247782,4152,288375,174876
hdfs://spark-nn.eemcs.utwente.nl/user/s1934538/clickstream/clickstream-enwiki-2019-11.tsv.gz,Us_(2019_film),50205,331318,1377,382900,107931
hdfs://spark-nn.eemcs.utwente.nl/user/s1934538/clickstream/clickstream-enwiki-2019-11.tsv.gz,Venom_(2018_film),32244,137938,4426,174608,82058
hdfs://spark-nn.eemcs.utwente.nl/user/s1934538/clickstream/clickstream-enwiki-2019-11.tsv.gz,Star_Wars:_The_Rise_of_Skywalker,293798,540888,24992,859678,503953
hdfs://spark-nn.eemcs.utwente.nl/user/s1934538/clickstream/clickstream-enwiki-2019-11.tsv.gz,The_Lion_King_(2019_film),117278,447823,3794,568895,319510
hdfs://spark-nn.eemcs.utwente.nl/user/s1934538/clickstream/clickstream-enwiki-2019-11.tsv.gz,Puneeth_Rajkumar,9053,28149,18,37220,13471
hdfs://spark-nn.eemcs.utwente.nl/user/s1934538/clickstream/clickstream-enwiki-2019-11.tsv.gz,Queen_(band),71573,332775,2938,407286,292399
hdfs://spark-nn.eemcs.utwente.nl/user/s1934538/clickstream/clickstream-enwiki-2019-11.tsv.gz,Tonya_Harding,29787,120838,527,151152,34399
hdfs://spark-nn.eemcs.utwente.nl/user/s1934538/clickstream/clickstream-enwiki-2019-11.tsv.gz,The_Haunting_of_Bly_Manor,5560,902,19,6481,6068
hdfs://spark-nn.eemcs.utwente.nl/user/s1934538/clickstream/clickstream-enwiki-2019-11.tsv.gz,Alexander_Hamilton,66881,264023,1655,332559,147670
hdfs://spark-nn.eemcs.utwente.nl/user/s1934538/clickstream/clickstream-enwiki-2019-11.tsv.gz,J._Robert_Oppenheimer,18816,90551,310,109677,35714
hdfs://spark-nn.eemcs.utwente.nl/user/s1934538/clickstream/clickstream-enwiki-2019-11.tsv.gz,Cardi_B,55070,436887,5105,497062,144272
hdfs://spark-nn.eemcs.utwente.nl/user/s1934538/clickstream/clickstream-enwiki-2019-11.tsv.gz,Game_of_Thrones_(season_8),14747,65618,1247,81612,28036
hdfs://spark-nn.eemcs.utwente.nl/user/s1934538/clickstream/clickstream-enwiki-2019-11.tsv.gz,Ukraine,51614,235723,5934,293271,126578
hdfs://spark-nn.eemcs.utwente.nl/user/s1934538/clickstream/clickstream-enwiki-2019-11.tsv.gz,Sushant_Singh_Rajput,45605,96110,398,142113,88915
hdfs://spark-nn.eemcs.utwente.nl/user/s1934538/clickstream/clickstream-enwiki-2019-11.tsv.gz,Irrfan_Khan,24165,49913,321,74399,28140
hdfs://spark-nn.eemcs.utwente.nl/user/s1934538/clickstream/clickstream-enwiki-2019-11.tsv.gz,Aquaman_(film),52471,165320,2970,220761,116895
hdfs://spark-nn.eemcs.utwente.nl/user/s1934538/clickstream/clickstream-enwiki-2019-11.tsv.gz,Saaho,46823,232551,1567,280941,73224
hdfs://spark-nn.eemcs.utwente.nl/user/s1934538/clickstream/clickstream-enwiki-2019-11.tsv.gz,William_Murdoch,502,1872,12,2386,349
hdfs://spark-nn.eemcs.utwente.nl/user/s1934538/clickstream/clickstream-enwiki-2019-11.tsv.gz,Anthony_Bourdain,14037,199181,1610,214828,58876
hdfs://spark-nn.eemcs.utwente.nl/user/s1934538/clickstream/clickstream-enwiki-2019-11.tsv.gz,Aaron_Hernandez,12882,114642,589,128113,47671
hdfs://spark-nn.eemcs.utwente.nl/user/s1934538/clickstream/clickstream-enwiki-2019-11.tsv.gz,Mulan_(2020_film),37109,50861,1356,89326,77398
hdfs://spark-nn.eemcs.utwente.nl/user/s1934538/clickstream/clickstream-enwiki-2019-11.tsv.gz,Death_of_Elisa_Lam,8291,70409,408,79108,20135
hdfs://spark-nn.eemcs.utwente.nl/user/s1934538/clickstream/clickstream-enwiki-2019-11.tsv.gz,Richard_Jewell,272110,2329482,11386,2612978,746192
hdfs://spark-nn.eemcs.utwente.nl/user/s1934538/clickstream/clickstream-enwiki-2019-11.tsv.gz,The_Irishman_(2019_film),379751,2915764,44125,3339640,2829976
hdfs://spark-nn.eemcs.utwente.nl/user/s1934538/clickstream/clickstream-enwiki-2019-11.tsv.gz,Valentine's_Day,3172,45625,363,49160,3625
hdfs://spark-nn.eemcs.utwente.nl/user/s1934538/clickstream/clickstream-enwiki-2019-11.tsv.gz,List_of_Queen_of_the_South_episodes,10831,8884,72,19787,492
hdfs://spark-nn.eemcs.utwente.nl/user/s1934538/clickstream/clickstream-enwiki-2019-11.tsv.gz,Bible,16289,1021244,1409,1038942,33243
hdfs://spark-nn.eemcs.utwente.nl/user/s1934538/clickstream/clickstream-enwiki-2019-11.tsv.gz,List_of_James_Bond_films,25822,232863,510,259195,123155
hdfs://spark-nn.eemcs.utwente.nl/user/s1934538/clickstream/clickstream-enwiki-2019-11.tsv.gz,Coronavirus,928,7347,56,8331,1089
hdfs://spark-nn.eemcs.utwente.nl/user/s1934538/clickstream/clickstream-enwiki-2019-11.tsv.gz,Amy_Coney_Barrett,1738,9145,72,10955,2328
hdfs://spark-nn.eemcs.utwente.nl/user/s1934538/clickstream/clickstream-enwiki-2019-11.tsv.gz,Nipsey_Hussle,32860,182728,1175,216763,69671
hdfs://spark-nn.eemcs.utwente.nl/user/s1934538/clickstream/clickstream-enwiki-2019-11.tsv.gz,Bonnie_and_Clyde,29881,293805,1980,325666,79182
hdfs://spark-nn.eemcs.utwente.nl/user/s1934538/clickstream/clickstream-enwiki-2019-11.tsv.gz,Jeffrey_Dahmer,27882,333472,3255,364609,150482
hdfs://spark-nn.eemcs.utwente.nl/user/s1934538/clickstream/clickstream-enwiki-2019-11.tsv.gz,Central_Park_jogger_case,47382,180283,364,228029,28850
hdfs://spark-nn.eemcs.utwente.nl/user/s1934538/clickstream/clickstream-enwiki-2019-11.tsv.gz,XXXTentacion,78962,499214,4964,583140,104132
hdfs://spark-nn.eemcs.utwente.nl/user/s1934538/clickstream/clickstream-enwiki-2019-11.tsv.gz,The_Shape_of_Water,26801,61136,692,88629,36060
hdfs://spark-nn.eemcs.utwente.nl/user/s1934538/clickstream/clickstream-enwiki-2019-11.tsv.gz,Sushma_Swaraj,5370,35046,28,40444,6800
hdfs://spark-nn.eemcs.utwente.nl/user/s1934538/clickstream/clickstream-enwiki-2019-11.tsv.gz,Jenna_Ortega,11408,9429,921,21758,5589
hdfs://spark-nn.eemcs.utwente.nl/user/s1934538/clickstream/clickstream-enwiki-2019-11.tsv.gz,YouTube,130039,1446687,9292,1586018,151690
hdfs://spark-nn.eemcs.utwente.nl/user/s1934538/clickstream/clickstream-enwiki-2019-11.tsv.gz,Keanu_Reeves,180802,1168462,9872,1359136,762664
hdfs://spark-nn.eemcs.utwente.nl/user/s1934538/clickstream/clickstream-enwiki-2019-11.tsv.gz,UEFA_Euro_2020,257047,1104789,30885,1392721,543480
hdfs://spark-nn.eemcs.utwente.nl/user/s1934538/clickstream/clickstream-enwiki-2019-11.tsv.gz,It_Chapter_Two,98153,424349,6887,529389,253490
hdfs://spark-nn.eemcs.utwente.nl/user/s1934538/clickstream/clickstream-enwiki-2019-11.tsv.gz,Henry_V_of_England,834230,2962863,12309,3809402,2551447
hdfs://spark-nn.eemcs.utwente.nl/user/s1934538/clickstream/clickstream-enwiki-2019-11.tsv.gz,Kobe_Bryant,37761,210660,1339,249760,62974
hdfs://spark-nn.eemcs.utwente.nl/user/s1934538/clickstream/clickstream-enwiki-2019-11.tsv.gz,George_H._W._Bush,133197,134378,1157,268732,148525
hdfs://spark-nn.eemcs.utwente.nl/user/s1934538/clickstream/clickstream-enwiki-2019-11.tsv.gz,The_Falcon_and_the_Winter_Soldier,63612,41895,320,105827,61816
hdfs://spark-nn.eemcs.utwente.nl/user/s1934538/clickstream/clickstream-enwiki-2019-11.tsv.gz,QAnon,10353,139654,1868,151875,30406
hdfs://spark-nn.eemcs.utwente.nl/user/s1934538/clickstream/clickstream-enwiki-2019-11.tsv.gz,Jimmy_Buffett,6861,38936,1237,47034,15119
hdfs://spark-nn.eemcs.utwente.nl/user/s1934538/clickstream/clickstream-enwiki-2019-11.tsv.gz,Afghanistan,46064,141851,1738,189653,98592
hdfs://spark-nn.eemcs.utwente.nl/user/s1934538/clickstream/clickstream-enwiki-2019-11.tsv.gz,United_States_Senate,63889,121809,1063,186761,65202
hdfs://spark-nn.eemcs.utwente.nl/user/s1934538/clickstream/clickstream-enwiki-2019-11.tsv.gz,2020_United_States_presidential_election,117541,399187,7619,524347,301423
hdfs://spark-nn.eemcs.utwente.nl/user/s1934538/clickstream/clickstream-enwiki-2019-11.tsv.gz,Rishi_Sunak,20644,54373,358,75375,19898
hdfs://spark-nn.eemcs.utwente.nl/user/s1934538/clickstream/clickstream-enwiki-2019-11.tsv.gz,Bird_Box_(film),18228,86817,864,105909,33500
hdfs://spark-nn.eemcs.utwente.nl/user/s1934538/clickstream/clickstream-enwiki-2019-11.tsv.gz,Jason_Momoa,134903,531679,3806,670388,334301
hdfs://spark-nn.eemcs.utwente.nl/user/s1934538/clickstream/clickstream-enwiki-2019-11.tsv.gz,Main_Page,32227,350559493,4263300,354855020,31319237
hdfs://spark-nn.eemcs.utwente.nl/user/s1934538/clickstream/clickstream-enwiki-2020-02.tsv.gz,Sushant_Singh_Rajput,21931,51407,270,73608,40236
hdfs://spark-nn.eemcs.utwente.nl/user/s1934538/clickstream/clickstream-enwiki-2020-02.tsv.gz,Sylvester_Stallone,79484,328834,2278,410596,277437
hdfs://spark-nn.eemcs.utwente.nl/user/s1934538/clickstream/clickstream-enwiki-2020-02.tsv.gz,"Citizenship_(Amendment)_Act,_2019",50703,562121,27,612851,71608
hdfs://spark-nn.eemcs.utwente.nl/user/s1934538/clickstream/clickstream-enwiki-2020-02.tsv.gz,List_of_most_popular_websites,13104,173699,151,186954,41584
hdfs://spark-nn.eemcs.utwente.nl/user/s1934538/clickstream/clickstream-enwiki-2020-02.tsv.gz,Joker_(2019_film),225870,1294575,21675,1542120,681130
hdfs://spark-nn.eemcs.utwente.nl/user/s1934538/clickstream/clickstream-enwiki-2020-02.tsv.gz,Bird_Box_(film),19613,85516,988,106117,32651
hdfs://spark-nn.eemcs.utwente.nl/user/s1934538/clickstream/clickstream-enwiki-2020-02.tsv.gz,Gaza_Strip,14953,33856,169,48978,17099
hdfs://spark-nn.eemcs.utwente.nl/user/s1934538/clickstream/clickstream-enwiki-2020-02.tsv.gz,Ruth_Bader_Ginsburg,33602,173951,980,208533,70200
hdfs://spark-nn.eemcs.utwente.nl/user/s1934538/clickstream/clickstream-enwiki-2020-02.tsv.gz,Main_Page,34865,294079745,4625002,298739612,32170659
hdfs://spark-nn.eemcs.utwente.nl/user/s1934538/clickstream/clickstream-enwiki-2020-02.tsv.gz,State_of_Palestine,36156,108330,82,144568,58835
hdfs://spark-nn.eemcs.utwente.nl/user/s1934538/clickstream/clickstream-enwiki-2020-02.tsv.gz,The_Suicide_Squad_(film),225689,110144,1710,337543,318939
hdfs://spark-nn.eemcs.utwente.nl/user/s1934538/clickstream/clickstream-enwiki-2020-02.tsv.gz,K.G.F:_Chapter_2,25426,132369,142,157937,58472
hdfs://spark-nn.eemcs.utwente.nl/user/s1934538/clickstream/clickstream-enwiki-2020-02.tsv.gz,UEFA_Euro_2020,56186,259428,4258,319872,121040
hdfs://spark-nn.eemcs.utwente.nl/user/s1934538/clickstream/clickstream-enwiki-2020-02.tsv.gz,Critical_race_theory,1898,20880,80,22858,4180
hdfs://spark-nn.eemcs.utwente.nl/user/s1934538/clickstream/clickstream-enwiki-2020-02.tsv.gz,Atal_Bihari_Vajpayee,22463,45864,92,68419,17865
hdfs://spark-nn.eemcs.utwente.nl/user/s1934538/clickstream/clickstream-enwiki-2020-02.tsv.gz,United_States_Electoral_College,56637,272997,608,330242,51349
hdfs://spark-nn.eemcs.utwente.nl/user/s1934538/clickstream/clickstream-enwiki-2020-02.tsv.gz,Freddie_Mercury,93413,598078,3937,695428,245713
hdfs://spark-nn.eemcs.utwente.nl/user/s1934538/clickstream/clickstream-enwiki-2020-02.tsv.gz,Deadpool_2,47160,54621,2861,104642,72523
hdfs://spark-nn.eemcs.utwente.nl/user/s1934538/clickstream/clickstream-enwiki-2020-02.tsv.gz,Star_Wars:_The_Rise_of_Skywalker,172871,435019,15599,623489,279599
hdfs://spark-nn.eemcs.utwente.nl/user/s1934538/clickstream/clickstream-enwiki-2020-02.tsv.gz,Ukraine,40344,131669,3036,175049,71746
hdfs://spark-nn.eemcs.utwente.nl/user/s1934538/clickstream/clickstream-enwiki-2020-02.tsv.gz,DMX_(rapper),12957,53923,328,67208,28972
hdfs://spark-nn.eemcs.utwente.nl/user/s1934538/clickstream/clickstream-enwiki-2020-02.tsv.gz,Keanu_Reeves,104100,605970,5199,715269,374790
hdfs://spark-nn.eemcs.utwente.nl/user/s1934538/clickstream/clickstream-enwiki-2020-02.tsv.gz,Mac_Miller,35581,220211,2001,257793,85027
hdfs://spark-nn.eemcs.utwente.nl/user/s1934538/clickstream/clickstream-enwiki-2020-02.tsv.gz,Tunnel,3274,12611,97,15982,3274
hdfs://spark-nn.eemcs.utwente.nl/user/s1934538/clickstream/clickstream-enwiki-2020-02.tsv.gz,Israel,71432,239570,4107,315109,145720
hdfs://spark-nn.eemcs.utwente.nl/user/s1934538/clickstream/clickstream-enwiki-2020-02.tsv.gz,Jeffrey_Epstein,32332,293789,2214,328335,108803
hdfs://spark-nn.eemcs.utwente.nl/user/s1934538/clickstream/clickstream-enwiki-2020-02.tsv.gz,Aretha_Franklin,26238,130726,1043,158007,47340
hdfs://spark-nn.eemcs.utwente.nl/user/s1934538/clickstream/clickstream-enwiki-2020-02.tsv.gz,Jimmy_Buffett,7332,41092,435,48859,17070
hdfs://spark-nn.eemcs.utwente.nl/user/s1934538/clickstream/clickstream-enwiki-2020-02.tsv.gz,XXXTentacion,63137,413918,5917,482972,88906
hdfs://spark-nn.eemcs.utwente.nl/user/s1934538/clickstream/clickstream-enwiki-2020-02.tsv.gz,Juice_Wrld,36346,340775,5998,383119,117958
hdfs://spark-nn.eemcs.utwente.nl/user/s1934538/clickstream/clickstream-enwiki-2020-02.tsv.gz,Simone_Biles,11192,93954,2713,107859,26596
hdfs://spark-nn.eemcs.utwente.nl/user/s1934538/clickstream/clickstream-enwiki-2020-02.tsv.gz,Donald_Glover,47514,163121,1717,212352,69601
hdfs://spark-nn.eemcs.utwente.nl/user/s1934538/clickstream/clickstream-enwiki-2020-02.tsv.gz,Asia_Cup,2082,26547,143,28772,15327
hdfs://spark-nn.eemcs.utwente.nl/user/s1934538/clickstream/clickstream-enwiki-2020-02.tsv.gz,J._Robert_Oppenheimer,19088,104949,349,124386,36223
hdfs://spark-nn.eemcs.utwente.nl/user/s1934538/clickstream/clickstream-enwiki-2020-02.tsv.gz,Kobe_Bryant_sexual_assault_case,46914,818653,1123,866690,46893
hdfs://spark-nn.eemcs.utwente.nl/user/s1934538/clickstream/clickstream-enwiki-2020-02.tsv.gz,Grover,1178,5782,35,6995,1238
hdfs://spark-nn.eemcs.utwente.nl/user/s1934538/clickstream/clickstream-enwiki-2020-02.tsv.gz,Jeffrey_Dahmer,28672,309966,2787,341425,142756
hdfs://spark-nn.eemcs.utwente.nl/user/s1934538/clickstream/clickstream-enwiki-2020-02.tsv.gz,Jimmy_Hoffa,114381,582956,4440,701777,235801
hdfs://spark-nn.eemcs.utwente.nl/user/s1934538/clickstream/clickstream-enwiki-2020-02.tsv.gz,Lionel_Messi,73599,494471,5632,573702,114506
hdfs://spark-nn.eemcs.utwente.nl/user/s1934538/clickstream/clickstream-enwiki-2020-02.tsv.gz,David_Beckham,41801,184218,1335,227354,76105
hdfs://spark-nn.eemcs.utwente.nl/user/s1934538/clickstream/clickstream-enwiki-2020-02.tsv.gz,Shinzo_Abe,27082,31776,278,59136,29062
hdfs://spark-nn.eemcs.utwente.nl/user/s1934538/clickstream/clickstream-enwiki-2020-02.tsv.gz,Pornhub,38587,428671,12686,479944,78075
hdfs://spark-nn.eemcs.utwente.nl/user/s1934538/clickstream/clickstream-enwiki-2020-02.tsv.gz,Grimes_(musician),166734,330764,2403,499901,210284
hdfs://spark-nn.eemcs.utwente.nl/user/s1934538/clickstream/clickstream-enwiki-2020-02.tsv.gz,Chadwick_Boseman,35537,102235,652,138424,48381
hdfs://spark-nn.eemcs.utwente.nl/user/s1934538/clickstream/clickstream-enwiki-2020-02.tsv.gz,Tonya_Harding,37595,175329,688,213612,50044
hdfs://spark-nn.eemcs.utwente.nl/user/s1934538/clickstream/clickstream-enwiki-2020-02.tsv.gz,Cricket_World_Cup,7775,65016,318,73109,30978
hdfs://spark-nn.eemcs.utwente.nl/user/s1934538/clickstream/clickstream-enwiki-2020-02.tsv.gz,Stranger_Things_(season_3),22174,65581,1043,88798,51908
hdfs://spark-nn.eemcs.utwente.nl/user/s1934538/clickstream/clickstream-enwiki-2020-02.tsv.gz,Aaron_Hernandez,24428,1029101,4680,1058209,291856
hdfs://spark-nn.eemcs.utwente.nl/user/s1934538/clickstream/clickstream-enwiki-2020-02.tsv.gz,Loki_(TV_series),49192,31481,433,81106,33159
hdfs://spark-nn.eemcs.utwente.nl/user/s1934538/clickstream/clickstream-enwiki-2020-02.tsv.gz,Anthony_Bourdain,17292,131736,1285,150313,42658
hdfs://spark-nn.eemcs.utwente.nl/user/s1934538/clickstream/clickstream-enwiki-2020-02.tsv.gz,Crazy_Rich_Asians_(film),35740,96376,1131,133247,116702
hdfs://spark-nn.eemcs.utwente.nl/user/s1934538/clickstream/clickstream-enwiki-2020-02.tsv.gz,Kylian_Mbappé,24996,151385,2393,178774,32310
hdfs://spark-nn.eemcs.utwente.nl/user/s1934538/clickstream/clickstream-enwiki-2020-02.tsv.gz,The_Shape_of_Water,45881,110133,1417,157431,68469
hdfs://spark-nn.eemcs.utwente.nl/user/s1934538/clickstream/clickstream-enwiki-2020-02.tsv.gz,Luke_Perry,85203,394785,2944,482932,124112
hdfs://spark-nn.eemcs.utwente.nl/user/s1934538/clickstream/clickstream-enwiki-2020-02.tsv.gz,JSON_Web_Token,843,30119,155,31117,2500
hdfs://spark-nn.eemcs.utwente.nl/user/s1934538/clickstream/clickstream-enwiki-2020-02.tsv.gz,Cleopatra,40354,171450,1659,213463,80095
hdfs://spark-nn.eemcs.utwente.nl/user/s1934538/clickstream/clickstream-enwiki-2020-02.tsv.gz,Notre-Dame_de_Paris,12139,84719,744,97602,19484
hdfs://spark-nn.eemcs.utwente.nl/user/s1934538/clickstream/clickstream-enwiki-2020-02.tsv.gz,The_Irishman,152630,667994,11692,832316,643434
hdfs://spark-nn.eemcs.utwente.nl/user/s1934538/clickstream/clickstream-enwiki-2020-02.tsv.gz,Fyre_Festival,12033,97871,550,110454,53090
hdfs://spark-nn.eemcs.utwente.nl/user/s1934538/clickstream/clickstream-enwiki-2020-02.tsv.gz,Khabib_Nurmagomedov,69385,200725,1997,272107,140432
hdfs://spark-nn.eemcs.utwente.nl/user/s1934538/clickstream/clickstream-enwiki-2020-02.tsv.gz,Death_of_Elisa_Lam,8544,64342,460,73346,19286
hdfs://spark-nn.eemcs.utwente.nl/user/s1934538/clickstream/clickstream-enwiki-2020-02.tsv.gz,Game_of_Thrones,60706,191975,5469,258150,172584
hdfs://spark-nn.eemcs.utwente.nl/user/s1934538/clickstream/clickstream-enwiki-2020-02.tsv.gz,NATO,42680,124582,1648,168910,58091
hdfs://spark-nn.eemcs.utwente.nl/user/s1934538/clickstream/clickstream-enwiki-2020-02.tsv.gz,Manti_Te'o,3291,15724,106,19121,1909
hdfs://spark-nn.eemcs.utwente.nl/user/s1934538/clickstream/clickstream-enwiki-2020-02.tsv.gz,"Diana,_Princess_of_Wales",137949,282735,2390,423074,250461
hdfs://spark-nn.eemcs.utwente.nl/user/s1934538/clickstream/clickstream-enwiki-2020-02.tsv.gz,Bob_Saget,17718,44163,672,62553,10953
hdfs://spark-nn.eemcs.utwente.nl/user/s1934538/clickstream/clickstream-enwiki-2020-02.tsv.gz,QAnon,9427,227748,972,238147,48805
hdfs://spark-nn.eemcs.utwente.nl/user/s1934538/clickstream/clickstream-enwiki-2020-02.tsv.gz,Dark_Phoenix_(film),56035,96042,1742,153819,75030
hdfs://spark-nn.eemcs.utwente.nl/user/s1934538/clickstream/clickstream-enwiki-2020-02.tsv.gz,Rihanna,60435,253908,3427,317770,144713
hdfs://spark-nn.eemcs.utwente.nl/user/s1934538/clickstream/clickstream-enwiki-2020-02.tsv.gz,Naomi_Osaka,14152,35329,297,49778,13090
hdfs://spark-nn.eemcs.utwente.nl/user/s1934538/clickstream/clickstream-enwiki-2020-02.tsv.gz,Spider-Man:_Far_From_Home,79104,177693,3181,259978,142982
hdfs://spark-nn.eemcs.utwente.nl/user/s1934538/clickstream/clickstream-enwiki-2020-02.tsv.gz,The_Umbrella_Academy_(TV_series),21781,127744,2108,151633,72807
hdfs://spark-nn.eemcs.utwente.nl/user/s1934538/clickstream/clickstream-enwiki-2020-02.tsv.gz,Chernobyl_(miniseries),23646,123110,2122,148878,128075
hdfs://spark-nn.eemcs.utwente.nl/user/s1934538/clickstream/clickstream-enwiki-2020-02.tsv.gz,List_of_Marvel_Cinematic_Universe_films,100128,589873,1834,691835,294788
hdfs://spark-nn.eemcs.utwente.nl/user/s1934538/clickstream/clickstream-enwiki-2020-02.tsv.gz,Rishi_Sunak,54283,564994,3545,622822,239717
hdfs://spark-nn.eemcs.utwente.nl/user/s1934538/clickstream/clickstream-enwiki-2020-02.tsv.gz,Avengers:_Infinity_War,52447,77992,1271,131710,77418
hdfs://spark-nn.eemcs.utwente.nl/user/s1934538/clickstream/clickstream-enwiki-2020-02.tsv.gz,Anna_Sorokin,8603,45332,155,54090,12772
hdfs://spark-nn.eemcs.utwente.nl/user/s1934538/clickstream/clickstream-enwiki-2020-02.tsv.gz,2018_Winter_Olympics,30297,26713,300,57310,37260
hdfs://spark-nn.eemcs.utwente.nl/user/s1934538/clickstream/clickstream-enwiki-2020-02.tsv.gz,The_Nun_(2018_film),16565,52622,320,69507,42545
hdfs://spark-nn.eemcs.utwente.nl/user/s1934538/clickstream/clickstream-enwiki-2020-02.tsv.gz,Cameron_Boyce,39696,271810,1730,313236,78064
hdfs://spark-nn.eemcs.utwente.nl/user/s1934538/clickstream/clickstream-enwiki-2020-02.tsv.gz,2018_FIFA_World_Cup,59248,97322,996,157566,81880
hdfs://spark-nn.eemcs.utwente.nl/user/s1934538/clickstream/clickstream-enwiki-2020-02.tsv.gz,The_Haunting_of_Bly_Manor,39499,27043,58,66600,52650
hdfs://spark-nn.eemcs.utwente.nl/user/s1934538/clickstream/clickstream-enwiki-2020-02.tsv.gz,Lance_Reddick,23903,22767,85,46755,9475
hdfs://spark-nn.eemcs.utwente.nl/user/s1934538/clickstream/clickstream-enwiki-2020-02.tsv.gz,HTTP_cookie,4863,291034,97,295994,31641
hdfs://spark-nn.eemcs.utwente.nl/user/s1934538/clickstream/clickstream-enwiki-2020-02.tsv.gz,XHamster,7997,68928,2496,79421,13146
hdfs://spark-nn.eemcs.utwente.nl/user/s1934538/clickstream/clickstream-enwiki-2020-02.tsv.gz,Lisa_Marie_Presley,104638,73183,231,178052,94814
hdfs://spark-nn.eemcs.utwente.nl/user/s1934538/clickstream/clickstream-enwiki-2020-02.tsv.gz,Brett_Kavanaugh,28430,43296,224,71950,25445
hdfs://spark-nn.eemcs.utwente.nl/user/s1934538/clickstream/clickstream-enwiki-2020-02.tsv.gz,Murder_of_Dee_Dee_Blanchard,25174,193705,579,219458,44433
hdfs://spark-nn.eemcs.utwente.nl/user/s1934538/clickstream/clickstream-enwiki-2020-02.tsv.gz,Exo_(band),16847,81074,431,98352,99332
hdfs://spark-nn.eemcs.utwente.nl/user/s1934538/clickstream/clickstream-enwiki-2020-02.tsv.gz,Once_Upon_a_Time_in_Hollywood,272094,1224749,18236,1515079,1487993
hdfs://spark-nn.eemcs.utwente.nl/user/s1934538/clickstream/clickstream-enwiki-2020-02.tsv.gz,United_States_Senate,99322,146061565,14243,146175130,111486
hdfs://spark-nn.eemcs.utwente.nl/user/s1934538/clickstream/clickstream-enwiki-2020-02.tsv.gz,Burt_Reynolds,56908,134262,1262,192432,69412
hdfs://spark-nn.eemcs.utwente.nl/user/s1934538/clickstream/clickstream-enwiki-2020-02.tsv.gz,WrestleMania_34,37079,16442,173,53694,39078
hdfs://spark-nn.eemcs.utwente.nl/user/s1934538/clickstream/clickstream-enwiki-2020-02.tsv.gz,Afghanistan,47661,147292,2028,196981,104614
hdfs://spark-nn.eemcs.utwente.nl/user/s1934538/clickstream/clickstream-enwiki-2020-02.tsv.gz,Kate_Spade,34146,61861,365,96372,31029
hdfs://spark-nn.eemcs.utwente.nl/user/s1934538/clickstream/clickstream-enwiki-2020-02.tsv.gz,Black_Panther_(film),47318,107509,3569,158396,90041
hdfs://spark-nn.eemcs.utwente.nl/user/s1934538/clickstream/clickstream-enwiki-2020-02.tsv.gz,Christopher_Scarver,53360,20142,25,73527,23942
hdfs://spark-nn.eemcs.utwente.nl/user/s1934538/clickstream/clickstream-enwiki-2020-02.tsv.gz,Fantastic_Beasts:_The_Crimes_of_Grindelwald,53149,69779,988,123916,65365
hdfs://spark-nn.eemcs.utwente.nl/user/s1934538/clickstream/clickstream-enwiki-2020-02.tsv.gz,Avengers:_Endgame,146079,272643,5805,424527,269677
hdfs://spark-nn.eemcs.utwente.nl/user/s1934538/clickstream/clickstream-enwiki-2020-02.tsv.gz,Croatia,35290,126236,1575,163101,52290
hdfs://spark-nn.eemcs.utwente.nl/user/s1934538/clickstream/clickstream-enwiki-2020-02.tsv.gz,List_of_awards_and_nominations_received_by_Meryl_Streep,23551,16617,328,40496,13782
hdfs://spark-nn.eemcs.utwente.nl/user/s1934538/clickstream/clickstream-enwiki-2020-02.tsv.gz,Spanish_flu,156066,1244322,14930,1415318,320987
hdfs://spark-nn.eemcs.utwente.nl/user/s1934538/clickstream/clickstream-enwiki-2020-02.tsv.gz,Darth_Vader,36277,330588,764,367629,75703
hdfs://spark-nn.eemcs.utwente.nl/user/s1934538/clickstream/clickstream-enwiki-2020-02.tsv.gz,Article_370_of_the_Constitution_of_India,4834,120066,135,125035,9654
hdfs://spark-nn.eemcs.utwente.nl/user/s1934538/clickstream/clickstream-enwiki-2020-02.tsv.gz,Kobe_Bryant,227586,3298329,49027,3574942,1094944
hdfs://spark-nn.eemcs.utwente.nl/user/s1934538/clickstream/clickstream-enwiki-2020-02.tsv.gz,2018_Asian_Games,5221,10010,28,15259,9685
hdfs://spark-nn.eemcs.utwente.nl/user/s1934538/clickstream/clickstream-enwiki-2020-02.tsv.gz,"Prince_Philip,_Duke_of_Edinburgh",258971,353602,10861,623434,400170
hdfs://spark-nn.eemcs.utwente.nl/user/s1934538/clickstream/clickstream-enwiki-2020-02.tsv.gz,IPv4,12031,49570,150,61751,10617
hdfs://spark-nn.eemcs.utwente.nl/user/s1934538/clickstream/clickstream-enwiki-2020-02.tsv.gz,William_Murdoch,593,1899,10,2502,359
hdfs://spark-nn.eemcs.utwente.nl/user/s1934538/clickstream/clickstream-enwiki-2020-02.tsv.gz,Avicii,18234,185770,1751,205755,87536
hdfs://spark-nn.eemcs.utwente.nl/user/s1934538/clickstream/clickstream-enwiki-2020-02.tsv.gz,Nipsey_Hussle,40017,214190,1522,255729,74874
hdfs://spark-nn.eemcs.utwente.nl/user/s1934538/clickstream/clickstream-enwiki-2020-02.tsv.gz,Indian_Premier_League,21199,129096,153,150448,89435
hdfs://spark-nn.eemcs.utwente.nl/user/s1934538/clickstream/clickstream-enwiki-2020-02.tsv.gz,A_Star_Is_Born_(2018_film),45619,173585,855,220059,98747
hdfs://spark-nn.eemcs.utwente.nl/user/s1934538/clickstream/clickstream-enwiki-2020-02.tsv.gz,Matthew_Perry,63448,210146,864,274458,136816
hdfs://spark-nn.eemcs.utwente.nl/user/s1934538/clickstream/clickstream-enwiki-2020-02.tsv.gz,2020_United_States_presidential_election,270444,616306,8839,895589,542038
hdfs://spark-nn.eemcs.utwente.nl/user/s1934538/clickstream/clickstream-enwiki-2020-02.tsv.gz,Hamas,14577,27820,167,42564,15890
hdfs://spark-nn.eemcs.utwente.nl/user/s1934538/clickstream/clickstream-enwiki-2020-02.tsv.gz,Vladimir_Putin,65780,186079,2411,254270,147668
hdfs://spark-nn.eemcs.utwente.nl/user/s1934538/clickstream/clickstream-enwiki-2020-02.tsv.gz,Charles_Sobhraj,3604,24898,95,28597,6118
hdfs://spark-nn.eemcs.utwente.nl/user/s1934538/clickstream/clickstream-enwiki-2020-02.tsv.gz,Louis_Tomlinson,36856,89859,975,127690,31301
hdfs://spark-nn.eemcs.utwente.nl/user/s1934538/clickstream/clickstream-enwiki-2020-02.tsv.gz,Microsoft_Office,8973,992568,726,1002267,23730
hdfs://spark-nn.eemcs.utwente.nl/user/s1934538/clickstream/clickstream-enwiki-2020-02.tsv.gz,The_Weeknd,80604,289749,4093,374446,185318
hdfs://spark-nn.eemcs.utwente.nl/user/s1934538/clickstream/clickstream-enwiki-2020-02.tsv.gz,Pelé,25395,175490,2342,203227,61726
hdfs://spark-nn.eemcs.utwente.nl/user/s1934538/clickstream/clickstream-enwiki-2020-02.tsv.gz,Top_Gun:_Maverick,61847,92906,1935,156688,122192
hdfs://spark-nn.eemcs.utwente.nl/user/s1934538/clickstream/clickstream-enwiki-2020-02.tsv.gz,Henry_V_of_England,79789,146346,668,226803,155042
hdfs://spark-nn.eemcs.utwente.nl/user/s1934538/clickstream/clickstream-enwiki-2020-02.tsv.gz,Hyphen-minus,4097,42514045,7043785,49561927,726
hdfs://spark-nn.eemcs.utwente.nl/user/s1934538/clickstream/clickstream-enwiki-2020-02.tsv.gz,Dennis_Nilsen,6131,29358,190,35679,6759
hdfs://spark-nn.eemcs.utwente.nl/user/s1934538/clickstream/clickstream-enwiki-2020-02.tsv.gz,Rami_Malek,102548,220530,2205,325283,118340
hdfs://spark-nn.eemcs.utwente.nl/user/s1934538/clickstream/clickstream-enwiki-2020-02.tsv.gz,Taliban,24087,111806,798,136691,82049
hdfs://spark-nn.eemcs.utwente.nl/user/s1934538/clickstream/clickstream-enwiki-2020-02.tsv.gz,When_They_See_Us,20267,88193,529,108989,54094
hdfs://spark-nn.eemcs.utwente.nl/user/s1934538/clickstream/clickstream-enwiki-2020-02.tsv.gz,Key_frame,706,6299,12,7017,438
hdfs://spark-nn.eemcs.utwente.nl/user/s1934538/clickstream/clickstream-enwiki-2020-02.tsv.gz,Central_Park_jogger_case,36926,163609,406,200941,22685
hdfs://spark-nn.eemcs.utwente.nl/user/s1934538/clickstream/clickstream-enwiki-2020-02.tsv.gz,Captain_Marvel_(film),44305,108718,1913,154936,84467
hdfs://spark-nn.eemcs.utwente.nl/user/s1934538/clickstream/clickstream-enwiki-2020-02.tsv.gz,Kim_Jong-un,54189,132878,1130,188197,110564
hdfs://spark-nn.eemcs.utwente.nl/user/s1934538/clickstream/clickstream-enwiki-2020-02.tsv.gz,Bipin_Rawat,5743,24085,106,29934,11845
hdfs://spark-nn.eemcs.utwente.nl/user/s1934538/clickstream/clickstream-enwiki-2020-02.tsv.gz,Parasite_(2019_film),533300,7456001,249701,8239002,2807337
hdfs://spark-nn.eemcs.utwente.nl/user/s1934538/clickstream/clickstream-enwiki-2020-02.tsv.gz,Juneteenth,1445,39286,67,40798,3526
hdfs://spark-nn.eemcs.utwente.nl/user/s1934538/clickstream/clickstream-enwiki-2020-02.tsv.gz,Roe_v._Wade,13814,87009,789,101612,28725
hdfs://spark-nn.eemcs.utwente.nl/user/s1934538/clickstream/clickstream-enwiki-2020-02.tsv.gz,Alexander_Hamilton,76852,300723,1934,379509,165620
hdfs://spark-nn.eemcs.utwente.nl/user/s1934538/clickstream/clickstream-enwiki-2020-02.tsv.gz,Brie_Larson,71893,222432,1690,296015,111220
hdfs://spark-nn.eemcs.utwente.nl/user/s1934538/clickstream/clickstream-enwiki-2020-04.tsv.gz,Mac_Miller,37807,216343,1934,256084,88352
hdfs://spark-nn.eemcs.utwente.nl/user/s1934538/clickstream/clickstream-enwiki-2020-04.tsv.gz,Stranger_Things_(season_3),26463,91214,662,118339,71662
hdfs://spark-nn.eemcs.utwente.nl/user/s1934538/clickstream/clickstream-enwiki-2020-04.tsv.gz,Roe_v._Wade,16506,87715,730,104951,28317
hdfs://spark-nn.eemcs.utwente.nl/user/s1934538/clickstream/clickstream-enwiki-2020-04.tsv.gz,"Princess_Margaret,_Countess_of_Snowdon",214473,671640,3953,890066,534342
hdfs://spark-nn.eemcs.utwente.nl/user/s1934538/clickstream/clickstream-enwiki-2020-04.tsv.gz,UEFA_Euro_2020,34777,98595,2259,135631,71676
hdfs://spark-nn.eemcs.utwente.nl/user/s1934538/clickstream/clickstream-enwiki-2020-04.tsv.gz,David_Beckham,54083,369118,2380,425581,133493
hdfs://spark-nn.eemcs.utwente.nl/user/s1934538/clickstream/clickstream-enwiki-2020-04.tsv.gz,IPv4,13186,60737,169,74092,11298
hdfs://spark-nn.eemcs.utwente.nl/user/s1934538/clickstream/clickstream-enwiki-2020-04.tsv.gz,The_Batman_(film),130971,112102,1583,244656,266106
hdfs://spark-nn.eemcs.utwente.nl/user/s1934538/clickstream/clickstream-enwiki-2020-04.tsv.gz,Tasuku_Honjo,7014,8388654,1080,8396748,230670
hdfs://spark-nn.eemcs.utwente.nl/user/s1934538/clickstream/clickstream-enwiki-2020-04.tsv.gz,Saaho,32967,128940,413,162320,50939
hdfs://spark-nn.eemcs.utwente.nl/user/s1934538/clickstream/clickstream-enwiki-2020-04.tsv.gz,Anthony_Bourdain,20197,172539,1351,194087,60429
hdfs://spark-nn.eemcs.utwente.nl/user/s1934538/clickstream/clickstream-enwiki-2020-04.tsv.gz,Elizabeth_II,724651,1472016,8524,2205191,1661319
hdfs://spark-nn.eemcs.utwente.nl/user/s1934538/clickstream/clickstream-enwiki-2020-04.tsv.gz,XXXTentacion,92205,425015,4859,522079,108031
hdfs://spark-nn.eemcs.utwente.nl/user/s1934538/clickstream/clickstream-enwiki-2020-04.tsv.gz,Exo_(band),33280,157476,497,191253,204291
hdfs://spark-nn.eemcs.utwente.nl/user/s1934538/clickstream/clickstream-enwiki-2020-04.tsv.gz,Matthew_Perry,88681,225973,798,315452,177383
hdfs://spark-nn.eemcs.utwente.nl/user/s1934538/clickstream/clickstream-enwiki-2020-04.tsv.gz,Jenna_Ortega,20930,29085,2200,52215,9060
hdfs://spark-nn.eemcs.utwente.nl/user/s1934538/clickstream/clickstream-enwiki-2020-04.tsv.gz,Chernobyl_(miniseries),29371,270802,3433,303606,230458
hdfs://spark-nn.eemcs.utwente.nl/user/s1934538/clickstream/clickstream-enwiki-2020-04.tsv.gz,2020_Summer_Olympics,56972,158510,32530,248012,149378
hdfs://spark-nn.eemcs.utwente.nl/user/s1934538/clickstream/clickstream-enwiki-2020-04.tsv.gz,Venom_(2018_film),34559,186513,2857,223929,119731
hdfs://spark-nn.eemcs.utwente.nl/user/s1934538/clickstream/clickstream-enwiki-2020-04.tsv.gz,Rishi_Sunak,47322,386307,1889,435518,186440
hdfs://spark-nn.eemcs.utwente.nl/user/s1934538/clickstream/clickstream-enwiki-2020-04.tsv.gz,Sidharth_Shukla,16652,65136,1139,82927,22094
hdfs://spark-nn.eemcs.utwente.nl/user/s1934538/clickstream/clickstream-enwiki-2020-04.tsv.gz,XXX:_Return_of_Xander_Cage,40217,111182,799,152198,54317
hdfs://spark-nn.eemcs.utwente.nl/user/s1934538/clickstream/clickstream-enwiki-2020-04.tsv.gz,2022_FIFA_World_Cup,50141,73257,1048,124446,70724
hdfs://spark-nn.eemcs.utwente.nl/user/s1934538/clickstream/clickstream-enwiki-2020-04.tsv.gz,"Meghan,_Duchess_of_Sussex",142857,362169,2822,507848,286664
hdfs://spark-nn.eemcs.utwente.nl/user/s1934538/clickstream/clickstream-enwiki-2020-04.tsv.gz,Hamas,31191,49133,320,80644,34837
hdfs://spark-nn.eemcs.utwente.nl/user/s1934538/clickstream/clickstream-enwiki-2020-04.tsv.gz,Critical_race_theory,1890,14879,34,16803,3234
hdfs://spark-nn.eemcs.utwente.nl/user/s1934538/clickstream/clickstream-enwiki-2020-04.tsv.gz,Tonya_Harding,49345,286524,1030,336899,79421
hdfs://spark-nn.eemcs.utwente.nl/user/s1934538/clickstream/clickstream-enwiki-2020-04.tsv.gz,The_Suicide_Squad_(film),124947,60224,711,185882,160909
hdfs://spark-nn.eemcs.utwente.nl/user/s1934538/clickstream/clickstream-enwiki-2020-04.tsv.gz,Wonder_Woman_1984,77010,100012,3756,180778,97103
hdfs://spark-nn.eemcs.utwente.nl/user/s1934538/clickstream/clickstream-enwiki-2020-04.tsv.gz,Main_Page,35737,318951208,5069261,324056206,37520778
hdfs://spark-nn.eemcs.utwente.nl/user/s1934538/clickstream/clickstream-enwiki-2020-04.tsv.gz,List_of_most_popular_websites,16597,331724,174,348495,57604
hdfs://spark-nn.eemcs.utwente.nl/user/s1934538/clickstream/clickstream-enwiki-2020-04.tsv.gz,Puneeth_Rajkumar,22222,48841,50,71113,34027
hdfs://spark-nn.eemcs.utwente.nl/user/s1934538/clickstream/clickstream-enwiki-2020-04.tsv.gz,The_Mandalorian,100220,650436,11440,762096,510287
hdfs://spark-nn.eemcs.utwente.nl/user/s1934538/clickstream/clickstream-enwiki-2020-04.tsv.gz,Hyphen-minus,5228,37548809,8611579,46165616,759
hdfs://spark-nn.eemcs.utwente.nl/user/s1934538/clickstream/clickstream-enwiki-2020-04.tsv.gz,Irrfan_Khan,204518,5845911,33943,6084372,1965136
hdfs://spark-nn.eemcs.utwente.nl/user/s1934538/clickstream/clickstream-enwiki-2020-04.tsv.gz,Salman_Rushdie,47766,74647,592,123005,52105
hdfs://spark-nn.eemcs.utwente.nl/user/s1934538/clickstream/clickstream-enwiki-2020-04.tsv.gz,Betty_White,78488,284138,2828,365454,99610
hdfs://spark-nn.eemcs.utwente.nl/user/s1934538/clickstream/clickstream-enwiki-2020-04.tsv.gz,Central_Park_jogger_case,49075,189592,229,238896,30183
hdfs://spark-nn.eemcs.utwente.nl/user/s1934538/clickstream/clickstream-enwiki-2020-04.tsv.gz,Kobe_Bryant_sexual_assault_case,6921,53973,123,61017,4429
hdfs://spark-nn.eemcs.utwente.nl/user/s1934538/clickstream/clickstream-enwiki-2020-04.tsv.gz,Godzilla_vs._Kong,88436,83179,1469,173084,102787
hdfs://spark-nn.eemcs.utwente.nl/user/s1934538/clickstream/clickstream-enwiki-2020-04.tsv.gz,Cleopatra,62035,1206084,2903,1271022,177824
hdfs://spark-nn.eemcs.utwente.nl/user/s1934538/clickstream/clickstream-enwiki-2020-04.tsv.gz,Cristiano_Ronaldo,107112,761479,4657,873248,212081
hdfs://spark-nn.eemcs.utwente.nl/user/s1934538/clickstream/clickstream-enwiki-2020-04.tsv.gz,Captain_Marvel_(film),71674,248116,2353,322143,169420
hdfs://spark-nn.eemcs.utwente.nl/user/s1934538/clickstream/clickstream-enwiki-2020-04.tsv.gz,JSON_Web_Token,879,33963,63,34905,2595
hdfs://spark-nn.eemcs.utwente.nl/user/s1934538/clickstream/clickstream-enwiki-2020-04.tsv.gz,Mötley_Crüe,38753,133902,1558,174213,206031
hdfs://spark-nn.eemcs.utwente.nl/user/s1934538/clickstream/clickstream-enwiki-2020-04.tsv.gz,Pornhub,45170,436402,20545,502117,110147
hdfs://spark-nn.eemcs.utwente.nl/user/s1934538/clickstream/clickstream-enwiki-2020-04.tsv.gz,Once_Upon_a_Time_in_Hollywood,186357,872473,11620,1070450,1167915
hdfs://spark-nn.eemcs.utwente.nl/user/s1934538/clickstream/clickstream-enwiki-2020-04.tsv.gz,Kylian_Mbappé,25467,157039,2933,185439,33678
hdfs://spark-nn.eemcs.utwente.nl/user/s1934538/clickstream/clickstream-enwiki-2020-04.tsv.gz,Asia_Cup,1408,23028,235,24671,16365
hdfs://spark-nn.eemcs.utwente.nl/user/s1934538/clickstream/clickstream-enwiki-2020-04.tsv.gz,Ray_Liotta,59722,76051,459,136232,45769
hdfs://spark-nn.eemcs.utwente.nl/user/s1934538/clickstream/clickstream-enwiki-2020-04.tsv.gz,Mortal_Kombat_(2021_film),44417,74668,175,119260,192102
hdfs://spark-nn.eemcs.utwente.nl/user/s1934538/clickstream/clickstream-enwiki-2020-04.tsv.gz,Afghanistan,59209,167789,2254,229252,127010
hdfs://spark-nn.eemcs.utwente.nl/user/s1934538/clickstream/clickstream-enwiki-2020-04.tsv.gz,Parasite_(2019_film),103285,1459473,9171,1571929,618197
hdfs://spark-nn.eemcs.utwente.nl/user/s1934538/clickstream/clickstream-enwiki-2020-04.tsv.gz,Anna_Sorokin,20239,41199,91,61529,13526
hdfs://spark-nn.eemcs.utwente.nl/user/s1934538/clickstream/clickstream-enwiki-2020-04.tsv.gz,Naya_Rivera,37884,53146,113,91143,18764
hdfs://spark-nn.eemcs.utwente.nl/user/s1934538/clickstream/clickstream-enwiki-2020-04.tsv.gz,Cricket_World_Cup,9940,78518,213,88671,48043
hdfs://spark-nn.eemcs.utwente.nl/user/s1934538/clickstream/clickstream-enwiki-2020-04.tsv.gz,Khabib_Nurmagomedov,71076,219468,3872,294416,158937
hdfs://spark-nn.eemcs.utwente.nl/user/s1934538/clickstream/clickstream-enwiki-2020-04.tsv.gz,YouTube,161490,1156390,9165,1327045,172203
hdfs://spark-nn.eemcs.utwente.nl/user/s1934538/clickstream/clickstream-enwiki-2020-04.tsv.gz,Article_370_of_the_Constitution_of_India,5011,55625,62,60698,5708
hdfs://spark-nn.eemcs.utwente.nl/user/s1934538/clickstream/clickstream-enwiki-2020-04.tsv.gz,List_of_highest-grossing_Indian_films,89230,226458,1879,317567,236091
hdfs://spark-nn.eemcs.utwente.nl/user/s1934538/clickstream/clickstream-enwiki-2020-04.tsv.gz,The_Witcher_(TV_series),49342,445300,5842,500484,307772
hdfs://spark-nn.eemcs.utwente.nl/user/s1934538/clickstream/clickstream-enwiki-2020-04.tsv.gz,Kelly_Preston,98767,67303,254,166324,48826
hdfs://spark-nn.eemcs.utwente.nl/user/s1934538/clickstream/clickstream-enwiki-2020-04.tsv.gz,Taliban,30600,84004,571,115175,70119
hdfs://spark-nn.eemcs.utwente.nl/user/s1934538/clickstream/clickstream-enwiki-2020-04.tsv.gz,Charles_Sobhraj,5036,34259,97,39392,9069
hdfs://spark-nn.eemcs.utwente.nl/user/s1934538/clickstream/clickstream-enwiki-2020-04.tsv.gz,2.0_(film),29903,69126,123,99152,27939
hdfs://spark-nn.eemcs.utwente.nl/user/s1934538/clickstream/clickstream-enwiki-2020-04.tsv.gz,George_H._W._Bush,216746,169018,981,386745,232403
hdfs://spark-nn.eemcs.utwente.nl/user/s1934538/clickstream/clickstream-enwiki-2020-04.tsv.gz,Lionel_Messi,75033,419139,5734,499906,114174
hdfs://spark-nn.eemcs.utwente.nl/user/s1934538/clickstream/clickstream-enwiki-2020-04.tsv.gz,Gaza_Strip,30133,105141,389,135663,48149
hdfs://spark-nn.eemcs.utwente.nl/user/s1934538/clickstream/clickstream-enwiki-2020-04.tsv.gz,List_of_James_Bond_films,121649,922351,1873,1045873,589970
hdfs://spark-nn.eemcs.utwente.nl/user/s1934538/clickstream/clickstream-enwiki-2020-04.tsv.gz,Simone_Biles,18989,117268,745,137002,38751
hdfs://spark-nn.eemcs.utwente.nl/user/s1934538/clickstream/clickstream-enwiki-2020-04.tsv.gz,Michael_Bloomberg,60588,100468,709,161765,70641
hdfs://spark-nn.eemcs.utwente.nl/user/s1934538/clickstream/clickstream-enwiki-2020-04.tsv.gz,The_Falcon_and_the_Winter_Soldier,66098,58097,309,124504,70495
hdfs://spark-nn.eemcs.utwente.nl/user/s1934538/clickstream/clickstream-enwiki-2020-04.tsv.gz,Richard_Jewell,46316,363758,1228,411302,136336
hdfs://spark-nn.eemcs.utwente.nl/user/s1934538/clickstream/clickstream-enwiki-2020-04.tsv.gz,Lance_Reddick,63115,85599,309,149023,27927
hdfs://spark-nn.eemcs.utwente.nl/user/s1934538/clickstream/clickstream-enwiki-2020-04.tsv.gz,United_States_Senate,76528,54288446,911,54365885,64785
hdfs://spark-nn.eemcs.utwente.nl/user/s1934538/clickstream/clickstream-enwiki-2020-04.tsv.gz,Microsoft_Office,10578,1210361,819,1221758,25524
hdfs://spark-nn.eemcs.utwente.nl/user/s1934538/clickstream/clickstream-enwiki-2020-04.tsv.gz,Game_of_Thrones_(season_8),24791,100392,1160,126343,44614
hdfs://spark-nn.eemcs.utwente.nl/user/s1934538/clickstream/clickstream-enwiki-2020-04.tsv.gz,Chernobyl_disaster,90115,798796,5628,894539,310060
hdfs://spark-nn.eemcs.utwente.nl/user/s1934538/clickstream/clickstream-enwiki-2020-04.tsv.gz,List_of_FIFA_World_Cup_finals,4506,96530,199,101235,39821
hdfs://spark-nn.eemcs.utwente.nl/user/s1934538/clickstream/clickstream-enwiki-2020-04.tsv.gz,Media,60,4468,435,4963,1958
hdfs://spark-nn.eemcs.utwente.nl/user/s1934538/clickstream/clickstream-enwiki-2020-04.tsv.gz,Sushma_Swaraj,7417,24554,23,31994,7988
hdfs://spark-nn.eemcs.utwente.nl/user/s1934538/clickstream/clickstream-enwiki-2020-04.tsv.gz,Vladimir_Putin,128204,365122,3942,497268,300807
hdfs://spark-nn.eemcs.utwente.nl/user/s1934538/clickstream/clickstream-enwiki-2020-04.tsv.gz,The_Umbrella_Academy_(TV_series),28069,163218,2343,193630,100654
hdfs://spark-nn.eemcs.utwente.nl/user/s1934538/clickstream/clickstream-enwiki-2020-04.tsv.gz,Bible,26466,3799202,2240,3827908,52751
hdfs://spark-nn.eemcs.utwente.nl/user/s1934538/clickstream/clickstream-enwiki-2020-04.tsv.gz,Joe_Biden,196798,857154,12983,1066935,401549
hdfs://spark-nn.eemcs.utwente.nl/user/s1934538/clickstream/clickstream-enwiki-2020-04.tsv.gz,Coronavirus_disease_2019,780560,2694511,73459,3548530,1240689
hdfs://spark-nn.eemcs.utwente.nl/user/s1934538/clickstream/clickstream-enwiki-2020-04.tsv.gz,Coronavirus,126040,3387931,54445,3568416,821956
hdfs://spark-nn.eemcs.utwente.nl/user/s1934538/clickstream/clickstream-enwiki-2020-04.tsv.gz,Area_51,20969,230244,2555,253768,55120
hdfs://spark-nn.eemcs.utwente.nl/user/s1934538/clickstream/clickstream-enwiki-2020-04.tsv.gz,Keanu_Reeves,126187,597737,3332,727256,431541
hdfs://spark-nn.eemcs.utwente.nl/user/s1934538/clickstream/clickstream-enwiki-2020-04.tsv.gz,Bonnie_and_Clyde,32851,344350,2016,379217,87508
hdfs://spark-nn.eemcs.utwente.nl/user/s1934538/clickstream/clickstream-enwiki-2020-04.tsv.gz,Avengers:_Endgame,220174,462660,6330,689164,479961
hdfs://spark-nn.eemcs.utwente.nl/user/s1934538/clickstream/clickstream-enwiki-2020-04.tsv.gz,Cardi_B,47476,322082,5239,374797,117439
hdfs://spark-nn.eemcs.utwente.nl/user/s1934538/clickstream/clickstream-enwiki-2020-04.tsv.gz,The_Weeknd,99709,403176,5587,508472,246181
hdfs://spark-nn.eemcs.utwente.nl/user/s1934538/clickstream/clickstream-enwiki-2020-04.tsv.gz,Johnny_Depp,195319,503750,3492,702561,533205
hdfs://spark-nn.eemcs.utwente.nl/user/s1934538/clickstream/clickstream-enwiki-2020-04.tsv.gz,Deaths_in_2020,1940889,2872393,16300,4829582,3191467
hdfs://spark-nn.eemcs.utwente.nl/user/s1934538/clickstream/clickstream-enwiki-2020-04.tsv.gz,Stranger_Things_(season_4),35076,142374,701,178151,116521
hdfs://spark-nn.eemcs.utwente.nl/user/s1934538/clickstream/clickstream-enwiki-2020-04.tsv.gz,Us_(2019_film),37228,215032,681,252941,74177
hdfs://spark-nn.eemcs.utwente.nl/user/s1934538/clickstream/clickstream-enwiki-2020-04.tsv.gz,Donald_Glover,154309,591501,4778,750588,299641
hdfs://spark-nn.eemcs.utwente.nl/user/s1934538/clickstream/clickstream-enwiki-2020-04.tsv.gz,Indian_Premier_League,14884,90462,159,105505,67676
hdfs://spark-nn.eemcs.utwente.nl/user/s1934538/clickstream/clickstream-enwiki-2020-04.tsv.gz,Henry_V_of_England,114115,174735,2212,291062,204961
hdfs://spark-nn.eemcs.utwente.nl/user/s1934538/clickstream/clickstream-enwiki-2020-04.tsv.gz,DMX_(rapper),17870,72776,762,91408,42202
hdfs://spark-nn.eemcs.utwente.nl/user/s1934538/clickstream/clickstream-enwiki-2020-04.tsv.gz,K.G.F:_Chapter_2,33931,92478,226,126635,54706
hdfs://spark-nn.eemcs.utwente.nl/user/s1934538/clickstream/clickstream-enwiki-2020-04.tsv.gz,Darth_Vader,55501,379261,799,435561,117142
hdfs://spark-nn.eemcs.utwente.nl/user/s1934538/clickstream/clickstream-enwiki-2020-04.tsv.gz,Grover,1680,7760,52,9492,2012
hdfs://spark-nn.eemcs.utwente.nl/user/s1934538/clickstream/clickstream-enwiki-2020-04.tsv.gz,2018_Winter_Olympics,24451,30885,534,55870,34864
hdfs://spark-nn.eemcs.utwente.nl/user/s1934538/clickstream/clickstream-enwiki-2020-04.tsv.gz,Laal_Singh_Chaddha,42458,31886,25,74369,38236
hdfs://spark-nn.eemcs.utwente.nl/user/s1934538/clickstream/clickstream-enwiki-2020-04.tsv.gz,Notre-Dame_de_Paris,19484,149618,6110,175212,42260
hdfs://spark-nn.eemcs.utwente.nl/user/s1934538/clickstream/clickstream-enwiki-2020-04.tsv.gz,List_of_Marvel_Cinematic_Universe_films,157356,1742628,5755,1905739,661165
hdfs://spark-nn.eemcs.utwente.nl/user/s1934538/clickstream/clickstream-enwiki-2020-04.tsv.gz,Dennis_Nilsen,6425,32468,1070,39963,9474
hdfs://spark-nn.eemcs.utwente.nl/user/s1934538/clickstream/clickstream-enwiki-2020-04.tsv.gz,John_McCain,49644,124418,1194,175256,77928
hdfs://spark-nn.eemcs.utwente.nl/user/s1934538/clickstream/clickstream-enwiki-2020-04.tsv.gz,George_VI,588326,288401,1814,878541,628747
hdfs://spark-nn.eemcs.utwente.nl/user/s1934538/clickstream/clickstream-enwiki-2020-04.tsv.gz,RRR_(film),62286,71890,63,134239,14093
hdfs://spark-nn.eemcs.utwente.nl/user/s1934538/clickstream/clickstream-enwiki-2020-04.tsv.gz,Spanish_flu,222792,4534960,40358,4798110,1046017
hdfs://spark-nn.eemcs.utwente.nl/user/s1934538/clickstream/clickstream-enwiki-2020-04.tsv.gz,Grimes_(musician),126541,148686,684,275911,98900
hdfs://spark-nn.eemcs.utwente.nl/user/s1934538/clickstream/clickstream-enwiki-2020-04.tsv.gz,Elon_Musk,120317,883912,6917,1011146,622754
hdfs://spark-nn.eemcs.utwente.nl/user/s1934538/clickstream/clickstream-enwiki-2020-04.tsv.gz,The_Haunting_of_Bly_Manor,39236,25163,77,64476,44522
hdfs://spark-nn.eemcs.utwente.nl/user/s1934538/clickstream/clickstream-enwiki-2020-04.tsv.gz,September_11_attacks,103144,440768,3850,547762,215503
hdfs://spark-nn.eemcs.utwente.nl/user/s1934538/clickstream/clickstream-enwiki-2020-04.tsv.gz,2018_FIFA_World_Cup,96857,214052,2608,313517,164194
hdfs://spark-nn.eemcs.utwente.nl/user/s1934538/clickstream/clickstream-enwiki-2020-04.tsv.gz,Jeffrey_Epstein,36051,336073,3203,375327,129022
hdfs://spark-nn.eemcs.utwente.nl/user/s1934538/clickstream/clickstream-enwiki-2020-04.tsv.gz,Amber_Heard,139160,403853,4745,547758,261985
hdfs://spark-nn.eemcs.utwente.nl/user/s1934538/clickstream/clickstream-enwiki-2020-04.tsv.gz,Michael_Jordan,435007,3226936,19889,3681832,1587826
hdfs://spark-nn.eemcs.utwente.nl/user/s1934538/clickstream/clickstream-enwiki-2020-04.tsv.gz,Stephen_Hawking,50261,612740,3349,666350,279915
hdfs://spark-nn.eemcs.utwente.nl/user/s1934538/clickstream/clickstream-enwiki-2020-04.tsv.gz,COVID-19_pandemic,3427497,11278331,53551,14759379,48
hdfs://spark-nn.eemcs.utwente.nl/user/s1934538/clickstream/clickstream-enwiki-2020-04.tsv.gz,Avengers:_Infinity_War,100779,177208,2110,280097,170871
hdfs://spark-nn.eemcs.utwente.nl/user/s1934538/clickstream/clickstream-enwiki-2020-04.tsv.gz,Tunnel,2938,12483,102,15523,3515
hdfs://spark-nn.eemcs.utwente.nl/user/s1934538/clickstream/clickstream-enwiki-2020-04.tsv.gz,Tenet_(film),125778,133424,2678,261880,166819
hdfs://spark-nn.eemcs.utwente.nl/user/s1934538/clickstream/clickstream-enwiki-2020-04.tsv.gz,Deion_Sanders,21948,217000,1311,240259,68792
hdfs://spark-nn.eemcs.utwente.nl/user/s1934538/clickstream/clickstream-enwiki-2020-04.tsv.gz,Antifa_(United_States),9658,62687,117,72462,13260
hdfs://spark-nn.eemcs.utwente.nl/user/s1934538/clickstream/clickstream-enwiki-2020-04.tsv.gz,Anne_Heche,41231,76833,320,118384,36143
hdfs://spark-nn.eemcs.utwente.nl/user/s1934538/clickstream/clickstream-enwiki-2020-04.tsv.gz,Dark_Phoenix_(film),84817,272425,2601,359843,214524
hdfs://spark-nn.eemcs.utwente.nl/user/s1934538/clickstream/clickstream-enwiki-2020-04.tsv.gz,Rihanna,81563,281521,4502,367586,182284
hdfs://spark-nn.eemcs.utwente.nl/user/s1934538/clickstream/clickstream-enwiki-2020-04.tsv.gz,Fantastic_Beasts:_The_Crimes_of_Grindelwald,86033,132346,1366,219745,116200
hdfs://spark-nn.eemcs.utwente.nl/user/s1934538/clickstream/clickstream-enwiki-2020-04.tsv.gz,Queen_(band),81764,314073,3586,399423,358636
hdfs://spark-nn.eemcs.utwente.nl/user/s1934538/clickstream/clickstream-enwiki-2020-04.tsv.gz,Naomi_Osaka,8692,23298,107,32097,8987
hdfs://spark-nn.eemcs.utwente.nl/user/s1934538/clickstream/clickstream-enwiki-2020-04.tsv.gz,War_(2019_film),52992,186356,289,239637,55492
hdfs://spark-nn.eemcs.utwente.nl/user/s1934538/clickstream/clickstream-enwiki-2020-04.tsv.gz,WandaVision,53174,38623,205,92002,48698
hdfs://spark-nn.eemcs.utwente.nl/user/s1934538/clickstream/clickstream-enwiki-2020-04.tsv.gz,Lists_of_deaths_by_year,7853,370608,553,379014,352288
hdfs://spark-nn.eemcs.utwente.nl/user/s1934538/clickstream/clickstream-enwiki-2020-04.tsv.gz,Nipsey_Hussle,44906,302871,1600,349377,108539
hdfs://spark-nn.eemcs.utwente.nl/user/s1934538/clickstream/clickstream-enwiki-2020-04.tsv.gz,Tom_Brady,99884,456973,5394,562251,213541
hdfs://spark-nn.eemcs.utwente.nl/user/s1934538/clickstream/clickstream-enwiki-2020-04.tsv.gz,NATO,63901,162354,16191,242446,100067
hdfs://spark-nn.eemcs.utwente.nl/user/s1934538/clickstream/clickstream-enwiki-2020-04.tsv.gz,Amy_Coney_Barrett,1357,3618,19,4994,1065
hdfs://spark-nn.eemcs.utwente.nl/user/s1934538/clickstream/clickstream-enwiki-2020-04.tsv.gz,List_of_awards_and_nominations_received_by_Meryl_Streep,23024,18166,142,41332,14471
hdfs://spark-nn.eemcs.utwente.nl/user/s1934538/clickstream/clickstream-enwiki-2020-04.tsv.gz,Ukraine,56755,142326,3168,202249,100487
hdfs://spark-nn.eemcs.utwente.nl/user/s1934538/clickstream/clickstream-enwiki-2020-04.tsv.gz,Tina_Turner,24976,165466,1652,192094,58929
hdfs://spark-nn.eemcs.utwente.nl/user/s1934538/clickstream/clickstream-enwiki-2020-04.tsv.gz,Lisa_Marie_Presley,140710,79685,226,220621,121535
hdfs://spark-nn.eemcs.utwente.nl/user/s1934538/clickstream/clickstream-enwiki-2020-04.tsv.gz,Jimmy_Hoffa,70846,356100,2378,429324,137352
hdfs://spark-nn.eemcs.utwente.nl/user/s1934538/clickstream/clickstream-enwiki-2020-04.tsv.gz,"Diana,_Princess_of_Wales",206213,460462,3481,670156,451392
hdfs://spark-nn.eemcs.utwente.nl/user/s1934538/clickstream/clickstream-enwiki-2020-04.tsv.gz,Deadpool_2,65156,101740,1624,168520,110997
hdfs://spark-nn.eemcs.utwente.nl/user/s1934538/clickstream/clickstream-enwiki-2020-12.tsv.gz,Cristiano_Ronaldo,138300,910867,5722,1054889,241569
hdfs://spark-nn.eemcs.utwente.nl/user/s1934538/clickstream/clickstream-enwiki-2020-12.tsv.gz,Eddie_Van_Halen,42762,134831,1950,179543,62299
hdfs://spark-nn.eemcs.utwente.nl/user/s1934538/clickstream/clickstream-enwiki-2020-12.tsv.gz,YouTube,134232,1509472,10702,1654406,129706
hdfs://spark-nn.eemcs.utwente.nl/user/s1934538/clickstream/clickstream-enwiki-2020-12.tsv.gz,Kobe_Bryant_sexual_assault_case,6170,28792,30,34992,2823
hdfs://spark-nn.eemcs.utwente.nl/user/s1934538/clickstream/clickstream-enwiki-2020-12.tsv.gz,Kylian_Mbappé,29315,172010,1748,203073,38946
hdfs://spark-nn.eemcs.utwente.nl/user/s1934538/clickstream/clickstream-enwiki-2020-12.tsv.gz,Jeffrey_Epstein,58960,297661,2415,359036,150500
hdfs://spark-nn.eemcs.utwente.nl/user/s1934538/clickstream/clickstream-enwiki-2020-12.tsv.gz,Death_of_Elisa_Lam,18358,225010,1607,244975,49455
hdfs://spark-nn.eemcs.utwente.nl/user/s1934538/clickstream/clickstream-enwiki-2020-12.tsv.gz,State_of_Palestine,47647,110698,109,158454,71747
hdfs://spark-nn.eemcs.utwente.nl/user/s1934538/clickstream/clickstream-enwiki-2020-12.tsv.gz,John_McCain,42434,99182,1136,142752,73012
hdfs://spark-nn.eemcs.utwente.nl/user/s1934538/clickstream/clickstream-enwiki-2020-12.tsv.gz,Laal_Singh_Chaddha,34737,34622,4552,73911,38061
hdfs://spark-nn.eemcs.utwente.nl/user/s1934538/clickstream/clickstream-enwiki-2020-12.tsv.gz,The_Mandalorian,436370,2924517,48888,3409775,2521001
hdfs://spark-nn.eemcs.utwente.nl/user/s1934538/clickstream/clickstream-enwiki-2020-12.tsv.gz,Army_of_the_Dead,31073,16655,250,47978,29665
hdfs://spark-nn.eemcs.utwente.nl/user/s1934538/clickstream/clickstream-enwiki-2020-12.tsv.gz,Vladimir_Putin,96395,269215,8638,374248,240966
hdfs://spark-nn.eemcs.utwente.nl/user/s1934538/clickstream/clickstream-enwiki-2020-12.tsv.gz,Puneeth_Rajkumar,9847,21252,299,31398,17656
hdfs://spark-nn.eemcs.utwente.nl/user/s1934538/clickstream/clickstream-enwiki-2020-12.tsv.gz,Roe_v._Wade,14386,73053,433,87872,25405
hdfs://spark-nn.eemcs.utwente.nl/user/s1934538/clickstream/clickstream-enwiki-2020-12.tsv.gz,UEFA_Euro_2020,32438,94924,1797,129159,53721
hdfs://spark-nn.eemcs.utwente.nl/user/s1934538/clickstream/clickstream-enwiki-2020-12.tsv.gz,2018_Winter_Olympics,22965,19113,269,42347,32249
hdfs://spark-nn.eemcs.utwente.nl/user/s1934538/clickstream/clickstream-enwiki-2020-12.tsv.gz,DMX_(rapper),15288,76333,561,92182,35845
hdfs://spark-nn.eemcs.utwente.nl/user/s1934538/clickstream/clickstream-enwiki-2020-12.tsv.gz,Chernobyl_disaster,62683,357386,3070,423139,181238
hdfs://spark-nn.eemcs.utwente.nl/user/s1934538/clickstream/clickstream-enwiki-2020-12.tsv.gz,Anna_Sorokin,10128,49119,157,59404,17264
hdfs://spark-nn.eemcs.utwente.nl/user/s1934538/clickstream/clickstream-enwiki-2020-12.tsv.gz,Irrfan_Khan,39228,105149,486,144863,47124
hdfs://spark-nn.eemcs.utwente.nl/user/s1934538/clickstream/clickstream-enwiki-2020-12.tsv.gz,Croatia,43275,123875,1789,168939,59988
hdfs://spark-nn.eemcs.utwente.nl/user/s1934538/clickstream/clickstream-enwiki-2020-12.tsv.gz,War_(2019_film),17297,66044,96,83437,22538
hdfs://spark-nn.eemcs.utwente.nl/user/s1934538/clickstream/clickstream-enwiki-2020-12.tsv.gz,Mötley_Crüe,32854,113092,1099,147045,177962
hdfs://spark-nn.eemcs.utwente.nl/user/s1934538/clickstream/clickstream-enwiki-2020-12.tsv.gz,Michael_Jordan,80880,446931,3929,531740,180884
hdfs://spark-nn.eemcs.utwente.nl/user/s1934538/clickstream/clickstream-enwiki-2020-12.tsv.gz,Tonya_Harding,27012,133333,565,160910,41908
hdfs://spark-nn.eemcs.utwente.nl/user/s1934538/clickstream/clickstream-enwiki-2020-12.tsv.gz,ICC_Men's_T20_World_Cup,8548,106085,206,114839,52550
hdfs://spark-nn.eemcs.utwente.nl/user/s1934538/clickstream/clickstream-enwiki-2020-12.tsv.gz,Ruth_Bader_Ginsburg,36248,193972,2360,232580,82352
hdfs://spark-nn.eemcs.utwente.nl/user/s1934538/clickstream/clickstream-enwiki-2020-12.tsv.gz,Royal_Rumble_(2018),11173,6388,144,17705,13031
hdfs://spark-nn.eemcs.utwente.nl/user/s1934538/clickstream/clickstream-enwiki-2020-12.tsv.gz,Adele,21815,156686,1935,180436,55215
hdfs://spark-nn.eemcs.utwente.nl/user/s1934538/clickstream/clickstream-enwiki-2020-12.tsv.gz,Charles_Sobhraj,25387,83344,469,109200,17384
hdfs://spark-nn.eemcs.utwente.nl/user/s1934538/clickstream/clickstream-enwiki-2020-12.tsv.gz,Coronavirus,33400,429586,5093,468079,116349
hdfs://spark-nn.eemcs.utwente.nl/user/s1934538/clickstream/clickstream-enwiki-2020-12.tsv.gz,Queen_(band),58606,190846,2450,251902,237837
hdfs://spark-nn.eemcs.utwente.nl/user/s1934538/clickstream/clickstream-enwiki-2020-12.tsv.gz,Cameron_Boyce,33627,187398,891,221916,62602
hdfs://spark-nn.eemcs.utwente.nl/user/s1934538/clickstream/clickstream-enwiki-2020-12.tsv.gz,Taliban,25528,61240,552,87320,60359
hdfs://spark-nn.eemcs.utwente.nl/user/s1934538/clickstream/clickstream-enwiki-2020-12.tsv.gz,COVID-19_pandemic,517989,772189,5265,1295443,616284
hdfs://spark-nn.eemcs.utwente.nl/user/s1934538/clickstream/clickstream-enwiki-2020-12.tsv.gz,Lionel_Messi,105357,577454,6082,688893,150474
hdfs://spark-nn.eemcs.utwente.nl/user/s1934538/clickstream/clickstream-enwiki-2020-12.tsv.gz,"Meghan,_Duchess_of_Sussex",191296,305142,1976,498414,262416
hdfs://spark-nn.eemcs.utwente.nl/user/s1934538/clickstream/clickstream-enwiki-2020-12.tsv.gz,The_Witcher_(TV_series),40552,231773,4870,277195,158979
hdfs://spark-nn.eemcs.utwente.nl/user/s1934538/clickstream/clickstream-enwiki-2020-12.tsv.gz,List_of_Queen_of_the_South_episodes,12209,10075,157,22441,546
hdfs://spark-nn.eemcs.utwente.nl/user/s1934538/clickstream/clickstream-enwiki-2020-12.tsv.gz,Bob_Saget,32132,37109,227,69468,11507
hdfs://spark-nn.eemcs.utwente.nl/user/s1934538/clickstream/clickstream-enwiki-2020-12.tsv.gz,Game_of_Thrones_(season_8),19897,56219,704,76820,26069
hdfs://spark-nn.eemcs.utwente.nl/user/s1934538/clickstream/clickstream-enwiki-2020-12.tsv.gz,Sushma_Swaraj,6380,37463,66,43909,7535
hdfs://spark-nn.eemcs.utwente.nl/user/s1934538/clickstream/clickstream-enwiki-2020-12.tsv.gz,Shang-Chi_and_the_Legend_of_the_Ten_Rings,114525,54926,408,169859,134493
hdfs://spark-nn.eemcs.utwente.nl/user/s1934538/clickstream/clickstream-enwiki-2020-12.tsv.gz,Alexander_Hamilton,113696,396116,2775,512587,271932
hdfs://spark-nn.eemcs.utwente.nl/user/s1934538/clickstream/clickstream-enwiki-2020-12.tsv.gz,Shinzo_Abe,32203,32135,421,64759,39073
hdfs://spark-nn.eemcs.utwente.nl/user/s1934538/clickstream/clickstream-enwiki-2020-12.tsv.gz,RRR_(film),30923,61782,948,93653,52905
hdfs://spark-nn.eemcs.utwente.nl/user/s1934538/clickstream/clickstream-enwiki-2020-12.tsv.gz,List_of_FIFA_World_Cup_finals,3413,59913,59,63385,21794
hdfs://spark-nn.eemcs.utwente.nl/user/s1934538/clickstream/clickstream-enwiki-2020-12.tsv.gz,Venom_(2018_film),27331,132216,1207,160754,66249
hdfs://spark-nn.eemcs.utwente.nl/user/s1934538/clickstream/clickstream-enwiki-2020-12.tsv.gz,Grover,1739,7061,59,8859,2004
hdfs://spark-nn.eemcs.utwente.nl/user/s1934538/clickstream/clickstream-enwiki-2020-12.tsv.gz,Naomi_Osaka,11889,62258,420,74567,21128
hdfs://spark-nn.eemcs.utwente.nl/user/s1934538/clickstream/clickstream-enwiki-2020-12.tsv.gz,Media,63,3887,239,4189,1541
hdfs://spark-nn.eemcs.utwente.nl/user/s1934538/clickstream/clickstream-enwiki-2020-12.tsv.gz,"Princess_Margaret,_Countess_of_Snowdon",640606,3069150,15351,3725107,1948757
hdfs://spark-nn.eemcs.utwente.nl/user/s1934538/clickstream/clickstream-enwiki-2020-12.tsv.gz,Louis_Tomlinson,41500,97779,468,139747,28120
hdfs://spark-nn.eemcs.utwente.nl/user/s1934538/clickstream/clickstream-enwiki-2020-12.tsv.gz,List_of_Marvel_Cinematic_Universe_films,142593,645392,2986,790971,379254
hdfs://spark-nn.eemcs.utwente.nl/user/s1934538/clickstream/clickstream-enwiki-2020-12.tsv.gz,Stephen_Hawking,37737,466171,2443,506351,201747
hdfs://spark-nn.eemcs.utwente.nl/user/s1934538/clickstream/clickstream-enwiki-2020-12.tsv.gz,The_Lion_King_(2019_film),58044,83175,793,142012,74888
hdfs://spark-nn.eemcs.utwente.nl/user/s1934538/clickstream/clickstream-enwiki-2020-12.tsv.gz,Hamilton_(musical),56468,335328,2519,394315,289245
hdfs://spark-nn.eemcs.utwente.nl/user/s1934538/clickstream/clickstream-enwiki-2020-12.tsv.gz,Anne_Heche,28723,62824,275,91822,28656
hdfs://spark-nn.eemcs.utwente.nl/user/s1934538/clickstream/clickstream-enwiki-2020-12.tsv.gz,Mac_Miller,57739,233838,1706,293283,94554
hdfs://spark-nn.eemcs.utwente.nl/user/s1934538/clickstream/clickstream-enwiki-2020-12.tsv.gz,Watts_family_murders,21040,242355,419,263814,59095
hdfs://spark-nn.eemcs.utwente.nl/user/s1934538/clickstream/clickstream-enwiki-2020-12.tsv.gz,Elliot_Page,305880,5813229,42685,6161794,2289671
hdfs://spark-nn.eemcs.utwente.nl/user/s1934538/clickstream/clickstream-enwiki-2020-12.tsv.gz,Shooting_of_Breonna_Taylor,6877,220767,583,228227,18079
hdfs://spark-nn.eemcs.utwente.nl/user/s1934538/clickstream/clickstream-enwiki-2020-12.tsv.gz,Elizabeth_II,1472145,2894835,9709,4376689,3860466
hdfs://spark-nn.eemcs.utwente.nl/user/s1934538/clickstream/clickstream-enwiki-2020-12.tsv.gz,Avengers:_Endgame,134387,232963,6739,374089,234087
hdfs://spark-nn.eemcs.utwente.nl/user/s1934538/clickstream/clickstream-enwiki-2020-12.tsv.gz,JSON_Web_Token,682,27439,39,28160,1551
hdfs://spark-nn.eemcs.utwente.nl/user/s1934538/clickstream/clickstream-enwiki-2020-12.tsv.gz,Cook's_Country,449,2946,23,3418,888
hdfs://spark-nn.eemcs.utwente.nl/user/s1934538/clickstream/clickstream-enwiki-2020-12.tsv.gz,Wikipedia,228687,824817,1187,1054691,320868
hdfs://spark-nn.eemcs.utwente.nl/user/s1934538/clickstream/clickstream-enwiki-2020-12.tsv.gz,Killing_of_George_Floyd,43139,95468,889,139496,48404
hdfs://spark-nn.eemcs.utwente.nl/user/s1934538/clickstream/clickstream-enwiki-2020-12.tsv.gz,21_Savage,13137,81889,806,95832,35210
hdfs://spark-nn.eemcs.utwente.nl/user/s1934538/clickstream/clickstream-enwiki-2020-12.tsv.gz,K.G.F:_Chapter_2,29228,218668,258,248154,77887
hdfs://spark-nn.eemcs.utwente.nl/user/s1934538/clickstream/clickstream-enwiki-2020-12.tsv.gz,Mortal_Kombat_(2021_film),51512,158430,2050,211992,151976
hdfs://spark-nn.eemcs.utwente.nl/user/s1934538/clickstream/clickstream-enwiki-2020-12.tsv.gz,"Diana,_Princess_of_Wales",632039,2074077,16870,2722986,1630077
hdfs://spark-nn.eemcs.utwente.nl/user/s1934538/clickstream/clickstream-enwiki-2020-12.tsv.gz,2018_Asian_Games,7214,7935,47,15196,11803
hdfs://spark-nn.eemcs.utwente.nl/user/s1934538/clickstream/clickstream-enwiki-2020-12.tsv.gz,Sridevi,33724,76942,174,110840,48767
hdfs://spark-nn.eemcs.utwente.nl/user/s1934538/clickstream/clickstream-enwiki-2020-12.tsv.gz,Deion_Sanders,14995,166076,831,181902,54886
hdfs://spark-nn.eemcs.utwente.nl/user/s1934538/clickstream/clickstream-enwiki-2020-12.tsv.gz,Keanu_Reeves,127803,908634,6116,1042553,600050
hdfs://spark-nn.eemcs.utwente.nl/user/s1934538/clickstream/clickstream-enwiki-2020-12.tsv.gz,Aquaman_(film),50630,119541,1518,171689,80327
hdfs://spark-nn.eemcs.utwente.nl/user/s1934538/clickstream/clickstream-enwiki-2020-12.tsv.gz,Aaron_Hernandez,11433,150012,627,162072,54149
hdfs://spark-nn.eemcs.utwente.nl/user/s1934538/clickstream/clickstream-enwiki-2020-12.tsv.gz,Kate_Spade,36500,83757,375,120632,42227
hdfs://spark-nn.eemcs.utwente.nl/user/s1934538/clickstream/clickstream-enwiki-2020-12.tsv.gz,HTTP_cookie,3162,306945,89,310196,21899
hdfs://spark-nn.eemcs.utwente.nl/user/s1934538/clickstream/clickstream-enwiki-2020-12.tsv.gz,Key_frame,671,6539,19,7229,461
hdfs://spark-nn.eemcs.utwente.nl/user/s1934538/clickstream/clickstream-enwiki-2020-12.tsv.gz,XHamster,9507,184405,4199,198111,26365
hdfs://spark-nn.eemcs.utwente.nl/user/s1934538/clickstream/clickstream-enwiki-2020-12.tsv.gz,Aaron_Carter,25235,50023,278,75536,28591
hdfs://spark-nn.eemcs.utwente.nl/user/s1934538/clickstream/clickstream-enwiki-2020-12.tsv.gz,Critical_race_theory,4733,138669,862,144264,28544
hdfs://spark-nn.eemcs.utwente.nl/user/s1934538/clickstream/clickstream-enwiki-2020-12.tsv.gz,Amber_Heard,142936,345912,2296,491144,218679
hdfs://spark-nn.eemcs.utwente.nl/user/s1934538/clickstream/clickstream-enwiki-2020-12.tsv.gz,Central_Park_jogger_case,18015,71922,196,90133,12076
hdfs://spark-nn.eemcs.utwente.nl/user/s1934538/clickstream/clickstream-enwiki-2020-12.tsv.gz,Stranger_Things_(season_4),31385,151998,604,183987,101434
hdfs://spark-nn.eemcs.utwente.nl/user/s1934538/clickstream/clickstream-enwiki-2020-12.tsv.gz,Manti_Te'o,8239,51526,278,60043,6740
hdfs://spark-nn.eemcs.utwente.nl/user/s1934538/clickstream/clickstream-enwiki-2020-12.tsv.gz,Valentine's_Day,5392,45974,263,51629,4847
hdfs://spark-nn.eemcs.utwente.nl/user/s1934538/clickstream/clickstream-enwiki-2020-12.tsv.gz,Dark_Phoenix_(film),50927,75701,710,127338,71682
hdfs://spark-nn.eemcs.utwente.nl/user/s1934538/clickstream/clickstream-enwiki-2020-12.tsv.gz,List_of_awards_and_nominations_received_by_Meryl_Streep,41723,40902,178,82803,21421
hdfs://spark-nn.eemcs.utwente.nl/user/s1934538/clickstream/clickstream-enwiki-2020-12.tsv.gz,Avicii,21911,195134,1514,218559,99238
hdfs://spark-nn.eemcs.utwente.nl/user/s1934538/clickstream/clickstream-enwiki-2020-12.tsv.gz,Godzilla_vs._Kong,72480,98483,3052,174015,101929
hdfs://spark-nn.eemcs.utwente.nl/user/s1934538/clickstream/clickstream-enwiki-2020-12.tsv.gz,Rihanna,77725,310719,3544,391988,183500
hdfs://spark-nn.eemcs.utwente.nl/user/s1934538/clickstream/clickstream-enwiki-2020-12.tsv.gz,Meat_Loaf,24470,92559,825,117854,40308
hdfs://spark-nn.eemcs.utwente.nl/user/s1934538/clickstream/clickstream-enwiki-2020-12.tsv.gz,Asia_Cup,1448,21284,52,22784,10368
hdfs://spark-nn.eemcs.utwente.nl/user/s1934538/clickstream/clickstream-enwiki-2020-12.tsv.gz,Naya_Rivera,83114,210456,1084,294654,99875
hdfs://spark-nn.eemcs.utwente.nl/user/s1934538/clickstream/clickstream-enwiki-2020-12.tsv.gz,Olivia_Newton-John,51663,186673,1403,239739,91186
hdfs://spark-nn.eemcs.utwente.nl/user/s1934538/clickstream/clickstream-enwiki-2020-12.tsv.gz,List_of_James_Bond_films,93346,704485,1236,799067,471013
hdfs://spark-nn.eemcs.utwente.nl/user/s1934538/clickstream/clickstream-enwiki-2020-12.tsv.gz,Sinéad_O'Connor,21941,97628,722,120291,35774
hdfs://spark-nn.eemcs.utwente.nl/user/s1934538/clickstream/clickstream-enwiki-2020-12.tsv.gz,2016_United_States_presidential_election,428632,315886,3007,747525,595703
hdfs://spark-nn.eemcs.utwente.nl/user/s1934538/clickstream/clickstream-enwiki-2020-12.tsv.gz,2.0_(film),16573,35649,86,52308,15245
hdfs://spark-nn.eemcs.utwente.nl/user/s1934538/clickstream/clickstream-enwiki-2020-12.tsv.gz,The_Shape_of_Water,31435,144215,1819,177469,87039
hdfs://spark-nn.eemcs.utwente.nl/user/s1934538/clickstream/clickstream-enwiki-2020-12.tsv.gz,Ted_Bundy,46757,507665,5097,559519,125612
hdfs://spark-nn.eemcs.utwente.nl/user/s1934538/clickstream/clickstream-enwiki-2020-12.tsv.gz,Jenna_Ortega,26960,35020,1352,63332,14152
hdfs://spark-nn.eemcs.utwente.nl/user/s1934538/clickstream/clickstream-enwiki-2020-12.tsv.gz,Ghislaine_Maxwell,62495,164682,1050,228227,90616
hdfs://spark-nn.eemcs.utwente.nl/user/s1934538/clickstream/clickstream-enwiki-2020-12.tsv.gz,Tina_Turner,22727,201653,1931,226311,66783
hdfs://spark-nn.eemcs.utwente.nl/user/s1934538/clickstream/clickstream-enwiki-2020-12.tsv.gz,Anthony_Bourdain,17972,196070,1394,215436,64764
hdfs://spark-nn.eemcs.utwente.nl/user/s1934538/clickstream/clickstream-enwiki-2020-12.tsv.gz,Lance_Reddick,31152,35901,295,67348,13384
hdfs://spark-nn.eemcs.utwente.nl/user/s1934538/clickstream/clickstream-enwiki-2020-12.tsv.gz,Ray_Liotta,39045,67320,404,106769,34073
hdfs://spark-nn.eemcs.utwente.nl/user/s1934538/clickstream/clickstream-enwiki-2020-12.tsv.gz,Microsoft_Office,8883,2026416,906,2036205,21910
hdfs://spark-nn.eemcs.utwente.nl/user/s1934538/clickstream/clickstream-enwiki-2020-12.tsv.gz,David_Beckham,37832,203651,1314,242797,84033
hdfs://spark-nn.eemcs.utwente.nl/user/s1934538/clickstream/clickstream-enwiki-2020-12.tsv.gz,Atal_Bihari_Vajpayee,32075,137597,278,169950,36415
hdfs://spark-nn.eemcs.utwente.nl/user/s1934538/clickstream/clickstream-enwiki-2020-12.tsv.gz,Jeffrey_Dahmer,29714,303808,3493,337015,145927
hdfs://spark-nn.eemcs.utwente.nl/user/s1934538/clickstream/clickstream-enwiki-2020-12.tsv.gz,WandaVision,89316,298533,4463,392312,186589
hdfs://spark-nn.eemcs.utwente.nl/user/s1934538/clickstream/clickstream-enwiki-2020-12.tsv.gz,Johnny_Depp,148629,544893,3514,697036,503817
hdfs://spark-nn.eemcs.utwente.nl/user/s1934538/clickstream/clickstream-enwiki-2020-12.tsv.gz,Greta_Thunberg,18907,198132,1665,218704,51404
hdfs://spark-nn.eemcs.utwente.nl/user/s1934538/clickstream/clickstream-enwiki-2020-12.tsv.gz,Fyre_Festival,9093,59957,431,69481,41963
hdfs://spark-nn.eemcs.utwente.nl/user/s1934538/clickstream/clickstream-enwiki-2020-12.tsv.gz,Jimmy_Buffett,7880,51572,546,59998,20459
hdfs://spark-nn.eemcs.utwente.nl/user/s1934538/clickstream/clickstream-enwiki-2020-12.tsv.gz,William_Murdoch,513,2465,48,3026,394
hdfs://spark-nn.eemcs.utwente.nl/user/s1934538/clickstream/clickstream-enwiki-2020-12.tsv.gz,Parasite_(2019_film),48583,324374,2732,375689,146211
hdfs://spark-nn.eemcs.utwente.nl/user/s1934538/clickstream/clickstream-enwiki-2020-12.tsv.gz,Donald_Glover,60835,225929,1381,288145,102011
hdfs://spark-nn.eemcs.utwente.nl/user/s1934538/clickstream/clickstream-enwiki-2020-12.tsv.gz,Michael_Bloomberg,51125,44150,580,95855,47456
hdfs://spark-nn.eemcs.utwente.nl/user/s1934538/clickstream/clickstream-enwiki-2020-12.tsv.gz,Cecil_Hotel_(Los_Angeles),10416,55059,75,65550,27653
hdfs://spark-nn.eemcs.utwente.nl/user/s1934538/clickstream/clickstream-enwiki-2020-12.tsv.gz,Chernobyl_(miniseries),20289,112815,1788,134892,123961
hdfs://spark-nn.eemcs.utwente.nl/user/s1934538/clickstream/clickstream-enwiki-2020-12.tsv.gz,Juice_Wrld,43966,606455,6693,657114,184292
hdfs://spark-nn.eemcs.utwente.nl/user/s1934538/clickstream/clickstream-enwiki-2020-12.tsv.gz,Qasem_Soleimani,15653,54550,308,70511,29661
hdfs://spark-nn.eemcs.utwente.nl/user/s1934538/clickstream/clickstream-enwiki-2020-12.tsv.gz,September_11_attacks,75128,280058,3305,358491,159896
hdfs://spark-nn.eemcs.utwente.nl/user/s1934538/clickstream/clickstream-enwiki-2020-12.tsv.gz,Nipsey_Hussle,33639,119653,1078,154370,48424
hdfs://spark-nn.eemcs.utwente.nl/user/s1934538/clickstream/clickstream-enwiki-2020-12.tsv.gz,2018_FIFA_World_Cup,73148,89226,1430,163804,103334
hdfs://spark-nn.eemcs.utwente.nl/user/s1934538/clickstream/clickstream-enwiki-2020-12.tsv.gz,Cardi_B,44120,264072,4239,312431,102419
hdfs://spark-nn.eemcs.utwente.nl/user/s1934538/clickstream/clickstream-enwiki-2020-12.tsv.gz,2022_FIFA_World_Cup,64344,129367,3025,196736,120444
hdfs://spark-nn.eemcs.utwente.nl/user/s1934538/clickstream/clickstream-enwiki-2020-12.tsv.gz,Shakira,25848,305035,2589,333472,146366
hdfs://spark-nn.eemcs.utwente.nl/user/s1934538/clickstream/clickstream-enwiki-2020-12.tsv.gz,The_Irishman,62478,154346,2375,219199,192068
hdfs://spark-nn.eemcs.utwente.nl/user/s1934538/clickstream/clickstream-enwiki-2020-12.tsv.gz,Pornhub,50220,528671,19432,598323,178763
hdfs://spark-nn.eemcs.utwente.nl/user/s1934538/clickstream/clickstream-enwiki-2020-12.tsv.gz,Captain_Marvel_(film),59648,148874,1910,210432,99937
hdfs://spark-nn.eemcs.utwente.nl/user/s1934538/clickstream/clickstream-enwiki-2020-12.tsv.gz,Sushant_Singh_Rajput,35667,186914,901,223482,85901
hdfs://spark-nn.eemcs.utwente.nl/user/s1934538/clickstream/clickstream-enwiki-2020-12.tsv.gz,Cricket_World_Cup,8979,64356,176,73511,38561
hdfs://spark-nn.eemcs.utwente.nl/user/s1934538/clickstream/clickstream-enwiki-2020-12.tsv.gz,Joe_Biden,331579,1059627,22163,1413369,708438
hdfs://spark-nn.eemcs.utwente.nl/user/s1934538/clickstream/clickstream-enwiki-2020-12.tsv.gz,Kim_Jong-un,49116,146732,1262,197110,97293
hdfs://spark-nn.eemcs.utwente.nl/user/s1934538/clickstream/clickstream-enwiki-2020-12.tsv.gz,Cleopatra,63321,2793082,3550,2859953,263326
hdfs://spark-nn.eemcs.utwente.nl/user/s1934538/clickstream/clickstream-enwiki-2020-12.tsv.gz,The_Sandman_(TV_series),2537,5827,57,8421,1347
hdfs://spark-nn.eemcs.utwente.nl/user/s1934538/clickstream/clickstream-enwiki-2020-12.tsv.gz,List_of_highest-grossing_films,125062,260352,11127,396541,202872
hdfs://spark-nn.eemcs.utwente.nl/user/s1934538/clickstream/clickstream-enwiki-2020-12.tsv.gz,Tunnel,3140,10314,104,13558,3541
hdfs://spark-nn.eemcs.utwente.nl/user/s1934538/clickstream/clickstream-enwiki-2020-12.tsv.gz,United_States_Senate,111828,164514,2085,278427,122832
hdfs://spark-nn.eemcs.utwente.nl/user/s1934538/clickstream/clickstream-enwiki-2020-12.tsv.gz,Joker_(2019_film),59953,255822,2351,318126,123759
hdfs://spark-nn.eemcs.utwente.nl/user/s1934538/clickstream/clickstream-enwiki-2020-12.tsv.gz,The_Falcon_and_the_Winter_Soldier,74007,84245,1026,159278,97874
hdfs://spark-nn.eemcs.utwente.nl/user/s1934538/clickstream/clickstream-enwiki-2020-12.tsv.gz,Game_of_Thrones,92216,334749,8049,435014,273703
hdfs://spark-nn.eemcs.utwente.nl/user/s1934538/clickstream/clickstream-enwiki-2020-12.tsv.gz,J._Robert_Oppenheimer,24736,109443,349,134528,47399
hdfs://spark-nn.eemcs.utwente.nl/user/s1934538/clickstream/clickstream-enwiki-2020-12.tsv.gz,Sidharth_Shukla,20817,74023,83,94923,28455
hdfs://spark-nn.eemcs.utwente.nl/user/s1934538/clickstream/clickstream-enwiki-2020-12.tsv.gz,Mulan_(2020_film),62144,737876,9421,809441,610022
hdfs://spark-nn.eemcs.utwente.nl/user/s1934538/clickstream/clickstream-enwiki-2020-12.tsv.gz,Lists_of_deaths_by_year,15264,2601399,1147680,3764343,120480
hdfs://spark-nn.eemcs.utwente.nl/user/s1934538/clickstream/clickstream-enwiki-2020-12.tsv.gz,QAnon,57315,565096,3620,626031,121747
hdfs://spark-nn.eemcs.utwente.nl/user/s1934538/clickstream/clickstream-enwiki-2020-12.tsv.gz,Dune_(2021_film),95309,302504,4684,402497,225069
hdfs://spark-nn.eemcs.utwente.nl/user/s1934538/clickstream/clickstream-enwiki-2020-12.tsv.gz,Ukraine,47395,124206,2573,174174,82875
hdfs://spark-nn.eemcs.utwente.nl/user/s1934538/clickstream/clickstream-enwiki-2020-12.tsv.gz,United_States_Electoral_College,60896,424240,1652,486788,75766
hdfs://spark-nn.eemcs.utwente.nl/user/s1934538/clickstream/clickstream-enwiki-2020-12.tsv.gz,The_Umbrella_Academy_(TV_series),96541,345821,6005,448367,259131
hdfs://spark-nn.eemcs.utwente.nl/user/s1934538/clickstream/clickstream-enwiki-2020-12.tsv.gz,Fantastic_Beasts:_The_Crimes_of_Grindelwald,53688,69758,754,124200,73057
hdfs://spark-nn.eemcs.utwente.nl/user/s1934538/clickstream/clickstream-enwiki-2020-12.tsv.gz,Once_Upon_a_Time_in_Hollywood,105154,208890,8428,322472,322120
hdfs://spark-nn.eemcs.utwente.nl/user/s1934538/clickstream/clickstream-enwiki-2021-01.tsv.gz,Black_Panther_(film),88348,155704,3120,247172,158368
hdfs://spark-nn.eemcs.utwente.nl/user/s1934538/clickstream/clickstream-enwiki-2021-01.tsv.gz,Zack_Snyder's_Justice_League,121458,185059,20903,327420,155355
hdfs://spark-nn.eemcs.utwente.nl/user/s1934538/clickstream/clickstream-enwiki-2021-01.tsv.gz,Louis_Tomlinson,40391,86715,383,127489,27613
hdfs://spark-nn.eemcs.utwente.nl/user/s1934538/clickstream/clickstream-enwiki-2021-01.tsv.gz,Ukraine,52293,135753,3063,191109,92581
hdfs://spark-nn.eemcs.utwente.nl/user/s1934538/clickstream/clickstream-enwiki-2021-01.tsv.gz,United_States_Senate,448368,739662,20192,1208222,659939
hdfs://spark-nn.eemcs.utwente.nl/user/s1934538/clickstream/clickstream-enwiki-2021-01.tsv.gz,The_Mandalorian,189699,978123,14501,1182323,928297
hdfs://spark-nn.eemcs.utwente.nl/user/s1934538/clickstream/clickstream-enwiki-2021-01.tsv.gz,Top_Gun:_Maverick,55739,75519,1856,133114,93745
hdfs://spark-nn.eemcs.utwente.nl/user/s1934538/clickstream/clickstream-enwiki-2021-01.tsv.gz,UEFA_Euro_2020,32140,101358,1664,135162,52730
hdfs://spark-nn.eemcs.utwente.nl/user/s1934538/clickstream/clickstream-enwiki-2021-01.tsv.gz,Shinzo_Abe,40942,43943,485,85370,51143
hdfs://spark-nn.eemcs.utwente.nl/user/s1934538/clickstream/clickstream-enwiki-2021-01.tsv.gz,Godzilla_vs._Kong,229087,920132,14748,1163967,742475
hdfs://spark-nn.eemcs.utwente.nl/user/s1934538/clickstream/clickstream-enwiki-2021-01.tsv.gz,Cardi_B,43363,257705,4619,305687,104436
hdfs://spark-nn.eemcs.utwente.nl/user/s1934538/clickstream/clickstream-enwiki-2021-01.tsv.gz,Freddie_Mercury,74441,467449,3555,545445,200646
hdfs://spark-nn.eemcs.utwente.nl/user/s1934538/clickstream/clickstream-enwiki-2021-01.tsv.gz,Taliban,27559,60696,483,88738,60493
hdfs://spark-nn.eemcs.utwente.nl/user/s1934538/clickstream/clickstream-enwiki-2021-01.tsv.gz,Valentine's_Day,7686,198507,1069,207262,14141
hdfs://spark-nn.eemcs.utwente.nl/user/s1934538/clickstream/clickstream-enwiki-2021-01.tsv.gz,Aquaman_(film),43402,81467,1257,126126,65450
hdfs://spark-nn.eemcs.utwente.nl/user/s1934538/clickstream/clickstream-enwiki-2021-01.tsv.gz,Game_of_Thrones_(season_8),22166,59730,804,82700,30747
hdfs://spark-nn.eemcs.utwente.nl/user/s1934538/clickstream/clickstream-enwiki-2021-01.tsv.gz,2018_Asian_Games,6565,10678,108,17351,11737
hdfs://spark-nn.eemcs.utwente.nl/user/s1934538/clickstream/clickstream-enwiki-2021-01.tsv.gz,The_Umbrella_Academy_(TV_series),42275,245835,4074,292184,176698
hdfs://spark-nn.eemcs.utwente.nl/user/s1934538/clickstream/clickstream-enwiki-2021-01.tsv.gz,WrestleMania_34,25736,14699,148,40583,27142
hdfs://spark-nn.eemcs.utwente.nl/user/s1934538/clickstream/clickstream-enwiki-2021-01.tsv.gz,Sidharth_Shukla,25501,67108,197,92806,26761
hdfs://spark-nn.eemcs.utwente.nl/user/s1934538/clickstream/clickstream-enwiki-2021-01.tsv.gz,Watts_family_murders,22690,244099,507,267296,61817
hdfs://spark-nn.eemcs.utwente.nl/user/s1934538/clickstream/clickstream-enwiki-2021-01.tsv.gz,Us_(2019_film),28778,128439,511,157728,55425
hdfs://spark-nn.eemcs.utwente.nl/user/s1934538/clickstream/clickstream-enwiki-2021-01.tsv.gz,The_Batman_(film),110257,141890,3160,255307,219892
hdfs://spark-nn.eemcs.utwente.nl/user/s1934538/clickstream/clickstream-enwiki-2021-01.tsv.gz,Avicii,25021,224802,1437,251260,113650
hdfs://spark-nn.eemcs.utwente.nl/user/s1934538/clickstream/clickstream-enwiki-2021-01.tsv.gz,Russo-Ukrainian_War,21907,28268,115,50290,29780
hdfs://spark-nn.eemcs.utwente.nl/user/s1934538/clickstream/clickstream-enwiki-2021-01.tsv.gz,21_Savage,15491,76570,1224,93285,34489
hdfs://spark-nn.eemcs.utwente.nl/user/s1934538/clickstream/clickstream-enwiki-2021-01.tsv.gz,Lance_Reddick,54569,51485,218,106272,19555
hdfs://spark-nn.eemcs.utwente.nl/user/s1934538/clickstream/clickstream-enwiki-2021-01.tsv.gz,Carlos_Alcaraz,980,3100,79,4159,724
hdfs://spark-nn.eemcs.utwente.nl/user/s1934538/clickstream/clickstream-enwiki-2021-01.tsv.gz,Venom_(2018_film),28879,121533,2818,153230,82182
hdfs://spark-nn.eemcs.utwente.nl/user/s1934538/clickstream/clickstream-enwiki-2021-01.tsv.gz,2018_Winter_Olympics,30895,23411,322,54628,42549
hdfs://spark-nn.eemcs.utwente.nl/user/s1934538/clickstream/clickstream-enwiki-2021-01.tsv.gz,YouTube,165298,1397104,12417,1574819,151369
hdfs://spark-nn.eemcs.utwente.nl/user/s1934538/clickstream/clickstream-enwiki-2021-01.tsv.gz,Wikipedia,261147,1247297,2736,1511180,541968
hdfs://spark-nn.eemcs.utwente.nl/user/s1934538/clickstream/clickstream-enwiki-2021-01.tsv.gz,List_of_Queen_of_the_South_episodes,18279,14243,203,32725,865
hdfs://spark-nn.eemcs.utwente.nl/user/s1934538/clickstream/clickstream-enwiki-2021-01.tsv.gz,FIFA_World_Cup,34387,193482,1702,229571,124730
hdfs://spark-nn.eemcs.utwente.nl/user/s1934538/clickstream/clickstream-enwiki-2021-01.tsv.gz,Tina_Turner,28035,162695,1597,192327,65006
hdfs://spark-nn.eemcs.utwente.nl/user/s1934538/clickstream/clickstream-enwiki-2021-01.tsv.gz,Aaron_Hernandez,16611,250995,1144,268750,86886
hdfs://spark-nn.eemcs.utwente.nl/user/s1934538/clickstream/clickstream-enwiki-2021-01.tsv.gz,2023_Cricket_World_Cup,16734,27599,58,44391,15173
hdfs://spark-nn.eemcs.utwente.nl/user/s1934538/clickstream/clickstream-enwiki-2021-01.tsv.gz,The_Witcher_(TV_series),40002,229325,4758,274085,157044
hdfs://spark-nn.eemcs.utwente.nl/user/s1934538/clickstream/clickstream-enwiki-2021-01.tsv.gz,IPv4,11375,42637,148,54160,9497
hdfs://spark-nn.eemcs.utwente.nl/user/s1934538/clickstream/clickstream-enwiki-2021-01.tsv.gz,Salman_Rushdie,31984,69261,438,101683,44067
hdfs://spark-nn.eemcs.utwente.nl/user/s1934538/clickstream/clickstream-enwiki-2021-01.tsv.gz,Spanish_flu,56283,623970,8700,688953,146492
hdfs://spark-nn.eemcs.utwente.nl/user/s1934538/clickstream/clickstream-enwiki-2021-01.tsv.gz,Eternals_(film),157138,135914,884,293936,312620
hdfs://spark-nn.eemcs.utwente.nl/user/s1934538/clickstream/clickstream-enwiki-2021-01.tsv.gz,Shooting_of_Breonna_Taylor,7935,163131,370,171436,13083
hdfs://spark-nn.eemcs.utwente.nl/user/s1934538/clickstream/clickstream-enwiki-2021-01.tsv.gz,Bible,20495,4239939,2579,4263013,39642
hdfs://spark-nn.eemcs.utwente.nl/user/s1934538/clickstream/clickstream-enwiki-2021-01.tsv.gz,Deion_Sanders,17008,139639,749,157396,52200
hdfs://spark-nn.eemcs.utwente.nl/user/s1934538/clickstream/clickstream-enwiki-2021-01.tsv.gz,WandaVision,314726,4087544,88405,4490675,2387589
hdfs://spark-nn.eemcs.utwente.nl/user/s1934538/clickstream/clickstream-enwiki-2021-01.tsv.gz,David_Beckham,45889,216413,1440,263742,95553
hdfs://spark-nn.eemcs.utwente.nl/user/s1934538/clickstream/clickstream-enwiki-2021-01.tsv.gz,Puneeth_Rajkumar,12478,21325,301,34104,19009
hdfs://spark-nn.eemcs.utwente.nl/user/s1934538/clickstream/clickstream-enwiki-2021-01.tsv.gz,Bridgerton,341525,5464555,59080,5865160,4518008
hdfs://spark-nn.eemcs.utwente.nl/user/s1934538/clickstream/clickstream-enwiki-2021-01.tsv.gz,Joe_Exotic,50290,505355,3586,559231,146137
hdfs://spark-nn.eemcs.utwente.nl/user/s1934538/clickstream/clickstream-enwiki-2021-01.tsv.gz,Tom_Brady,223890,2068297,19776,2311963,876464
hdfs://spark-nn.eemcs.utwente.nl/user/s1934538/clickstream/clickstream-enwiki-2021-01.tsv.gz,Jeffrey_Dahmer,44668,380968,4563,430199,190628
hdfs://spark-nn.eemcs.utwente.nl/user/s1934538/clickstream/clickstream-enwiki-2021-01.tsv.gz,The_Queen's_Gambit_(miniseries),203518,1806367,15063,2024948,1078523
hdfs://spark-nn.eemcs.utwente.nl/user/s1934538/clickstream/clickstream-enwiki-2021-01.tsv.gz,Sushant_Singh_Rajput,35031,232084,985,268100,100098
hdfs://spark-nn.eemcs.utwente.nl/user/s1934538/clickstream/clickstream-enwiki-2021-01.tsv.gz,2022_FIFA_World_Cup,52374,99051,1420,152845,78431
hdfs://spark-nn.eemcs.utwente.nl/user/s1934538/clickstream/clickstream-enwiki-2021-01.tsv.gz,Army_of_the_Dead,44542,70711,1174,116427,80276
hdfs://spark-nn.eemcs.utwente.nl/user/s1934538/clickstream/clickstream-enwiki-2021-01.tsv.gz,XXXTentacion,70945,617385,6535,694865,112092
hdfs://spark-nn.eemcs.utwente.nl/user/s1934538/clickstream/clickstream-enwiki-2021-01.tsv.gz,Shakira,26044,224078,2178,252300,114251
hdfs://spark-nn.eemcs.utwente.nl/user/s1934538/clickstream/clickstream-enwiki-2021-01.tsv.gz,Crazy_Rich_Asians_(film),34539,133615,1329,169483,175044
hdfs://spark-nn.eemcs.utwente.nl/user/s1934538/clickstream/clickstream-enwiki-2021-01.tsv.gz,Jimmy_Hoffa,45181,207735,1752,254668,94328
hdfs://spark-nn.eemcs.utwente.nl/user/s1934538/clickstream/clickstream-enwiki-2021-01.tsv.gz,Don't_Look_Up_(2021_film),125676,183922,1068,310666,114550
hdfs://spark-nn.eemcs.utwente.nl/user/s1934538/clickstream/clickstream-enwiki-2021-01.tsv.gz,Nipsey_Hussle,30219,110671,1581,142471,45633
hdfs://spark-nn.eemcs.utwente.nl/user/s1934538/clickstream/clickstream-enwiki-2021-01.tsv.gz,Sylvester_Stallone,108473,340631,2712,451816,333650
hdfs://spark-nn.eemcs.utwente.nl/user/s1934538/clickstream/clickstream-enwiki-2021-01.tsv.gz,Aaron_Carter,19824,44843,287,64954,28023
hdfs://spark-nn.eemcs.utwente.nl/user/s1934538/clickstream/clickstream-enwiki-2021-01.tsv.gz,List_of_most_popular_websites,11749,60498,129,72376,25928
hdfs://spark-nn.eemcs.utwente.nl/user/s1934538/clickstream/clickstream-enwiki-2021-01.tsv.gz,Avengers:_Endgame,200462,355348,8101,563911,359493
hdfs://spark-nn.eemcs.utwente.nl/user/s1934538/clickstream/clickstream-enwiki-2021-01.tsv.gz,George_VI,703704,381966,4882,1090552,806418
hdfs://spark-nn.eemcs.utwente.nl/user/s1934538/clickstream/clickstream-enwiki-2021-01.tsv.gz,Sridevi,33689,85671,263,119623,53338
hdfs://spark-nn.eemcs.utwente.nl/user/s1934538/clickstream/clickstream-enwiki-2021-01.tsv.gz,Captain_Marvel_(film),100105,243461,3153,346719,195075
hdfs://spark-nn.eemcs.utwente.nl/user/s1934538/clickstream/clickstream-enwiki-2021-01.tsv.gz,A_Quiet_Place_(film),38613,112838,1043,152494,51257
hdfs://spark-nn.eemcs.utwente.nl/user/s1934538/clickstream/clickstream-enwiki-2021-01.tsv.gz,Stranger_Things_(season_4),37032,255262,845,293139,154777
hdfs://spark-nn.eemcs.utwente.nl/user/s1934538/clickstream/clickstream-enwiki-2021-01.tsv.gz,Henry_V_of_England,99653,136150,535,236338,164725
hdfs://spark-nn.eemcs.utwente.nl/user/s1934538/clickstream/clickstream-enwiki-2021-01.tsv.gz,NATO,54481,121178,1978,177637,65631
hdfs://spark-nn.eemcs.utwente.nl/user/s1934538/clickstream/clickstream-enwiki-2021-01.tsv.gz,Qasem_Soleimani,22848,106779,1102,130729,54382
hdfs://spark-nn.eemcs.utwente.nl/user/s1934538/clickstream/clickstream-enwiki-2021-01.tsv.gz,Stephen_Hawking,39190,560955,2762,602907,223569
hdfs://spark-nn.eemcs.utwente.nl/user/s1934538/clickstream/clickstream-enwiki-2021-01.tsv.gz,Juneteenth,4648,85566,271,90485,6216
hdfs://spark-nn.eemcs.utwente.nl/user/s1934538/clickstream/clickstream-enwiki-2021-01.tsv.gz,K.G.F:_Chapter_2,75696,853971,1387,931054,309152
hdfs://spark-nn.eemcs.utwente.nl/user/s1934538/clickstream/clickstream-enwiki-2021-01.tsv.gz,R._Kelly,42654,201674,2050,246378,103913
hdfs://spark-nn.eemcs.utwente.nl/user/s1934538/clickstream/clickstream-enwiki-2021-01.tsv.gz,Meat_Loaf,26859,95444,913,123216,45544
hdfs://spark-nn.eemcs.utwente.nl/user/s1934538/clickstream/clickstream-enwiki-2021-01.tsv.gz,Elizabeth_II,914620,1754578,2039,2671237,2242153
hdfs://spark-nn.eemcs.utwente.nl/user/s1934538/clickstream/clickstream-enwiki-2021-01.tsv.gz,It_Chapter_Two,32960,68283,627,101870,68207
hdfs://spark-nn.eemcs.utwente.nl/user/s1934538/clickstream/clickstream-enwiki-2021-01.tsv.gz,J._Robert_Oppenheimer,23891,92019,300,116210,38441
hdfs://spark-nn.eemcs.utwente.nl/user/s1934538/clickstream/clickstream-enwiki-2021-01.tsv.gz,Vladimir_Putin,153473,448176,8409,610058,398755
hdfs://spark-nn.eemcs.utwente.nl/user/s1934538/clickstream/clickstream-enwiki-2021-01.tsv.gz,Avengers:_Infinity_War,85193,134767,2177,222137,138057
hdfs://spark-nn.eemcs.utwente.nl/user/s1934538/clickstream/clickstream-enwiki-2021-01.tsv.gz,2020_United_States_presidential_election,637917,1092932,43184,1774033,1589876
hdfs://spark-nn.eemcs.utwente.nl/user/s1934538/clickstream/clickstream-enwiki-2021-01.tsv.gz,Betty_White,107589,1048514,13302,1169405,407764
hdfs://spark-nn.eemcs.utwente.nl/user/s1934538/clickstream/clickstream-enwiki-2021-01.tsv.gz,Naomi_Osaka,15640,73259,462,89361,25789
hdfs://spark-nn.eemcs.utwente.nl/user/s1934538/clickstream/clickstream-enwiki-2021-01.tsv.gz,Cricket_World_Cup,10176,67000,233,77409,40969
hdfs://spark-nn.eemcs.utwente.nl/user/s1934538/clickstream/clickstream-enwiki-2021-01.tsv.gz,Royal_Rumble_(2018),37451,31671,359,69481,45216
hdfs://spark-nn.eemcs.utwente.nl/user/s1934538/clickstream/clickstream-enwiki-2021-01.tsv.gz,Tunnel,3226,9766,102,13094,3313
hdfs://spark-nn.eemcs.utwente.nl/user/s1934538/clickstream/clickstream-enwiki-2021-01.tsv.gz,Atal_Bihari_Vajpayee,29327,55081,165,84573,26509
hdfs://spark-nn.eemcs.utwente.nl/user/s1934538/clickstream/clickstream-enwiki-2021-01.tsv.gz,Anna_Sorokin,13116,63172,162,76450,23090
hdfs://spark-nn.eemcs.utwente.nl/user/s1934538/clickstream/clickstream-enwiki-2021-01.tsv.gz,List_of_awards_and_nominations_received_by_Meryl_Streep,20123,15164,265,35552,12777
hdfs://spark-nn.eemcs.utwente.nl/user/s1934538/clickstream/clickstream-enwiki-2021-01.tsv.gz,Israel,94971,300434,7456,402861,184439
hdfs://spark-nn.eemcs.utwente.nl/user/s1934538/clickstream/clickstream-enwiki-2021-01.tsv.gz,Lisa_Marie_Presley,152914,86981,360,240255,124864
hdfs://spark-nn.eemcs.utwente.nl/user/s1934538/clickstream/clickstream-enwiki-2021-01.tsv.gz,Doctor_Strange_in_the_Multiverse_of_Madness,162262,114595,950,277807,177314
hdfs://spark-nn.eemcs.utwente.nl/user/s1934538/clickstream/clickstream-enwiki-2021-01.tsv.gz,United_States_Electoral_College,50847,175900,900,227647,37951
hdfs://spark-nn.eemcs.utwente.nl/user/s1934538/clickstream/clickstream-enwiki-2021-01.tsv.gz,Stranger_Things_(season_3),21009,55277,439,76725,41054
hdfs://spark-nn.eemcs.utwente.nl/user/s1934538/clickstream/clickstream-enwiki-2021-01.tsv.gz,Dune_(2021_film),87652,247761,3201,338614,199525
hdfs://spark-nn.eemcs.utwente.nl/user/s1934538/clickstream/clickstream-enwiki-2021-01.tsv.gz,Michael_Bloomberg,64913,53810,354,119077,56364
hdfs://spark-nn.eemcs.utwente.nl/user/s1934538/clickstream/clickstream-enwiki-2021-01.tsv.gz,Cameron_Boyce,40956,192114,787,233857,67137
hdfs://spark-nn.eemcs.utwente.nl/user/s1934538/clickstream/clickstream-enwiki-2021-01.tsv.gz,Priyanka_Chopra,201594,479481,1983,683058,256586
hdfs://spark-nn.eemcs.utwente.nl/user/s1934538/clickstream/clickstream-enwiki-2021-01.tsv.gz,The_Weeknd,140977,931741,8015,1080733,341917
hdfs://spark-nn.eemcs.utwente.nl/user/s1934538/clickstream/clickstream-enwiki-2021-01.tsv.gz,Laal_Singh_Chaddha,25570,34037,6948,66555,34448
hdfs://spark-nn.eemcs.utwente.nl/user/s1934538/clickstream/clickstream-enwiki-2021-01.tsv.gz,Fyre_Festival,9779,63757,405,73941,43294
hdfs://spark-nn.eemcs.utwente.nl/user/s1934538/clickstream/clickstream-enwiki-2021-01.tsv.gz,Simone_Biles,14656,88334,740,103730,31744
hdfs://spark-nn.eemcs.utwente.nl/user/s1934538/clickstream/clickstream-enwiki-2021-01.tsv.gz,Once_Upon_a_Time_in_Hollywood,119519,216995,2789,339303,338990
hdfs://spark-nn.eemcs.utwente.nl/user/s1934538/clickstream/clickstream-enwiki-2021-01.tsv.gz,Tenet_(film),155378,1131505,12046,1298929,663608
hdfs://spark-nn.eemcs.utwente.nl/user/s1934538/clickstream/clickstream-enwiki-2021-01.tsv.gz,Gaza_Strip,18794,36021,212,55027,22015
hdfs://spark-nn.eemcs.utwente.nl/user/s1934538/clickstream/clickstream-enwiki-2021-01.tsv.gz,Aretha_Franklin,34455,193044,1408,228907,82493
hdfs://spark-nn.eemcs.utwente.nl/user/s1934538/clickstream/clickstream-enwiki-2021-01.tsv.gz,The_Shape_of_Water,32280,78992,968,112240,51752
hdfs://spark-nn.eemcs.utwente.nl/user/s1934538/clickstream/clickstream-enwiki-2021-01.tsv.gz,Glass_(2019_film),74826,79085,511,154422,50318
hdfs://spark-nn.eemcs.utwente.nl/user/s1934538/clickstream/clickstream-enwiki-2021-01.tsv.gz,Luke_Perry,49098,249807,760,299665,91628
hdfs://spark-nn.eemcs.utwente.nl/user/s1934538/clickstream/clickstream-enwiki-2021-01.tsv.gz,"Prince_Philip,_Duke_of_Edinburgh",578760,844220,6349,1429329,895409
hdfs://spark-nn.eemcs.utwente.nl/user/s1934538/clickstream/clickstream-enwiki-2021-01.tsv.gz,Kylian_Mbappé,26849,136382,1463,164694,31142
hdfs://spark-nn.eemcs.utwente.nl/user/s1934538/clickstream/clickstream-enwiki-2021-01.tsv.gz,Kobe_Bryant_sexual_assault_case,9111,55634,95,64840,4595
hdfs://spark-nn.eemcs.utwente.nl/user/s1934538/clickstream/clickstream-enwiki-2021-01.tsv.gz,Deaths_in_2021,1854441,2111366,14570,3980377,2647836
hdfs://spark-nn.eemcs.utwente.nl/user/s1934538/clickstream/clickstream-enwiki-2021-01.tsv.gz,Anne_Heche,44816,126670,529,172015,58332
hdfs://spark-nn.eemcs.utwente.nl/user/s1934538/clickstream/clickstream-enwiki-2021-01.tsv.gz,Parasite_(2019_film),56529,352205,3080,411814,172325
hdfs://spark-nn.eemcs.utwente.nl/user/s1934538/clickstream/clickstream-enwiki-2021-01.tsv.gz,Media,52,3715,340,4107,1823
hdfs://spark-nn.eemcs.utwente.nl/user/s1934538/clickstream/clickstream-enwiki-2021-01.tsv.gz,Asia_Cup,1802,32169,81,34052,17067
hdfs://spark-nn.eemcs.utwente.nl/user/s1934538/clickstream/clickstream-enwiki-2021-01.tsv.gz,Khabib_Nurmagomedov,235098,513320,3663,752081,406629
hdfs://spark-nn.eemcs.utwente.nl/user/s1934538/clickstream/clickstream-enwiki-2021-01.tsv.gz,List_of_James_Bond_films,71911,555405,859,628175,377285
hdfs://spark-nn.eemcs.utwente.nl/user/s1934538/clickstream/clickstream-enwiki-2021-01.tsv.gz,Chernobyl_disaster,71252,407139,3609,482000,204366
hdfs://spark-nn.eemcs.utwente.nl/user/s1934538/clickstream/clickstream-enwiki-2021-01.tsv.gz,Pornhub,43252,511874,17066,572192,119720
hdfs://spark-nn.eemcs.utwente.nl/user/s1934538/clickstream/clickstream-enwiki-2021-01.tsv.gz,September_11_attacks,108518,314095,3575,426188,196387
hdfs://spark-nn.eemcs.utwente.nl/user/s1934538/clickstream/clickstream-enwiki-2021-01.tsv.gz,Fantastic_Beasts:_The_Crimes_of_Grindelwald,66563,164831,1663,233057,148367
hdfs://spark-nn.eemcs.utwente.nl/user/s1934538/clickstream/clickstream-enwiki-2021-01.tsv.gz,Sushma_Swaraj,5554,17579,46,23179,5858
hdfs://spark-nn.eemcs.utwente.nl/user/s1934538/clickstream/clickstream-enwiki-2021-01.tsv.gz,Kate_Spade,38486,64941,289,103716,37970
hdfs://spark-nn.eemcs.utwente.nl/user/s1934538/clickstream/clickstream-enwiki-2021-01.tsv.gz,Joaquin_Phoenix,152161,229208,1135,382504,234124
hdfs://spark-nn.eemcs.utwente.nl/user/s1934538/clickstream/clickstream-enwiki-2021-01.tsv.gz,List_of_highest-grossing_films,125245,247652,1089,373986,200394
hdfs://spark-nn.eemcs.utwente.nl/user/s1934538/clickstream/clickstream-enwiki-2021-01.tsv.gz,Google_logo,1160,18938,15,20113,1179
hdfs://spark-nn.eemcs.utwente.nl/user/s1934538/clickstream/clickstream-enwiki-2021-01.tsv.gz,Queen_(band),50663,164800,2180,217643,205113
hdfs://spark-nn.eemcs.utwente.nl/user/s1934538/clickstream/clickstream-enwiki-2021-01.tsv.gz,Coronavirus,25553,386253,5021,416827,98979
hdfs://spark-nn.eemcs.utwente.nl/user/s1934538/clickstream/clickstream-enwiki-2021-01.tsv.gz,Cleopatra,51147,3032997,2304,3086448,254417
hdfs://spark-nn.eemcs.utwente.nl/user/s1934538/clickstream/clickstream-enwiki-2021-01.tsv.gz,Indian_Premier_League,19019,81962,107,101088,64855
hdfs://spark-nn.eemcs.utwente.nl/user/s1934538/clickstream/clickstream-enwiki-2021-01.tsv.gz,Spider-Man:_Far_From_Home,83774,136343,3458,223575,129722
hdfs://spark-nn.eemcs.utwente.nl/user/s1934538/clickstream/clickstream-enwiki-2021-01.tsv.gz,Richard_Ramirez,176129,5133191,22707,5332027,1581137
hdfs://spark-nn.eemcs.utwente.nl/user/s1934538/clickstream/clickstream-enwiki-2021-01.tsv.gz,Lionel_Messi,88650,480804,5774,575228,119072
hdfs://spark-nn.eemcs.utwente.nl/user/s1934538/clickstream/clickstream-enwiki-2021-01.tsv.gz,Richard_Jewell,75355,512574,1850,589779,205677
hdfs://spark-nn.eemcs.utwente.nl/user/s1934538/clickstream/clickstream-enwiki-2021-01.tsv.gz,ICC_Men's_T20_World_Cup,8419,97183,162,105764,47120
hdfs://spark-nn.eemcs.utwente.nl/user/s1934538/clickstream/clickstream-enwiki-2021-01.tsv.gz,Kamala_Harris,1106280,4847884,69804,6023968,3205547
hdfs://spark-nn.eemcs.utwente.nl/user/s1934538/clickstream/clickstream-enwiki-2021-01.tsv.gz,Notre-Dame_de_Paris,13165,79073,777,93015,20310
hdfs://spark-nn.eemcs.utwente.nl/user/s1934538/clickstream/clickstream-enwiki-2021-01.tsv.gz,Elon_Musk,321401,4150340,26120,4497861,2740009
hdfs://spark-nn.eemcs.utwente.nl/user/s1934538/clickstream/clickstream-enwiki-2021-01.tsv.gz,Juice_Wrld,44927,369371,5461,419759,141472
hdfs://spark-nn.eemcs.utwente.nl/user/s1934538/clickstream/clickstream-enwiki-2021-01.tsv.gz,"Citizenship_(Amendment)_Act,_2019",5197,39879,145,45221,4600
hdfs://spark-nn.eemcs.utwente.nl/user/s1934538/clickstream/clickstream-enwiki-2021-01.tsv.gz,Charles_III,240,316,56,612,434
hdfs://spark-nn.eemcs.utwente.nl/user/s1934538/clickstream/clickstream-enwiki-2021-01.tsv.gz,Matthew_Perry,93114,188720,972,282806,154287
hdfs://spark-nn.eemcs.utwente.nl/user/s1934538/clickstream/clickstream-enwiki-2021-01.tsv.gz,Stan_Lee,61578,187670,1465,250713,66705
hdfs://spark-nn.eemcs.utwente.nl/user/s1934538/clickstream/clickstream-enwiki-2021-01.tsv.gz,Joker_(2019_film),61877,206427,2538,270842,127852
hdfs://spark-nn.eemcs.utwente.nl/user/s1934538/clickstream/clickstream-enwiki-2021-01.tsv.gz,Chadwick_Boseman,97865,448322,5763,551950,154668
hdfs://spark-nn.eemcs.utwente.nl/user/s1934538/clickstream/clickstream-enwiki-2021-01.tsv.gz,John_McCain,97664,208382,2277,308323,156471
hdfs://spark-nn.eemcs.utwente.nl/user/s1934538/clickstream/clickstream-enwiki-2021-01.tsv.gz,Critical_race_theory,11384,169880,1016,182280,33811
hdfs://spark-nn.eemcs.utwente.nl/user/s1934538/clickstream/clickstream-enwiki-2021-01.tsv.gz,XXX:_Return_of_Xander_Cage,39669,587018,831,627518,83425
hdfs://spark-nn.eemcs.utwente.nl/user/s1934538/clickstream/clickstream-enwiki-2021-01.tsv.gz,Anthony_Bourdain,26030,221344,1444,248818,77338
hdfs://spark-nn.eemcs.utwente.nl/user/s1934538/clickstream/clickstream-enwiki-2021-01.tsv.gz,Kelly_Preston,126667,235424,1237,363328,97242
hdfs://spark-nn.eemcs.utwente.nl/user/s1934538/clickstream/clickstream-enwiki-2021-01.tsv.gz,Irrfan_Khan,37380,107529,281,145190,47687
hdfs://spark-nn.eemcs.utwente.nl/user/s1934538/clickstream/clickstream-enwiki-2021-01.tsv.gz,Cristiano_Ronaldo,126425,850080,6706,983211,229420
hdfs://spark-nn.eemcs.utwente.nl/user/s1934538/clickstream/clickstream-enwiki-2021-04.tsv.gz,Glass_(2019_film),57516,133304,1255,192075,78505
hdfs://spark-nn.eemcs.utwente.nl/user/s1934538/clickstream/clickstream-enwiki-2021-04.tsv.gz,"Meghan,_Duchess_of_Sussex",288447,530106,4875,823428,415428
hdfs://spark-nn.eemcs.utwente.nl/user/s1934538/clickstream/clickstream-enwiki-2021-04.tsv.gz,Stranger_Things_(season_3),18376,41022,441,59839,34241
hdfs://spark-nn.eemcs.utwente.nl/user/s1934538/clickstream/clickstream-enwiki-2021-04.tsv.gz,RRR_(film),44231,114210,333,158774,106458
hdfs://spark-nn.eemcs.utwente.nl/user/s1934538/clickstream/clickstream-enwiki-2021-04.tsv.gz,Kylian_Mbappé,41834,286355,2620,330809,72833
hdfs://spark-nn.eemcs.utwente.nl/user/s1934538/clickstream/clickstream-enwiki-2021-04.tsv.gz,Kobe_Bryant_sexual_assault_case,6167,26576,56,32799,2913
hdfs://spark-nn.eemcs.utwente.nl/user/s1934538/clickstream/clickstream-enwiki-2021-04.tsv.gz,The_Queen's_Gambit_(miniseries),55090,337772,3122,395984,212041
hdfs://spark-nn.eemcs.utwente.nl/user/s1934538/clickstream/clickstream-enwiki-2021-04.tsv.gz,2.0_(film),20870,28437,47,49354,17081
hdfs://spark-nn.eemcs.utwente.nl/user/s1934538/clickstream/clickstream-enwiki-2021-04.tsv.gz,Russo-Ukrainian_War,43474,186790,842,231106,131393
hdfs://spark-nn.eemcs.utwente.nl/user/s1934538/clickstream/clickstream-enwiki-2021-04.tsv.gz,William_Murdoch,613,1251,22,1886,346
hdfs://spark-nn.eemcs.utwente.nl/user/s1934538/clickstream/clickstream-enwiki-2021-04.tsv.gz,Mulan_(2020_film),33259,105618,2217,141094,85740
hdfs://spark-nn.eemcs.utwente.nl/user/s1934538/clickstream/clickstream-enwiki-2021-04.tsv.gz,Dark_Phoenix_(film),52515,60320,711,113546,67982
hdfs://spark-nn.eemcs.utwente.nl/user/s1934538/clickstream/clickstream-enwiki-2021-04.tsv.gz,Laal_Singh_Chaddha,29875,35317,501,65693,28252
hdfs://spark-nn.eemcs.utwente.nl/user/s1934538/clickstream/clickstream-enwiki-2021-04.tsv.gz,Sylvester_Stallone,127882,353778,2912,484572,373504
hdfs://spark-nn.eemcs.utwente.nl/user/s1934538/clickstream/clickstream-enwiki-2021-04.tsv.gz,Main_Page,70297,172782439,5161228,178013964,38401823
hdfs://spark-nn.eemcs.utwente.nl/user/s1934538/clickstream/clickstream-enwiki-2021-04.tsv.gz,QAnon,84850,526362,4825,616037,154675
hdfs://spark-nn.eemcs.utwente.nl/user/s1934538/clickstream/clickstream-enwiki-2021-04.tsv.gz,Tom_Brady,68805,276162,4057,349024,130569
hdfs://spark-nn.eemcs.utwente.nl/user/s1934538/clickstream/clickstream-enwiki-2021-04.tsv.gz,Pornhub,41191,345694,14854,401739,101725
hdfs://spark-nn.eemcs.utwente.nl/user/s1934538/clickstream/clickstream-enwiki-2021-04.tsv.gz,Richard_Ramirez,26510,425974,2217,454701,126904
hdfs://spark-nn.eemcs.utwente.nl/user/s1934538/clickstream/clickstream-enwiki-2021-04.tsv.gz,Avengers:_Endgame,191242,298513,5970,495725,317716
hdfs://spark-nn.eemcs.utwente.nl/user/s1934538/clickstream/clickstream-enwiki-2021-04.tsv.gz,YouTube,157893,836479,11889,1006261,140079
hdfs://spark-nn.eemcs.utwente.nl/user/s1934538/clickstream/clickstream-enwiki-2021-04.tsv.gz,Ray_Liotta,38134,48592,386,87112,31182
hdfs://spark-nn.eemcs.utwente.nl/user/s1934538/clickstream/clickstream-enwiki-2021-04.tsv.gz,Lionel_Messi,96714,485630,6522,588866,154654
hdfs://spark-nn.eemcs.utwente.nl/user/s1934538/clickstream/clickstream-enwiki-2021-04.tsv.gz,Sridevi,38061,97555,275,135891,60379
hdfs://spark-nn.eemcs.utwente.nl/user/s1934538/clickstream/clickstream-enwiki-2021-04.tsv.gz,Area_51,15750,224107,1411,241268,43846
hdfs://spark-nn.eemcs.utwente.nl/user/s1934538/clickstream/clickstream-enwiki-2021-04.tsv.gz,Jimmy_Hoffa,30675,118703,1098,150476,57532
hdfs://spark-nn.eemcs.utwente.nl/user/s1934538/clickstream/clickstream-enwiki-2021-04.tsv.gz,Bonnie_and_Clyde,25377,216815,1715,243907,62976
hdfs://spark-nn.eemcs.utwente.nl/user/s1934538/clickstream/clickstream-enwiki-2021-04.tsv.gz,Elliot_Page,95832,486673,3822,586327,252043
hdfs://spark-nn.eemcs.utwente.nl/user/s1934538/clickstream/clickstream-enwiki-2021-04.tsv.gz,Queen_(band),83845,279313,3947,367105,339930
hdfs://spark-nn.eemcs.utwente.nl/user/s1934538/clickstream/clickstream-enwiki-2021-04.tsv.gz,Joe_Biden,364809,704939,17008,1086756,621353
hdfs://spark-nn.eemcs.utwente.nl/user/s1934538/clickstream/clickstream-enwiki-2021-04.tsv.gz,Israel,110767,305284,7344,423395,212592
hdfs://spark-nn.eemcs.utwente.nl/user/s1934538/clickstream/clickstream-enwiki-2021-04.tsv.gz,The_Weeknd,64614,256519,3196,324329,137301
hdfs://spark-nn.eemcs.utwente.nl/user/s1934538/clickstream/clickstream-enwiki-2021-04.tsv.gz,The_Irishman,55565,101812,2257,159634,131472
hdfs://spark-nn.eemcs.utwente.nl/user/s1934538/clickstream/clickstream-enwiki-2021-04.tsv.gz,R._Kelly,54974,176254,1857,233085,107352
hdfs://spark-nn.eemcs.utwente.nl/user/s1934538/clickstream/clickstream-enwiki-2021-04.tsv.gz,Naya_Rivera,93081,180865,1131,275077,108322
hdfs://spark-nn.eemcs.utwente.nl/user/s1934538/clickstream/clickstream-enwiki-2021-04.tsv.gz,Ruth_Bader_Ginsburg,24145,114422,835,139402,47231
hdfs://spark-nn.eemcs.utwente.nl/user/s1934538/clickstream/clickstream-enwiki-2021-04.tsv.gz,ICC_Men's_T20_World_Cup,10348,116191,265,126804,59968
hdfs://spark-nn.eemcs.utwente.nl/user/s1934538/clickstream/clickstream-enwiki-2021-04.tsv.gz,Tina_Turner,57508,686283,6304,750095,272636
hdfs://spark-nn.eemcs.utwente.nl/user/s1934538/clickstream/clickstream-enwiki-2021-04.tsv.gz,Saaho,17448,42443,119,60010,21693
hdfs://spark-nn.eemcs.utwente.nl/user/s1934538/clickstream/clickstream-enwiki-2021-04.tsv.gz,Us_(2019_film),37835,144361,826,183022,62914
hdfs://spark-nn.eemcs.utwente.nl/user/s1934538/clickstream/clickstream-enwiki-2021-04.tsv.gz,J._Robert_Oppenheimer,23410,82858,1360,107628,36916
hdfs://spark-nn.eemcs.utwente.nl/user/s1934538/clickstream/clickstream-enwiki-2021-04.tsv.gz,2016_United_States_presidential_election,157301,100019,1615,258935,237161
hdfs://spark-nn.eemcs.utwente.nl/user/s1934538/clickstream/clickstream-enwiki-2021-04.tsv.gz,Kelly_Preston,120443,274336,1635,396414,110270
hdfs://spark-nn.eemcs.utwente.nl/user/s1934538/clickstream/clickstream-enwiki-2021-04.tsv.gz,Anne_Heche,26459,59248,407,86114,31257
hdfs://spark-nn.eemcs.utwente.nl/user/s1934538/clickstream/clickstream-enwiki-2021-04.tsv.gz,Hamas,27837,30086,296,58219,24915
hdfs://spark-nn.eemcs.utwente.nl/user/s1934538/clickstream/clickstream-enwiki-2021-04.tsv.gz,Sidharth_Shukla,9362,25802,335,35499,10893
hdfs://spark-nn.eemcs.utwente.nl/user/s1934538/clickstream/clickstream-enwiki-2021-04.tsv.gz,When_They_See_Us,19200,43524,309,63033,29825
hdfs://spark-nn.eemcs.utwente.nl/user/s1934538/clickstream/clickstream-enwiki-2021-04.tsv.gz,Bird_Box_(film),21628,78761,768,101157,32241
hdfs://spark-nn.eemcs.utwente.nl/user/s1934538/clickstream/clickstream-enwiki-2021-04.tsv.gz,Jeffrey_Epstein,62818,258542,2354,323714,148480
hdfs://spark-nn.eemcs.utwente.nl/user/s1934538/clickstream/clickstream-enwiki-2021-04.tsv.gz,Spanish_flu,55241,426951,4916,487108,105894
hdfs://spark-nn.eemcs.utwente.nl/user/s1934538/clickstream/clickstream-enwiki-2021-04.tsv.gz,Stranger_Things_(season_4),46000,129241,1083,176324,101670
hdfs://spark-nn.eemcs.utwente.nl/user/s1934538/clickstream/clickstream-enwiki-2021-04.tsv.gz,War_(2019_film),15424,45335,234,60993,18493
hdfs://spark-nn.eemcs.utwente.nl/user/s1934538/clickstream/clickstream-enwiki-2021-04.tsv.gz,The_Shape_of_Water,35458,86842,1202,123502,59195
hdfs://spark-nn.eemcs.utwente.nl/user/s1934538/clickstream/clickstream-enwiki-2021-04.tsv.gz,Key_frame,708,5391,14,6113,508
hdfs://spark-nn.eemcs.utwente.nl/user/s1934538/clickstream/clickstream-enwiki-2021-04.tsv.gz,Johnny_Depp,163466,374011,2972,540449,401161
hdfs://spark-nn.eemcs.utwente.nl/user/s1934538/clickstream/clickstream-enwiki-2021-04.tsv.gz,Spider-Man:_No_Way_Home,268652,265556,4367,538575,305855
hdfs://spark-nn.eemcs.utwente.nl/user/s1934538/clickstream/clickstream-enwiki-2021-04.tsv.gz,Joaquin_Phoenix,134315,221726,2987,359028,221985
hdfs://spark-nn.eemcs.utwente.nl/user/s1934538/clickstream/clickstream-enwiki-2021-04.tsv.gz,Aaron_Carter,21738,61158,347,83243,32322
hdfs://spark-nn.eemcs.utwente.nl/user/s1934538/clickstream/clickstream-enwiki-2021-04.tsv.gz,Afghanistan,75293,184105,4345,263743,159759
hdfs://spark-nn.eemcs.utwente.nl/user/s1934538/clickstream/clickstream-enwiki-2021-04.tsv.gz,Olivia_Newton-John,36327,114333,1268,151928,64943
hdfs://spark-nn.eemcs.utwente.nl/user/s1934538/clickstream/clickstream-enwiki-2021-04.tsv.gz,2018_FIFA_World_Cup,90340,100406,1468,192214,124026
hdfs://spark-nn.eemcs.utwente.nl/user/s1934538/clickstream/clickstream-enwiki-2021-04.tsv.gz,Matthew_Perry,71977,142274,713,214964,115643
hdfs://spark-nn.eemcs.utwente.nl/user/s1934538/clickstream/clickstream-enwiki-2021-04.tsv.gz,Irrfan_Khan,45233,143936,411,189580,67410
hdfs://spark-nn.eemcs.utwente.nl/user/s1934538/clickstream/clickstream-enwiki-2021-04.tsv.gz,Juice_Wrld,39953,277925,5507,323385,113513
hdfs://spark-nn.eemcs.utwente.nl/user/s1934538/clickstream/clickstream-enwiki-2021-04.tsv.gz,Death_of_Elisa_Lam,33106,175028,627,208761,48650
hdfs://spark-nn.eemcs.utwente.nl/user/s1934538/clickstream/clickstream-enwiki-2021-04.tsv.gz,1917_(2019_film),29803,105628,2221,137652,75507
hdfs://spark-nn.eemcs.utwente.nl/user/s1934538/clickstream/clickstream-enwiki-2021-04.tsv.gz,Taliban,46249,135395,1681,183325,128746
hdfs://spark-nn.eemcs.utwente.nl/user/s1934538/clickstream/clickstream-enwiki-2021-04.tsv.gz,Once_Upon_a_Time_in_Hollywood,115412,191587,4243,311242,281645
hdfs://spark-nn.eemcs.utwente.nl/user/s1934538/clickstream/clickstream-enwiki-2021-04.tsv.gz,Anna_Sorokin,10651,73845,329,84825,23418
hdfs://spark-nn.eemcs.utwente.nl/user/s1934538/clickstream/clickstream-enwiki-2021-04.tsv.gz,Amy_Coney_Barrett,33179,50435,461,84075,28665
hdfs://spark-nn.eemcs.utwente.nl/user/s1934538/clickstream/clickstream-enwiki-2021-04.tsv.gz,United_States_Electoral_College,14804,46832,417,62053,9556
hdfs://spark-nn.eemcs.utwente.nl/user/s1934538/clickstream/clickstream-enwiki-2021-04.tsv.gz,Cameron_Boyce,42186,215729,1048,258963,65522
hdfs://spark-nn.eemcs.utwente.nl/user/s1934538/clickstream/clickstream-enwiki-2021-04.tsv.gz,Deadpool_2,62316,76154,2966,141436,109601
hdfs://spark-nn.eemcs.utwente.nl/user/s1934538/clickstream/clickstream-enwiki-2021-04.tsv.gz,Kenosha_unrest_shooting,14853,192078,989,207920,33153
hdfs://spark-nn.eemcs.utwente.nl/user/s1934538/clickstream/clickstream-enwiki-2021-04.tsv.gz,Salman_Rushdie,39299,75820,472,115591,47713
hdfs://spark-nn.eemcs.utwente.nl/user/s1934538/clickstream/clickstream-enwiki-2021-04.tsv.gz,Jimmy_Buffett,10214,56483,955,67652,26200
hdfs://spark-nn.eemcs.utwente.nl/user/s1934538/clickstream/clickstream-enwiki-2021-04.tsv.gz,Jason_Momoa,106042,332581,2279,440902,205240
hdfs://spark-nn.eemcs.utwente.nl/user/s1934538/clickstream/clickstream-enwiki-2021-04.tsv.gz,Cricket_World_Cup,10628,83753,273,94654,49443
hdfs://spark-nn.eemcs.utwente.nl/user/s1934538/clickstream/clickstream-enwiki-2021-04.tsv.gz,Critical_race_theory,10039,496511,3492,510042,85764
hdfs://spark-nn.eemcs.utwente.nl/user/s1934538/clickstream/clickstream-enwiki-2021-04.tsv.gz,Google_logo,1195,3085554,25,3086774,1489
hdfs://spark-nn.eemcs.utwente.nl/user/s1934538/clickstream/clickstream-enwiki-2021-04.tsv.gz,Captain_Marvel_(film),61097,160283,2851,224231,135115
hdfs://spark-nn.eemcs.utwente.nl/user/s1934538/clickstream/clickstream-enwiki-2021-04.tsv.gz,2018_Asian_Games,7289,7274,59,14622,14367
hdfs://spark-nn.eemcs.utwente.nl/user/s1934538/clickstream/clickstream-enwiki-2021-04.tsv.gz,Central_Park_jogger_case,20761,69283,171,90215,13034
hdfs://spark-nn.eemcs.utwente.nl/user/s1934538/clickstream/clickstream-enwiki-2021-04.tsv.gz,House_of_the_Dragon,29166,15944,847,45957,31697
hdfs://spark-nn.eemcs.utwente.nl/user/s1934538/clickstream/clickstream-enwiki-2021-04.tsv.gz,Aretha_Franklin,60206,480527,3637,544370,262955
hdfs://spark-nn.eemcs.utwente.nl/user/s1934538/clickstream/clickstream-enwiki-2021-04.tsv.gz,George_H._W._Bush,172283,127865,2013,302161,180047
hdfs://spark-nn.eemcs.utwente.nl/user/s1934538/clickstream/clickstream-enwiki-2021-04.tsv.gz,Hamilton_(musical),42356,212468,2099,256923,169690
hdfs://spark-nn.eemcs.utwente.nl/user/s1934538/clickstream/clickstream-enwiki-2021-04.tsv.gz,Watts_family_murders,20582,223489,384,244455,60901
hdfs://spark-nn.eemcs.utwente.nl/user/s1934538/clickstream/clickstream-enwiki-2021-04.tsv.gz,Mötley_Crüe,35434,109714,1517,146665,160721
hdfs://spark-nn.eemcs.utwente.nl/user/s1934538/clickstream/clickstream-enwiki-2021-04.tsv.gz,Dennis_Nilsen,12967,60119,390,73476,18875
hdfs://spark-nn.eemcs.utwente.nl/user/s1934538/clickstream/clickstream-enwiki-2021-04.tsv.gz,Chernobyl_disaster,96334,531004,6675,634013,271748
hdfs://spark-nn.eemcs.utwente.nl/user/s1934538/clickstream/clickstream-enwiki-2021-04.tsv.gz,Atal_Bihari_Vajpayee,36167,49439,130,85736,31298
hdfs://spark-nn.eemcs.utwente.nl/user/s1934538/clickstream/clickstream-enwiki-2021-04.tsv.gz,Bridgerton,63026,522766,8716,594508,420023
hdfs://spark-nn.eemcs.utwente.nl/user/s1934538/clickstream/clickstream-enwiki-2021-04.tsv.gz,Keanu_Reeves,104615,585005,4001,693621,395101
hdfs://spark-nn.eemcs.utwente.nl/user/s1934538/clickstream/clickstream-enwiki-2021-04.tsv.gz,List_of_Marvel_Cinematic_Universe_films,190988,928341,1881,1121210,556949
hdfs://spark-nn.eemcs.utwente.nl/user/s1934538/clickstream/clickstream-enwiki-2021-04.tsv.gz,Sinéad_O'Connor,15510,86059,743,102312,32497
hdfs://spark-nn.eemcs.utwente.nl/user/s1934538/clickstream/clickstream-enwiki-2021-04.tsv.gz,"Diana,_Princess_of_Wales",734178,1151121,9420,1894719,1231235
hdfs://spark-nn.eemcs.utwente.nl/user/s1934538/clickstream/clickstream-enwiki-2021-04.tsv.gz,Lance_Reddick,70602,54039,248,124889,22229
hdfs://spark-nn.eemcs.utwente.nl/user/s1934538/clickstream/clickstream-enwiki-2021-04.tsv.gz,Everything_Everywhere_All_at_Once,4656,924,909,6489,2143
hdfs://spark-nn.eemcs.utwente.nl/user/s1934538/clickstream/clickstream-enwiki-2021-04.tsv.gz,Black_Widow_(2021_film),187345,263219,6177,456741,273302
hdfs://spark-nn.eemcs.utwente.nl/user/s1934538/clickstream/clickstream-enwiki-2021-04.tsv.gz,XXXTentacion,64014,459416,6072,529502,97511
hdfs://spark-nn.eemcs.utwente.nl/user/s1934538/clickstream/clickstream-enwiki-2021-04.tsv.gz,Deaths_in_2021,1624741,2410411,23409,4058561,2461953
hdfs://spark-nn.eemcs.utwente.nl/user/s1934538/clickstream/clickstream-enwiki-2021-04.tsv.gz,The_Sandman_(TV_series),15151,13625,162,28938,19742
hdfs://spark-nn.eemcs.utwente.nl/user/s1934538/clickstream/clickstream-enwiki-2021-04.tsv.gz,Wikipedia,248036,960944,1459,1210439,425171
hdfs://spark-nn.eemcs.utwente.nl/user/s1934538/clickstream/clickstream-enwiki-2021-04.tsv.gz,Michael_Jordan,117871,547130,6270,671271,255440
hdfs://spark-nn.eemcs.utwente.nl/user/s1934538/clickstream/clickstream-enwiki-2021-04.tsv.gz,Bible,21934,3612281,2220,3636435,44155
hdfs://spark-nn.eemcs.utwente.nl/user/s1934538/clickstream/clickstream-enwiki-2021-04.tsv.gz,Alexander_Hamilton,77183,245430,2163,324776,173313
hdfs://spark-nn.eemcs.utwente.nl/user/s1934538/clickstream/clickstream-enwiki-2021-04.tsv.gz,Pelé,31302,116611,1154,149067,49388
hdfs://spark-nn.eemcs.utwente.nl/user/s1934538/clickstream/clickstream-enwiki-2021-04.tsv.gz,Bipin_Rawat,8680,17371,29,26080,13061
hdfs://spark-nn.eemcs.utwente.nl/user/s1934538/clickstream/clickstream-enwiki-2021-04.tsv.gz,Adele,23146,128713,1743,153602,55588
hdfs://spark-nn.eemcs.utwente.nl/user/s1934538/clickstream/clickstream-enwiki-2021-04.tsv.gz,Louis_Tomlinson,34650,67737,462,102849,24130
hdfs://spark-nn.eemcs.utwente.nl/user/s1934538/clickstream/clickstream-enwiki-2021-04.tsv.gz,Brie_Larson,90328,265696,1997,358021,136425
hdfs://spark-nn.eemcs.utwente.nl/user/s1934538/clickstream/clickstream-enwiki-2021-04.tsv.gz,Valentine's_Day,3528,27370,232,31130,3174
hdfs://spark-nn.eemcs.utwente.nl/user/s1934538/clickstream/clickstream-enwiki-2021-04.tsv.gz,Notre-Dame_de_Paris,14187,84894,1110,100191,26873
hdfs://spark-nn.eemcs.utwente.nl/user/s1934538/clickstream/clickstream-enwiki-2021-04.tsv.gz,Shinzo_Abe,41040,41036,4764,86840,54465
hdfs://spark-nn.eemcs.utwente.nl/user/s1934538/clickstream/clickstream-enwiki-2021-04.tsv.gz,Tenet_(film),110773,558401,5566,674740,332156
hdfs://spark-nn.eemcs.utwente.nl/user/s1934538/clickstream/clickstream-enwiki-2021-04.tsv.gz,Charles_III,224,363,140,727,662
hdfs://spark-nn.eemcs.utwente.nl/user/s1934538/clickstream/clickstream-enwiki-2021-04.tsv.gz,No_Time_to_Die,173562,151287,2630,327479,176042
hdfs://spark-nn.eemcs.utwente.nl/user/s1934538/clickstream/clickstream-enwiki-2021-04.tsv.gz,Vivek_Ramaswamy,902,4775,13,5690,1202
hdfs://spark-nn.eemcs.utwente.nl/user/s1934538/clickstream/clickstream-enwiki-2021-04.tsv.gz,A_Quiet_Place_(film),29195,88427,942,118564,40510
hdfs://spark-nn.eemcs.utwente.nl/user/s1934538/clickstream/clickstream-enwiki-2021-04.tsv.gz,"Citizenship_(Amendment)_Act,_2019",5575,30863,28,36466,4500
hdfs://spark-nn.eemcs.utwente.nl/user/s1934538/clickstream/clickstream-enwiki-2021-04.tsv.gz,Stephen_Hawking,40316,394207,3128,437651,180990
hdfs://spark-nn.eemcs.utwente.nl/user/s1934538/clickstream/clickstream-enwiki-2021-04.tsv.gz,The_Mandalorian,72623,244419,4987,322029,231783
hdfs://spark-nn.eemcs.utwente.nl/user/s1934538/clickstream/clickstream-enwiki-2021-04.tsv.gz,Coronavirus,22452,288288,5210,315950,85745
hdfs://spark-nn.eemcs.utwente.nl/user/s1934538/clickstream/clickstream-enwiki-2021-04.tsv.gz,Royal_Rumble_(2018),9613,6085,126,15824,11951
hdfs://spark-nn.eemcs.utwente.nl/user/s1934538/clickstream/clickstream-enwiki-2021-04.tsv.gz,Shakira,24211,173677,1901,199789,90428
hdfs://spark-nn.eemcs.utwente.nl/user/s1934538/clickstream/clickstream-enwiki-2021-04.tsv.gz,Parasite_(2019_film),52322,255677,3403,311402,128197
hdfs://spark-nn.eemcs.utwente.nl/user/s1934538/clickstream/clickstream-enwiki-2021-04.tsv.gz,Vladimir_Putin,125857,394409,6506,526772,317108
hdfs://spark-nn.eemcs.utwente.nl/user/s1934538/clickstream/clickstream-enwiki-2021-04.tsv.gz,The_Haunting_of_Bly_Manor,23714,76200,642,100556,48682
hdfs://spark-nn.eemcs.utwente.nl/user/s1934538/clickstream/clickstream-enwiki-2021-04.tsv.gz,Fantastic_Beasts:_The_Crimes_of_Grindelwald,46297,58258,745,105300,63745
hdfs://spark-nn.eemcs.utwente.nl/user/s1934538/clickstream/clickstream-enwiki-2021-04.tsv.gz,Ted_Bundy,43268,393866,5139,442273,102462
hdfs://spark-nn.eemcs.utwente.nl/user/s1934538/clickstream/clickstream-enwiki-2021-04.tsv.gz,Tunnel,3586,10401,97,14084,3820
hdfs://spark-nn.eemcs.utwente.nl/user/s1934538/clickstream/clickstream-enwiki-2021-04.tsv.gz,XXX:_Return_of_Xander_Cage,40853,362501,648,404002,61135
hdfs://spark-nn.eemcs.utwente.nl/user/s1934538/clickstream/clickstream-enwiki-2021-04.tsv.gz,Ghislaine_Maxwell,61089,135418,904,197411,88273
hdfs://spark-nn.eemcs.utwente.nl/user/s1934538/clickstream/clickstream-enwiki-2021-04.tsv.gz,State_of_Palestine,51894,111029,217,163140,77480
hdfs://spark-nn.eemcs.utwente.nl/user/s1934538/clickstream/clickstream-enwiki-2021-04.tsv.gz,Rami_Malek,80239,222185,927,303351,131251
hdfs://spark-nn.eemcs.utwente.nl/user/s1934538/clickstream/clickstream-enwiki-2021-04.tsv.gz,FIFA_World_Cup,51475,195441,2745,249661,169070
hdfs://spark-nn.eemcs.utwente.nl/user/s1934538/clickstream/clickstream-enwiki-2021-04.tsv.gz,K.G.F:_Chapter_2,24270,81508,304,106082,44463
hdfs://spark-nn.eemcs.utwente.nl/user/s1934538/clickstream/clickstream-enwiki-2021-04.tsv.gz,Top_Gun:_Maverick,68930,93987,2686,165603,105267
hdfs://spark-nn.eemcs.utwente.nl/user/s1934538/clickstream/clickstream-enwiki-2021-04.tsv.gz,The_Lion_King_(2019_film),46466,57870,552,104888,55289
hdfs://spark-nn.eemcs.utwente.nl/user/s1934538/clickstream/clickstream-enwiki-2021-04.tsv.gz,Kobe_Bryant,64725,350025,4801,419551,122045
hdfs://spark-nn.eemcs.utwente.nl/user/s1934538/clickstream/clickstream-enwiki-2021-04.tsv.gz,Black_Panther_(film),141741,202270,4891,348902,224661
hdfs://spark-nn.eemcs.utwente.nl/user/s1934538/clickstream/clickstream-enwiki-2021-04.tsv.gz,Sushma_Swaraj,7162,20984,101,28247,7819
hdfs://spark-nn.eemcs.utwente.nl/user/s1934538/clickstream/clickstream-enwiki-2021-04.tsv.gz,Cecil_Hotel_(Los_Angeles),14701,160294,551,175546,44509
hdfs://spark-nn.eemcs.utwente.nl/user/s1934538/clickstream/clickstream-enwiki-2021-04.tsv.gz,Nipsey_Hussle,31713,153587,1205,186505,55921
hdfs://spark-nn.eemcs.utwente.nl/user/s1934538/clickstream/clickstream-enwiki-2021-04.tsv.gz,Article_370_of_the_Constitution_of_India,2537,30926,17,33480,2481
hdfs://spark-nn.eemcs.utwente.nl/user/s1934538/clickstream/clickstream-enwiki-2021-04.tsv.gz,DMX_(rapper),294078,8362926,93417,8750421,2018006
hdfs://spark-nn.eemcs.utwente.nl/user/s1934538/clickstream/clickstream-enwiki-2021-04.tsv.gz,Deion_Sanders,11381,120179,1051,132611,44140
hdfs://spark-nn.eemcs.utwente.nl/user/s1934538/clickstream/clickstream-enwiki-2021-04.tsv.gz,List_of_FIFA_World_Cup_finals,3777,59549,75,63401,21270
hdfs://spark-nn.eemcs.utwente.nl/user/s1934538/clickstream/clickstream-enwiki-2021-04.tsv.gz,WrestleMania_34,60197,40128,384,100709,66883
hdfs://spark-nn.eemcs.utwente.nl/user/s1934538/clickstream/clickstream-enwiki-2021-04.tsv.gz,Rishi_Sunak,18057,49414,258,67729,29622
hdfs://spark-nn.eemcs.utwente.nl/user/s1934538/clickstream/clickstream-enwiki-2021-04.tsv.gz,List_of_Queen_of_the_South_episodes,33717,22260,243,56220,2069
hdfs://spark-nn.eemcs.utwente.nl/user/s1934538/clickstream/clickstream-enwiki-2021-04.tsv.gz,Avicii,25889,284115,2112,312116,143159
hdfs://spark-nn.eemcs.utwente.nl/user/s1934538/clickstream/clickstream-enwiki-2021-04.tsv.gz,Godzilla_vs._Kong,448920,3872469,73768,4395157,2398509
hdfs://spark-nn.eemcs.utwente.nl/user/s1934538/clickstream/clickstream-enwiki-2021-04.tsv.gz,Roe_v._Wade,14096,96434,881,111411,32980
hdfs://spark-nn.eemcs.utwente.nl/user/s1934538/clickstream/clickstream-enwiki-2021-04.tsv.gz,Carlos_Alcaraz,1171,11529,63,12763,2315
hdfs://spark-nn.eemcs.utwente.nl/user/s1934538/clickstream/clickstream-enwiki-2021-04.tsv.gz,Elon_Musk,168270,1421858,12370,1602498,859737
hdfs://spark-nn.eemcs.utwente.nl/user/s1934538/clickstream/clickstream-enwiki-2021-04.tsv.gz,Manti_Te'o,3599,18008,81,21688,2412
hdfs://spark-nn.eemcs.utwente.nl/user/s1934538/clickstream/clickstream-enwiki-2021-04.tsv.gz,Cook's_Country,507,3183,31,3721,1110
hdfs://spark-nn.eemcs.utwente.nl/user/s1934538/clickstream/clickstream-enwiki-2021-04.tsv.gz,Ant-Man_and_the_Wasp:_Quantumania,110150,28925,129,139204,109556
hdfs://spark-nn.eemcs.utwente.nl/user/s1934538/clickstream/clickstream-enwiki-2021-04.tsv.gz,Sushant_Singh_Rajput,32916,131039,880,164835,72257
hdfs://spark-nn.eemcs.utwente.nl/user/s1934538/clickstream/clickstream-enwiki-2022-06.tsv.gz,Sylvester_Stallone,83693,223304,2149,309146,228579
hdfs://spark-nn.eemcs.utwente.nl/user/s1934538/clickstream/clickstream-enwiki-2022-06.tsv.gz,Spider-Man:_Across_the_Spider-Verse,73300,38746,726,112772,59362
hdfs://spark-nn.eemcs.utwente.nl/user/s1934538/clickstream/clickstream-enwiki-2022-06.tsv.gz,Chernobyl_disaster,43260,242305,2916,288481,123984
hdfs://spark-nn.eemcs.utwente.nl/user/s1934538/clickstream/clickstream-enwiki-2022-06.tsv.gz,Doctor_Strange_in_the_Multiverse_of_Madness,427403,2316158,47113,2790674,1529064
hdfs://spark-nn.eemcs.utwente.nl/user/s1934538/clickstream/clickstream-enwiki-2022-06.tsv.gz,Eternals_(film),85099,175409,3986,264494,234446
hdfs://spark-nn.eemcs.utwente.nl/user/s1934538/clickstream/clickstream-enwiki-2022-06.tsv.gz,Bipin_Rawat,10361,31871,24,42256,16413
hdfs://spark-nn.eemcs.utwente.nl/user/s1934538/clickstream/clickstream-enwiki-2022-06.tsv.gz,Salman_Rushdie,26646,61026,394,88066,38474
hdfs://spark-nn.eemcs.utwente.nl/user/s1934538/clickstream/clickstream-enwiki-2022-06.tsv.gz,"Citizenship_(Amendment)_Act,_2019",2629,18450,23,21102,2444
hdfs://spark-nn.eemcs.utwente.nl/user/s1934538/clickstream/clickstream-enwiki-2022-06.tsv.gz,Puneeth_Rajkumar,16004,59139,723,75866,32769
hdfs://spark-nn.eemcs.utwente.nl/user/s1934538/clickstream/clickstream-enwiki-2022-06.tsv.gz,Elon_Musk,173787,1573115,17478,1764380,1042974
hdfs://spark-nn.eemcs.utwente.nl/user/s1934538/clickstream/clickstream-enwiki-2022-06.tsv.gz,Joe_Biden,192573,552632,10272,755477,342063
hdfs://spark-nn.eemcs.utwente.nl/user/s1934538/clickstream/clickstream-enwiki-2022-06.tsv.gz,Cook's_Country,326,1388,27,1741,516
hdfs://spark-nn.eemcs.utwente.nl/user/s1934538/clickstream/clickstream-enwiki-2022-06.tsv.gz,Jenna_Ortega,77567,157342,1881,236790,92081
hdfs://spark-nn.eemcs.utwente.nl/user/s1934538/clickstream/clickstream-enwiki-2022-06.tsv.gz,Jason_Momoa,80214,289054,2295,371563,149807
hdfs://spark-nn.eemcs.utwente.nl/user/s1934538/clickstream/clickstream-enwiki-2022-06.tsv.gz,List_of_awards_and_nominations_received_by_Meryl_Streep,6441,9006,37,15484,6300
hdfs://spark-nn.eemcs.utwente.nl/user/s1934538/clickstream/clickstream-enwiki-2022-06.tsv.gz,Black_Panther:_Wakanda_Forever,137354,99670,4610,241634,203731
hdfs://spark-nn.eemcs.utwente.nl/user/s1934538/clickstream/clickstream-enwiki-2022-06.tsv.gz,1917_(2019_film),18527,112115,2350,132992,75247
hdfs://spark-nn.eemcs.utwente.nl/user/s1934538/clickstream/clickstream-enwiki-2022-06.tsv.gz,Jurassic_World_Dominion,600722,2882026,102891,3585639,2147907
hdfs://spark-nn.eemcs.utwente.nl/user/s1934538/clickstream/clickstream-enwiki-2022-06.tsv.gz,George_H._W._Bush,159704,104420,1155,265279,155875
hdfs://spark-nn.eemcs.utwente.nl/user/s1934538/clickstream/clickstream-enwiki-2022-06.tsv.gz,Bible,14994,1683222,1633,1699849,28048
hdfs://spark-nn.eemcs.utwente.nl/user/s1934538/clickstream/clickstream-enwiki-2022-06.tsv.gz,The_Witcher_(TV_series),22584,128578,3125,154287,86353
hdfs://spark-nn.eemcs.utwente.nl/user/s1934538/clickstream/clickstream-enwiki-2022-06.tsv.gz,Meat_Loaf,20585,105690,1229,127504,42291
hdfs://spark-nn.eemcs.utwente.nl/user/s1934538/clickstream/clickstream-enwiki-2022-06.tsv.gz,Stranger_Things,780620,3068651,68782,3918053,4223346
hdfs://spark-nn.eemcs.utwente.nl/user/s1934538/clickstream/clickstream-enwiki-2022-06.tsv.gz,Thor:_Love_and_Thunder,226191,865335,27194,1118720,525291
hdfs://spark-nn.eemcs.utwente.nl/user/s1934538/clickstream/clickstream-enwiki-2022-06.tsv.gz,Jimmy_Buffett,10661,57143,746,68550,26172
hdfs://spark-nn.eemcs.utwente.nl/user/s1934538/clickstream/clickstream-enwiki-2022-06.tsv.gz,Michael_Jordan,116852,510600,5631,633083,224284
hdfs://spark-nn.eemcs.utwente.nl/user/s1934538/clickstream/clickstream-enwiki-2022-06.tsv.gz,YouTube,122872,3016672,9289,3148833,108719
hdfs://spark-nn.eemcs.utwente.nl/user/s1934538/clickstream/clickstream-enwiki-2022-06.tsv.gz,Chernobyl_(miniseries),16581,64594,1300,82475,72865
hdfs://spark-nn.eemcs.utwente.nl/user/s1934538/clickstream/clickstream-enwiki-2022-06.tsv.gz,Star_Wars:_The_Rise_of_Skywalker,145558,107165,2431,255154,144088
hdfs://spark-nn.eemcs.utwente.nl/user/s1934538/clickstream/clickstream-enwiki-2022-06.tsv.gz,War_(2019_film),31760,37377,53,69190,19056
hdfs://spark-nn.eemcs.utwente.nl/user/s1934538/clickstream/clickstream-enwiki-2022-06.tsv.gz,The_Umbrella_Academy_(TV_series),164343,1400074,38765,1603182,1344218
hdfs://spark-nn.eemcs.utwente.nl/user/s1934538/clickstream/clickstream-enwiki-2022-06.tsv.gz,Loki_(TV_series),40253,90979,2233,133465,83363
hdfs://spark-nn.eemcs.utwente.nl/user/s1934538/clickstream/clickstream-enwiki-2022-06.tsv.gz,The_Batman_(film),153664,426833,10935,591432,317431
hdfs://spark-nn.eemcs.utwente.nl/user/s1934538/clickstream/clickstream-enwiki-2022-06.tsv.gz,The_Sandman_(TV_series),38585,122651,2427,163663,182040
hdfs://spark-nn.eemcs.utwente.nl/user/s1934538/clickstream/clickstream-enwiki-2022-06.tsv.gz,XHamster,9376,319724,5609,334709,32049
hdfs://spark-nn.eemcs.utwente.nl/user/s1934538/clickstream/clickstream-enwiki-2022-06.tsv.gz,Central_Park_jogger_case,10303,37580,132,48015,7044
hdfs://spark-nn.eemcs.utwente.nl/user/s1934538/clickstream/clickstream-enwiki-2022-06.tsv.gz,Stan_Lee,39103,142890,784,182777,46310
hdfs://spark-nn.eemcs.utwente.nl/user/s1934538/clickstream/clickstream-enwiki-2022-06.tsv.gz,Amy_Coney_Barrett,162862,230392,1334,394588,121967
hdfs://spark-nn.eemcs.utwente.nl/user/s1934538/clickstream/clickstream-enwiki-2022-06.tsv.gz,WrestleMania_34,11788,6328,180,18296,11956
hdfs://spark-nn.eemcs.utwente.nl/user/s1934538/clickstream/clickstream-enwiki-2022-06.tsv.gz,Nipsey_Hussle,20321,133475,1005,154801,52077
hdfs://spark-nn.eemcs.utwente.nl/user/s1934538/clickstream/clickstream-enwiki-2022-06.tsv.gz,Ted_Bundy,30429,309594,4441,344464,92726
hdfs://spark-nn.eemcs.utwente.nl/user/s1934538/clickstream/clickstream-enwiki-2022-06.tsv.gz,Cristiano_Ronaldo,128253,807210,6090,941553,238651
hdfs://spark-nn.eemcs.utwente.nl/user/s1934538/clickstream/clickstream-enwiki-2022-06.tsv.gz,Cricket_World_Cup,13057,73738,440,87235,63559
hdfs://spark-nn.eemcs.utwente.nl/user/s1934538/clickstream/clickstream-enwiki-2022-06.tsv.gz,Tasuku_Honjo,890,32505,11,33406,1603
hdfs://spark-nn.eemcs.utwente.nl/user/s1934538/clickstream/clickstream-enwiki-2022-06.tsv.gz,House_of_the_Dragon,36411,124990,2085,163486,123782
hdfs://spark-nn.eemcs.utwente.nl/user/s1934538/clickstream/clickstream-enwiki-2022-06.tsv.gz,Shakira,78635,959388,7908,1045931,510733
hdfs://spark-nn.eemcs.utwente.nl/user/s1934538/clickstream/clickstream-enwiki-2022-06.tsv.gz,2018_Asian_Games,8509,6732,36,15277,16791
hdfs://spark-nn.eemcs.utwente.nl/user/s1934538/clickstream/clickstream-enwiki-2022-06.tsv.gz,Keanu_Reeves,98711,463529,3093,565333,358835
hdfs://spark-nn.eemcs.utwente.nl/user/s1934538/clickstream/clickstream-enwiki-2022-06.tsv.gz,No_Time_to_Die,138971,442715,9316,591002,410585
hdfs://spark-nn.eemcs.utwente.nl/user/s1934538/clickstream/clickstream-enwiki-2022-06.tsv.gz,Lists_of_deaths_by_year,3263,183465,733,187461,203351
hdfs://spark-nn.eemcs.utwente.nl/user/s1934538/clickstream/clickstream-enwiki-2022-06.tsv.gz,Adipurush,53680,40096,306,94082,76768
hdfs://spark-nn.eemcs.utwente.nl/user/s1934538/clickstream/clickstream-enwiki-2022-06.tsv.gz,Spider-Man:_Far_From_Home,55198,65763,911,121872,54864
hdfs://spark-nn.eemcs.utwente.nl/user/s1934538/clickstream/clickstream-enwiki-2022-06.tsv.gz,Microsoft_Office,6322,2163457,690,2170469,17092
hdfs://spark-nn.eemcs.utwente.nl/user/s1934538/clickstream/clickstream-enwiki-2022-06.tsv.gz,Mötley_Crüe,38576,141925,2170,182671,220502
hdfs://spark-nn.eemcs.utwente.nl/user/s1934538/clickstream/clickstream-enwiki-2022-06.tsv.gz,Pornhub,51715,343906,13387,409008,81549
hdfs://spark-nn.eemcs.utwente.nl/user/s1934538/clickstream/clickstream-enwiki-2022-06.tsv.gz,Anna_Sorokin,41235,359470,1531,402236,154102
hdfs://spark-nn.eemcs.utwente.nl/user/s1934538/clickstream/clickstream-enwiki-2022-06.tsv.gz,Burt_Reynolds,53716,136498,1294,191508,93501
hdfs://spark-nn.eemcs.utwente.nl/user/s1934538/clickstream/clickstream-enwiki-2022-06.tsv.gz,Indian_Premier_League,21194,87780,6637,115611,69247
hdfs://spark-nn.eemcs.utwente.nl/user/s1934538/clickstream/clickstream-enwiki-2022-06.tsv.gz,Dark_Phoenix_(film),35961,32849,455,69265,38197
hdfs://spark-nn.eemcs.utwente.nl/user/s1934538/clickstream/clickstream-enwiki-2022-06.tsv.gz,WandaVision,74789,161476,2567,238832,116329
hdfs://spark-nn.eemcs.utwente.nl/user/s1934538/clickstream/clickstream-enwiki-2022-06.tsv.gz,JSON_Web_Token,646,26184,46,26876,1946
hdfs://spark-nn.eemcs.utwente.nl/user/s1934538/clickstream/clickstream-enwiki-2022-06.tsv.gz,Game_of_Thrones,75438,241345,6724,323507,221913
hdfs://spark-nn.eemcs.utwente.nl/user/s1934538/clickstream/clickstream-enwiki-2022-06.tsv.gz,Tom_Brady,53756,211897,2139,267792,103226
hdfs://spark-nn.eemcs.utwente.nl/user/s1934538/clickstream/clickstream-enwiki-2022-06.tsv.gz,Bird_Box_(film),28981,53711,1042,83734,29693
hdfs://spark-nn.eemcs.utwente.nl/user/s1934538/clickstream/clickstream-enwiki-2022-06.tsv.gz,It_Chapter_Two,49224,75580,719,125523,91471
hdfs://spark-nn.eemcs.utwente.nl/user/s1934538/clickstream/clickstream-enwiki-2022-06.tsv.gz,Avatar:_The_Way_of_Water,82941,137531,2409,222881,124593
hdfs://spark-nn.eemcs.utwente.nl/user/s1934538/clickstream/clickstream-enwiki-2022-06.tsv.gz,Hamas,20918,23247,275,44440,19869
hdfs://spark-nn.eemcs.utwente.nl/user/s1934538/clickstream/clickstream-enwiki-2022-06.tsv.gz,The_Shape_of_Water,18147,36205,451,54803,25124
hdfs://spark-nn.eemcs.utwente.nl/user/s1934538/clickstream/clickstream-enwiki-2022-06.tsv.gz,"Meghan,_Duchess_of_Sussex",115739,300890,2064,418693,248599
hdfs://spark-nn.eemcs.utwente.nl/user/s1934538/clickstream/clickstream-enwiki-2022-06.tsv.gz,Richard_Ramirez,15421,169372,1564,186357,56540
hdfs://spark-nn.eemcs.utwente.nl/user/s1934538/clickstream/clickstream-enwiki-2022-06.tsv.gz,Tina_Turner,19369,155269,1658,176296,56802
hdfs://spark-nn.eemcs.utwente.nl/user/s1934538/clickstream/clickstream-enwiki-2022-06.tsv.gz,Grover,1089,3713,69,4871,1114
hdfs://spark-nn.eemcs.utwente.nl/user/s1934538/clickstream/clickstream-enwiki-2022-06.tsv.gz,Sidharth_Shukla,7127,43099,170,50396,9285
hdfs://spark-nn.eemcs.utwente.nl/user/s1934538/clickstream/clickstream-enwiki-2022-06.tsv.gz,2018_FIFA_World_Cup,149321,157406,1876,308603,191995
hdfs://spark-nn.eemcs.utwente.nl/user/s1934538/clickstream/clickstream-enwiki-2022-06.tsv.gz,Aretha_Franklin,39649,413030,2610,455289,233960
hdfs://spark-nn.eemcs.utwente.nl/user/s1934538/clickstream/clickstream-enwiki-2022-06.tsv.gz,Dune_(2021_film),112357,233704,5802,351863,240969
hdfs://spark-nn.eemcs.utwente.nl/user/s1934538/clickstream/clickstream-enwiki-2022-06.tsv.gz,FIFA_World_Cup,92916,369624,8965,471505,263460
hdfs://spark-nn.eemcs.utwente.nl/user/s1934538/clickstream/clickstream-enwiki-2022-06.tsv.gz,Rishi_Sunak,14787,44215,317,59319,28853
hdfs://spark-nn.eemcs.utwente.nl/user/s1934538/clickstream/clickstream-enwiki-2022-06.tsv.gz,Kamala_Harris,75315,147552,1313,224180,99694
hdfs://spark-nn.eemcs.utwente.nl/user/s1934538/clickstream/clickstream-enwiki-2022-06.tsv.gz,Spanish_flu,17102,62623,613,80338,21502
hdfs://spark-nn.eemcs.utwente.nl/user/s1934538/clickstream/clickstream-enwiki-2022-06.tsv.gz,Notre-Dame_de_Paris,12771,72575,3579,88925,18389
hdfs://spark-nn.eemcs.utwente.nl/user/s1934538/clickstream/clickstream-enwiki-2022-06.tsv.gz,When_They_See_Us,7673,20572,153,28398,14479
hdfs://spark-nn.eemcs.utwente.nl/user/s1934538/clickstream/clickstream-enwiki-2022-06.tsv.gz,Richard_Jewell,9809,36832,212,46853,18089
hdfs://spark-nn.eemcs.utwente.nl/user/s1934538/clickstream/clickstream-enwiki-2022-06.tsv.gz,HTTP_cookie,2453,235567,103,238123,19456
hdfs://spark-nn.eemcs.utwente.nl/user/s1934538/clickstream/clickstream-enwiki-2022-06.tsv.gz,Saaho,37550,34298,132,71980,19554
hdfs://spark-nn.eemcs.utwente.nl/user/s1934538/clickstream/clickstream-enwiki-2022-06.tsv.gz,Afghanistan,123444,216515,4989,344948,252860
hdfs://spark-nn.eemcs.utwente.nl/user/s1934538/clickstream/clickstream-enwiki-2022-06.tsv.gz,Henry_V_of_England,76121,80439,391,156951,115350
hdfs://spark-nn.eemcs.utwente.nl/user/s1934538/clickstream/clickstream-enwiki-2022-06.tsv.gz,List_of_James_Bond_films,94121,437669,2579,534369,320550
hdfs://spark-nn.eemcs.utwente.nl/user/s1934538/clickstream/clickstream-enwiki-2022-06.tsv.gz,Kylian_Mbappé,35611,202348,1872,239831,58398
hdfs://spark-nn.eemcs.utwente.nl/user/s1934538/clickstream/clickstream-enwiki-2022-06.tsv.gz,Stephen_Hawking,27624,299389,2358,329371,135620
hdfs://spark-nn.eemcs.utwente.nl/user/s1934538/clickstream/clickstream-enwiki-2022-06.tsv.gz,Aaron_Hernandez,7228,72899,466,80593,31402
hdfs://spark-nn.eemcs.utwente.nl/user/s1934538/clickstream/clickstream-enwiki-2022-06.tsv.gz,2022_FIFA_World_Cup,337647,1177087,27907,1542641,1112035
hdfs://spark-nn.eemcs.utwente.nl/user/s1934538/clickstream/clickstream-enwiki-2022-06.tsv.gz,QAnon,38613,143415,1221,183249,59108
hdfs://spark-nn.eemcs.utwente.nl/user/s1934538/clickstream/clickstream-enwiki-2022-06.tsv.gz,Bonnie_and_Clyde,19259,145744,1140,166143,47137
hdfs://spark-nn.eemcs.utwente.nl/user/s1934538/clickstream/clickstream-enwiki-2022-06.tsv.gz,Stranger_Things_(season_3),288247,415778,4622,708647,387204
hdfs://spark-nn.eemcs.utwente.nl/user/s1934538/clickstream/clickstream-enwiki-2022-06.tsv.gz,R._Kelly,37634,729446,9979,777059,456042
hdfs://spark-nn.eemcs.utwente.nl/user/s1934538/clickstream/clickstream-enwiki-2022-06.tsv.gz,Ponniyin_Selvan:_I,76909,76610,322,153841,142341
hdfs://spark-nn.eemcs.utwente.nl/user/s1934538/clickstream/clickstream-enwiki-2022-06.tsv.gz,Priyanka_Chopra,78536,196177,696,275409,103833
hdfs://spark-nn.eemcs.utwente.nl/user/s1934538/clickstream/clickstream-enwiki-2022-06.tsv.gz,Juice_Wrld,34963,176447,2718,214128,89413
hdfs://spark-nn.eemcs.utwente.nl/user/s1934538/clickstream/clickstream-enwiki-2022-06.tsv.gz,Cameron_Boyce,24837,156773,656,182266,48940
hdfs://spark-nn.eemcs.utwente.nl/user/s1934538/clickstream/clickstream-enwiki-2022-06.tsv.gz,List_of_highest-grossing_films,173403,503489,15850,692742,340340
hdfs://spark-nn.eemcs.utwente.nl/user/s1934538/clickstream/clickstream-enwiki-2022-06.tsv.gz,Avengers:_Endgame,103202,147217,3303,253722,143187
hdfs://spark-nn.eemcs.utwente.nl/user/s1934538/clickstream/clickstream-enwiki-2022-06.tsv.gz,Key_frame,529,3865,13,4407,323
hdfs://spark-nn.eemcs.utwente.nl/user/s1934538/clickstream/clickstream-enwiki-2022-06.tsv.gz,Once_Upon_a_Time_in_Hollywood,111353,133453,2759,247565,241418
hdfs://spark-nn.eemcs.utwente.nl/user/s1934538/clickstream/clickstream-enwiki-2022-06.tsv.gz,Wonder_Woman_1984,32589,42499,1120,76208,36806
hdfs://spark-nn.eemcs.utwente.nl/user/s1934538/clickstream/clickstream-enwiki-2022-06.tsv.gz,Kate_Spade,24229,62146,371,86746,31008
hdfs://spark-nn.eemcs.utwente.nl/user/s1934538/clickstream/clickstream-enwiki-2022-06.tsv.gz,The_Mandalorian,100445,209360,3893,313698,237767
hdfs://spark-nn.eemcs.utwente.nl/user/s1934538/clickstream/clickstream-enwiki-2022-06.tsv.gz,Oppenheimer_(film),141084,57432,1038,199554,190090
hdfs://spark-nn.eemcs.utwente.nl/user/s1934538/clickstream/clickstream-enwiki-2022-06.tsv.gz,Elliot_Page,159682,1108165,4672,1272519,538501
hdfs://spark-nn.eemcs.utwente.nl/user/s1934538/clickstream/clickstream-enwiki-2022-06.tsv.gz,Shang-Chi_and_the_Legend_of_the_Ten_Rings,76486,124279,2010,202775,121317
hdfs://spark-nn.eemcs.utwente.nl/user/s1934538/clickstream/clickstream-enwiki-2022-06.tsv.gz,Rami_Malek,75300,182700,882,258882,118450
hdfs://spark-nn.eemcs.utwente.nl/user/s1934538/clickstream/clickstream-enwiki-2022-06.tsv.gz,Greta_Thunberg,14180,112172,1077,127429,30906
hdfs://spark-nn.eemcs.utwente.nl/user/s1934538/clickstream/clickstream-enwiki-2022-06.tsv.gz,Alexander_Hamilton,64718,177687,1786,244191,124714
hdfs://spark-nn.eemcs.utwente.nl/user/s1934538/clickstream/clickstream-enwiki-2022-06.tsv.gz,Amber_Heard,423873,2934685,26671,3385229,1608767
hdfs://spark-nn.eemcs.utwente.nl/user/s1934538/clickstream/clickstream-enwiki-2022-06.tsv.gz,Naya_Rivera,59640,116284,541,176465,78351
hdfs://spark-nn.eemcs.utwente.nl/user/s1934538/clickstream/clickstream-enwiki-2022-06.tsv.gz,Jimmy_Hoffa,32752,117730,1137,151619,63637
hdfs://spark-nn.eemcs.utwente.nl/user/s1934538/clickstream/clickstream-enwiki-2022-06.tsv.gz,Sushma_Swaraj,8496,15818,120,24434,6690
hdfs://spark-nn.eemcs.utwente.nl/user/s1934538/clickstream/clickstream-enwiki-2022-06.tsv.gz,A_Star_Is_Born_(2018_film),23325,62792,502,86619,40291
hdfs://spark-nn.eemcs.utwente.nl/user/s1934538/clickstream/clickstream-enwiki-2022-06.tsv.gz,Gaza_Strip,14563,26629,258,41450,15825
hdfs://spark-nn.eemcs.utwente.nl/user/s1934538/clickstream/clickstream-enwiki-2022-06.tsv.gz,Charles_III,155,261,118,534,469
hdfs://spark-nn.eemcs.utwente.nl/user/s1934538/clickstream/clickstream-enwiki-2022-06.tsv.gz,State_of_Palestine,42058,89088,117,131263,62688
hdfs://spark-nn.eemcs.utwente.nl/user/s1934538/clickstream/clickstream-enwiki-2022-06.tsv.gz,Tonya_Harding,13181,44110,284,57575,15206
hdfs://spark-nn.eemcs.utwente.nl/user/s1934538/clickstream/clickstream-enwiki-2022-06.tsv.gz,Avengers:_Infinity_War,51725,64728,1076,117529,66166
hdfs://spark-nn.eemcs.utwente.nl/user/s1934538/clickstream/clickstream-enwiki-2022-06.tsv.gz,Avicii,17222,168690,1453,187365,54037
hdfs://spark-nn.eemcs.utwente.nl/user/s1934538/clickstream/clickstream-enwiki-2022-06.tsv.gz,Sinéad_O'Connor,14210,72212,656,87078,27777
hdfs://spark-nn.eemcs.utwente.nl/user/s1934538/clickstream/clickstream-enwiki-2022-06.tsv.gz,The_Last_of_Us_(TV_series),38027,65590,582,104199,82884
hdfs://spark-nn.eemcs.utwente.nl/user/s1934538/clickstream/clickstream-enwiki-2022-06.tsv.gz,Ant-Man_and_the_Wasp:_Quantumania,82359,33215,224,115798,71003
hdfs://spark-nn.eemcs.utwente.nl/user/s1934538/clickstream/clickstream-enwiki-2022-06.tsv.gz,Jeffrey_Epstein,81430,319770,2137,403337,205333
hdfs://spark-nn.eemcs.utwente.nl/user/s1934538/clickstream/clickstream-enwiki-2022-06.tsv.gz,Lisa_Marie_Presley,521380,465148,1240,987768,612588
hdfs://spark-nn.eemcs.utwente.nl/user/s1934538/clickstream/clickstream-enwiki-2022-06.tsv.gz,Critical_race_theory,15803,146018,997,162818,20070
hdfs://spark-nn.eemcs.utwente.nl/user/s1934538/clickstream/clickstream-enwiki-2022-06.tsv.gz,Watts_family_murders,10546,191774,351,202671,56225
hdfs://spark-nn.eemcs.utwente.nl/user/s1934538/clickstream/clickstream-enwiki-2022-06.tsv.gz,Volodymyr_Zelenskyy,91995,201762,2066,295823,143412
hdfs://spark-nn.eemcs.utwente.nl/user/s1934538/clickstream/clickstream-enwiki-2022-06.tsv.gz,Barbie_(film),127328,323962,2396,453686,454685
hdfs://spark-nn.eemcs.utwente.nl/user/s1934538/clickstream/clickstream-enwiki-2022-06.tsv.gz,Mortal_Kombat_(2021_film),19276,53977,916,74169,62709
hdfs://spark-nn.eemcs.utwente.nl/user/s1934538/clickstream/clickstream-enwiki-2022-06.tsv.gz,Game_of_Thrones_(season_8),15507,34811,541,50859,18931
hdfs://spark-nn.eemcs.utwente.nl/user/s1934538/clickstream/clickstream-enwiki-2022-06.tsv.gz,Antifa_(United_States),12897,91997,353,105247,17975
hdfs://spark-nn.eemcs.utwente.nl/user/s1934538/clickstream/clickstream-enwiki-2022-06.tsv.gz,Olivia_Newton-John,22894,70670,876,94440,44246
hdfs://spark-nn.eemcs.utwente.nl/user/s1934538/clickstream/clickstream-enwiki-2022-06.tsv.gz,2020_United_States_presidential_election,142368,217609,5158,365135,331035
hdfs://spark-nn.eemcs.utwente.nl/user/s1934538/clickstream/clickstream-enwiki-2022-06.tsv.gz,Article_370_of_the_Constitution_of_India,4150,72810,63,77023,3629
hdfs://spark-nn.eemcs.utwente.nl/user/s1934538/clickstream/clickstream-enwiki-2022-06.tsv.gz,Captain_Marvel_(film),47930,120217,1847,169994,83252
hdfs://spark-nn.eemcs.utwente.nl/user/s1934538/clickstream/clickstream-enwiki-2022-06.tsv.gz,Anne_Heche,23610,36159,205,59974,19360
hdfs://spark-nn.eemcs.utwente.nl/user/s1934538/clickstream/clickstream-enwiki-2022-06.tsv.gz,United_States_Electoral_College,13270,41672,151,55093,9751
hdfs://spark-nn.eemcs.utwente.nl/user/s1934538/clickstream/clickstream-enwiki-2022-06.tsv.gz,2016_United_States_presidential_election,107797,98394,1338,207529,159269
hdfs://spark-nn.eemcs.utwente.nl/user/s1934538/clickstream/clickstream-enwiki-2022-06.tsv.gz,Vikram_(2022_film),330227,3798864,26674,4155765,2066391
hdfs://spark-nn.eemcs.utwente.nl/user/s1934538/clickstream/clickstream-enwiki-2022-06.tsv.gz,Irrfan_Khan,42602,64319,140,107061,45819
hdfs://spark-nn.eemcs.utwente.nl/user/s1934538/clickstream/clickstream-enwiki-2022-06.tsv.gz,Aquaman_(film),73383,165039,2650,241072,120748
hdfs://spark-nn.eemcs.utwente.nl/user/s1934538/clickstream/clickstream-enwiki-2022-06.tsv.gz,"Princess_Margaret,_Countess_of_Snowdon",180005,342072,2525,524602,309023
hdfs://spark-nn.eemcs.utwente.nl/user/s1934538/clickstream/clickstream-enwiki-2022-06.tsv.gz,Crazy_Rich_Asians_(film),33192,67944,1176,102312,88005
hdfs://spark-nn.eemcs.utwente.nl/user/s1934538/clickstream/clickstream-enwiki-2022-06.tsv.gz,Ruth_Bader_Ginsburg,73069,168624,1581,243274,98224
hdfs://spark-nn.eemcs.utwente.nl/user/s1934538/clickstream/clickstream-enwiki-2022-06.tsv.gz,Cleopatra,52885,5222046,2415,5277346,356439
hdfs://spark-nn.eemcs.utwente.nl/user/s1934538/clickstream/clickstream-enwiki-2022-06.tsv.gz,Hyphen-minus,644,7439563,19960,7460167,747
hdfs://spark-nn.eemcs.utwente.nl/user/s1934538/clickstream/clickstream-enwiki-2022-06.tsv.gz,William_Murdoch,574,1187,16,1777,325
hdfs://spark-nn.eemcs.utwente.nl/user/s1934538/clickstream/clickstream-enwiki-2022-06.tsv.gz,Main_Page,81338,130998090,4760828,135840256,33484945
hdfs://spark-nn.eemcs.utwente.nl/user/s1934538/clickstream/clickstream-enwiki-2022-06.tsv.gz,The_Queen's_Gambit_(miniseries),37025,79088,928,117041,59154
hdfs://spark-nn.eemcs.utwente.nl/user/s1934538/clickstream/clickstream-enwiki-2022-06.tsv.gz,Qasem_Soleimani,11061,19053,76,30190,17770
hdfs://spark-nn.eemcs.utwente.nl/user/s1934538/clickstream/clickstream-enwiki-2022-06.tsv.gz,Black_Widow_(2021_film),55994,90803,1718,148515,82199
hdfs://spark-nn.eemcs.utwente.nl/user/s1934538/clickstream/clickstream-enwiki-2022-06.tsv.gz,The_Kashmir_Files,35025,154279,1026,190330,78230
hdfs://spark-nn.eemcs.utwente.nl/user/s1934538/clickstream/clickstream-enwiki-2022-06.tsv.gz,Sushant_Singh_Rajput,21574,134430,371,156375,70159
hdfs://spark-nn.eemcs.utwente.nl/user/s1934538/clickstream/clickstream-enwiki-2022-06.tsv.gz,Louis_Tomlinson,57343,67726,463,125532,40276
hdfs://spark-nn.eemcs.utwente.nl/user/s1934538/clickstream/clickstream-enwiki-2022-06.tsv.gz,21_Savage,16604,69858,663,87125,34957
hdfs://spark-nn.eemcs.utwente.nl/user/s1934538/clickstream/clickstream-enwiki-2022-06.tsv.gz,UEFA_Euro_2020,67791,120282,4460,192533,93773
hdfs://spark-nn.eemcs.utwente.nl/user/s1934538/clickstream/clickstream-enwiki-2022-06.tsv.gz,Russo-Ukrainian_War,149122,556902,11038,717062,347013
hdfs://spark-nn.eemcs.utwente.nl/user/s1934538/clickstream/clickstream-enwiki-2022-06.tsv.gz,John_McCain,28607,54039,588,83234,42234
hdfs://spark-nn.eemcs.utwente.nl/user/s1934538/clickstream/clickstream-enwiki-2022-06.tsv.gz,Mission:_Impossible_–_Dead_Reckoning_Part_One,144986,71891,1698,218575,193743
hdfs://spark-nn.eemcs.utwente.nl/user/s1934538/clickstream/clickstream-enwiki-2022-06.tsv.gz,Joker_(2019_film),56044,173051,4429,233524,115534
hdfs://spark-nn.eemcs.utwente.nl/user/s1934538/clickstream/clickstream-enwiki-2022-06.tsv.gz,Vivek_Ramaswamy,288,9991,40,10319,1419
hdfs://spark-nn.eemcs.utwente.nl/user/s1934538/clickstream/clickstream-enwiki-2022-06.tsv.gz,Ray_Liotta,68774,668125,10701,747600,177846
hdfs://spark-nn.eemcs.utwente.nl/user/s1934538/clickstream/clickstream-enwiki-2022-06.tsv.gz,Kelly_Preston,84131,94490,469,179090,53262
hdfs://spark-nn.eemcs.utwente.nl/user/s1934538/clickstream/clickstream-enwiki-2022-06.tsv.gz,Joaquin_Phoenix,107992,133367,1032,242391,155702
hdfs://spark-nn.eemcs.utwente.nl/user/s1934538/clickstream/clickstream-enwiki-2022-06.tsv.gz,Kobe_Bryant,92628,412867,3887,509382,168190
hdfs://spark-nn.eemcs.utwente.nl/user/s1934538/clickstream/clickstream-enwiki-2022-06.tsv.gz,Shinzo_Abe,21200,23519,475,45194,24750
hdfs://spark-nn.eemcs.utwente.nl/user/s1934538/clickstream/clickstream-enwiki-2022-06.tsv.gz,NATO,72233,322720,11715,406668,179984
hdfs://spark-nn.eemcs.utwente.nl/user/s1934538/clickstream/clickstream-enwiki-2022-06.tsv.gz,Michael_Bloomberg,26444,27770,194,54408,25023
hdfs://spark-nn.eemcs.utwente.nl/user/s1934538/clickstream/clickstream-enwiki-2022-06.tsv.gz,Tunnel,6155,7417,86,13658,3444
hdfs://spark-nn.eemcs.utwente.nl/user/s1934538/clickstream/clickstream-enwiki-2022-06.tsv.gz,2.0_(film),48919,47492,246,96657,25182
hdfs://spark-nn.eemcs.utwente.nl/user/s1934538/clickstream/clickstream-enwiki-2022-06.tsv.gz,2018_Winter_Olympics,7218,6545,62,13825,8853
hdfs://spark-nn.eemcs.utwente.nl/user/s1934538/clickstream/clickstream-enwiki-2022-06.tsv.gz,John_Wick:_Chapter_4,50790,58711,521,110022,61914
hdfs://spark-nn.eemcs.utwente.nl/user/s1934538/clickstream/clickstream-enwiki-2022-07.tsv.gz,Jimmy_Hoffa,31330,144896,18522,194748,81844
hdfs://spark-nn.eemcs.utwente.nl/user/s1934538/clickstream/clickstream-enwiki-2022-07.tsv.gz,Army_of_the_Dead,44693,44118,523,89334,49090
hdfs://spark-nn.eemcs.utwente.nl/user/s1934538/clickstream/clickstream-enwiki-2022-07.tsv.gz,Aaron_Hernandez,8091,95326,447,103864,41341
hdfs://spark-nn.eemcs.utwente.nl/user/s1934538/clickstream/clickstream-enwiki-2022-07.tsv.gz,Kelly_Preston,82763,101992,370,185125,55349
hdfs://spark-nn.eemcs.utwente.nl/user/s1934538/clickstream/clickstream-enwiki-2022-07.tsv.gz,George_VI,295834,106749,1768,404351,299947
hdfs://spark-nn.eemcs.utwente.nl/user/s1934538/clickstream/clickstream-enwiki-2022-07.tsv.gz,The_Haunting_of_Bly_Manor,22710,46990,396,70096,36219
hdfs://spark-nn.eemcs.utwente.nl/user/s1934538/clickstream/clickstream-enwiki-2022-07.tsv.gz,Jimmy_Buffett,11233,67946,740,79919,32414
hdfs://spark-nn.eemcs.utwente.nl/user/s1934538/clickstream/clickstream-enwiki-2022-07.tsv.gz,The_Suicide_Squad_(film),79267,74453,1253,154973,90538
hdfs://spark-nn.eemcs.utwente.nl/user/s1934538/clickstream/clickstream-enwiki-2022-07.tsv.gz,No_Time_to_Die,132982,293423,5420,431825,271746
hdfs://spark-nn.eemcs.utwente.nl/user/s1934538/clickstream/clickstream-enwiki-2022-07.tsv.gz,Gaza_Strip,16492,26411,143,43046,18428
hdfs://spark-nn.eemcs.utwente.nl/user/s1934538/clickstream/clickstream-enwiki-2022-07.tsv.gz,Lance_Reddick,106394,127194,719,234307,61787
hdfs://spark-nn.eemcs.utwente.nl/user/s1934538/clickstream/clickstream-enwiki-2022-07.tsv.gz,Jurassic_World_Dominion,287366,952515,23419,1263300,815080
hdfs://spark-nn.eemcs.utwente.nl/user/s1934538/clickstream/clickstream-enwiki-2022-07.tsv.gz,Hyphen-minus,683,7679298,18904,7698885,755
hdfs://spark-nn.eemcs.utwente.nl/user/s1934538/clickstream/clickstream-enwiki-2022-07.tsv.gz,Keanu_Reeves,96816,487665,3606,588087,370928
hdfs://spark-nn.eemcs.utwente.nl/user/s1934538/clickstream/clickstream-enwiki-2022-07.tsv.gz,Watts_family_murders,10195,151359,332,161886,47237
hdfs://spark-nn.eemcs.utwente.nl/user/s1934538/clickstream/clickstream-enwiki-2022-07.tsv.gz,Bird_Box_(film),18516,62057,681,81254,30141
hdfs://spark-nn.eemcs.utwente.nl/user/s1934538/clickstream/clickstream-enwiki-2022-07.tsv.gz,Chernobyl_disaster,36733,236108,2355,275196,120628
hdfs://spark-nn.eemcs.utwente.nl/user/s1934538/clickstream/clickstream-enwiki-2022-07.tsv.gz,Salman_Rushdie,25712,54180,353,80245,36150
hdfs://spark-nn.eemcs.utwente.nl/user/s1934538/clickstream/clickstream-enwiki-2022-07.tsv.gz,Puneeth_Rajkumar,19471,76023,594,96088,42617
hdfs://spark-nn.eemcs.utwente.nl/user/s1934538/clickstream/clickstream-enwiki-2022-07.tsv.gz,Once_Upon_a_Time_in_Hollywood,122658,178216,3506,304380,318413
hdfs://spark-nn.eemcs.utwente.nl/user/s1934538/clickstream/clickstream-enwiki-2022-07.tsv.gz,Murder_of_Dee_Dee_Blanchard,16436,85749,370,102555,23534
hdfs://spark-nn.eemcs.utwente.nl/user/s1934538/clickstream/clickstream-enwiki-2022-07.tsv.gz,Area_51,17745,129770,1124,148639,50652
hdfs://spark-nn.eemcs.utwente.nl/user/s1934538/clickstream/clickstream-enwiki-2022-07.tsv.gz,Simone_Biles,14676,94039,767,109482,36314
hdfs://spark-nn.eemcs.utwente.nl/user/s1934538/clickstream/clickstream-enwiki-2022-07.tsv.gz,Bob_Saget,25374,105678,922,131974,30159
hdfs://spark-nn.eemcs.utwente.nl/user/s1934538/clickstream/clickstream-enwiki-2022-07.tsv.gz,September_11_attacks,103137,243471,2960,349568,228550
hdfs://spark-nn.eemcs.utwente.nl/user/s1934538/clickstream/clickstream-enwiki-2022-07.tsv.gz,Fyre_Festival,10659,57798,508,68965,41603
hdfs://spark-nn.eemcs.utwente.nl/user/s1934538/clickstream/clickstream-enwiki-2022-07.tsv.gz,Sidharth_Shukla,9302,65302,98,74702,17191
hdfs://spark-nn.eemcs.utwente.nl/user/s1934538/clickstream/clickstream-enwiki-2022-07.tsv.gz,Adele,32294,224681,5092,262067,103951
hdfs://spark-nn.eemcs.utwente.nl/user/s1934538/clickstream/clickstream-enwiki-2022-07.tsv.gz,Valentine's_Day,2860,26501,111,29472,2626
hdfs://spark-nn.eemcs.utwente.nl/user/s1934538/clickstream/clickstream-enwiki-2022-07.tsv.gz,John_Wick:_Chapter_4,90476,155754,2691,248921,160187
hdfs://spark-nn.eemcs.utwente.nl/user/s1934538/clickstream/clickstream-enwiki-2022-07.tsv.gz,Indian_Premier_League,21772,58658,105,80535,46068
hdfs://spark-nn.eemcs.utwente.nl/user/s1934538/clickstream/clickstream-enwiki-2022-07.tsv.gz,Joe_Biden,241279,734509,11132,986920,463881
hdfs://spark-nn.eemcs.utwente.nl/user/s1934538/clickstream/clickstream-enwiki-2022-07.tsv.gz,Dennis_Nilsen,7740,53586,329,61655,16938
hdfs://spark-nn.eemcs.utwente.nl/user/s1934538/clickstream/clickstream-enwiki-2022-07.tsv.gz,Doctor_Strange_in_the_Multiverse_of_Madness,296664,1049239,30228,1376131,892278
hdfs://spark-nn.eemcs.utwente.nl/user/s1934538/clickstream/clickstream-enwiki-2022-07.tsv.gz,Emma_Raducanu,25430,148576,1005,175011,35603
hdfs://spark-nn.eemcs.utwente.nl/user/s1934538/clickstream/clickstream-enwiki-2022-07.tsv.gz,Elon_Musk,160125,1737454,18826,1916405,1238235
hdfs://spark-nn.eemcs.utwente.nl/user/s1934538/clickstream/clickstream-enwiki-2022-07.tsv.gz,Avengers:_Endgame,167188,199688,4268,371144,209002
hdfs://spark-nn.eemcs.utwente.nl/user/s1934538/clickstream/clickstream-enwiki-2022-07.tsv.gz,The_Idol_(TV_series),33553,160757,994,195304,128431
hdfs://spark-nn.eemcs.utwente.nl/user/s1934538/clickstream/clickstream-enwiki-2022-07.tsv.gz,Ruth_Bader_Ginsburg,30753,84920,675,116348,48518
hdfs://spark-nn.eemcs.utwente.nl/user/s1934538/clickstream/clickstream-enwiki-2022-07.tsv.gz,Anne_Heche,27236,39839,218,67293,22356
hdfs://spark-nn.eemcs.utwente.nl/user/s1934538/clickstream/clickstream-enwiki-2022-07.tsv.gz,Mulan_(2020_film),17181,33901,511,51593,28573
hdfs://spark-nn.eemcs.utwente.nl/user/s1934538/clickstream/clickstream-enwiki-2022-07.tsv.gz,Article_370_of_the_Constitution_of_India,3074,47915,32,51021,2892
hdfs://spark-nn.eemcs.utwente.nl/user/s1934538/clickstream/clickstream-enwiki-2022-07.tsv.gz,Sylvester_Stallone,109503,321655,3222,434380,316232
hdfs://spark-nn.eemcs.utwente.nl/user/s1934538/clickstream/clickstream-enwiki-2022-07.tsv.gz,1917_(2019_film),19857,87907,1861,109625,62171
hdfs://spark-nn.eemcs.utwente.nl/user/s1934538/clickstream/clickstream-enwiki-2022-07.tsv.gz,Captain_Marvel_(film),54911,122136,1532,178579,89449
hdfs://spark-nn.eemcs.utwente.nl/user/s1934538/clickstream/clickstream-enwiki-2022-07.tsv.gz,Roe_v._Wade,48703,793038,6095,847836,295906
hdfs://spark-nn.eemcs.utwente.nl/user/s1934538/clickstream/clickstream-enwiki-2022-07.tsv.gz,2023_Cricket_World_Cup,28381,92892,186,121459,39465
hdfs://spark-nn.eemcs.utwente.nl/user/s1934538/clickstream/clickstream-enwiki-2022-07.tsv.gz,Cricket_World_Cup,13607,79013,414,93034,67122
hdfs://spark-nn.eemcs.utwente.nl/user/s1934538/clickstream/clickstream-enwiki-2022-07.tsv.gz,Cleopatra,56397,4994836,1968,5053201,426822
hdfs://spark-nn.eemcs.utwente.nl/user/s1934538/clickstream/clickstream-enwiki-2022-07.tsv.gz,Ray_Liotta,87225,557854,5772,650851,126956
hdfs://spark-nn.eemcs.utwente.nl/user/s1934538/clickstream/clickstream-enwiki-2022-07.tsv.gz,Priyanka_Chopra,88201,247043,8530,343774,129213
hdfs://spark-nn.eemcs.utwente.nl/user/s1934538/clickstream/clickstream-enwiki-2022-07.tsv.gz,Naomi_Osaka,25820,63782,349,89951,25989
hdfs://spark-nn.eemcs.utwente.nl/user/s1934538/clickstream/clickstream-enwiki-2022-07.tsv.gz,Ukraine,108411,391355,11376,511142,255099
hdfs://spark-nn.eemcs.utwente.nl/user/s1934538/clickstream/clickstream-enwiki-2022-07.tsv.gz,List_of_highest-grossing_Indian_films,109686,417134,1251,528071,286078
hdfs://spark-nn.eemcs.utwente.nl/user/s1934538/clickstream/clickstream-enwiki-2022-07.tsv.gz,Richard_Jewell,12043,46776,208,59027,21932
hdfs://spark-nn.eemcs.utwente.nl/user/s1934538/clickstream/clickstream-enwiki-2022-07.tsv.gz,Meat_Loaf,22372,105334,1064,128770,45055
hdfs://spark-nn.eemcs.utwente.nl/user/s1934538/clickstream/clickstream-enwiki-2022-07.tsv.gz,"Meghan,_Duchess_of_Sussex",74709,212252,1341,288302,153298
hdfs://spark-nn.eemcs.utwente.nl/user/s1934538/clickstream/clickstream-enwiki-2022-07.tsv.gz,Oppenheimer_(film),200903,384619,5827,591349,622975
hdfs://spark-nn.eemcs.utwente.nl/user/s1934538/clickstream/clickstream-enwiki-2022-07.tsv.gz,Greta_Thunberg,8956,102581,1131,112668,26969
hdfs://spark-nn.eemcs.utwente.nl/user/s1934538/clickstream/clickstream-enwiki-2022-07.tsv.gz,Amy_Coney_Barrett,48918,85969,751,135638,44984
hdfs://spark-nn.eemcs.utwente.nl/user/s1934538/clickstream/clickstream-enwiki-2022-07.tsv.gz,NATO,69378,264616,9112,343106,164665
hdfs://spark-nn.eemcs.utwente.nl/user/s1934538/clickstream/clickstream-enwiki-2022-07.tsv.gz,XXX:_Return_of_Xander_Cage,65585,711651,1236,778472,97809
hdfs://spark-nn.eemcs.utwente.nl/user/s1934538/clickstream/clickstream-enwiki-2022-07.tsv.gz,Vikram_(2022_film),167366,1443363,7746,1618475,901877
hdfs://spark-nn.eemcs.utwente.nl/user/s1934538/clickstream/clickstream-enwiki-2022-07.tsv.gz,Mission:_Impossible_–_Dead_Reckoning_Part_One,93832,47207,849,141888,120503
hdfs://spark-nn.eemcs.utwente.nl/user/s1934538/clickstream/clickstream-enwiki-2022-07.tsv.gz,Hamas,24479,24842,279,49600,24538
hdfs://spark-nn.eemcs.utwente.nl/user/s1934538/clickstream/clickstream-enwiki-2022-07.tsv.gz,Charles_III,82,160,92,334,287
hdfs://spark-nn.eemcs.utwente.nl/user/s1934538/clickstream/clickstream-enwiki-2022-07.tsv.gz,Amber_Heard,97408,380353,2867,480628,199092
hdfs://spark-nn.eemcs.utwente.nl/user/s1934538/clickstream/clickstream-enwiki-2022-07.tsv.gz,Avengers:_Infinity_War,78716,92756,1384,172856,91782
hdfs://spark-nn.eemcs.utwente.nl/user/s1934538/clickstream/clickstream-enwiki-2022-07.tsv.gz,K.G.F:_Chapter_2,92170,380062,2403,474635,149712
hdfs://spark-nn.eemcs.utwente.nl/user/s1934538/clickstream/clickstream-enwiki-2022-07.tsv.gz,XHamster,13054,264072,5303,282429,30163
hdfs://spark-nn.eemcs.utwente.nl/user/s1934538/clickstream/clickstream-enwiki-2022-07.tsv.gz,Shang-Chi_and_the_Legend_of_the_Ten_Rings,108016,149612,2217,259845,147775
hdfs://spark-nn.eemcs.utwente.nl/user/s1934538/clickstream/clickstream-enwiki-2022-07.tsv.gz,Pelé,29564,102109,792,132465,51983
hdfs://spark-nn.eemcs.utwente.nl/user/s1934538/clickstream/clickstream-enwiki-2022-07.tsv.gz,Johnny_Depp,139727,458724,3999,602450,316726
hdfs://spark-nn.eemcs.utwente.nl/user/s1934538/clickstream/clickstream-enwiki-2022-07.tsv.gz,Spider-Man:_No_Way_Home,222224,483628,16886,722738,399710
hdfs://spark-nn.eemcs.utwente.nl/user/s1934538/clickstream/clickstream-enwiki-2022-07.tsv.gz,List_of_Queen_of_the_South_episodes,9830,7022,79,16931,322
hdfs://spark-nn.eemcs.utwente.nl/user/s1934538/clickstream/clickstream-enwiki-2022-07.tsv.gz,Black_Panther_(film),90954,181993,4389,277336,182612
hdfs://spark-nn.eemcs.utwente.nl/user/s1934538/clickstream/clickstream-enwiki-2022-07.tsv.gz,Juneteenth,5722,79457,337,85516,8872
hdfs://spark-nn.eemcs.utwente.nl/user/s1934538/clickstream/clickstream-enwiki-2022-07.tsv.gz,Burt_Reynolds,63522,152862,1316,217700,108563
hdfs://spark-nn.eemcs.utwente.nl/user/s1934538/clickstream/clickstream-enwiki-2022-07.tsv.gz,Deaths_in_2022,1452134,2479423,17476,3949033,2439052
hdfs://spark-nn.eemcs.utwente.nl/user/s1934538/clickstream/clickstream-enwiki-2022-07.tsv.gz,Venom_(2018_film),20170,72685,921,93776,43226
hdfs://spark-nn.eemcs.utwente.nl/user/s1934538/clickstream/clickstream-enwiki-2022-07.tsv.gz,Ghislaine_Maxwell,68046,305736,1912,375694,154264
hdfs://spark-nn.eemcs.utwente.nl/user/s1934538/clickstream/clickstream-enwiki-2022-07.tsv.gz,A_Star_Is_Born_(2018_film),23829,64807,468,89104,42575
hdfs://spark-nn.eemcs.utwente.nl/user/s1934538/clickstream/clickstream-enwiki-2022-07.tsv.gz,Mortal_Kombat_(2021_film),21011,59470,963,81444,68031
hdfs://spark-nn.eemcs.utwente.nl/user/s1934538/clickstream/clickstream-enwiki-2022-07.tsv.gz,FIFA_World_Cup,54082,224999,3478,282559,150637
hdfs://spark-nn.eemcs.utwente.nl/user/s1934538/clickstream/clickstream-enwiki-2022-07.tsv.gz,Us_(2019_film),114937,151005,874,266816,97865
hdfs://spark-nn.eemcs.utwente.nl/user/s1934538/clickstream/clickstream-enwiki-2022-07.tsv.gz,The_Witcher_(TV_series),26003,146401,3418,175822,102778
hdfs://spark-nn.eemcs.utwente.nl/user/s1934538/clickstream/clickstream-enwiki-2022-07.tsv.gz,Naya_Rivera,76910,125889,592,203391,89041
hdfs://spark-nn.eemcs.utwente.nl/user/s1934538/clickstream/clickstream-enwiki-2022-07.tsv.gz,Microsoft_Office,6391,2151177,550,2158118,16349
hdfs://spark-nn.eemcs.utwente.nl/user/s1934538/clickstream/clickstream-enwiki-2022-07.tsv.gz,Anna_Sorokin,41860,354596,1204,397660,149458
hdfs://spark-nn.eemcs.utwente.nl/user/s1934538/clickstream/clickstream-enwiki-2022-07.tsv.gz,Stan_Lee,49451,175595,884,225930,58838
hdfs://spark-nn.eemcs.utwente.nl/user/s1934538/clickstream/clickstream-enwiki-2022-07.tsv.gz,Alexander_Hamilton,74708,221470,2052,298230,165499
hdfs://spark-nn.eemcs.utwente.nl/user/s1934538/clickstream/clickstream-enwiki-2022-07.tsv.gz,Simple_Mail_Transfer_Protocol,2314,32186,109,34609,2732
hdfs://spark-nn.eemcs.utwente.nl/user/s1934538/clickstream/clickstream-enwiki-2022-07.tsv.gz,Charles_Sobhraj,10510,43537,430,54477,10203
hdfs://spark-nn.eemcs.utwente.nl/user/s1934538/clickstream/clickstream-enwiki-2022-07.tsv.gz,Jason_Momoa,69038,254339,1699,325076,125013
hdfs://spark-nn.eemcs.utwente.nl/user/s1934538/clickstream/clickstream-enwiki-2022-07.tsv.gz,Parasite_(2019_film),28858,113061,1315,143234,61943
hdfs://spark-nn.eemcs.utwente.nl/user/s1934538/clickstream/clickstream-enwiki-2022-07.tsv.gz,Kenosha_unrest_shooting,11423,39344,99,50866,10900
hdfs://spark-nn.eemcs.utwente.nl/user/s1934538/clickstream/clickstream-enwiki-2022-07.tsv.gz,Central_Park_jogger_case,11267,62175,444,73886,11258
hdfs://spark-nn.eemcs.utwente.nl/user/s1934538/clickstream/clickstream-enwiki-2022-07.tsv.gz,Mac_Miller,27696,164579,1017,193292,62285
hdfs://spark-nn.eemcs.utwente.nl/user/s1934538/clickstream/clickstream-enwiki-2022-07.tsv.gz,Betty_White,39808,120498,1523,161829,42156
hdfs://spark-nn.eemcs.utwente.nl/user/s1934538/clickstream/clickstream-enwiki-2022-07.tsv.gz,Rihanna,61783,269125,3029,333937,181477
hdfs://spark-nn.eemcs.utwente.nl/user/s1934538/clickstream/clickstream-enwiki-2022-07.tsv.gz,21_Savage,12270,59660,523,72453,25801
hdfs://spark-nn.eemcs.utwente.nl/user/s1934538/clickstream/clickstream-enwiki-2022-07.tsv.gz,Dark_Phoenix_(film),40858,34737,354,75949,42711
hdfs://spark-nn.eemcs.utwente.nl/user/s1934538/clickstream/clickstream-enwiki-2022-07.tsv.gz,Jenna_Ortega,67134,85587,1139,153860,47909
hdfs://spark-nn.eemcs.utwente.nl/user/s1934538/clickstream/clickstream-enwiki-2022-07.tsv.gz,Stephen_Hawking,25879,323499,1805,351183,132110
hdfs://spark-nn.eemcs.utwente.nl/user/s1934538/clickstream/clickstream-enwiki-2022-07.tsv.gz,Hamilton_(musical),27451,161445,1702,190598,124201
hdfs://spark-nn.eemcs.utwente.nl/user/s1934538/clickstream/clickstream-enwiki-2022-07.tsv.gz,Vladimir_Putin,107078,344474,5478,457030,243252
hdfs://spark-nn.eemcs.utwente.nl/user/s1934538/clickstream/clickstream-enwiki-2022-07.tsv.gz,RRR_(film),80647,663051,5583,749281,448649
hdfs://spark-nn.eemcs.utwente.nl/user/s1934538/clickstream/clickstream-enwiki-2022-07.tsv.gz,2022_Russian_invasion_of_Ukraine,867390,1465509,5702,2338601,1161071
hdfs://spark-nn.eemcs.utwente.nl/user/s1934538/clickstream/clickstream-enwiki-2022-07.tsv.gz,The_Sandman_(TV_series),46963,158936,3814,209713,237023
hdfs://spark-nn.eemcs.utwente.nl/user/s1934538/clickstream/clickstream-enwiki-2022-07.tsv.gz,Kobe_Bryant_sexual_assault_case,10046,31167,20,41233,4010
hdfs://spark-nn.eemcs.utwente.nl/user/s1934538/clickstream/clickstream-enwiki-2022-07.tsv.gz,Google_logo,570,16900,10,17480,788
hdfs://spark-nn.eemcs.utwente.nl/user/s1934538/clickstream/clickstream-enwiki-2022-07.tsv.gz,Volodymyr_Zelenskyy,91639,179770,2505,273914,134112
hdfs://spark-nn.eemcs.utwente.nl/user/s1934538/clickstream/clickstream-enwiki-2022-07.tsv.gz,Rami_Malek,70141,175129,825,246095,112805
hdfs://spark-nn.eemcs.utwente.nl/user/s1934538/clickstream/clickstream-enwiki-2022-07.tsv.gz,Juice_Wrld,31140,164674,2092,197906,80094
hdfs://spark-nn.eemcs.utwente.nl/user/s1934538/clickstream/clickstream-enwiki-2022-07.tsv.gz,When_They_See_Us,8881,20404,141,29426,14889
hdfs://spark-nn.eemcs.utwente.nl/user/s1934538/clickstream/clickstream-enwiki-2022-07.tsv.gz,Donald_Trump,484692,1003491,10923,1499106,1229168
hdfs://spark-nn.eemcs.utwente.nl/user/s1934538/clickstream/clickstream-enwiki-2022-07.tsv.gz,List_of_highest-grossing_films,195139,675753,19360,890252,416352
hdfs://spark-nn.eemcs.utwente.nl/user/s1934538/clickstream/clickstream-enwiki-2022-07.tsv.gz,Stranger_Things,609756,3126174,63951,3799881,3954121
hdfs://spark-nn.eemcs.utwente.nl/user/s1934538/clickstream/clickstream-enwiki-2022-07.tsv.gz,Notre-Dame_de_Paris,12408,86410,908,99726,20706
hdfs://spark-nn.eemcs.utwente.nl/user/s1934538/clickstream/clickstream-enwiki-2022-07.tsv.gz,Avatar:_The_Way_of_Water,99513,184101,3434,287048,152131
hdfs://spark-nn.eemcs.utwente.nl/user/s1934538/clickstream/clickstream-enwiki-2022-07.tsv.gz,Ponniyin_Selvan:_I,119213,950688,3036,1072937,1141203
hdfs://spark-nn.eemcs.utwente.nl/user/s1934538/clickstream/clickstream-enwiki-2022-07.tsv.gz,William_Murdoch,679,1079,16,1774,354
hdfs://spark-nn.eemcs.utwente.nl/user/s1934538/clickstream/clickstream-enwiki-2022-07.tsv.gz,Wonder_Woman_1984,35845,52459,1169,89473,43648
hdfs://spark-nn.eemcs.utwente.nl/user/s1934538/clickstream/clickstream-enwiki-2022-07.tsv.gz,Tom_Brady,52269,207086,2283,261638,98937
hdfs://spark-nn.eemcs.utwente.nl/user/s1934538/clickstream/clickstream-enwiki-2022-07.tsv.gz,Tasuku_Honjo,736,85865,31,86632,3139
hdfs://spark-nn.eemcs.utwente.nl/user/s1934538/clickstream/clickstream-enwiki-2022-07.tsv.gz,Lionel_Messi,83259,448586,3835,535680,127206
hdfs://spark-nn.eemcs.utwente.nl/user/s1934538/clickstream/clickstream-enwiki-2022-07.tsv.gz,Brett_Kavanaugh,35398,62674,608,98680,36664
hdfs://spark-nn.eemcs.utwente.nl/user/s1934538/clickstream/clickstream-enwiki-2022-07.tsv.gz,Jawan_(film),16261,125,326,16712,877
hdfs://spark-nn.eemcs.utwente.nl/user/s1934538/clickstream/clickstream-enwiki-2022-07.tsv.gz,Tina_Turner,23289,200306,1755,225350,75986
hdfs://spark-nn.eemcs.utwente.nl/user/s1934538/clickstream/clickstream-enwiki-2022-07.tsv.gz,The_Weeknd,85403,236455,2801,324659,151726
hdfs://spark-nn.eemcs.utwente.nl/user/s1934538/clickstream/clickstream-enwiki-2022-07.tsv.gz,Grover,1348,3953,58,5359,1256
hdfs://spark-nn.eemcs.utwente.nl/user/s1934538/clickstream/clickstream-enwiki-2022-07.tsv.gz,Brie_Larson,89966,137767,1215,228948,96652
hdfs://spark-nn.eemcs.utwente.nl/user/s1934538/clickstream/clickstream-enwiki-2022-07.tsv.gz,Critical_race_theory,21184,178876,1008,201068,23442
hdfs://spark-nn.eemcs.utwente.nl/user/s1934538/clickstream/clickstream-enwiki-2022-07.tsv.gz,Adipurush,49139,38277,202,87618,68407
hdfs://spark-nn.eemcs.utwente.nl/user/s1934538/clickstream/clickstream-enwiki-2022-07.tsv.gz,Bridgerton,41267,198880,4030,244177,188612
hdfs://spark-nn.eemcs.utwente.nl/user/s1934538/clickstream/clickstream-enwiki-2022-07.tsv.gz,Pornhub,52295,337327,12639,402261,78234
hdfs://spark-nn.eemcs.utwente.nl/user/s1934538/clickstream/clickstream-enwiki-2022-07.tsv.gz,Manti_Te'o,2522,131763,628,134913,13936
hdfs://spark-nn.eemcs.utwente.nl/user/s1934538/clickstream/clickstream-enwiki-2022-07.tsv.gz,Ant-Man_and_the_Wasp:_Quantumania,206101,110107,1982,318190,227689
hdfs://spark-nn.eemcs.utwente.nl/user/s1934538/clickstream/clickstream-enwiki-2022-07.tsv.gz,Olivia_Newton-John,25363,78199,895,104457,48326
hdfs://spark-nn.eemcs.utwente.nl/user/s1934538/clickstream/clickstream-enwiki-2022-07.tsv.gz,HTTP_cookie,2510,228579,94,231183,22500
hdfs://spark-nn.eemcs.utwente.nl/user/s1934538/clickstream/clickstream-enwiki-2022-07.tsv.gz,The_Falcon_and_the_Winter_Soldier,38499,53840,1320,93659,55774
hdfs://spark-nn.eemcs.utwente.nl/user/s1934538/clickstream/clickstream-enwiki-2022-07.tsv.gz,XNXX,17364,1011253,6998,1035615,86848
hdfs://spark-nn.eemcs.utwente.nl/user/s1934538/clickstream/clickstream-enwiki-2022-07.tsv.gz,Michael_Jordan,86355,467943,4355,558653,192086
hdfs://spark-nn.eemcs.utwente.nl/user/s1934538/clickstream/clickstream-enwiki-2023-08.tsv.gz,Oppenheimer_(film),984917,5746884,104760,6836561,6488082
hdfs://spark-nn.eemcs.utwente.nl/user/s1934538/clickstream/clickstream-enwiki-2023-08.tsv.gz,Avicii,20587,201670,1353,223610,67925
hdfs://spark-nn.eemcs.utwente.nl/user/s1934538/clickstream/clickstream-enwiki-2023-08.tsv.gz,Charles_Sobhraj,9976,47117,99,57192,13944
hdfs://spark-nn.eemcs.utwente.nl/user/s1934538/clickstream/clickstream-enwiki-2023-08.tsv.gz,Top_Gun:_Maverick,95141,202424,4009,301574,209292
hdfs://spark-nn.eemcs.utwente.nl/user/s1934538/clickstream/clickstream-enwiki-2023-08.tsv.gz,Deion_Sanders,20131,234969,1378,256478,80030
hdfs://spark-nn.eemcs.utwente.nl/user/s1934538/clickstream/clickstream-enwiki-2023-08.tsv.gz,Tenet_(film),151885,243379,2556,397820,188349
hdfs://spark-nn.eemcs.utwente.nl/user/s1934538/clickstream/clickstream-enwiki-2023-08.tsv.gz,Cricket_World_Cup,30997,144495,841,176333,73487
hdfs://spark-nn.eemcs.utwente.nl/user/s1934538/clickstream/clickstream-enwiki-2023-08.tsv.gz,Tina_Turner,24478,225623,2215,252316,82270
hdfs://spark-nn.eemcs.utwente.nl/user/s1934538/clickstream/clickstream-enwiki-2023-08.tsv.gz,XNXX,11302,631574,7752,650628,40276
hdfs://spark-nn.eemcs.utwente.nl/user/s1934538/clickstream/clickstream-enwiki-2023-08.tsv.gz,Indian_Premier_League,14841,112864,323,128028,36331
hdfs://spark-nn.eemcs.utwente.nl/user/s1934538/clickstream/clickstream-enwiki-2023-08.tsv.gz,The_Super_Mario_Bros._Movie,236533,563522,8350,808405,365495
hdfs://spark-nn.eemcs.utwente.nl/user/s1934538/clickstream/clickstream-enwiki-2023-08.tsv.gz,Donald_Trump,292960,1136699,16858,1446517,781732
hdfs://spark-nn.eemcs.utwente.nl/user/s1934538/clickstream/clickstream-enwiki-2023-08.tsv.gz,YouTube,136868,5916166,11196,6064230,121089
hdfs://spark-nn.eemcs.utwente.nl/user/s1934538/clickstream/clickstream-enwiki-2023-08.tsv.gz,Lists_of_deaths_by_year,18923,197570,888,217381,238910
hdfs://spark-nn.eemcs.utwente.nl/user/s1934538/clickstream/clickstream-enwiki-2023-08.tsv.gz,Donald_Glover,40138,120239,726,161103,71583
hdfs://spark-nn.eemcs.utwente.nl/user/s1934538/clickstream/clickstream-enwiki-2023-08.tsv.gz,2.0_(film),72340,82618,214,155172,33031
hdfs://spark-nn.eemcs.utwente.nl/user/s1934538/clickstream/clickstream-enwiki-2023-08.tsv.gz,Joker_(2019_film),68617,155335,1794,225746,114873
hdfs://spark-nn.eemcs.utwente.nl/user/s1934538/clickstream/clickstream-enwiki-2023-08.tsv.gz,Israel,89885,260257,4600,354742,174973
hdfs://spark-nn.eemcs.utwente.nl/user/s1934538/clickstream/clickstream-enwiki-2023-08.tsv.gz,Qasem_Soleimani,13128,27740,109,40977,24783
hdfs://spark-nn.eemcs.utwente.nl/user/s1934538/clickstream/clickstream-enwiki-2023-08.tsv.gz,COVID-19_pandemic_by_country_and_territory,5587,17083,408,23078,9699
hdfs://spark-nn.eemcs.utwente.nl/user/s1934538/clickstream/clickstream-enwiki-2023-08.tsv.gz,Eddie_Van_Halen,55402,112060,917,168379,72094
hdfs://spark-nn.eemcs.utwente.nl/user/s1934538/clickstream/clickstream-enwiki-2023-08.tsv.gz,Rishi_Sunak,114762,260449,2015,377226,188076
hdfs://spark-nn.eemcs.utwente.nl/user/s1934538/clickstream/clickstream-enwiki-2023-08.tsv.gz,Barbie_(film),929745,3916181,88152,4934078,3850824
hdfs://spark-nn.eemcs.utwente.nl/user/s1934538/clickstream/clickstream-enwiki-2023-08.tsv.gz,Simone_Biles,33914,380447,2551,416912,188955
hdfs://spark-nn.eemcs.utwente.nl/user/s1934538/clickstream/clickstream-enwiki-2023-08.tsv.gz,Anthony_Bourdain,24755,240578,1562,266895,117312
hdfs://spark-nn.eemcs.utwente.nl/user/s1934538/clickstream/clickstream-enwiki-2023-08.tsv.gz,Vivek_Ramaswamy,76804,4324856,20364,4422024,1120809
hdfs://spark-nn.eemcs.utwente.nl/user/s1934538/clickstream/clickstream-enwiki-2023-08.tsv.gz,House_of_the_Dragon,51655,238571,4877,295103,173194
hdfs://spark-nn.eemcs.utwente.nl/user/s1934538/clickstream/clickstream-enwiki-2023-08.tsv.gz,Black_Panther:_Wakanda_Forever,53511,97779,2000,153290,92830
hdfs://spark-nn.eemcs.utwente.nl/user/s1934538/clickstream/clickstream-enwiki-2023-08.tsv.gz,Ted_Bundy,28143,335630,3707,367480,88178
hdfs://spark-nn.eemcs.utwente.nl/user/s1934538/clickstream/clickstream-enwiki-2023-08.tsv.gz,Ruth_Bader_Ginsburg,16040,93067,417,109524,35079
hdfs://spark-nn.eemcs.utwente.nl/user/s1934538/clickstream/clickstream-enwiki-2023-08.tsv.gz,Royal_Rumble_(2018),7287,4671,46,12004,9562
hdfs://spark-nn.eemcs.utwente.nl/user/s1934538/clickstream/clickstream-enwiki-2023-08.tsv.gz,Shinzo_Abe,46413,86216,1759,134388,97821
hdfs://spark-nn.eemcs.utwente.nl/user/s1934538/clickstream/clickstream-enwiki-2023-08.tsv.gz,Elliot_Page,65197,239683,1158,306038,135814
hdfs://spark-nn.eemcs.utwente.nl/user/s1934538/clickstream/clickstream-enwiki-2023-08.tsv.gz,Spanish_flu,17320,40019,587,57926,16895
hdfs://spark-nn.eemcs.utwente.nl/user/s1934538/clickstream/clickstream-enwiki-2023-08.tsv.gz,Laal_Singh_Chaddha,24890,52085,133,77108,27770
hdfs://spark-nn.eemcs.utwente.nl/user/s1934538/clickstream/clickstream-enwiki-2023-08.tsv.gz,Shakira,21939,231391,1882,255212,103456
hdfs://spark-nn.eemcs.utwente.nl/user/s1934538/clickstream/clickstream-enwiki-2023-08.tsv.gz,Ant-Man_and_the_Wasp:_Quantumania,74461,123367,3229,201057,117334
hdfs://spark-nn.eemcs.utwente.nl/user/s1934538/clickstream/clickstream-enwiki-2023-08.tsv.gz,"Meghan,_Duchess_of_Sussex",124233,549815,2056,676104,339394
hdfs://spark-nn.eemcs.utwente.nl/user/s1934538/clickstream/clickstream-enwiki-2023-08.tsv.gz,List_of_FIFA_World_Cup_finals,5419,99965,125,105509,28681
hdfs://spark-nn.eemcs.utwente.nl/user/s1934538/clickstream/clickstream-enwiki-2023-08.tsv.gz,List_of_Queen_of_the_South_episodes,4444,4327,37,8808,180
hdfs://spark-nn.eemcs.utwente.nl/user/s1934538/clickstream/clickstream-enwiki-2023-08.tsv.gz,John_Wick:_Chapter_4,79819,243211,6115,329145,215948
hdfs://spark-nn.eemcs.utwente.nl/user/s1934538/clickstream/clickstream-enwiki-2023-08.tsv.gz,War_(2019_film),37563,43937,2668,84168,21752
hdfs://spark-nn.eemcs.utwente.nl/user/s1934538/clickstream/clickstream-enwiki-2023-08.tsv.gz,Captain_Marvel_(film),36800,64993,891,102684,47490
hdfs://spark-nn.eemcs.utwente.nl/user/s1934538/clickstream/clickstream-enwiki-2023-08.tsv.gz,The_Kerala_Story,64415,152493,319,217227,38939
hdfs://spark-nn.eemcs.utwente.nl/user/s1934538/clickstream/clickstream-enwiki-2023-08.tsv.gz,The_Witcher_(TV_series),58242,693128,14883,766253,382654
hdfs://spark-nn.eemcs.utwente.nl/user/s1934538/clickstream/clickstream-enwiki-2023-08.tsv.gz,Joaquin_Phoenix,170897,209033,1353,381283,256615
hdfs://spark-nn.eemcs.utwente.nl/user/s1934538/clickstream/clickstream-enwiki-2023-08.tsv.gz,Elizabeth_II,285499,411222,3311,700032,449796
hdfs://spark-nn.eemcs.utwente.nl/user/s1934538/clickstream/clickstream-enwiki-2023-08.tsv.gz,Joe_Biden,235362,616119,9596,861077,401306
hdfs://spark-nn.eemcs.utwente.nl/user/s1934538/clickstream/clickstream-enwiki-2023-08.tsv.gz,Jeffrey_Epstein,53240,267604,8991,329835,150469
hdfs://spark-nn.eemcs.utwente.nl/user/s1934538/clickstream/clickstream-enwiki-2023-08.tsv.gz,WrestleMania_34,20153,9847,52,30052,20804
hdfs://spark-nn.eemcs.utwente.nl/user/s1934538/clickstream/clickstream-enwiki-2023-08.tsv.gz,Salaar:_Part_1_–_Ceasefire,51721,202224,4693,258638,100982
hdfs://spark-nn.eemcs.utwente.nl/user/s1934538/clickstream/clickstream-enwiki-2023-08.tsv.gz,Spider-Man:_No_Way_Home,91705,130471,2074,224250,94117
hdfs://spark-nn.eemcs.utwente.nl/user/s1934538/clickstream/clickstream-enwiki-2023-08.tsv.gz,Priyanka_Chopra,101918,298427,749,401094,136894
hdfs://spark-nn.eemcs.utwente.nl/user/s1934538/clickstream/clickstream-enwiki-2023-08.tsv.gz,The_Umbrella_Academy_(TV_series),23938,69385,1362,94685,55506
hdfs://spark-nn.eemcs.utwente.nl/user/s1934538/clickstream/clickstream-enwiki-2023-08.tsv.gz,Us_(2019_film),20650,50528,252,71430,21671
hdfs://spark-nn.eemcs.utwente.nl/user/s1934538/clickstream/clickstream-enwiki-2023-08.tsv.gz,Ghislaine_Maxwell,67509,103378,444,171331,76516
hdfs://spark-nn.eemcs.utwente.nl/user/s1934538/clickstream/clickstream-enwiki-2023-08.tsv.gz,Carlos_Alcaraz,53258,371920,1212,426390,92855
hdfs://spark-nn.eemcs.utwente.nl/user/s1934538/clickstream/clickstream-enwiki-2023-08.tsv.gz,Black_Widow_(2021_film),36633,83714,751,121098,46997
hdfs://spark-nn.eemcs.utwente.nl/user/s1934538/clickstream/clickstream-enwiki-2023-08.tsv.gz,Simple_Mail_Transfer_Protocol,2289,23150,92,25531,2407
hdfs://spark-nn.eemcs.utwente.nl/user/s1934538/clickstream/clickstream-enwiki-2023-08.tsv.gz,Darth_Vader,32611,61376,604,94591,59326
hdfs://spark-nn.eemcs.utwente.nl/user/s1934538/clickstream/clickstream-enwiki-2023-08.tsv.gz,J._Robert_Oppenheimer,991476,4384898,34513,5410887,3589428
hdfs://spark-nn.eemcs.utwente.nl/user/s1934538/clickstream/clickstream-enwiki-2023-08.tsv.gz,Joe_Exotic,29127,47453,213,76793,32563
hdfs://spark-nn.eemcs.utwente.nl/user/s1934538/clickstream/clickstream-enwiki-2023-08.tsv.gz,Stranger_Things_(season_3),10238,22541,180,32959,16451
hdfs://spark-nn.eemcs.utwente.nl/user/s1934538/clickstream/clickstream-enwiki-2023-08.tsv.gz,Wonder_Woman_1984,39002,52503,1432,92937,37165
hdfs://spark-nn.eemcs.utwente.nl/user/s1934538/clickstream/clickstream-enwiki-2023-08.tsv.gz,Line_shaft,332,710,10,1052,107
hdfs://spark-nn.eemcs.utwente.nl/user/s1934538/clickstream/clickstream-enwiki-2023-08.tsv.gz,The_Idol_(TV_series),55469,163119,2476,221064,122010
hdfs://spark-nn.eemcs.utwente.nl/user/s1934538/clickstream/clickstream-enwiki-2023-08.tsv.gz,Once_Upon_a_Time_in_Hollywood,119519,184180,2859,306558,320685
hdfs://spark-nn.eemcs.utwente.nl/user/s1934538/clickstream/clickstream-enwiki-2023-08.tsv.gz,Stranger_Things_(season_4),21493,72635,742,94870,50955
hdfs://spark-nn.eemcs.utwente.nl/user/s1934538/clickstream/clickstream-enwiki-2023-08.tsv.gz,2023_Indian_Premier_League,6008,57471,21,63500,8638
hdfs://spark-nn.eemcs.utwente.nl/user/s1934538/clickstream/clickstream-enwiki-2023-08.tsv.gz,JSON_Web_Token,721,21193,41,21955,1877
hdfs://spark-nn.eemcs.utwente.nl/user/s1934538/clickstream/clickstream-enwiki-2023-08.tsv.gz,Valentine's_Day,3467,39777,205,43449,3366
hdfs://spark-nn.eemcs.utwente.nl/user/s1934538/clickstream/clickstream-enwiki-2023-08.tsv.gz,Pathaan_(film),150941,404666,6171,561778,146025
hdfs://spark-nn.eemcs.utwente.nl/user/s1934538/clickstream/clickstream-enwiki-2023-08.tsv.gz,Ukraine,86634,312042,7789,406465,182582
hdfs://spark-nn.eemcs.utwente.nl/user/s1934538/clickstream/clickstream-enwiki-2023-08.tsv.gz,Fantastic_Beasts:_The_Crimes_of_Grindelwald,38017,42638,418,81073,47043
hdfs://spark-nn.eemcs.utwente.nl/user/s1934538/clickstream/clickstream-enwiki-2023-08.tsv.gz,Hamilton_(musical),22219,126604,1053,149876,95101
hdfs://spark-nn.eemcs.utwente.nl/user/s1934538/clickstream/clickstream-enwiki-2023-08.tsv.gz,Star_Wars:_The_Rise_of_Skywalker,68485,38447,753,107685,53932
hdfs://spark-nn.eemcs.utwente.nl/user/s1934538/clickstream/clickstream-enwiki-2023-08.tsv.gz,Sylvester_Stallone,111646,424574,2919,539139,390638
hdfs://spark-nn.eemcs.utwente.nl/user/s1934538/clickstream/clickstream-enwiki-2023-08.tsv.gz,Media,22,1800,178,2000,929
hdfs://spark-nn.eemcs.utwente.nl/user/s1934538/clickstream/clickstream-enwiki-2023-08.tsv.gz,Kenosha_unrest_shooting,10754,25529,66,36349,9715
hdfs://spark-nn.eemcs.utwente.nl/user/s1934538/clickstream/clickstream-enwiki-2023-08.tsv.gz,Jason_Momoa,64030,375839,2279,442148,188492
hdfs://spark-nn.eemcs.utwente.nl/user/s1934538/clickstream/clickstream-enwiki-2023-08.tsv.gz,COVID-19_pandemic,89142,196039,4047,289228,99246
hdfs://spark-nn.eemcs.utwente.nl/user/s1934538/clickstream/clickstream-enwiki-2023-08.tsv.gz,Squid_Game,23257,137548,1848,162653,78419
hdfs://spark-nn.eemcs.utwente.nl/user/s1934538/clickstream/clickstream-enwiki-2023-08.tsv.gz,Antifa_(United_States),13558,63905,222,77685,14332
hdfs://spark-nn.eemcs.utwente.nl/user/s1934538/clickstream/clickstream-enwiki-2023-08.tsv.gz,William_Murdoch,743,1423,16,2182,420
hdfs://spark-nn.eemcs.utwente.nl/user/s1934538/clickstream/clickstream-enwiki-2023-08.tsv.gz,Fyre_Festival,13807,154668,1091,169566,76776
hdfs://spark-nn.eemcs.utwente.nl/user/s1934538/clickstream/clickstream-enwiki-2023-08.tsv.gz,The_Falcon_and_the_Winter_Soldier,16564,26169,317,43050,22765
hdfs://spark-nn.eemcs.utwente.nl/user/s1934538/clickstream/clickstream-enwiki-2023-08.tsv.gz,Brie_Larson,61210,146463,981,208654,80770
hdfs://spark-nn.eemcs.utwente.nl/user/s1934538/clickstream/clickstream-enwiki-2023-08.tsv.gz,Chadwick_Boseman,36411,142846,887,180144,49869
hdfs://spark-nn.eemcs.utwente.nl/user/s1934538/clickstream/clickstream-enwiki-2023-08.tsv.gz,Louis_Tomlinson,23699,46371,175,70245,20481
hdfs://spark-nn.eemcs.utwente.nl/user/s1934538/clickstream/clickstream-enwiki-2023-08.tsv.gz,Kantara_(film),24864,87827,258,112949,38132
hdfs://spark-nn.eemcs.utwente.nl/user/s1934538/clickstream/clickstream-enwiki-2023-08.tsv.gz,Betty_White,50003,147207,1299,198509,50542
hdfs://spark-nn.eemcs.utwente.nl/user/s1934538/clickstream/clickstream-enwiki-2023-08.tsv.gz,Microsoft_Office,5488,195849,471,201808,16142
hdfs://spark-nn.eemcs.utwente.nl/user/s1934538/clickstream/clickstream-enwiki-2023-08.tsv.gz,Loki_(TV_series),33425,79719,2397,115541,71940
hdfs://spark-nn.eemcs.utwente.nl/user/s1934538/clickstream/clickstream-enwiki-2023-08.tsv.gz,Critical_race_theory,17022,75417,440,92879,10998
hdfs://spark-nn.eemcs.utwente.nl/user/s1934538/clickstream/clickstream-enwiki-2023-08.tsv.gz,Brahmāstra:_Part_One_–_Shiva,46069,85655,1886,133610,33043
hdfs://spark-nn.eemcs.utwente.nl/user/s1934538/clickstream/clickstream-enwiki-2023-08.tsv.gz,The_Sandman_(TV_series),36335,72792,1204,110331,70700
hdfs://spark-nn.eemcs.utwente.nl/user/s1934538/clickstream/clickstream-enwiki-2023-08.tsv.gz,ICC_Men's_T20_World_Cup,12432,111153,641,124226,46294
hdfs://spark-nn.eemcs.utwente.nl/user/s1934538/clickstream/clickstream-enwiki-2023-08.tsv.gz,Cameron_Boyce,24538,130298,413,155249,39814
hdfs://spark-nn.eemcs.utwente.nl/user/s1934538/clickstream/clickstream-enwiki-2023-08.tsv.gz,Spider-Man:_Far_From_Home,37524,51693,419,89636,36170
hdfs://spark-nn.eemcs.utwente.nl/user/s1934538/clickstream/clickstream-enwiki-2023-08.tsv.gz,The_Haunting_of_Bly_Manor,20520,38039,347,58906,32303
hdfs://spark-nn.eemcs.utwente.nl/user/s1934538/clickstream/clickstream-enwiki-2023-08.tsv.gz,Main_Page,89011,136016743,4724076,140829830,33363219
hdfs://spark-nn.eemcs.utwente.nl/user/s1934538/clickstream/clickstream-enwiki-2023-08.tsv.gz,Croatia,56739,214020,3180,273939,87929
hdfs://spark-nn.eemcs.utwente.nl/user/s1934538/clickstream/clickstream-enwiki-2023-08.tsv.gz,Stan_Lee,37074,101094,719,138887,45935
hdfs://spark-nn.eemcs.utwente.nl/user/s1934538/clickstream/clickstream-enwiki-2023-08.tsv.gz,Meat_Loaf,24115,98304,1019,123438,46113
hdfs://spark-nn.eemcs.utwente.nl/user/s1934538/clickstream/clickstream-enwiki-2023-08.tsv.gz,George_VI,258042,88239,527,346808,247092
hdfs://spark-nn.eemcs.utwente.nl/user/s1934538/clickstream/clickstream-enwiki-2023-08.tsv.gz,Richard_Jewell,9007,31415,281,40703,14995
hdfs://spark-nn.eemcs.utwente.nl/user/s1934538/clickstream/clickstream-enwiki-2023-08.tsv.gz,Tom_Brady,63089,406292,3927,473308,181441
hdfs://spark-nn.eemcs.utwente.nl/user/s1934538/clickstream/clickstream-enwiki-2023-08.tsv.gz,Vikram_(2022_film),72637,261781,747,335165,108364
hdfs://spark-nn.eemcs.utwente.nl/user/s1934538/clickstream/clickstream-enwiki-2023-08.tsv.gz,Pelé,41407,176421,1222,219050,78925
hdfs://spark-nn.eemcs.utwente.nl/user/s1934538/clickstream/clickstream-enwiki-2023-08.tsv.gz,Naomi_Osaka,22113,73330,352,95795,29778
hdfs://spark-nn.eemcs.utwente.nl/user/s1934538/clickstream/clickstream-enwiki-2023-08.tsv.gz,Mulan_(2020_film),20829,74652,845,96326,58394
hdfs://spark-nn.eemcs.utwente.nl/user/s1934538/clickstream/clickstream-enwiki-2023-08.tsv.gz,2020_United_States_presidential_election,188131,247337,5345,440813,423773
hdfs://spark-nn.eemcs.utwente.nl/user/s1934538/clickstream/clickstream-enwiki-2023-08.tsv.gz,The_Batman_(film),102477,231079,3451,337007,165343
hdfs://spark-nn.eemcs.utwente.nl/user/s1934538/clickstream/clickstream-enwiki-2023-08.tsv.gz,Saaho,25862,38109,35,64006,14332
hdfs://spark-nn.eemcs.utwente.nl/user/s1934538/clickstream/clickstream-enwiki-2023-08.tsv.gz,2018_Winter_Olympics,12149,12125,102,24376,16729
hdfs://spark-nn.eemcs.utwente.nl/user/s1934538/clickstream/clickstream-enwiki-2023-08.tsv.gz,Rihanna,69882,324193,3427,397502,201740
hdfs://spark-nn.eemcs.utwente.nl/user/s1934538/clickstream/clickstream-enwiki-2023-08.tsv.gz,Alexander_Hamilton,59307,158891,1198,219396,125264
hdfs://spark-nn.eemcs.utwente.nl/user/s1934538/clickstream/clickstream-enwiki-2023-08.tsv.gz,Bonnie_and_Clyde,22726,232667,1198,256591,63964
hdfs://spark-nn.eemcs.utwente.nl/user/s1934538/clickstream/clickstream-enwiki-2023-08.tsv.gz,Bob_Saget,28212,91845,617,120674,24114
hdfs://spark-nn.eemcs.utwente.nl/user/s1934538/clickstream/clickstream-enwiki-2023-08.tsv.gz,The_Shape_of_Water,21956,44935,436,67327,28264
hdfs://spark-nn.eemcs.utwente.nl/user/s1934538/clickstream/clickstream-enwiki-2023-08.tsv.gz,Brett_Kavanaugh,16052,17804,96,33952,14046
hdfs://spark-nn.eemcs.utwente.nl/user/s1934538/clickstream/clickstream-enwiki-2023-08.tsv.gz,The_Suicide_Squad_(film),81176,103241,1644,186061,102009
hdfs://spark-nn.eemcs.utwente.nl/user/s1934538/clickstream/clickstream-enwiki-2023-08.tsv.gz,2016_United_States_presidential_election,145521,95552,1405,242478,220901
hdfs://spark-nn.eemcs.utwente.nl/user/s1934538/clickstream/clickstream-enwiki-2023-08.tsv.gz,Game_of_Thrones,68386,328263,5923,402572,219929
hdfs://spark-nn.eemcs.utwente.nl/user/s1934538/clickstream/clickstream-enwiki-2023-08.tsv.gz,Gaza_Strip,18020,31020,215,49255,21132
hdfs://spark-nn.eemcs.utwente.nl/user/s1934538/clickstream/clickstream-enwiki-2023-08.tsv.gz,Notre-Dame_de_Paris,14435,79351,629,94415,20848
hdfs://spark-nn.eemcs.utwente.nl/user/s1934538/clickstream/clickstream-enwiki-2023-08.tsv.gz,Wikipedia,284833,1430651,770,1716254,739853
hdfs://spark-nn.eemcs.utwente.nl/user/s1934538/clickstream/clickstream-enwiki-2023-08.tsv.gz,WandaVision,19174,42742,687,62603,30667
hdfs://spark-nn.eemcs.utwente.nl/user/s1934538/clickstream/clickstream-enwiki-2023-08.tsv.gz,List_of_James_Bond_films,61242,357272,1474,419988,280112
hdfs://spark-nn.eemcs.utwente.nl/user/s1934538/clickstream/clickstream-enwiki-2023-08.tsv.gz,Khabib_Nurmagomedov,70387,240052,1560,311999,167735
hdfs://spark-nn.eemcs.utwente.nl/user/s1934538/clickstream/clickstream-enwiki-2023-08.tsv.gz,Salman_Rushdie,30451,69538,549,100538,55583
hdfs://spark-nn.eemcs.utwente.nl/user/s1934538/clickstream/clickstream-enwiki-2023-08.tsv.gz,Amber_Heard,144793,644280,3011,792084,401975
hdfs://spark-nn.eemcs.utwente.nl/user/s1934538/clickstream/clickstream-enwiki-2023-08.tsv.gz,Richard_Ramirez,14529,173272,1147,188948,54936
hdfs://spark-nn.eemcs.utwente.nl/user/s1934538/clickstream/clickstream-enwiki-2023-08.tsv.gz,1917_(2019_film),18569,55393,1090,75052,38800
hdfs://spark-nn.eemcs.utwente.nl/user/s1934538/clickstream/clickstream-enwiki-2023-08.tsv.gz,Stephen_Hawking,27726,327392,2208,357326,142437
hdfs://spark-nn.eemcs.utwente.nl/user/s1934538/clickstream/clickstream-enwiki-2023-08.tsv.gz,Afghanistan,113117,224698,4083,341898,257162
hdfs://spark-nn.eemcs.utwente.nl/user/s1934538/clickstream/clickstream-enwiki-2023-08.tsv.gz,21_Savage,19308,82436,552,102296,34585
hdfs://spark-nn.eemcs.utwente.nl/user/s1934538/clickstream/clickstream-enwiki-2023-08.tsv.gz,Zack_Snyder's_Justice_League,58219,79851,536,138606,56236
hdfs://spark-nn.eemcs.utwente.nl/user/s1934538/clickstream/clickstream-enwiki-2023-08.tsv.gz,Puneeth_Rajkumar,112875,198531,135,311541,125137
hdfs://spark-nn.eemcs.utwente.nl/user/s1934538/clickstream/clickstream-enwiki-2023-08.tsv.gz,Kamala_Harris,79418,183391,1431,264240,118170
hdfs://spark-nn.eemcs.utwente.nl/user/s1934538/clickstream/clickstream-enwiki-2023-08.tsv.gz,Sushant_Singh_Rajput,18038,102757,185,120980,52055
hdfs://spark-nn.eemcs.utwente.nl/user/s1934538/clickstream/clickstream-enwiki-2023-08.tsv.gz,Kobe_Bryant_sexual_assault_case,9737,44871,40,54648,5176
hdfs://spark-nn.eemcs.utwente.nl/user/s1934538/clickstream/clickstream-enwiki-2023-08.tsv.gz,No_Time_to_Die,92723,131270,1932,225925,121789
hdfs://spark-nn.eemcs.utwente.nl/user/s1934538/clickstream/clickstream-enwiki-2023-08.tsv.gz,The_Kashmir_Files,18716,56579,191,75486,26971
hdfs://spark-nn.eemcs.utwente.nl/user/s1934538/clickstream/clickstream-enwiki-2023-08.tsv.gz,Sinéad_O'Connor,50337,1476638,30560,1557535,572240
hdfs://spark-nn.eemcs.utwente.nl/user/s1934538/clickstream/clickstream-enwiki-2023-08.tsv.gz,Ponniyin_Selvan:_I,47203,92574,407,140184,59297
hdfs://spark-nn.eemcs.utwente.nl/user/s1934538/clickstream/clickstream-enwiki-2023-08.tsv.gz,Cristiano_Ronaldo,207767,1600345,8052,1816164,447435
hdfs://spark-nn.eemcs.utwente.nl/user/s1934538/clickstream/clickstream-enwiki-2023-08.tsv.gz,Godzilla_vs._Kong,38826,63343,846,103015,55734
hdfs://spark-nn.eemcs.utwente.nl/user/s1934538/clickstream/clickstream-enwiki-2023-08.tsv.gz,Dennis_Nilsen,13793,45432,330,59555,15972
hdfs://spark-nn.eemcs.utwente.nl/user/s1934538/clickstream/clickstream-enwiki-2023-08.tsv.gz,2018_FIFA_World_Cup,85768,55907,733,142408,101987
hdfs://spark-nn.eemcs.utwente.nl/user/s1934538/clickstream/clickstream-enwiki-2023-08.tsv.gz,State_of_Palestine,55696,99896,792,156384,73933
hdfs://spark-nn.eemcs.utwente.nl/user/s1934538/clickstream/clickstream-enwiki-2023-08.tsv.gz,Death_of_Elisa_Lam,8529,43860,146,52535,17825
hdfs://spark-nn.eemcs.utwente.nl/user/s1934538/clickstream/clickstream-enwiki-2023-08.tsv.gz,The_Flash_(film),115793,873569,17075,1006437,489810
hdfs://spark-nn.eemcs.utwente.nl/user/s1934538/clickstream/clickstream-enwiki-2023-08.tsv.gz,The_Weeknd,76314,307425,2523,386262,166698
hdfs://spark-nn.eemcs.utwente.nl/user/s1934538/clickstream/clickstream-enwiki-2023-08.tsv.gz,Luke_Perry,55251,117454,551,173256,68476
hdfs://spark-nn.eemcs.utwente.nl/user/s1934538/clickstream/clickstream-enwiki-2023-08.tsv.gz,2023_Cricket_World_Cup,50077,490286,889,541252,96951
hdfs://spark-nn.eemcs.utwente.nl/user/s1934538/clickstream/clickstream-enwiki-2023-08.tsv.gz,List_of_Marvel_Cinematic_Universe_films,149546,485843,1822,637211,425685
hdfs://spark-nn.eemcs.utwente.nl/user/s1934538/clickstream/clickstream-enwiki-2023-08.tsv.gz,Google_logo,1577,22816,14,24407,1691
hdfs://spark-nn.eemcs.utwente.nl/user/s1934538/clickstream/clickstream-enwiki-2023-08.tsv.gz,Game_of_Thrones_(season_8),14707,54779,402,69888,20702
hdfs://spark-nn.eemcs.utwente.nl/user/s1934538/clickstream/clickstream-enwiki-2023-08.tsv.gz,Sushma_Swaraj,10650,39509,81,50240,15406
hdfs://spark-nn.eemcs.utwente.nl/user/s1934538/clickstream/clickstream-enwiki-2023-08.tsv.gz,Animal_(2023_film),47404,50591,194,98189,43038
hdfs://spark-nn.eemcs.utwente.nl/user/s1934538/clickstream/clickstream-enwiki-2023-08.tsv.gz,Bird_Box_(film),19731,97591,841,118163,51501
hdfs://spark-nn.eemcs.utwente.nl/user/s1934538/clickstream/clickstream-enwiki-2023-08.tsv.gz,XXX:_Return_of_Xander_Cage,59609,4073126,1374,4134109,165944
hdfs://spark-nn.eemcs.utwente.nl/user/s1934538/clickstream/clickstream-enwiki-2023-08.tsv.gz,The_Queen's_Gambit_(miniseries),15126,100445,785,116356,52359
hdfs://spark-nn.eemcs.utwente.nl/user/s1934538/clickstream/clickstream-enwiki-2023-08.tsv.gz,Aquaman_(film),34880,82026,862,117768,48061
hdfs://spark-nn.eemcs.utwente.nl/user/s1934538/clickstream/clickstream-enwiki-2023-08.tsv.gz,Avengers:_Infinity_War,45144,68732,840,114716,53016
hdfs://spark-nn.eemcs.utwente.nl/user/s1934538/clickstream/clickstream-enwiki-2023-08.tsv.gz,Bipin_Rawat,7740,19795,49,27584,11277
hdfs://spark-nn.eemcs.utwente.nl/user/s1934538/clickstream/clickstream-enwiki-2023-08.tsv.gz,Michael_Bloomberg,45809,45401,235,91445,47154
hdfs://spark-nn.eemcs.utwente.nl/user/s1934538/clickstream/clickstream-enwiki-2023-08.tsv.gz,Aaron_Carter,32071,112710,759,145540,93805
hdfs://spark-nn.eemcs.utwente.nl/user/s1934538/clickstream/clickstream-enwiki-2023-08.tsv.gz,A_Star_Is_Born_(2018_film),28327,74488,517,103332,50562
hdfs://spark-nn.eemcs.utwente.nl/user/s1934538/clickstream/clickstream-enwiki-2023-08.tsv.gz,Leave_the_World_Behind_(film),14227,5975,59,20261,6204
hdfs://spark-nn.eemcs.utwente.nl/user/s1934538/clickstream/clickstream-enwiki-2023-08.tsv.gz,When_They_See_Us,12858,28834,178,41870,18766
hdfs://spark-nn.eemcs.utwente.nl/user/s1934538/clickstream/clickstream-enwiki-2023-08.tsv.gz,Key_frame,577,2753,11,3341,295
hdfs://spark-nn.eemcs.utwente.nl/user/s1934538/clickstream/clickstream-enwiki-2023-08.tsv.gz,Area_51,19285,141187,1348,161820,53631
hdfs://spark-nn.eemcs.utwente.nl/user/s1934538/clickstream/clickstream-enwiki-2023-10.tsv.gz,Croatia,50791,159718,1955,212464,67917
hdfs://spark-nn.eemcs.utwente.nl/user/s1934538/clickstream/clickstream-enwiki-2023-10.tsv.gz,Donald_Glover,38606,113101,663,152370,66646
hdfs://spark-nn.eemcs.utwente.nl/user/s1934538/clickstream/clickstream-enwiki-2023-10.tsv.gz,Indian_Premier_League,27450,84405,296,112151,61819
hdfs://spark-nn.eemcs.utwente.nl/user/s1934538/clickstream/clickstream-enwiki-2023-10.tsv.gz,Kobe_Bryant,48065,286889,2053,337007,96602
hdfs://spark-nn.eemcs.utwente.nl/user/s1934538/clickstream/clickstream-enwiki-2023-10.tsv.gz,2023_Indian_Premier_League,9995,56758,88,66841,14561
hdfs://spark-nn.eemcs.utwente.nl/user/s1934538/clickstream/clickstream-enwiki-2023-10.tsv.gz,"Diana,_Princess_of_Wales",102277,225271,2011,329559,182458
hdfs://spark-nn.eemcs.utwente.nl/user/s1934538/clickstream/clickstream-enwiki-2023-10.tsv.gz,Cleopatra,67628,4971333,2248,5041209,462419
hdfs://spark-nn.eemcs.utwente.nl/user/s1934538/clickstream/clickstream-enwiki-2023-10.tsv.gz,2020_United_States_presidential_election,136643,150442,3204,290289,283486
hdfs://spark-nn.eemcs.utwente.nl/user/s1934538/clickstream/clickstream-enwiki-2023-10.tsv.gz,XNXX,10883,1093176,9115,1113174,56743
hdfs://spark-nn.eemcs.utwente.nl/user/s1934538/clickstream/clickstream-enwiki-2023-10.tsv.gz,Darth_Vader,33262,72691,694,106647,69941
hdfs://spark-nn.eemcs.utwente.nl/user/s1934538/clickstream/clickstream-enwiki-2023-10.tsv.gz,Salman_Rushdie,34746,104014,977,139737,83327
hdfs://spark-nn.eemcs.utwente.nl/user/s1934538/clickstream/clickstream-enwiki-2023-10.tsv.gz,Vikram_(2022_film),174312,313570,533,488415,164724
hdfs://spark-nn.eemcs.utwente.nl/user/s1934538/clickstream/clickstream-enwiki-2023-10.tsv.gz,George_H._W._Bush,168781,134003,897,303681,182394
hdfs://spark-nn.eemcs.utwente.nl/user/s1934538/clickstream/clickstream-enwiki-2023-10.tsv.gz,Saaho,21377,31894,62,53333,13413
hdfs://spark-nn.eemcs.utwente.nl/user/s1934538/clickstream/clickstream-enwiki-2023-10.tsv.gz,Anne_Heche,40956,132449,854,174259,65019
hdfs://spark-nn.eemcs.utwente.nl/user/s1934538/clickstream/clickstream-enwiki-2023-10.tsv.gz,David_Beckham,778731,5953209,27498,6759438,2982597
hdfs://spark-nn.eemcs.utwente.nl/user/s1934538/clickstream/clickstream-enwiki-2023-10.tsv.gz,The_Flash_(film),51392,225564,3559,280515,117904
hdfs://spark-nn.eemcs.utwente.nl/user/s1934538/clickstream/clickstream-enwiki-2023-10.tsv.gz,Spider-Man:_No_Way_Home,74690,136727,1622,213039,102014
hdfs://spark-nn.eemcs.utwente.nl/user/s1934538/clickstream/clickstream-enwiki-2023-10.tsv.gz,2022_FIFA_World_Cup,162516,232924,2806,398246,220592
hdfs://spark-nn.eemcs.utwente.nl/user/s1934538/clickstream/clickstream-enwiki-2023-10.tsv.gz,Stranger_Things_(season_3),8995,17054,118,26167,14193
hdfs://spark-nn.eemcs.utwente.nl/user/s1934538/clickstream/clickstream-enwiki-2023-10.tsv.gz,Roe_v._Wade,11606,80949,425,92980,27933
hdfs://spark-nn.eemcs.utwente.nl/user/s1934538/clickstream/clickstream-enwiki-2023-10.tsv.gz,QAnon,55689,101131,912,157732,51228
hdfs://spark-nn.eemcs.utwente.nl/user/s1934538/clickstream/clickstream-enwiki-2023-10.tsv.gz,Jason_Momoa,64557,344363,2115,411035,169460
hdfs://spark-nn.eemcs.utwente.nl/user/s1934538/clickstream/clickstream-enwiki-2023-10.tsv.gz,Venom_(2018_film),17393,80571,946,98910,43106
hdfs://spark-nn.eemcs.utwente.nl/user/s1934538/clickstream/clickstream-enwiki-2023-10.tsv.gz,2016_United_States_presidential_election,103896,72922,957,177775,157359
hdfs://spark-nn.eemcs.utwente.nl/user/s1934538/clickstream/clickstream-enwiki-2023-10.tsv.gz,Manti_Te'o,5253,45322,169,50744,6370
hdfs://spark-nn.eemcs.utwente.nl/user/s1934538/clickstream/clickstream-enwiki-2023-10.tsv.gz,Fantastic_Beasts:_The_Crimes_of_Grindelwald,30349,30758,235,61342,33459
hdfs://spark-nn.eemcs.utwente.nl/user/s1934538/clickstream/clickstream-enwiki-2023-10.tsv.gz,Bridgerton,44718,105824,1619,152161,102504
hdfs://spark-nn.eemcs.utwente.nl/user/s1934538/clickstream/clickstream-enwiki-2023-10.tsv.gz,Juneteenth,6545,39173,129,45847,4186
hdfs://spark-nn.eemcs.utwente.nl/user/s1934538/clickstream/clickstream-enwiki-2023-10.tsv.gz,Elliot_Page,52852,189701,905,243458,130221
hdfs://spark-nn.eemcs.utwente.nl/user/s1934538/clickstream/clickstream-enwiki-2023-10.tsv.gz,J._Robert_Oppenheimer,87838,360741,2950,451529,193816
hdfs://spark-nn.eemcs.utwente.nl/user/s1934538/clickstream/clickstream-enwiki-2023-10.tsv.gz,Naomi_Osaka,13696,49417,565,63678,17909
hdfs://spark-nn.eemcs.utwente.nl/user/s1934538/clickstream/clickstream-enwiki-2023-10.tsv.gz,The_Matrix_Resurrections,50097,71168,986,122251,58702
hdfs://spark-nn.eemcs.utwente.nl/user/s1934538/clickstream/clickstream-enwiki-2023-10.tsv.gz,Bob_Saget,34705,156388,1239,192332,33851
hdfs://spark-nn.eemcs.utwente.nl/user/s1934538/clickstream/clickstream-enwiki-2023-10.tsv.gz,Carlos_Alcaraz,16692,83591,291,100574,20825
hdfs://spark-nn.eemcs.utwente.nl/user/s1934538/clickstream/clickstream-enwiki-2023-10.tsv.gz,No_Time_to_Die,81717,101109,1296,184122,98541
hdfs://spark-nn.eemcs.utwente.nl/user/s1934538/clickstream/clickstream-enwiki-2023-10.tsv.gz,Antifa_(United_States),11709,54503,262,66474,11598
hdfs://spark-nn.eemcs.utwente.nl/user/s1934538/clickstream/clickstream-enwiki-2023-10.tsv.gz,September_11_attacks,126474,370883,9035,506392,331161
hdfs://spark-nn.eemcs.utwente.nl/user/s1934538/clickstream/clickstream-enwiki-2023-10.tsv.gz,The_Haunting_of_Bly_Manor,105163,153930,1204,260297,156322
hdfs://spark-nn.eemcs.utwente.nl/user/s1934538/clickstream/clickstream-enwiki-2023-10.tsv.gz,Lionel_Messi,201824,1288520,8869,1499213,363398
hdfs://spark-nn.eemcs.utwente.nl/user/s1934538/clickstream/clickstream-enwiki-2023-10.tsv.gz,The_Irishman,95307,112923,1491,209721,149912
hdfs://spark-nn.eemcs.utwente.nl/user/s1934538/clickstream/clickstream-enwiki-2023-10.tsv.gz,United_States_Electoral_College,14976,36337,97,51410,8936
hdfs://spark-nn.eemcs.utwente.nl/user/s1934538/clickstream/clickstream-enwiki-2023-10.tsv.gz,2023_Israel–Hamas_war,2814471,4795593,32203,7642267,3702252
hdfs://spark-nn.eemcs.utwente.nl/user/s1934538/clickstream/clickstream-enwiki-2023-10.tsv.gz,2023_Asia_Cup,23424,238595,497,262516,26942
hdfs://spark-nn.eemcs.utwente.nl/user/s1934538/clickstream/clickstream-enwiki-2023-10.tsv.gz,Saltburn_(film),51191,166783,2490,220464,117155
hdfs://spark-nn.eemcs.utwente.nl/user/s1934538/clickstream/clickstream-enwiki-2023-10.tsv.gz,Cristiano_Ronaldo,187731,1571553,7479,1766763,411916
hdfs://spark-nn.eemcs.utwente.nl/user/s1934538/clickstream/clickstream-enwiki-2023-10.tsv.gz,Kate_Spade,25617,47790,264,73671,24574
hdfs://spark-nn.eemcs.utwente.nl/user/s1934538/clickstream/clickstream-enwiki-2023-10.tsv.gz,Black_Widow_(2021_film),27630,76262,850,104742,40597
hdfs://spark-nn.eemcs.utwente.nl/user/s1934538/clickstream/clickstream-enwiki-2023-10.tsv.gz,Jailer_(2023_Tamil_film),79021,536489,4190,619700,181000
hdfs://spark-nn.eemcs.utwente.nl/user/s1934538/clickstream/clickstream-enwiki-2023-10.tsv.gz,Rami_Malek,49267,160805,790,210862,78408
hdfs://spark-nn.eemcs.utwente.nl/user/s1934538/clickstream/clickstream-enwiki-2023-10.tsv.gz,Spider-Man:_Across_the_Spider-Verse,114598,324988,5575,445161,250180
hdfs://spark-nn.eemcs.utwente.nl/user/s1934538/clickstream/clickstream-enwiki-2023-10.tsv.gz,War_(2019_film),75263,64227,154,139644,37817
hdfs://spark-nn.eemcs.utwente.nl/user/s1934538/clickstream/clickstream-enwiki-2023-10.tsv.gz,The_Kerala_Story,21359,82393,266,104018,19855
hdfs://spark-nn.eemcs.utwente.nl/user/s1934538/clickstream/clickstream-enwiki-2023-10.tsv.gz,2018_FIFA_World_Cup,77441,53516,626,131583,89433
hdfs://spark-nn.eemcs.utwente.nl/user/s1934538/clickstream/clickstream-enwiki-2023-10.tsv.gz,House_of_the_Dragon,40778,194467,3586,238831,125224
hdfs://spark-nn.eemcs.utwente.nl/user/s1934538/clickstream/clickstream-enwiki-2023-10.tsv.gz,Ruth_Bader_Ginsburg,14581,93774,435,108790,30903
hdfs://spark-nn.eemcs.utwente.nl/user/s1934538/clickstream/clickstream-enwiki-2023-10.tsv.gz,Bird_Box_(film),12384,53057,436,65877,28070
hdfs://spark-nn.eemcs.utwente.nl/user/s1934538/clickstream/clickstream-enwiki-2023-10.tsv.gz,State_of_Palestine,1408332,5212774,6168,6627274,2516696
hdfs://spark-nn.eemcs.utwente.nl/user/s1934538/clickstream/clickstream-enwiki-2023-10.tsv.gz,Pelé,38458,174265,1320,214043,67792
hdfs://spark-nn.eemcs.utwente.nl/user/s1934538/clickstream/clickstream-enwiki-2023-10.tsv.gz,NATO,64574,216049,5025,285648,119556
hdfs://spark-nn.eemcs.utwente.nl/user/s1934538/clickstream/clickstream-enwiki-2023-10.tsv.gz,Mac_Miller,23714,122181,961,146856,42545
hdfs://spark-nn.eemcs.utwente.nl/user/s1934538/clickstream/clickstream-enwiki-2023-10.tsv.gz,Watts_family_murders,5213,289298,321,294832,53365
hdfs://spark-nn.eemcs.utwente.nl/user/s1934538/clickstream/clickstream-enwiki-2023-10.tsv.gz,Notre-Dame_de_Paris,14753,80035,752,95540,21149
hdfs://spark-nn.eemcs.utwente.nl/user/s1934538/clickstream/clickstream-enwiki-2023-10.tsv.gz,Article_370_of_the_Constitution_of_India,2532,41883,34,44449,2263
hdfs://spark-nn.eemcs.utwente.nl/user/s1934538/clickstream/clickstream-enwiki-2023-10.tsv.gz,Game_of_Thrones_(season_8),11928,69436,359,81723,16315
hdfs://spark-nn.eemcs.utwente.nl/user/s1934538/clickstream/clickstream-enwiki-2023-10.tsv.gz,YouTube,134006,6562027,12108,6708141,130712
hdfs://spark-nn.eemcs.utwente.nl/user/s1934538/clickstream/clickstream-enwiki-2023-10.tsv.gz,It_Chapter_Two,44767,101689,958,147414,102385
hdfs://spark-nn.eemcs.utwente.nl/user/s1934538/clickstream/clickstream-enwiki-2023-10.tsv.gz,Anthony_Bourdain,22611,184733,1355,208699,90031
hdfs://spark-nn.eemcs.utwente.nl/user/s1934538/clickstream/clickstream-enwiki-2023-10.tsv.gz,Richard_Ramirez,15080,161972,1199,178251,52510
hdfs://spark-nn.eemcs.utwente.nl/user/s1934538/clickstream/clickstream-enwiki-2023-10.tsv.gz,The_Mandalorian,52287,115478,2765,170530,115533
hdfs://spark-nn.eemcs.utwente.nl/user/s1934538/clickstream/clickstream-enwiki-2023-10.tsv.gz,Glass_(2019_film),43699,48923,570,93192,29766
hdfs://spark-nn.eemcs.utwente.nl/user/s1934538/clickstream/clickstream-enwiki-2023-10.tsv.gz,Dennis_Nilsen,8699,42108,302,51109,11546
hdfs://spark-nn.eemcs.utwente.nl/user/s1934538/clickstream/clickstream-enwiki-2023-10.tsv.gz,Joaquin_Phoenix,138136,217150,1512,356798,234811
hdfs://spark-nn.eemcs.utwente.nl/user/s1934538/clickstream/clickstream-enwiki-2023-10.tsv.gz,2020_Summer_Olympics,76003,77988,1017,155008,142890
hdfs://spark-nn.eemcs.utwente.nl/user/s1934538/clickstream/clickstream-enwiki-2023-10.tsv.gz,Hamas,1337891,6587098,107810,8032799,4408674
hdfs://spark-nn.eemcs.utwente.nl/user/s1934538/clickstream/clickstream-enwiki-2023-10.tsv.gz,Keanu_Reeves,83518,439603,3054,526175,313374
hdfs://spark-nn.eemcs.utwente.nl/user/s1934538/clickstream/clickstream-enwiki-2023-10.tsv.gz,Coronavirus,5299,34223,356,39878,9622
hdfs://spark-nn.eemcs.utwente.nl/user/s1934538/clickstream/clickstream-enwiki-2023-10.tsv.gz,Kantara_(film),14508,86169,253,100930,35443
hdfs://spark-nn.eemcs.utwente.nl/user/s1934538/clickstream/clickstream-enwiki-2023-10.tsv.gz,The_Witcher_(TV_series),23045,191517,3251,217813,98639
hdfs://spark-nn.eemcs.utwente.nl/user/s1934538/clickstream/clickstream-enwiki-2023-10.tsv.gz,Cardi_B,33093,292019,3047,328159,90793
hdfs://spark-nn.eemcs.utwente.nl/user/s1934538/clickstream/clickstream-enwiki-2023-10.tsv.gz,Russo-Ukrainian_War,89127,439260,4963,533350,311183
hdfs://spark-nn.eemcs.utwente.nl/user/s1934538/clickstream/clickstream-enwiki-2023-10.tsv.gz,Cook's_Country,395,3108,32,3535,505
hdfs://spark-nn.eemcs.utwente.nl/user/s1934538/clickstream/clickstream-enwiki-2023-10.tsv.gz,Deadpool_2,26072,36674,519,63265,38110
hdfs://spark-nn.eemcs.utwente.nl/user/s1934538/clickstream/clickstream-enwiki-2023-10.tsv.gz,Bible,28143,117426,1680,147249,45799
hdfs://spark-nn.eemcs.utwente.nl/user/s1934538/clickstream/clickstream-enwiki-2023-10.tsv.gz,Queen_(band),45439,170714,2543,218696,215268
hdfs://spark-nn.eemcs.utwente.nl/user/s1934538/clickstream/clickstream-enwiki-2023-10.tsv.gz,Irrfan_Khan,24324,61172,134,85630,30956
hdfs://spark-nn.eemcs.utwente.nl/user/s1934538/clickstream/clickstream-enwiki-2023-10.tsv.gz,Betty_White,41937,88113,822,130872,35142
hdfs://spark-nn.eemcs.utwente.nl/user/s1934538/clickstream/clickstream-enwiki-2023-10.tsv.gz,Once_Upon_a_Time_in_Hollywood,88673,109315,1534,199522,160524
hdfs://spark-nn.eemcs.utwente.nl/user/s1934538/clickstream/clickstream-enwiki-2023-10.tsv.gz,Pornhub,62120,523817,13281,599218,91497
hdfs://spark-nn.eemcs.utwente.nl/user/s1934538/clickstream/clickstream-enwiki-2023-10.tsv.gz,The_Super_Mario_Bros._Movie,71296,246170,2329,319795,102718
hdfs://spark-nn.eemcs.utwente.nl/user/s1934538/clickstream/clickstream-enwiki-2023-10.tsv.gz,Matthew_Perry,509914,11304528,107504,11921946,4374559
hdfs://spark-nn.eemcs.utwente.nl/user/s1934538/clickstream/clickstream-enwiki-2023-10.tsv.gz,Black_Panther:_Wakanda_Forever,38737,71216,1118,111071,65148
hdfs://spark-nn.eemcs.utwente.nl/user/s1934538/clickstream/clickstream-enwiki-2023-10.tsv.gz,Everything_Everywhere_All_at_Once,70172,152899,1738,224809,92883
hdfs://spark-nn.eemcs.utwente.nl/user/s1934538/clickstream/clickstream-enwiki-2023-10.tsv.gz,Brahmāstra:_Part_One_–_Shiva,38970,75985,149,115104,29513
hdfs://spark-nn.eemcs.utwente.nl/user/s1934538/clickstream/clickstream-enwiki-2023-10.tsv.gz,Tiger_3,99586,433202,5148,537936,266810
hdfs://spark-nn.eemcs.utwente.nl/user/s1934538/clickstream/clickstream-enwiki-2023-10.tsv.gz,Nipsey_Hussle,20161,63440,340,83941,27160
hdfs://spark-nn.eemcs.utwente.nl/user/s1934538/clickstream/clickstream-enwiki-2023-10.tsv.gz,21_Savage,19437,129872,1079,150388,50325
hdfs://spark-nn.eemcs.utwente.nl/user/s1934538/clickstream/clickstream-enwiki-2023-10.tsv.gz,Parasite_(2019_film),26704,135389,1046,163139,66146
hdfs://spark-nn.eemcs.utwente.nl/user/s1934538/clickstream/clickstream-enwiki-2023-10.tsv.gz,2018_Asian_Games,125034,90364,275,215673,156676
hdfs://spark-nn.eemcs.utwente.nl/user/s1934538/clickstream/clickstream-enwiki-2023-10.tsv.gz,Elon_Musk,103914,1060235,13464,1177613,595499
hdfs://spark-nn.eemcs.utwente.nl/user/s1934538/clickstream/clickstream-enwiki-2023-10.tsv.gz,Chadwick_Boseman,27424,99955,591,127970,37960
hdfs://spark-nn.eemcs.utwente.nl/user/s1934538/clickstream/clickstream-enwiki-2023-10.tsv.gz,Hyphen-minus,905,5448905,21858,5471668,899
hdfs://spark-nn.eemcs.utwente.nl/user/s1934538/clickstream/clickstream-enwiki-2023-10.tsv.gz,JSON_Web_Token,692,23372,37,24101,1724
hdfs://spark-nn.eemcs.utwente.nl/user/s1934538/clickstream/clickstream-enwiki-2023-10.tsv.gz,Tom_Brady,80795,381435,7307,469537,206965
hdfs://spark-nn.eemcs.utwente.nl/user/s1934538/clickstream/clickstream-enwiki-2023-10.tsv.gz,Brie_Larson,93128,403135,2391,498654,215973
hdfs://spark-nn.eemcs.utwente.nl/user/s1934538/clickstream/clickstream-enwiki-2023-10.tsv.gz,Chernobyl_(miniseries),18516,51571,1118,71205,84041
hdfs://spark-nn.eemcs.utwente.nl/user/s1934538/clickstream/clickstream-enwiki-2023-10.tsv.gz,Tina_Turner,21803,251896,2097,275796,78060
hdfs://spark-nn.eemcs.utwente.nl/user/s1934538/clickstream/clickstream-enwiki-2023-10.tsv.gz,Valentine's_Day,3802,45227,164,49193,4027
hdfs://spark-nn.eemcs.utwente.nl/user/s1934538/clickstream/clickstream-enwiki-2023-10.tsv.gz,Luke_Perry,45219,280229,3782,329230,105633
hdfs://spark-nn.eemcs.utwente.nl/user/s1934538/clickstream/clickstream-enwiki-2023-10.tsv.gz,FIFA_World_Cup,86790,529217,6129,622136,245013
hdfs://spark-nn.eemcs.utwente.nl/user/s1934538/clickstream/clickstream-enwiki-2023-10.tsv.gz,Naya_Rivera,39098,54640,215,93953,42749
hdfs://spark-nn.eemcs.utwente.nl/user/s1934538/clickstream/clickstream-enwiki-2023-10.tsv.gz,Tenet_(film),53618,94050,988,148656,65282
hdfs://spark-nn.eemcs.utwente.nl/user/s1934538/clickstream/clickstream-enwiki-2023-10.tsv.gz,Johnny_Depp,113178,288595,2966,404739,252779
hdfs://spark-nn.eemcs.utwente.nl/user/s1934538/clickstream/clickstream-enwiki-2023-10.tsv.gz,Google_logo,1812,23353,41,25206,1918
hdfs://spark-nn.eemcs.utwente.nl/user/s1934538/clickstream/clickstream-enwiki-2023-10.tsv.gz,Mötley_Crüe,26788,80857,1183,108828,125244
hdfs://spark-nn.eemcs.utwente.nl/user/s1934538/clickstream/clickstream-enwiki-2023-10.tsv.gz,XXXTentacion,43257,1114953,5041,1163251,81411
hdfs://spark-nn.eemcs.utwente.nl/user/s1934538/clickstream/clickstream-enwiki-2023-10.tsv.gz,Joe_Biden,202356,749591,9188,961135,390258
hdfs://spark-nn.eemcs.utwente.nl/user/s1934538/clickstream/clickstream-enwiki-2023-10.tsv.gz,Ray_Liotta,61673,210004,1749,273426,104553
hdfs://spark-nn.eemcs.utwente.nl/user/s1934538/clickstream/clickstream-enwiki-2023-10.tsv.gz,When_They_See_Us,11077,16427,104,27608,11706
hdfs://spark-nn.eemcs.utwente.nl/user/s1934538/clickstream/clickstream-enwiki-2023-10.tsv.gz,Burt_Reynolds,49779,105721,925,156425,83156
hdfs://spark-nn.eemcs.utwente.nl/user/s1934538/clickstream/clickstream-enwiki-2023-10.tsv.gz,Sridevi,32000,119936,170,152106,58571
hdfs://spark-nn.eemcs.utwente.nl/user/s1934538/clickstream/clickstream-enwiki-2023-10.tsv.gz,Loki_(TV_series),131244,589694,19095,740033,493491
hdfs://spark-nn.eemcs.utwente.nl/user/s1934538/clickstream/clickstream-enwiki-2023-10.tsv.gz,Lance_Reddick,76697,195875,1316,273888,64804
hdfs://spark-nn.eemcs.utwente.nl/user/s1934538/clickstream/clickstream-enwiki-2023-10.tsv.gz,Jawan_(film),205961,2711665,16514,2934140,900686
hdfs://spark-nn.eemcs.utwente.nl/user/s1934538/clickstream/clickstream-enwiki-2023-10.tsv.gz,Vladimir_Putin,99526,531180,5652,636358,277201
hdfs://spark-nn.eemcs.utwente.nl/user/s1934538/clickstream/clickstream-enwiki-2023-10.tsv.gz,2023_Cricket_World_Cup,356828,15568431,16719,15941978,742359
hdfs://spark-nn.eemcs.utwente.nl/user/s1934538/clickstream/clickstream-enwiki-2023-10.tsv.gz,Murder_of_Dee_Dee_Blanchard,12577,163545,740,176862,41921
hdfs://spark-nn.eemcs.utwente.nl/user/s1934538/clickstream/clickstream-enwiki-2023-10.tsv.gz,Fyre_Festival,5625,39849,480,45954,21648
hdfs://spark-nn.eemcs.utwente.nl/user/s1934538/clickstream/clickstream-enwiki-2023-10.tsv.gz,Greta_Thunberg,11447,254067,2433,267947,72529
hdfs://spark-nn.eemcs.utwente.nl/user/s1934538/clickstream/clickstream-enwiki-2023-10.tsv.gz,1917_(2019_film),14308,43519,708,58535,27556
hdfs://spark-nn.eemcs.utwente.nl/user/s1934538/clickstream/clickstream-enwiki-2023-10.tsv.gz,Amy_Coney_Barrett,17933,29040,192,47165,14813
hdfs://spark-nn.eemcs.utwente.nl/user/s1934538/clickstream/clickstream-enwiki-2023-10.tsv.gz,Death_of_Elisa_Lam,8945,46856,184,55985,17793
hdfs://spark-nn.eemcs.utwente.nl/user/s1934538/clickstream/clickstream-enwiki-2023-10.tsv.gz,Spanish_flu,18585,54617,456,73658,19590
hdfs://spark-nn.eemcs.utwente.nl/user/s1934538/clickstream/clickstream-enwiki-2023-10.tsv.gz,Alexander_Hamilton,63360,174549,1179,239088,134587
hdfs://spark-nn.eemcs.utwente.nl/user/s1934538/clickstream/clickstream-enwiki-2023-10.tsv.gz,Stranger_Things,54455,262548,5277,322280,227351
hdfs://spark-nn.eemcs.utwente.nl/user/s1934538/clickstream/clickstream-enwiki-2023-10.tsv.gz,Kobe_Bryant_sexual_assault_case,6120,29279,39,35438,3198
hdfs://spark-nn.eemcs.utwente.nl/user/s1934538/clickstream/clickstream-enwiki-2023-10.tsv.gz,Gaza_Strip,1075893,7028458,75283,8179634,2760657
hdfs://spark-nn.eemcs.utwente.nl/user/s1934538/clickstream/clickstream-enwiki-2023-10.tsv.gz,Joe_Exotic,22967,56396,184,79547,32851
hdfs://spark-nn.eemcs.utwente.nl/user/s1934538/clickstream/clickstream-enwiki-2023-10.tsv.gz,Jimmy_Hoffa,30894,99703,729,131326,51322
hdfs://spark-nn.eemcs.utwente.nl/user/s1934538/clickstream/clickstream-enwiki-2023-10.tsv.gz,List_of_highest-grossing_films,111724,319549,1691,432964,206414
hdfs://spark-nn.eemcs.utwente.nl/user/s1934538/clickstream/clickstream-enwiki-2023-10.tsv.gz,Game_of_Thrones,58682,298418,4472,361572,184918
hdfs://spark-nn.eemcs.utwente.nl/user/s1934538/clickstream/clickstream-enwiki-2023-10.tsv.gz,Ghislaine_Maxwell,47530,82399,304,130233,57535
hdfs://spark-nn.eemcs.utwente.nl/user/s1934538/clickstream/clickstream-enwiki-2023-10.tsv.gz,Shang-Chi_and_the_Legend_of_the_Ten_Rings,29727,63533,499,93759,41957
hdfs://spark-nn.eemcs.utwente.nl/user/s1934538/clickstream/clickstream-enwiki-2023-10.tsv.gz,Line_shaft,267,749,10,1026,127
hdfs://spark-nn.eemcs.utwente.nl/user/s1934538/clickstream/clickstream-enwiki-2023-10.tsv.gz,Asia_Cup,15277,184097,145,199519,31837
hdfs://spark-nn.eemcs.utwente.nl/user/s1934538/clickstream/clickstream-enwiki-2023-10.tsv.gz,The_Falcon_and_the_Winter_Soldier,13687,18110,279,32076,16793
hdfs://spark-nn.eemcs.utwente.nl/user/s1934538/clickstream/clickstream-enwiki-2023-10.tsv.gz,Stranger_Things_(season_4),18498,60419,579,79496,43436
hdfs://spark-nn.eemcs.utwente.nl/user/s1934538/clickstream/clickstream-enwiki-2023-10.tsv.gz,The_Nun_(2018_film),88588,412240,4081,504909,265030
hdfs://spark-nn.eemcs.utwente.nl/user/s1934538/clickstream/clickstream-enwiki-2023-10.tsv.gz,Aaron_Hernandez,13146,102091,757,115994,47636
hdfs://spark-nn.eemcs.utwente.nl/user/s1934538/clickstream/clickstream-enwiki-2023-10.tsv.gz,Captain_Marvel_(film),28996,71489,873,101358,42386
hdfs://spark-nn.eemcs.utwente.nl/user/s1934538/clickstream/clickstream-enwiki-2023-10.tsv.gz,Charles_III,328850,209439,2395,540684,357522
hdfs://spark-nn.eemcs.utwente.nl/user/s1934538/clickstream/clickstream-enwiki-2023-10.tsv.gz,Ant-Man_and_the_Wasp:_Quantumania,59061,91813,1822,152696,86321
hdfs://spark-nn.eemcs.utwente.nl/user/s1934538/clickstream/clickstream-enwiki-2023-10.tsv.gz,Michael_Bloomberg,32468,38557,232,71257,31551
hdfs://spark-nn.eemcs.utwente.nl/user/s1934538/clickstream/clickstream-enwiki-2023-10.tsv.gz,Stephen_Hawking,22831,310473,1915,335219,126318
hdfs://spark-nn.eemcs.utwente.nl/user/s1934538/clickstream/clickstream-enwiki-2023-10.tsv.gz,Doctor_Strange_in_the_Multiverse_of_Madness,53374,88881,1394,143649,59324
hdfs://spark-nn.eemcs.utwente.nl/user/s1934538/clickstream/clickstream-enwiki-2023-10.tsv.gz,Wikipedia,258167,1455989,1451,1715607,743770
hdfs://spark-nn.eemcs.utwente.nl/user/s1934538/clickstream/clickstream-enwiki-2023-10.tsv.gz,Salaar:_Part_1_–_Ceasefire,56367,204865,1243,262475,113822
hdfs://spark-nn.eemcs.utwente.nl/user/s1934538/clickstream/clickstream-enwiki-2023-10.tsv.gz,Eddie_Van_Halen,65244,145836,1206,212286,90127
hdfs://spark-nn.eemcs.utwente.nl/user/s1934538/clickstream/clickstream-enwiki-2023-10.tsv.gz,Crazy_Rich_Asians_(film),20104,69907,578,90589,62519
hdfs://spark-nn.eemcs.utwente.nl/user/s1934538/clickstream/clickstream-enwiki-2023-10.tsv.gz,John_Wick:_Chapter_4,74246,233167,5838,313251,220792
hdfs://spark-nn.eemcs.utwente.nl/user/s1934538/clickstream/clickstream-enwiki-2023-10.tsv.gz,Bonnie_and_Clyde,19587,182911,1138,203636,51630
hdfs://spark-nn.eemcs.utwente.nl/user/s1934538/clickstream/clickstream-enwiki-2023-10.tsv.gz,Joker_(2019_film),48501,178264,1566,228331,102780
hdfs://spark-nn.eemcs.utwente.nl/user/s1934538/clickstream/clickstream-enwiki-2023-10.tsv.gz,Ponniyin_Selvan:_I,31218,53126,155,84499,35970
hdfs://spark-nn.eemcs.utwente.nl/user/s1934538/clickstream/clickstream-enwiki-2023-10.tsv.gz,Us_(2019_film),44466,318701,1757,364924,120655
hdfs://spark-nn.eemcs.utwente.nl/user/s1934538/clickstream/clickstream-enwiki-2023-10.tsv.gz,2.0_(film),38456,56626,250,95332,16059
hdfs://spark-nn.eemcs.utwente.nl/user/s1934538/clickstream/clickstream-enwiki-2023-10.tsv.gz,Critical_race_theory,10556,64630,329,75515,9026
hdfs://spark-nn.eemcs.utwente.nl/user/s1934538/clickstream/clickstream-enwiki-2023-10.tsv.gz,Kamala_Harris,84772,174055,1286,260113,116739
hdfs://spark-nn.eemcs.utwente.nl/user/s1934538/clickstream/clickstream-enwiki-2023-10.tsv.gz,2018_Winter_Olympics,11545,7794,58,19397,12978
hdfs://spark-nn.eemcs.utwente.nl/user/s1934538/clickstream/clickstream-enwiki-2023-10.tsv.gz,Mission:_Impossible_–_Dead_Reckoning_Part_One,160119,722827,12051,894997,570632
hdfs://spark-nn.eemcs.utwente.nl/user/s1934538/clickstream/clickstream-enwiki-2023-10.tsv.gz,Avatar:_The_Way_of_Water,56975,153957,2684,213616,91612
hdfs://spark-nn.eemcs.utwente.nl/user/s1934538/clickstream/clickstream-enwiki-2023-10.tsv.gz,Sidharth_Shukla,7962,43023,222,51207,9989
hdfs://spark-nn.eemcs.utwente.nl/user/s1934538/clickstream/clickstream-enwiki-2023-10.tsv.gz,Vivek_Ramaswamy,21983,403142,1537,426662,117558
hdfs://spark-nn.eemcs.utwente.nl/user/s1934538/clickstream/clickstream-enwiki-2023-10.tsv.gz,ChatGPT,17634,2108587,2922,2129143,102391
hdfs://spark-nn.eemcs.utwente.nl/user/s1934538/clickstream/clickstream-enwiki-2023-10.tsv.gz,The_Suicide_Squad_(film),49175,99843,982,150000,93598
hdfs://spark-nn.eemcs.utwente.nl/user/s1934538/clickstream/clickstream-enwiki-2023-10.tsv.gz,Cecil_Hotel_(Los_Angeles),6709,36333,80,43122,10855
hdfs://spark-nn.eemcs.utwente.nl/user/s1934538/clickstream/clickstream-enwiki-2023-10.tsv.gz,Jenna_Ortega,101650,340459,3419,445528,145098
hdfs://spark-nn.eemcs.utwente.nl/user/s1934538/clickstream/clickstream-enwiki-2023-10.tsv.gz,Khabib_Nurmagomedov,111333,356056,2138,469527,268070
hdfs://spark-nn.eemcs.utwente.nl/user/s1934538/clickstream/clickstream-enwiki-2023-10.tsv.gz,Lists_of_deaths_by_year,17245,177322,1114,195681,209759
hdfs://spark-nn.eemcs.utwente.nl/user/s1934538/clickstream/clickstream-enwiki-2023-10.tsv.gz,Laal_Singh_Chaddha,20769,41401,203,62373,21244
hdfs://spark-nn.eemcs.utwente.nl/user/s1934538/clickstream/clickstream-enwiki-2023-10.tsv.gz,Star_Wars:_The_Rise_of_Skywalker,63988,42483,802,107273,59310
hdfs://spark-nn.eemcs.utwente.nl/user/s1934538/clickstream/clickstream-enwiki-2023-11.tsv.gz,Venom_(2018_film),22671,85755,899,109325,47643
hdfs://spark-nn.eemcs.utwente.nl/user/s1934538/clickstream/clickstream-enwiki-2023-11.tsv.gz,Sidharth_Shukla,6811,38885,277,45973,9715
hdfs://spark-nn.eemcs.utwente.nl/user/s1934538/clickstream/clickstream-enwiki-2023-11.tsv.gz,Puneeth_Rajkumar,16373,62168,41,78582,26118
hdfs://spark-nn.eemcs.utwente.nl/user/s1934538/clickstream/clickstream-enwiki-2023-11.tsv.gz,Aaron_Hernandez,18605,125619,736,144960,55720
hdfs://spark-nn.eemcs.utwente.nl/user/s1934538/clickstream/clickstream-enwiki-2023-11.tsv.gz,Guardians_of_the_Galaxy_Vol._3,100442,215078,2867,318387,137763
hdfs://spark-nn.eemcs.utwente.nl/user/s1934538/clickstream/clickstream-enwiki-2023-11.tsv.gz,Jurassic_World_Dominion,42969,70947,676,114592,64310
hdfs://spark-nn.eemcs.utwente.nl/user/s1934538/clickstream/clickstream-enwiki-2023-11.tsv.gz,September_11_attacks,103252,284232,4457,391941,241432
hdfs://spark-nn.eemcs.utwente.nl/user/s1934538/clickstream/clickstream-enwiki-2023-11.tsv.gz,Lance_Reddick,66293,199424,1068,266785,57123
hdfs://spark-nn.eemcs.utwente.nl/user/s1934538/clickstream/clickstream-enwiki-2023-11.tsv.gz,WandaVision,31855,49342,968,82165,38862
hdfs://spark-nn.eemcs.utwente.nl/user/s1934538/clickstream/clickstream-enwiki-2023-11.tsv.gz,"Meghan,_Duchess_of_Sussex",88858,293895,1135,383888,200045
hdfs://spark-nn.eemcs.utwente.nl/user/s1934538/clickstream/clickstream-enwiki-2023-11.tsv.gz,WrestleMania_34,11942,6378,45,18365,12658
hdfs://spark-nn.eemcs.utwente.nl/user/s1934538/clickstream/clickstream-enwiki-2023-11.tsv.gz,Elliot_Page,55324,165764,957,222045,117099
hdfs://spark-nn.eemcs.utwente.nl/user/s1934538/clickstream/clickstream-enwiki-2023-11.tsv.gz,Michael_Bloomberg,33645,35627,174,69446,31612
hdfs://spark-nn.eemcs.utwente.nl/user/s1934538/clickstream/clickstream-enwiki-2023-11.tsv.gz,Saltburn_(film),132433,1548493,14601,1695527,870461
hdfs://spark-nn.eemcs.utwente.nl/user/s1934538/clickstream/clickstream-enwiki-2023-11.tsv.gz,War_(2019_film),81743,107062,219,189024,75398
hdfs://spark-nn.eemcs.utwente.nl/user/s1934538/clickstream/clickstream-enwiki-2023-11.tsv.gz,Ted_Bundy,26988,276700,3464,307152,71311
hdfs://spark-nn.eemcs.utwente.nl/user/s1934538/clickstream/clickstream-enwiki-2023-11.tsv.gz,Kylian_Mbappé,60099,335176,2249,397524,77921
hdfs://spark-nn.eemcs.utwente.nl/user/s1934538/clickstream/clickstream-enwiki-2023-11.tsv.gz,Hamas,324797,1013753,14954,1353504,864627
hdfs://spark-nn.eemcs.utwente.nl/user/s1934538/clickstream/clickstream-enwiki-2023-11.tsv.gz,Black_Panther:_Wakanda_Forever,60359,86767,1270,148396,81985
hdfs://spark-nn.eemcs.utwente.nl/user/s1934538/clickstream/clickstream-enwiki-2023-11.tsv.gz,The_Queen's_Gambit_(miniseries),17310,108572,859,126741,56232
hdfs://spark-nn.eemcs.utwente.nl/user/s1934538/clickstream/clickstream-enwiki-2023-11.tsv.gz,Top_Gun:_Maverick,67881,129212,2261,199354,142253
hdfs://spark-nn.eemcs.utwente.nl/user/s1934538/clickstream/clickstream-enwiki-2023-11.tsv.gz,David_Beckham,107720,1858658,6030,1972408,715745
hdfs://spark-nn.eemcs.utwente.nl/user/s1934538/clickstream/clickstream-enwiki-2023-11.tsv.gz,Kenosha_unrest_shooting,12667,29414,48,42129,10455
hdfs://spark-nn.eemcs.utwente.nl/user/s1934538/clickstream/clickstream-enwiki-2023-11.tsv.gz,William_Murdoch,624,1265,11,1900,336
hdfs://spark-nn.eemcs.utwente.nl/user/s1934538/clickstream/clickstream-enwiki-2023-11.tsv.gz,1917_(2019_film),17601,83862,1473,102936,55666
hdfs://spark-nn.eemcs.utwente.nl/user/s1934538/clickstream/clickstream-enwiki-2023-11.tsv.gz,Chernobyl_(miniseries),25188,72315,1228,98731,106694
hdfs://spark-nn.eemcs.utwente.nl/user/s1934538/clickstream/clickstream-enwiki-2023-11.tsv.gz,Loki_(TV_series),145808,687699,16378,849885,551824
hdfs://spark-nn.eemcs.utwente.nl/user/s1934538/clickstream/clickstream-enwiki-2023-11.tsv.gz,Naomi_Osaka,12001,44367,317,56685,16055
hdfs://spark-nn.eemcs.utwente.nl/user/s1934538/clickstream/clickstream-enwiki-2023-11.tsv.gz,NATO,56219,148869,3382,208470,93312
hdfs://spark-nn.eemcs.utwente.nl/user/s1934538/clickstream/clickstream-enwiki-2023-11.tsv.gz,Manti_Te'o,4702,39019,140,43861,6221
hdfs://spark-nn.eemcs.utwente.nl/user/s1934538/clickstream/clickstream-enwiki-2023-11.tsv.gz,The_Kerala_Story,11578,67817,8445,87840,16495
hdfs://spark-nn.eemcs.utwente.nl/user/s1934538/clickstream/clickstream-enwiki-2023-11.tsv.gz,Anthony_Bourdain,22431,202237,1602,226270,99383
hdfs://spark-nn.eemcs.utwente.nl/user/s1934538/clickstream/clickstream-enwiki-2023-11.tsv.gz,ChatGPT,28683,2206441,4071,2239195,136501
hdfs://spark-nn.eemcs.utwente.nl/user/s1934538/clickstream/clickstream-enwiki-2023-11.tsv.gz,XNXX,16005,3806186,8472,3830663,85442
hdfs://spark-nn.eemcs.utwente.nl/user/s1934538/clickstream/clickstream-enwiki-2023-11.tsv.gz,Brie_Larson,192557,594767,4332,791656,366763
hdfs://spark-nn.eemcs.utwente.nl/user/s1934538/clickstream/clickstream-enwiki-2023-11.tsv.gz,Roe_v._Wade,12895,85343,646,98884,30866
hdfs://spark-nn.eemcs.utwente.nl/user/s1934538/clickstream/clickstream-enwiki-2023-11.tsv.gz,FIFA_World_Cup,72217,530381,5558,608156,228500
hdfs://spark-nn.eemcs.utwente.nl/user/s1934538/clickstream/clickstream-enwiki-2023-11.tsv.gz,2016_United_States_presidential_election,122357,82011,1270,205638,182112
hdfs://spark-nn.eemcs.utwente.nl/user/s1934538/clickstream/clickstream-enwiki-2023-11.tsv.gz,Kelly_Preston,113491,148536,473,262500,79206
hdfs://spark-nn.eemcs.utwente.nl/user/s1934538/clickstream/clickstream-enwiki-2023-11.tsv.gz,Game_of_Thrones_(season_8),12677,54795,320,67792,19438
hdfs://spark-nn.eemcs.utwente.nl/user/s1934538/clickstream/clickstream-enwiki-2023-11.tsv.gz,Pornhub,60112,4119923,11344,4191379,101009
hdfs://spark-nn.eemcs.utwente.nl/user/s1934538/clickstream/clickstream-enwiki-2023-11.tsv.gz,Johnny_Depp,104996,260261,2029,367286,227887
hdfs://spark-nn.eemcs.utwente.nl/user/s1934538/clickstream/clickstream-enwiki-2023-11.tsv.gz,Nipsey_Hussle,24580,66964,505,92049,29523
hdfs://spark-nn.eemcs.utwente.nl/user/s1934538/clickstream/clickstream-enwiki-2023-11.tsv.gz,Grover,1241,7189,46,8476,1617
hdfs://spark-nn.eemcs.utwente.nl/user/s1934538/clickstream/clickstream-enwiki-2023-11.tsv.gz,The_Suicide_Squad_(film),52024,98806,875,151705,89060
hdfs://spark-nn.eemcs.utwente.nl/user/s1934538/clickstream/clickstream-enwiki-2023-11.tsv.gz,Betty_White,37068,88499,925,126492,34674
hdfs://spark-nn.eemcs.utwente.nl/user/s1934538/clickstream/clickstream-enwiki-2023-11.tsv.gz,Once_Upon_a_Time_in_Hollywood,82613,118529,3925,205067,187560
hdfs://spark-nn.eemcs.utwente.nl/user/s1934538/clickstream/clickstream-enwiki-2023-11.tsv.gz,Dune_(2021_film),52433,197805,3460,253698,181140
hdfs://spark-nn.eemcs.utwente.nl/user/s1934538/clickstream/clickstream-enwiki-2023-11.tsv.gz,It_Chapter_Two,30248,52991,520,83759,53243
hdfs://spark-nn.eemcs.utwente.nl/user/s1934538/clickstream/clickstream-enwiki-2023-11.tsv.gz,Stranger_Things_(season_4),20229,62021,672,82922,45022
hdfs://spark-nn.eemcs.utwente.nl/user/s1934538/clickstream/clickstream-enwiki-2023-11.tsv.gz,Cristiano_Ronaldo,151167,1193450,5622,1350239,306924
hdfs://spark-nn.eemcs.utwente.nl/user/s1934538/clickstream/clickstream-enwiki-2023-11.tsv.gz,Tunnel,5019,13391,172,18582,4003
hdfs://spark-nn.eemcs.utwente.nl/user/s1934538/clickstream/clickstream-enwiki-2023-11.tsv.gz,Eddie_Van_Halen,51763,91436,959,144158,62522
hdfs://spark-nn.eemcs.utwente.nl/user/s1934538/clickstream/clickstream-enwiki-2023-11.tsv.gz,John_Wick:_Chapter_4,64511,186877,4056,255444,178740
hdfs://spark-nn.eemcs.utwente.nl/user/s1934538/clickstream/clickstream-enwiki-2023-11.tsv.gz,Olivia_Newton-John,27834,111162,972,139968,56521
hdfs://spark-nn.eemcs.utwente.nl/user/s1934538/clickstream/clickstream-enwiki-2023-11.tsv.gz,Stephen_Hawking,24053,301933,1826,327812,119461
hdfs://spark-nn.eemcs.utwente.nl/user/s1934538/clickstream/clickstream-enwiki-2023-11.tsv.gz,Death_of_Elisa_Lam,7977,35968,170,44115,14577
hdfs://spark-nn.eemcs.utwente.nl/user/s1934538/clickstream/clickstream-enwiki-2023-11.tsv.gz,United_States_Electoral_College,14760,39968,103,54831,9849
hdfs://spark-nn.eemcs.utwente.nl/user/s1934538/clickstream/clickstream-enwiki-2023-11.tsv.gz,Rishi_Sunak,169824,380110,3046,552980,282109
hdfs://spark-nn.eemcs.utwente.nl/user/s1934538/clickstream/clickstream-enwiki-2023-11.tsv.gz,Avicii,20198,171638,1064,192900,56768
hdfs://spark-nn.eemcs.utwente.nl/user/s1934538/clickstream/clickstream-enwiki-2023-11.tsv.gz,Spider-Man:_Across_the_Spider-Verse,177470,529902,9650,717022,560654
hdfs://spark-nn.eemcs.utwente.nl/user/s1934538/clickstream/clickstream-enwiki-2023-11.tsv.gz,House_of_the_Dragon,45185,230214,3710,279109,141983
hdfs://spark-nn.eemcs.utwente.nl/user/s1934538/clickstream/clickstream-enwiki-2023-11.tsv.gz,Jimmy_Buffett,13930,157136,1397,172463,62336
hdfs://spark-nn.eemcs.utwente.nl/user/s1934538/clickstream/clickstream-enwiki-2023-11.tsv.gz,Charles_III,480680,375830,5116,861626,577799
hdfs://spark-nn.eemcs.utwente.nl/user/s1934538/clickstream/clickstream-enwiki-2023-11.tsv.gz,Valentine's_Day,4119,51007,251,55377,4277
hdfs://spark-nn.eemcs.utwente.nl/user/s1934538/clickstream/clickstream-enwiki-2023-11.tsv.gz,George_H._W._Bush,214080,148150,1261,363491,224930
hdfs://spark-nn.eemcs.utwente.nl/user/s1934538/clickstream/clickstream-enwiki-2023-11.tsv.gz,Stranger_Things,60940,288547,5600,355087,254816
hdfs://spark-nn.eemcs.utwente.nl/user/s1934538/clickstream/clickstream-enwiki-2023-11.tsv.gz,Spider-Man:_Far_From_Home,44574,58592,637,103803,46516
hdfs://spark-nn.eemcs.utwente.nl/user/s1934538/clickstream/clickstream-enwiki-2023-11.tsv.gz,Asia_Cup,22924,121021,273,144218,34200
hdfs://spark-nn.eemcs.utwente.nl/user/s1934538/clickstream/clickstream-enwiki-2023-11.tsv.gz,Joe_Biden,213022,980464,10638,1204124,365088
hdfs://spark-nn.eemcs.utwente.nl/user/s1934538/clickstream/clickstream-enwiki-2023-11.tsv.gz,Croatia,46944,135415,1744,184103,61019
hdfs://spark-nn.eemcs.utwente.nl/user/s1934538/clickstream/clickstream-enwiki-2023-11.tsv.gz,Louis_Tomlinson,26750,42640,178,69568,17625
hdfs://spark-nn.eemcs.utwente.nl/user/s1934538/clickstream/clickstream-enwiki-2023-11.tsv.gz,List_of_highest-grossing_Indian_films,169747,696344,685,866776,417708
hdfs://spark-nn.eemcs.utwente.nl/user/s1934538/clickstream/clickstream-enwiki-2023-11.tsv.gz,Simple_Mail_Transfer_Protocol,2504,24973,104,27581,2669
hdfs://spark-nn.eemcs.utwente.nl/user/s1934538/clickstream/clickstream-enwiki-2023-11.tsv.gz,Vivek_Ramaswamy,32192,602824,3269,638285,180161
hdfs://spark-nn.eemcs.utwente.nl/user/s1934538/clickstream/clickstream-enwiki-2023-11.tsv.gz,Mötley_Crüe,27744,90298,1247,119289,140238
hdfs://spark-nn.eemcs.utwente.nl/user/s1934538/clickstream/clickstream-enwiki-2023-11.tsv.gz,YouTube,137529,6332674,12709,6482912,126983
hdfs://spark-nn.eemcs.utwente.nl/user/s1934538/clickstream/clickstream-enwiki-2023-11.tsv.gz,Volodymyr_Zelenskyy,50155,115268,1037,166460,82218
hdfs://spark-nn.eemcs.utwente.nl/user/s1934538/clickstream/clickstream-enwiki-2023-11.tsv.gz,Hyphen-minus,957,6740194,19992,6761143,1031
hdfs://spark-nn.eemcs.utwente.nl/user/s1934538/clickstream/clickstream-enwiki-2023-11.tsv.gz,HTTP_cookie,2217,306056,138,308411,23102
hdfs://spark-nn.eemcs.utwente.nl/user/s1934538/clickstream/clickstream-enwiki-2023-11.tsv.gz,Black_Widow_(2021_film),41869,88805,880,131554,51895
hdfs://spark-nn.eemcs.utwente.nl/user/s1934538/clickstream/clickstream-enwiki-2023-11.tsv.gz,2018_Asian_Games,3902,3612,18,7532,4667
hdfs://spark-nn.eemcs.utwente.nl/user/s1934538/clickstream/clickstream-enwiki-2023-11.tsv.gz,2020_Summer_Olympics,35555,44635,532,80722,62402
hdfs://spark-nn.eemcs.utwente.nl/user/s1934538/clickstream/clickstream-enwiki-2023-11.tsv.gz,JSON_Web_Token,712,22349,45,23106,1825
hdfs://spark-nn.eemcs.utwente.nl/user/s1934538/clickstream/clickstream-enwiki-2023-11.tsv.gz,Elon_Musk,119661,1440998,15754,1576413,873268
hdfs://spark-nn.eemcs.utwente.nl/user/s1934538/clickstream/clickstream-enwiki-2023-11.tsv.gz,XXXTentacion,40524,1452498,5258,1498280,87388
hdfs://spark-nn.eemcs.utwente.nl/user/s1934538/clickstream/clickstream-enwiki-2023-11.tsv.gz,Afghanistan,122324,243864,3793,369981,262180
hdfs://spark-nn.eemcs.utwente.nl/user/s1934538/clickstream/clickstream-enwiki-2023-11.tsv.gz,Avengers:_Infinity_War,42027,61314,699,104040,49431
hdfs://spark-nn.eemcs.utwente.nl/user/s1934538/clickstream/clickstream-enwiki-2023-11.tsv.gz,Juneteenth,6411,35387,173,41971,4016
hdfs://spark-nn.eemcs.utwente.nl/user/s1934538/clickstream/clickstream-enwiki-2023-11.tsv.gz,2023_Cricket_World_Cup,466636,13639475,31237,14137348,787365
hdfs://spark-nn.eemcs.utwente.nl/user/s1934538/clickstream/clickstream-enwiki-2023-11.tsv.gz,Bob_Saget,33975,134256,934,169165,30823
hdfs://spark-nn.eemcs.utwente.nl/user/s1934538/clickstream/clickstream-enwiki-2023-11.tsv.gz,Cleopatra,63843,4601887,2340,4668070,442059
hdfs://spark-nn.eemcs.utwente.nl/user/s1934538/clickstream/clickstream-enwiki-2023-11.tsv.gz,Emma_Raducanu,3801,38201,176,42178,6641
hdfs://spark-nn.eemcs.utwente.nl/user/s1934538/clickstream/clickstream-enwiki-2023-11.tsv.gz,Deadpool_2,39830,48047,768,88645,57212
hdfs://spark-nn.eemcs.utwente.nl/user/s1934538/clickstream/clickstream-enwiki-2023-11.tsv.gz,The_Kashmir_Files,9671,21357,79,31107,10553
hdfs://spark-nn.eemcs.utwente.nl/user/s1934538/clickstream/clickstream-enwiki-2023-11.tsv.gz,The_Last_of_Us_(TV_series),48033,328828,2961,379822,102272
hdfs://spark-nn.eemcs.utwente.nl/user/s1934538/clickstream/clickstream-enwiki-2023-11.tsv.gz,Brahmāstra:_Part_One_–_Shiva,45363,81909,178,127450,32012
hdfs://spark-nn.eemcs.utwente.nl/user/s1934538/clickstream/clickstream-enwiki-2023-11.tsv.gz,Parasite_(2019_film),26134,170105,1278,197517,83747
hdfs://spark-nn.eemcs.utwente.nl/user/s1934538/clickstream/clickstream-enwiki-2023-11.tsv.gz,Keanu_Reeves,80352,426465,2948,509765,303522
hdfs://spark-nn.eemcs.utwente.nl/user/s1934538/clickstream/clickstream-enwiki-2023-11.tsv.gz,Gaza_Strip,196441,871861,8308,1076610,350227
hdfs://spark-nn.eemcs.utwente.nl/user/s1934538/clickstream/clickstream-enwiki-2023-11.tsv.gz,Greta_Thunberg,11534,195978,1590,209102,56295
hdfs://spark-nn.eemcs.utwente.nl/user/s1934538/clickstream/clickstream-enwiki-2023-11.tsv.gz,Cecil_Hotel_(Los_Angeles),5224,29611,65,34900,9234
hdfs://spark-nn.eemcs.utwente.nl/user/s1934538/clickstream/clickstream-enwiki-2023-11.tsv.gz,Pelé,31513,144736,1061,177310,61060
hdfs://spark-nn.eemcs.utwente.nl/user/s1934538/clickstream/clickstream-enwiki-2023-11.tsv.gz,Jailer_(2023_Tamil_film),66782,390860,4234,461876,126402
hdfs://spark-nn.eemcs.utwente.nl/user/s1934538/clickstream/clickstream-enwiki-2023-11.tsv.gz,Tiger_3,212882,4275038,22038,4509958,1224419
hdfs://spark-nn.eemcs.utwente.nl/user/s1934538/clickstream/clickstream-enwiki-2023-11.tsv.gz,Black_Adam_(film),31920,78731,925,111576,43415
hdfs://spark-nn.eemcs.utwente.nl/user/s1934538/clickstream/clickstream-enwiki-2023-11.tsv.gz,21_Savage,15785,68500,432,84717,27098
hdfs://spark-nn.eemcs.utwente.nl/user/s1934538/clickstream/clickstream-enwiki-2023-11.tsv.gz,Indian_Premier_League,47030,229918,817,277765,177606
hdfs://spark-nn.eemcs.utwente.nl/user/s1934538/clickstream/clickstream-enwiki-2023-11.tsv.gz,List_of_highest-grossing_films,109863,268474,1459,379796,207746
hdfs://spark-nn.eemcs.utwente.nl/user/s1934538/clickstream/clickstream-enwiki-2023-11.tsv.gz,Jawan_(film),160171,1754222,6915,1921308,809427
hdfs://spark-nn.eemcs.utwente.nl/user/s1934538/clickstream/clickstream-enwiki-2023-11.tsv.gz,Cameron_Boyce,20784,146617,522,167923,43131
hdfs://spark-nn.eemcs.utwente.nl/user/s1934538/clickstream/clickstream-enwiki-2023-11.tsv.gz,Ant-Man_and_the_Wasp:_Quantumania,94245,123995,3478,221718,113689
hdfs://spark-nn.eemcs.utwente.nl/user/s1934538/clickstream/clickstream-enwiki-2023-11.tsv.gz,Christopher_Scarver,52798,32307,27,85132,31838
hdfs://spark-nn.eemcs.utwente.nl/user/s1934538/clickstream/clickstream-enwiki-2023-11.tsv.gz,Royal_Rumble_(2018),5972,3222,35,9229,7427
hdfs://spark-nn.eemcs.utwente.nl/user/s1934538/clickstream/clickstream-enwiki-2023-11.tsv.gz,List_of_Queen_of_the_South_episodes,3658,2680,13,6351,120
hdfs://spark-nn.eemcs.utwente.nl/user/s1934538/clickstream/clickstream-enwiki-2023-11.tsv.gz,Tenet_(film),55786,91485,909,148180,64987
hdfs://spark-nn.eemcs.utwente.nl/user/s1934538/clickstream/clickstream-enwiki-2023-11.tsv.gz,Rami_Malek,54796,147410,1110,203316,76696
hdfs://spark-nn.eemcs.utwente.nl/user/s1934538/clickstream/clickstream-enwiki-2023-11.tsv.gz,Qasem_Soleimani,28767,49284,147,78198,45988
hdfs://spark-nn.eemcs.utwente.nl/user/s1934538/clickstream/clickstream-enwiki-2023-11.tsv.gz,COVID-19_pandemic,76546,168793,3433,248772,84232
hdfs://spark-nn.eemcs.utwente.nl/user/s1934538/clickstream/clickstream-enwiki-2023-11.tsv.gz,Jimmy_Hoffa,39879,148710,1314,189903,76321
hdfs://spark-nn.eemcs.utwente.nl/user/s1934538/clickstream/clickstream-enwiki-2023-11.tsv.gz,Eternals_(film),63983,110703,1257,175943,109638
hdfs://spark-nn.eemcs.utwente.nl/user/s1934538/clickstream/clickstream-enwiki-2023-11.tsv.gz,George_VI,325002,141116,1828,467946,343048
hdfs://spark-nn.eemcs.utwente.nl/user/s1934538/clickstream/clickstream-enwiki-2023-11.tsv.gz,Meat_Loaf,26669,96675,969,124313,45802
hdfs://spark-nn.eemcs.utwente.nl/user/s1934538/clickstream/clickstream-enwiki-2023-11.tsv.gz,Ruth_Bader_Ginsburg,13530,77376,377,91283,26011
hdfs://spark-nn.eemcs.utwente.nl/user/s1934538/clickstream/clickstream-enwiki-2023-11.tsv.gz,Wonder_Woman_1984,23481,41591,602,65674,28840
hdfs://spark-nn.eemcs.utwente.nl/user/s1934538/clickstream/clickstream-enwiki-2023-11.tsv.gz,Area_51,14320,88795,812,103927,35386
hdfs://spark-nn.eemcs.utwente.nl/user/s1934538/clickstream/clickstream-enwiki-2023-11.tsv.gz,Oppenheimer_(film),206534,1504429,26375,1737338,1428229
hdfs://spark-nn.eemcs.utwente.nl/user/s1934538/clickstream/clickstream-enwiki-2023-11.tsv.gz,XHamster,13625,2427828,5771,2447224,37954
hdfs://spark-nn.eemcs.utwente.nl/user/s1934538/clickstream/clickstream-enwiki-2023-11.tsv.gz,Barbie_(film),149566,448768,9447,607781,411446
hdfs://spark-nn.eemcs.utwente.nl/user/s1934538/clickstream/clickstream-enwiki-2023-11.tsv.gz,Salman_Rushdie,33373,86204,700,120277,72589
hdfs://spark-nn.eemcs.utwente.nl/user/s1934538/clickstream/clickstream-enwiki-2023-11.tsv.gz,Spanish_flu,21302,53891,593,75786,19554
hdfs://spark-nn.eemcs.utwente.nl/user/s1934538/clickstream/clickstream-enwiki-2023-11.tsv.gz,J._Robert_Oppenheimer,263877,1355911,6522,1626310,869795
hdfs://spark-nn.eemcs.utwente.nl/user/s1934538/clickstream/clickstream-enwiki-2023-11.tsv.gz,Aretha_Franklin,22635,106965,942,130542,60670
hdfs://spark-nn.eemcs.utwente.nl/user/s1934538/clickstream/clickstream-enwiki-2023-11.tsv.gz,Salaar:_Part_1_–_Ceasefire,43883,250032,12466,306381,127205
hdfs://spark-nn.eemcs.utwente.nl/user/s1934538/clickstream/clickstream-enwiki-2023-11.tsv.gz,The_Witcher_(TV_series),25082,199159,2767,227008,122220
hdfs://spark-nn.eemcs.utwente.nl/user/s1934538/clickstream/clickstream-enwiki-2023-11.tsv.gz,Adele,52576,269762,35089,357427,164146
hdfs://spark-nn.eemcs.utwente.nl/user/s1934538/clickstream/clickstream-enwiki-2023-11.tsv.gz,Black_Panther_(film),27640,79083,756,107479,44316
hdfs://spark-nn.eemcs.utwente.nl/user/s1934538/clickstream/clickstream-enwiki-2023-11.tsv.gz,Jason_Momoa,79214,424078,2598,505890,224248
hdfs://spark-nn.eemcs.utwente.nl/user/s1934538/clickstream/clickstream-enwiki-2023-11.tsv.gz,Luke_Perry,36048,148969,1155,186172,65289
hdfs://spark-nn.eemcs.utwente.nl/user/s1934538/clickstream/clickstream-enwiki-2023-11.tsv.gz,Lionel_Messi,130361,863763,6499,1000623,239479
hdfs://spark-nn.eemcs.utwente.nl/user/s1934538/clickstream/clickstream-enwiki-2023-11.tsv.gz,The_Mandalorian,38685,96422,2295,137402,88852
hdfs://spark-nn.eemcs.utwente.nl/user/s1934538/clickstream/clickstream-enwiki-2023-11.tsv.gz,The_Irishman,64459,102298,1531,168288,137615
hdfs://spark-nn.eemcs.utwente.nl/user/s1934538/clickstream/clickstream-enwiki-2023-11.tsv.gz,Cardi_B,24471,156950,1614,183035,52614
hdfs://spark-nn.eemcs.utwente.nl/user/s1934538/clickstream/clickstream-enwiki-2023-11.tsv.gz,The_Umbrella_Academy_(TV_series),17749,63969,1147,82865,51036
hdfs://spark-nn.eemcs.utwente.nl/user/s1934538/clickstream/clickstream-enwiki-2023-11.tsv.gz,Irrfan_Khan,24779,73711,180,98670,43784
hdfs://spark-nn.eemcs.utwente.nl/user/s1934538/clickstream/clickstream-enwiki-2023-11.tsv.gz,Avengers:_Endgame,84056,142000,1824,227880,110466
hdfs://spark-nn.eemcs.utwente.nl/user/s1934538/clickstream/clickstream-enwiki-2023-11.tsv.gz,Carlos_Alcaraz,22951,106109,337,129397,25083
hdfs://spark-nn.eemcs.utwente.nl/user/s1934538/clickstream/clickstream-enwiki-2023-11.tsv.gz,Tom_Brady,67063,315439,3186,385688,170360
hdfs://spark-nn.eemcs.utwente.nl/user/s1934538/clickstream/clickstream-enwiki-2023-11.tsv.gz,Captain_Marvel_(film),86386,209909,2374,298669,133202
hdfs://spark-nn.eemcs.utwente.nl/user/s1934538/clickstream/clickstream-enwiki-2023-11.tsv.gz,Stan_Lee,38109,86580,993,125682,44535
hdfs://spark-nn.eemcs.utwente.nl/user/s1934538/clickstream/clickstream-enwiki-2023-11.tsv.gz,The_Flash_(film),54898,221974,4964,281836,114821
hdfs://spark-nn.eemcs.utwente.nl/user/s1934538/clickstream/clickstream-enwiki-2023-11.tsv.gz,Adipurush,41729,85805,337,127871,41881
hdfs://spark-nn.eemcs.utwente.nl/user/s1934538/clickstream/clickstream-enwiki-2023-11.tsv.gz,No_Time_to_Die,89829,117515,1503,208847,116042
hdfs://spark-nn.eemcs.utwente.nl/user/s1934538/clickstream/clickstream-enwiki-2023-11.tsv.gz,Game_of_Thrones,61067,394758,4650,460475,217118
hdfs://spark-nn.eemcs.utwente.nl/user/s1934538/clickstream/clickstream-enwiki-2023-11.tsv.gz,Mortal_Kombat_(2021_film),22125,57216,832,80173,71796
hdfs://spark-nn.eemcs.utwente.nl/user/s1934538/clickstream/clickstream-enwiki-2023-11.tsv.gz,Kantara_(film),25679,164509,362,190550,80936
hdfs://spark-nn.eemcs.utwente.nl/user/s1934538/clickstream/clickstream-enwiki-2023-11.tsv.gz,The_Sandman_(TV_series),26094,59187,890,86171,53822
hdfs://spark-nn.eemcs.utwente.nl/user/s1934538/clickstream/clickstream-enwiki-2023-11.tsv.gz,Atal_Bihari_Vajpayee,28049,51307,70,79426,26488
hdfs://spark-nn.eemcs.utwente.nl/user/s1934538/clickstream/clickstream-enwiki-2023-11.tsv.gz,State_of_Palestine,310850,1167867,5341,1484058,527363
hdfs://spark-nn.eemcs.utwente.nl/user/s1934538/clickstream/clickstream-enwiki-2023-11.tsv.gz,Avatar:_The_Way_of_Water,64663,161568,2957,229188,103098
hdfs://spark-nn.eemcs.utwente.nl/user/s1934538/clickstream/clickstream-enwiki-2023-11.tsv.gz,Amy_Coney_Barrett,17206,20809,109,38124,12122
hdfs://spark-nn.eemcs.utwente.nl/user/s1934538/clickstream/clickstream-enwiki-2023-11.tsv.gz,Mulan_(2020_film),15911,40639,295,56845,27355
hdfs://spark-nn.eemcs.utwente.nl/user/s1934538/clickstream/clickstream-enwiki-2023-11.tsv.gz,Simone_Biles,18725,120304,786,139815,62925
hdfs://spark-nn.eemcs.utwente.nl/user/s1934538/clickstream/clickstream-enwiki-2023-11.tsv.gz,List_of_awards_and_nominations_received_by_Meryl_Streep,7683,7831,39,15553,7385
hdfs://spark-nn.eemcs.utwente.nl/user/s1934538/clickstream/clickstream-enwiki-2023-11.tsv.gz,"Diana,_Princess_of_Wales",364284,946070,8724,1319078,872344
hdfs://spark-nn.eemcs.utwente.nl/user/s1934538/clickstream/clickstream-enwiki-2023-11.tsv.gz,Lisa_Marie_Presley,338893,352697,1588,693178,413948
hdfs://spark-nn.eemcs.utwente.nl/user/s1934538/clickstream/clickstream-enwiki-2023-11.tsv.gz,Jeffrey_Epstein,50566,225316,2799,278681,132932
hdfs://spark-nn.eemcs.utwente.nl/user/s1934538/clickstream/clickstream-enwiki-2023-11.tsv.gz,List_of_James_Bond_films,71711,459116,1998,532825,343047
hdfs://spark-nn.eemcs.utwente.nl/user/s1934538/clickstream/clickstream-enwiki-2023-11.tsv.gz,The_Haunting_of_Bly_Manor,42360,84685,759,127804,74885
hdfs://spark-nn.eemcs.utwente.nl/user/s1934538/clickstream/clickstream-enwiki-2023-11.tsv.gz,Kobe_Bryant_sexual_assault_case,6708,33860,32,40600,3957
hdfs://spark-nn.eemcs.utwente.nl/user/s1934538/clickstream/clickstream-enwiki-2023-11.tsv.gz,Alexander_Hamilton,63219,177417,1179,241815,133273
hdfs://spark-nn.eemcs.utwente.nl/user/s1934538/clickstream/clickstream-enwiki-2023-11.tsv.gz,Donald_Trump,254558,979460,8347,1242365,538039
hdfs://spark-nn.eemcs.utwente.nl/user/s1934538/clickstream/clickstream-enwiki-2023-11.tsv.gz,Coronavirus,5448,29528,382,35358,9955
hdfs://spark-nn.eemcs.utwente.nl/user/s1934538/clickstream/clickstream-enwiki-2023-11.tsv.gz,Gadar_2,56355,257229,1009,314593,97023
hdfs://spark-nn.eemcs.utwente.nl/user/s1934538/clickstream/clickstream-enwiki-2023-11.tsv.gz,Army_of_the_Dead,33950,31864,280,66094,33634
hdfs://spark-nn.eemcs.utwente.nl/user/s1934538/clickstream/clickstream-enwiki-2023-11.tsv.gz,Ray_Liotta,59280,202007,1694,262981,107058
hdfs://spark-nn.eemcs.utwente.nl/user/s1934538/clickstream/clickstream-enwiki-2023-11.tsv.gz,Aaron_Carter,30381,91627,789,122797,77415
hdfs://spark-nn.eemcs.utwente.nl/user/s1934538/clickstream/clickstream-enwiki-2023-11.tsv.gz,Hamilton_(musical),25404,167162,1119,193685,112983
hdfs://spark-nn.eemcs.utwente.nl/user/s1934538/clickstream/clickstream-enwiki-2023-11.tsv.gz,Cricket_World_Cup,306918,13775546,7519,14089983,1048109
hdfs://spark-nn.eemcs.utwente.nl/user/s1934538/clickstream/clickstream-enwiki-2023-11.tsv.gz,Darth_Vader,23214,62724,530,86468,50467
hdfs://spark-nn.eemcs.utwente.nl/user/s1934538/clickstream/clickstream-enwiki-2023-11.tsv.gz,Matthew_Perry,247578,2890267,47574,3185419,1582774
hdfs://spark-nn.eemcs.utwente.nl/user/s1934538/clickstream/clickstream-enwiki-2018-06.tsv.gz,Johnny_Depp,96841,580092,5822,682755,360576
hdfs://spark-nn.eemcs.utwente.nl/user/s1934538/clickstream/clickstream-enwiki-2018-06.tsv.gz,Tom_Brady,25008,170664,1415,197087,55939
hdfs://spark-nn.eemcs.utwente.nl/user/s1934538/clickstream/clickstream-enwiki-2018-06.tsv.gz,Wikipedia,39852,453401,986,494239,176569
hdfs://spark-nn.eemcs.utwente.nl/user/s1934538/clickstream/clickstream-enwiki-2018-06.tsv.gz,List_of_highest-grossing_Indian_films,67553,439694,1318,508565,227742
hdfs://spark-nn.eemcs.utwente.nl/user/s1934538/clickstream/clickstream-enwiki-2018-06.tsv.gz,Ruth_Bader_Ginsburg,95355,352363,1984,449702,114762
hdfs://spark-nn.eemcs.utwente.nl/user/s1934538/clickstream/clickstream-enwiki-2018-06.tsv.gz,Kim_Jong-un,97054,1183952,33666,1314672,507652
hdfs://spark-nn.eemcs.utwente.nl/user/s1934538/clickstream/clickstream-enwiki-2018-06.tsv.gz,Qasem_Soleimani,1670,5407,22,7099,2612
hdfs://spark-nn.eemcs.utwente.nl/user/s1934538/clickstream/clickstream-enwiki-2018-06.tsv.gz,Fyre_Festival,3518,49934,265,53717,21816
hdfs://spark-nn.eemcs.utwente.nl/user/s1934538/clickstream/clickstream-enwiki-2018-06.tsv.gz,Captain_Marvel_(film),138668,180286,2813,321767,206342
hdfs://spark-nn.eemcs.utwente.nl/user/s1934538/clickstream/clickstream-enwiki-2018-06.tsv.gz,Tunnel,3338,11934,110,15382,3363
hdfs://spark-nn.eemcs.utwente.nl/user/s1934538/clickstream/clickstream-enwiki-2018-06.tsv.gz,David_Beckham,68741,527626,3048,599415,162184
hdfs://spark-nn.eemcs.utwente.nl/user/s1934538/clickstream/clickstream-enwiki-2018-06.tsv.gz,List_of_Marvel_Cinematic_Universe_films,136951,1089194,2294,1228439,335579
hdfs://spark-nn.eemcs.utwente.nl/user/s1934538/clickstream/clickstream-enwiki-2018-06.tsv.gz,Kobe_Bryant_sexual_assault_case,3787,28239,35,32061,3463
hdfs://spark-nn.eemcs.utwente.nl/user/s1934538/clickstream/clickstream-enwiki-2018-06.tsv.gz,The_Lion_King_(2019_film),66895,115303,1123,183321,151084
hdfs://spark-nn.eemcs.utwente.nl/user/s1934538/clickstream/clickstream-enwiki-2018-06.tsv.gz,Cook's_Country,127,2852,16,2995,30
hdfs://spark-nn.eemcs.utwente.nl/user/s1934538/clickstream/clickstream-enwiki-2018-06.tsv.gz,Sushma_Swaraj,3938,35030,58,39026,8127
hdfs://spark-nn.eemcs.utwente.nl/user/s1934538/clickstream/clickstream-enwiki-2018-06.tsv.gz,1234,54,2277,18,2349,199
hdfs://spark-nn.eemcs.utwente.nl/user/s1934538/clickstream/clickstream-enwiki-2018-06.tsv.gz,Crazy_Rich_Asians_(film),41271,70221,486,111978,100274
hdfs://spark-nn.eemcs.utwente.nl/user/s1934538/clickstream/clickstream-enwiki-2018-06.tsv.gz,Ukraine,40336,149692,2685,192713,79499
hdfs://spark-nn.eemcs.utwente.nl/user/s1934538/clickstream/clickstream-enwiki-2018-06.tsv.gz,List_of_James_Bond_films,14424,167446,208,182078,72815
hdfs://spark-nn.eemcs.utwente.nl/user/s1934538/clickstream/clickstream-enwiki-2018-06.tsv.gz,Deion_Sanders,6837,88883,399,96119,17093
hdfs://spark-nn.eemcs.utwente.nl/user/s1934538/clickstream/clickstream-enwiki-2018-06.tsv.gz,Kate_Spade,238889,4523546,80129,4842564,1871100
hdfs://spark-nn.eemcs.utwente.nl/user/s1934538/clickstream/clickstream-enwiki-2018-06.tsv.gz,Kelly_Preston,82757,104696,405,187858,53461
hdfs://spark-nn.eemcs.utwente.nl/user/s1934538/clickstream/clickstream-enwiki-2018-06.tsv.gz,WrestleMania_34,36447,51822,689,88958,55477
hdfs://spark-nn.eemcs.utwente.nl/user/s1934538/clickstream/clickstream-enwiki-2018-06.tsv.gz,XXXTentacion,203793,7845402,131115,8180310,1417455
hdfs://spark-nn.eemcs.utwente.nl/user/s1934538/clickstream/clickstream-enwiki-2018-06.tsv.gz,Lionel_Messi,267092,2987655,21421,3276168,559196
hdfs://spark-nn.eemcs.utwente.nl/user/s1934538/clickstream/clickstream-enwiki-2018-06.tsv.gz,XHamster,7235,7514277,3118,7524630,29297
hdfs://spark-nn.eemcs.utwente.nl/user/s1934538/clickstream/clickstream-enwiki-2018-06.tsv.gz,2020_Summer_Olympics,52839,114908,2620,170367,81883
hdfs://spark-nn.eemcs.utwente.nl/user/s1934538/clickstream/clickstream-enwiki-2018-06.tsv.gz,Nipsey_Hussle,13672,60067,175,73914,30231
hdfs://spark-nn.eemcs.utwente.nl/user/s1934538/clickstream/clickstream-enwiki-2018-06.tsv.gz,Fantastic_Beasts:_The_Crimes_of_Grindelwald,66406,65876,655,132937,75543
hdfs://spark-nn.eemcs.utwente.nl/user/s1934538/clickstream/clickstream-enwiki-2018-06.tsv.gz,Taliban,14543,69179,564,84286,39981
hdfs://spark-nn.eemcs.utwente.nl/user/s1934538/clickstream/clickstream-enwiki-2018-06.tsv.gz,Richard_Jewell,2486,27470,88,30044,6550
hdfs://spark-nn.eemcs.utwente.nl/user/s1934538/clickstream/clickstream-enwiki-2018-06.tsv.gz,Rihanna,53973,434031,4791,492795,168797
hdfs://spark-nn.eemcs.utwente.nl/user/s1934538/clickstream/clickstream-enwiki-2018-06.tsv.gz,Critical_race_theory,1350,10883,28,12261,2462
hdfs://spark-nn.eemcs.utwente.nl/user/s1934538/clickstream/clickstream-enwiki-2018-06.tsv.gz,Lisa_Marie_Presley,113466,91782,267,205515,94688
hdfs://spark-nn.eemcs.utwente.nl/user/s1934538/clickstream/clickstream-enwiki-2018-06.tsv.gz,Valentine's_Day,2649,39784,152,42585,487
hdfs://spark-nn.eemcs.utwente.nl/user/s1934538/clickstream/clickstream-enwiki-2018-06.tsv.gz,Jimmy_Buffett,7918,64891,604,73413,19778
hdfs://spark-nn.eemcs.utwente.nl/user/s1934538/clickstream/clickstream-enwiki-2018-06.tsv.gz,Jeffrey_Epstein,8589,59233,197,68019,15654
hdfs://spark-nn.eemcs.utwente.nl/user/s1934538/clickstream/clickstream-enwiki-2018-06.tsv.gz,21_Savage,31896,117189,3305,152390,49492
hdfs://spark-nn.eemcs.utwente.nl/user/s1934538/clickstream/clickstream-enwiki-2018-06.tsv.gz,Gaza_Strip,14036,54392,318,68746,21624
hdfs://spark-nn.eemcs.utwente.nl/user/s1934538/clickstream/clickstream-enwiki-2018-06.tsv.gz,Irrfan_Khan,36867,152130,426,189423,81552
hdfs://spark-nn.eemcs.utwente.nl/user/s1934538/clickstream/clickstream-enwiki-2018-06.tsv.gz,Avicii,25065,386612,5993,417670,76926
hdfs://spark-nn.eemcs.utwente.nl/user/s1934538/clickstream/clickstream-enwiki-2018-06.tsv.gz,The_Irishman_(2019_film),56563,57927,512,115002,82900
hdfs://spark-nn.eemcs.utwente.nl/user/s1934538/clickstream/clickstream-enwiki-2018-06.tsv.gz,List_of_awards_and_nominations_received_by_Meryl_Streep,11425,8529,122,20076,6455
hdfs://spark-nn.eemcs.utwente.nl/user/s1934538/clickstream/clickstream-enwiki-2018-06.tsv.gz,Cameron_Boyce,12515,49979,276,62770,11213
hdfs://spark-nn.eemcs.utwente.nl/user/s1934538/clickstream/clickstream-enwiki-2018-06.tsv.gz,Chadwick_Boseman,75957,212683,1760,290400,73492
hdfs://spark-nn.eemcs.utwente.nl/user/s1934538/clickstream/clickstream-enwiki-2018-06.tsv.gz,Lance_Reddick,18121,20496,106,38723,7266
hdfs://spark-nn.eemcs.utwente.nl/user/s1934538/clickstream/clickstream-enwiki-2018-06.tsv.gz,Kobe_Bryant,56141,404963,3516,464620,121441
hdfs://spark-nn.eemcs.utwente.nl/user/s1934538/clickstream/clickstream-enwiki-2018-06.tsv.gz,"Prince_Philip,_Duke_of_Edinburgh",275199,508049,9945,793193,428347
hdfs://spark-nn.eemcs.utwente.nl/user/s1934538/clickstream/clickstream-enwiki-2018-06.tsv.gz,Ted_Bundy,32215,272668,3299,308182,68621
hdfs://spark-nn.eemcs.utwente.nl/user/s1934538/clickstream/clickstream-enwiki-2018-06.tsv.gz,Hyphen-minus,7127,40532289,8594371,49133787,872
hdfs://spark-nn.eemcs.utwente.nl/user/s1934538/clickstream/clickstream-enwiki-2018-06.tsv.gz,Stan_Lee,62831,230451,2076,295358,91212
hdfs://spark-nn.eemcs.utwente.nl/user/s1934538/clickstream/clickstream-enwiki-2018-06.tsv.gz,Simone_Biles,7045,44251,139,51435,12520
hdfs://spark-nn.eemcs.utwente.nl/user/s1934538/clickstream/clickstream-enwiki-2018-06.tsv.gz,Tonya_Harding,68421,614255,2049,684725,155380
hdfs://spark-nn.eemcs.utwente.nl/user/s1934538/clickstream/clickstream-enwiki-2018-06.tsv.gz,United_States_Senate,42363,71065,2194,115622,39864
hdfs://spark-nn.eemcs.utwente.nl/user/s1934538/clickstream/clickstream-enwiki-2018-06.tsv.gz,The_Shape_of_Water,32531,174767,2910,210208,90589
hdfs://spark-nn.eemcs.utwente.nl/user/s1934538/clickstream/clickstream-enwiki-2018-06.tsv.gz,Louis_Tomlinson,25889,56226,3698,85813,10557
hdfs://spark-nn.eemcs.utwente.nl/user/s1934538/clickstream/clickstream-enwiki-2018-06.tsv.gz,Deadpool_2,232472,1148328,26161,1406961,891756
hdfs://spark-nn.eemcs.utwente.nl/user/s1934538/clickstream/clickstream-enwiki-2018-06.tsv.gz,Asia_Cup,7432,28244,180,35856,11979
hdfs://spark-nn.eemcs.utwente.nl/user/s1934538/clickstream/clickstream-enwiki-2018-06.tsv.gz,Hamas,13944,50198,392,64534,20783
hdfs://spark-nn.eemcs.utwente.nl/user/s1934538/clickstream/clickstream-enwiki-2018-06.tsv.gz,The_Witcher_(TV_series),3824,21629,79,25532,6410
hdfs://spark-nn.eemcs.utwente.nl/user/s1934538/clickstream/clickstream-enwiki-2018-06.tsv.gz,Aretha_Franklin,13241,65679,684,79604,22207
hdfs://spark-nn.eemcs.utwente.nl/user/s1934538/clickstream/clickstream-enwiki-2018-06.tsv.gz,Anthony_Bourdain,173110,8165505,125381,8463996,1727840
hdfs://spark-nn.eemcs.utwente.nl/user/s1934538/clickstream/clickstream-enwiki-2018-06.tsv.gz,Priyanka_Chopra,62492,1088364,19148,1170004,204767
hdfs://spark-nn.eemcs.utwente.nl/user/s1934538/clickstream/clickstream-enwiki-2018-06.tsv.gz,September_11_attacks,57975,252918,2162,313055,126317
hdfs://spark-nn.eemcs.utwente.nl/user/s1934538/clickstream/clickstream-enwiki-2018-06.tsv.gz,Pornhub,34879,314512,9313,358704,62073
hdfs://spark-nn.eemcs.utwente.nl/user/s1934538/clickstream/clickstream-enwiki-2018-06.tsv.gz,William_Murdoch,449,1698,13,2160,303
hdfs://spark-nn.eemcs.utwente.nl/user/s1934538/clickstream/clickstream-enwiki-2018-06.tsv.gz,Betty_White,38614,202896,1507,243017,47736
hdfs://spark-nn.eemcs.utwente.nl/user/s1934538/clickstream/clickstream-enwiki-2018-06.tsv.gz,Bible,12649,88249,1496,102394,28791
hdfs://spark-nn.eemcs.utwente.nl/user/s1934538/clickstream/clickstream-enwiki-2018-06.tsv.gz,Amber_Heard,104193,189725,1083,295001,143465
hdfs://spark-nn.eemcs.utwente.nl/user/s1934538/clickstream/clickstream-enwiki-2018-06.tsv.gz,Joe_Biden,22746,86044,1032,109822,29254
hdfs://spark-nn.eemcs.utwente.nl/user/s1934538/clickstream/clickstream-enwiki-2018-06.tsv.gz,Brett_Kavanaugh,6919,66936,507,74362,17728
hdfs://spark-nn.eemcs.utwente.nl/user/s1934538/clickstream/clickstream-enwiki-2018-06.tsv.gz,Top_Gun:_Maverick,60887,51095,1069,113051,47240
hdfs://spark-nn.eemcs.utwente.nl/user/s1934538/clickstream/clickstream-enwiki-2018-06.tsv.gz,The_Irishman,33,628,26,687,484
hdfs://spark-nn.eemcs.utwente.nl/user/s1934538/clickstream/clickstream-enwiki-2018-06.tsv.gz,Saaho,37435,59746,810,97991,59844
hdfs://spark-nn.eemcs.utwente.nl/user/s1934538/clickstream/clickstream-enwiki-2018-06.tsv.gz,Olivia_Newton-John,25320,148585,1143,175048,63204
hdfs://spark-nn.eemcs.utwente.nl/user/s1934538/clickstream/clickstream-enwiki-2018-06.tsv.gz,List_of_highest-grossing_films,361561,1154216,7863,1523640,429792
hdfs://spark-nn.eemcs.utwente.nl/user/s1934538/clickstream/clickstream-enwiki-2018-06.tsv.gz,Matthew_Perry,50944,151278,1477,203699,85755
hdfs://spark-nn.eemcs.utwente.nl/user/s1934538/clickstream/clickstream-enwiki-2018-06.tsv.gz,Vladimir_Putin,65330,310994,3239,379563,155544
hdfs://spark-nn.eemcs.utwente.nl/user/s1934538/clickstream/clickstream-enwiki-2018-06.tsv.gz,Bob_Saget,14542,35993,249,50784,8872
hdfs://spark-nn.eemcs.utwente.nl/user/s1934538/clickstream/clickstream-enwiki-2018-06.tsv.gz,Donald_Glover,122800,864309,5808,992917,238020
hdfs://spark-nn.eemcs.utwente.nl/user/s1934538/clickstream/clickstream-enwiki-2018-06.tsv.gz,Henry_V_of_England,38038,29434,123,67595,40157
hdfs://spark-nn.eemcs.utwente.nl/user/s1934538/clickstream/clickstream-enwiki-2018-06.tsv.gz,Amy_Coney_Barrett,9055,120785,705,130545,30006
hdfs://spark-nn.eemcs.utwente.nl/user/s1934538/clickstream/clickstream-enwiki-2018-06.tsv.gz,Game_of_Thrones,84585,505864,12567,603016,366249
hdfs://spark-nn.eemcs.utwente.nl/user/s1934538/clickstream/clickstream-enwiki-2018-06.tsv.gz,Jimmy_Hoffa,21296,98521,838,120655,39656
hdfs://spark-nn.eemcs.utwente.nl/user/s1934538/clickstream/clickstream-enwiki-2018-06.tsv.gz,Michael_Jordan,108327,832504,6989,947820,290866
hdfs://spark-nn.eemcs.utwente.nl/user/s1934538/clickstream/clickstream-enwiki-2018-06.tsv.gz,Chernobyl_disaster,21662,198834,1329,221825,55784
hdfs://spark-nn.eemcs.utwente.nl/user/s1934538/clickstream/clickstream-enwiki-2018-06.tsv.gz,Queen_(band),46676,195826,2764,245266,205347
hdfs://spark-nn.eemcs.utwente.nl/user/s1934538/clickstream/clickstream-enwiki-2018-06.tsv.gz,J._Robert_Oppenheimer,13080,60621,201,73902,22418
hdfs://spark-nn.eemcs.utwente.nl/user/s1934538/clickstream/clickstream-enwiki-2018-06.tsv.gz,Israel,64036,304581,6116,374733,150618
hdfs://spark-nn.eemcs.utwente.nl/user/s1934538/clickstream/clickstream-enwiki-2018-06.tsv.gz,NATO,36340,167145,2036,205521,72127
hdfs://spark-nn.eemcs.utwente.nl/user/s1934538/clickstream/clickstream-enwiki-2018-06.tsv.gz,Antifa_(United_States),8112,95594,174,103880,18616
hdfs://spark-nn.eemcs.utwente.nl/user/s1934538/clickstream/clickstream-enwiki-2018-06.tsv.gz,Shakira,17208,440425,3874,461507,206797
hdfs://spark-nn.eemcs.utwente.nl/user/s1934538/clickstream/clickstream-enwiki-2018-06.tsv.gz,List_of_FIFA_World_Cup_finals,30340,3063446,2612,3096398,616463
hdfs://spark-nn.eemcs.utwente.nl/user/s1934538/clickstream/clickstream-enwiki-2018-06.tsv.gz,Croatia,68934,508888,6713,584535,144145
hdfs://spark-nn.eemcs.utwente.nl/user/s1934538/clickstream/clickstream-enwiki-2018-06.tsv.gz,Donald_Trump,231465,1203095,34066,1468626,753562
hdfs://spark-nn.eemcs.utwente.nl/user/s1934538/clickstream/clickstream-enwiki-2018-06.tsv.gz,Christopher_Scarver,53706,24584,28,78318,22699
hdfs://spark-nn.eemcs.utwente.nl/user/s1934538/clickstream/clickstream-enwiki-2018-06.tsv.gz,Elizabeth_II,510361,1122076,5452,1637889,1179777
hdfs://spark-nn.eemcs.utwente.nl/user/s1934538/clickstream/clickstream-enwiki-2018-06.tsv.gz,Once_Upon_a_Time_in_Hollywood,84719,103827,1298,189844,165871
hdfs://spark-nn.eemcs.utwente.nl/user/s1934538/clickstream/clickstream-enwiki-2018-06.tsv.gz,Exo_(band),27075,1907640,751,1935466,168399
hdfs://spark-nn.eemcs.utwente.nl/user/s1934538/clickstream/clickstream-enwiki-2018-06.tsv.gz,Stephen_Hawking,24060,503260,4016,531336,151611
hdfs://spark-nn.eemcs.utwente.nl/user/s1934538/clickstream/clickstream-enwiki-2018-06.tsv.gz,Rami_Malek,58879,115388,588,174855,55107
hdfs://spark-nn.eemcs.utwente.nl/user/s1934538/clickstream/clickstream-enwiki-2018-06.tsv.gz,"Princess_Margaret,_Countess_of_Snowdon",181721,649251,3272,834244,452456
hdfs://spark-nn.eemcs.utwente.nl/user/s1934538/clickstream/clickstream-enwiki-2018-06.tsv.gz,Stranger_Things,47218,366778,7664,421660,248374
hdfs://spark-nn.eemcs.utwente.nl/user/s1934538/clickstream/clickstream-enwiki-2018-06.tsv.gz,Michael_Bloomberg,22049,69464,421,91934,33236
hdfs://spark-nn.eemcs.utwente.nl/user/s1934538/clickstream/clickstream-enwiki-2018-06.tsv.gz,The_Nun_(2018_film),75160,302196,2891,380247,203824
hdfs://spark-nn.eemcs.utwente.nl/user/s1934538/clickstream/clickstream-enwiki-2018-06.tsv.gz,Bipin_Rawat,5119,18534,23,23676,6600
hdfs://spark-nn.eemcs.utwente.nl/user/s1934538/clickstream/clickstream-enwiki-2018-06.tsv.gz,Article_370_of_the_Constitution_of_India,7322,101703,77,109102,6703
hdfs://spark-nn.eemcs.utwente.nl/user/s1934538/clickstream/clickstream-enwiki-2018-06.tsv.gz,Meat_Loaf,14897,68430,650,83977,26730
hdfs://spark-nn.eemcs.utwente.nl/user/s1934538/clickstream/clickstream-enwiki-2018-06.tsv.gz,R._Kelly,24858,99637,730,125225,50314
hdfs://spark-nn.eemcs.utwente.nl/user/s1934538/clickstream/clickstream-enwiki-2018-06.tsv.gz,Chernobyl_(miniseries),2935,1897,11,4843,1806
hdfs://spark-nn.eemcs.utwente.nl/user/s1934538/clickstream/clickstream-enwiki-2018-06.tsv.gz,Key_frame,591,5270,10,5871,509
hdfs://spark-nn.eemcs.utwente.nl/user/s1934538/clickstream/clickstream-enwiki-2018-06.tsv.gz,Coronavirus,632,6859,13,7504,894
hdfs://spark-nn.eemcs.utwente.nl/user/s1934538/clickstream/clickstream-enwiki-2018-06.tsv.gz,Venom_(2018_film),46948,144686,2377,194011,81100
hdfs://spark-nn.eemcs.utwente.nl/user/s1934538/clickstream/clickstream-enwiki-2018-06.tsv.gz,2022_FIFA_World_Cup,670325,983871,6163,1660359,780070
hdfs://spark-nn.eemcs.utwente.nl/user/s1934538/clickstream/clickstream-enwiki-2018-06.tsv.gz,Freddie_Mercury,83828,576889,4158,664875,205177
hdfs://spark-nn.eemcs.utwente.nl/user/s1934538/clickstream/clickstream-enwiki-2018-06.tsv.gz,Grimes_(musician),44143,84411,469,129023,32494
hdfs://spark-nn.eemcs.utwente.nl/user/s1934538/clickstream/clickstream-enwiki-2018-06.tsv.gz,John_McCain,24299,174179,1907,200385,66227
hdfs://spark-nn.eemcs.utwente.nl/user/s1934538/clickstream/clickstream-enwiki-2018-06.tsv.gz,Ray_Liotta,29438,357493,1479,388410,69816
hdfs://spark-nn.eemcs.utwente.nl/user/s1934538/clickstream/clickstream-enwiki-2018-06.tsv.gz,JSON_Web_Token,1071,24811,27,25909,1607
hdfs://spark-nn.eemcs.utwente.nl/user/s1934538/clickstream/clickstream-enwiki-2018-06.tsv.gz,Joaquin_Phoenix,69704,114302,1075,185081,107502
hdfs://spark-nn.eemcs.utwente.nl/user/s1934538/clickstream/clickstream-enwiki-2018-07.tsv.gz,Deadpool_2,141779,464144,12003,617926,382333
hdfs://spark-nn.eemcs.utwente.nl/user/s1934538/clickstream/clickstream-enwiki-2018-07.tsv.gz,Dark_Phoenix_(film),149048,102087,1254,252389,153671
hdfs://spark-nn.eemcs.utwente.nl/user/s1934538/clickstream/clickstream-enwiki-2018-07.tsv.gz,Ukraine,51675,178729,3697,234101,93455
hdfs://spark-nn.eemcs.utwente.nl/user/s1934538/clickstream/clickstream-enwiki-2018-07.tsv.gz,Captain_Marvel_(film),182162,264684,3348,450194,292203
hdfs://spark-nn.eemcs.utwente.nl/user/s1934538/clickstream/clickstream-enwiki-2018-07.tsv.gz,Lionel_Messi,182816,1280409,11793,1475018,311161
hdfs://spark-nn.eemcs.utwente.nl/user/s1934538/clickstream/clickstream-enwiki-2018-07.tsv.gz,Irrfan_Khan,34367,130645,480,165492,75146
hdfs://spark-nn.eemcs.utwente.nl/user/s1934538/clickstream/clickstream-enwiki-2018-07.tsv.gz,Keanu_Reeves,62048,399085,2518,463651,204264
hdfs://spark-nn.eemcs.utwente.nl/user/s1934538/clickstream/clickstream-enwiki-2018-07.tsv.gz,Sylvester_Stallone,78856,388409,2456,469721,258740
hdfs://spark-nn.eemcs.utwente.nl/user/s1934538/clickstream/clickstream-enwiki-2018-07.tsv.gz,Lisa_Marie_Presley,113667,88828,264,202759,96145
hdfs://spark-nn.eemcs.utwente.nl/user/s1934538/clickstream/clickstream-enwiki-2018-07.tsv.gz,Jeffrey_Dahmer,34398,641993,4206,680597,257424
hdfs://spark-nn.eemcs.utwente.nl/user/s1934538/clickstream/clickstream-enwiki-2018-07.tsv.gz,Exo_(band),26431,5757192,1173,5784796,157104
hdfs://spark-nn.eemcs.utwente.nl/user/s1934538/clickstream/clickstream-enwiki-2018-07.tsv.gz,The_Witcher_(TV_series),4323,19113,116,23552,6674
hdfs://spark-nn.eemcs.utwente.nl/user/s1934538/clickstream/clickstream-enwiki-2018-07.tsv.gz,2.0_(film),49062,143704,752,193518,69931
hdfs://spark-nn.eemcs.utwente.nl/user/s1934538/clickstream/clickstream-enwiki-2018-07.tsv.gz,Aaron_Carter,13692,44577,238,58507,16946
hdfs://spark-nn.eemcs.utwente.nl/user/s1934538/clickstream/clickstream-enwiki-2018-07.tsv.gz,Grimes_(musician),96619,112474,750,209843,42332
hdfs://spark-nn.eemcs.utwente.nl/user/s1934538/clickstream/clickstream-enwiki-2018-07.tsv.gz,Central_Park_jogger_case,4593,53963,333,58889,7893
hdfs://spark-nn.eemcs.utwente.nl/user/s1934538/clickstream/clickstream-enwiki-2018-07.tsv.gz,"Princess_Margaret,_Countess_of_Snowdon",157170,521340,3032,681542,374744
hdfs://spark-nn.eemcs.utwente.nl/user/s1934538/clickstream/clickstream-enwiki-2018-07.tsv.gz,Michael_Bloomberg,24095,50908,360,75363,29159
hdfs://spark-nn.eemcs.utwente.nl/user/s1934538/clickstream/clickstream-enwiki-2018-07.tsv.gz,"Diana,_Princess_of_Wales",124463,299750,4327,428540,222068
hdfs://spark-nn.eemcs.utwente.nl/user/s1934538/clickstream/clickstream-enwiki-2018-07.tsv.gz,Meat_Loaf,19444,107431,1113,127988,41643
hdfs://spark-nn.eemcs.utwente.nl/user/s1934538/clickstream/clickstream-enwiki-2018-07.tsv.gz,Afghanistan,41355,137858,2020,181233,104195
hdfs://spark-nn.eemcs.utwente.nl/user/s1934538/clickstream/clickstream-enwiki-2018-07.tsv.gz,Wonder_Woman_1984,141204,89094,970,231268,129010
hdfs://spark-nn.eemcs.utwente.nl/user/s1934538/clickstream/clickstream-enwiki-2018-07.tsv.gz,Joe_Biden,27202,112090,1541,140833,40773
hdfs://spark-nn.eemcs.utwente.nl/user/s1934538/clickstream/clickstream-enwiki-2018-07.tsv.gz,Avengers:_Infinity_War,364664,1197639,33391,1595694,876536
hdfs://spark-nn.eemcs.utwente.nl/user/s1934538/clickstream/clickstream-enwiki-2018-07.tsv.gz,The_Shape_of_Water,35023,167504,3549,206076,98103
hdfs://spark-nn.eemcs.utwente.nl/user/s1934538/clickstream/clickstream-enwiki-2018-07.tsv.gz,Kelly_Preston,64139,46647,156,110942,28235
hdfs://spark-nn.eemcs.utwente.nl/user/s1934538/clickstream/clickstream-enwiki-2018-07.tsv.gz,Crazy_Rich_Asians_(film),46174,148998,1332,196504,175996
hdfs://spark-nn.eemcs.utwente.nl/user/s1934538/clickstream/clickstream-enwiki-2018-07.tsv.gz,Key_frame,661,5003,12,5676,598
hdfs://spark-nn.eemcs.utwente.nl/user/s1934538/clickstream/clickstream-enwiki-2018-07.tsv.gz,Lance_Reddick,20850,22104,118,43072,8647
hdfs://spark-nn.eemcs.utwente.nl/user/s1934538/clickstream/clickstream-enwiki-2018-07.tsv.gz,Cricket_World_Cup,11251,134367,1012,146630,84736
hdfs://spark-nn.eemcs.utwente.nl/user/s1934538/clickstream/clickstream-enwiki-2018-07.tsv.gz,Microsoft_Office,8657,91243,591,100491,21020
hdfs://spark-nn.eemcs.utwente.nl/user/s1934538/clickstream/clickstream-enwiki-2018-07.tsv.gz,Charles_Sobhraj,3550,102428,598,106576,13023
hdfs://spark-nn.eemcs.utwente.nl/user/s1934538/clickstream/clickstream-enwiki-2018-07.tsv.gz,2023_Cricket_World_Cup,26338,18684,348,45370,15924
hdfs://spark-nn.eemcs.utwente.nl/user/s1934538/clickstream/clickstream-enwiki-2018-07.tsv.gz,Valentine's_Day,2194,28612,128,30934,381
hdfs://spark-nn.eemcs.utwente.nl/user/s1934538/clickstream/clickstream-enwiki-2018-07.tsv.gz,Brie_Larson,143338,174857,1196,319391,118923
hdfs://spark-nn.eemcs.utwente.nl/user/s1934538/clickstream/clickstream-enwiki-2018-07.tsv.gz,George_H._W._Bush,110755,153965,995,265715,131383
hdfs://spark-nn.eemcs.utwente.nl/user/s1934538/clickstream/clickstream-enwiki-2018-07.tsv.gz,Tunnel,3466,12529,145,16140,3677
hdfs://spark-nn.eemcs.utwente.nl/user/s1934538/clickstream/clickstream-enwiki-2018-07.tsv.gz,Stan_Lee,78574,274191,2796,355561,111685
hdfs://spark-nn.eemcs.utwente.nl/user/s1934538/clickstream/clickstream-enwiki-2018-07.tsv.gz,Manti_Te'o,2972,12531,48,15551,506
hdfs://spark-nn.eemcs.utwente.nl/user/s1934538/clickstream/clickstream-enwiki-2018-07.tsv.gz,Hyphen-minus,8532,79329056,9267956,88605544,886
hdfs://spark-nn.eemcs.utwente.nl/user/s1934538/clickstream/clickstream-enwiki-2018-07.tsv.gz,Sushant_Singh_Rajput,23933,69139,405,93477,48503
hdfs://spark-nn.eemcs.utwente.nl/user/s1934538/clickstream/clickstream-enwiki-2018-07.tsv.gz,Anthony_Bourdain,22398,538906,5874,567178,148104
hdfs://spark-nn.eemcs.utwente.nl/user/s1934538/clickstream/clickstream-enwiki-2018-07.tsv.gz,Atal_Bihari_Vajpayee,27375,101321,130,128826,27410
hdfs://spark-nn.eemcs.utwente.nl/user/s1934538/clickstream/clickstream-enwiki-2018-07.tsv.gz,Coronavirus,647,5825,15,6487,855
hdfs://spark-nn.eemcs.utwente.nl/user/s1934538/clickstream/clickstream-enwiki-2018-07.tsv.gz,Naya_Rivera,22299,60812,152,83263,15307
hdfs://spark-nn.eemcs.utwente.nl/user/s1934538/clickstream/clickstream-enwiki-2018-07.tsv.gz,XHamster,7681,6968710,2099,6978490,37155
hdfs://spark-nn.eemcs.utwente.nl/user/s1934538/clickstream/clickstream-enwiki-2018-07.tsv.gz,WrestleMania_34,38054,47225,703,85982,55506
hdfs://spark-nn.eemcs.utwente.nl/user/s1934538/clickstream/clickstream-enwiki-2018-07.tsv.gz,Venom_(2018_film),63432,274661,6007,344100,186139
hdfs://spark-nn.eemcs.utwente.nl/user/s1934538/clickstream/clickstream-enwiki-2018-07.tsv.gz,Puneeth_Rajkumar,9009,21663,38,30710,12906
hdfs://spark-nn.eemcs.utwente.nl/user/s1934538/clickstream/clickstream-enwiki-2018-07.tsv.gz,Cardi_B,106286,1507066,12321,1625673,453251
hdfs://spark-nn.eemcs.utwente.nl/user/s1934538/clickstream/clickstream-enwiki-2018-07.tsv.gz,FIFA_World_Cup,598551,2860682,30847,3490080,2777555
hdfs://spark-nn.eemcs.utwente.nl/user/s1934538/clickstream/clickstream-enwiki-2018-07.tsv.gz,Priyanka_Chopra,69062,1062832,20448,1152342,241504
hdfs://spark-nn.eemcs.utwente.nl/user/s1934538/clickstream/clickstream-enwiki-2018-07.tsv.gz,Elon_Musk,126203,1457931,10721,1594855,839928
hdfs://spark-nn.eemcs.utwente.nl/user/s1934538/clickstream/clickstream-enwiki-2018-07.tsv.gz,Darth_Vader,21751,2327206,604,2349561,49737
hdfs://spark-nn.eemcs.utwente.nl/user/s1934538/clickstream/clickstream-enwiki-2018-07.tsv.gz,Vladimir_Putin,107303,763101,8473,878877,392367
hdfs://spark-nn.eemcs.utwente.nl/user/s1934538/clickstream/clickstream-enwiki-2018-07.tsv.gz,George_VI,369167,276152,1001,646320,433360
hdfs://spark-nn.eemcs.utwente.nl/user/s1934538/clickstream/clickstream-enwiki-2018-07.tsv.gz,Bonnie_and_Clyde,13759,148601,1070,163430,33790
hdfs://spark-nn.eemcs.utwente.nl/user/s1934538/clickstream/clickstream-enwiki-2018-07.tsv.gz,List_of_FIFA_World_Cup_finals,39381,3479840,3739,3522960,779502
hdfs://spark-nn.eemcs.utwente.nl/user/s1934538/clickstream/clickstream-enwiki-2018-07.tsv.gz,DMX_(rapper),12867,75623,671,89161,32252
hdfs://spark-nn.eemcs.utwente.nl/user/s1934538/clickstream/clickstream-enwiki-2018-07.tsv.gz,The_Weeknd,57441,138071,1322,196834,70251
hdfs://spark-nn.eemcs.utwente.nl/user/s1934538/clickstream/clickstream-enwiki-2018-07.tsv.gz,Gaza_Strip,12683,46204,582,59469,20858
hdfs://spark-nn.eemcs.utwente.nl/user/s1934538/clickstream/clickstream-enwiki-2018-07.tsv.gz,Game_of_Thrones,92718,566768,13514,673000,424290
hdfs://spark-nn.eemcs.utwente.nl/user/s1934538/clickstream/clickstream-enwiki-2018-07.tsv.gz,JSON_Web_Token,1076,23817,22,24915,1841
hdfs://spark-nn.eemcs.utwente.nl/user/s1934538/clickstream/clickstream-enwiki-2018-07.tsv.gz,Mac_Miller,30299,77969,549,108817,42406
hdfs://spark-nn.eemcs.utwente.nl/user/s1934538/clickstream/clickstream-enwiki-2018-07.tsv.gz,Kobe_Bryant_sexual_assault_case,3610,25099,37,28746,3114
hdfs://spark-nn.eemcs.utwente.nl/user/s1934538/clickstream/clickstream-enwiki-2018-07.tsv.gz,Christopher_Scarver,104680,32080,15,136775,38918
hdfs://spark-nn.eemcs.utwente.nl/user/s1934538/clickstream/clickstream-enwiki-2018-07.tsv.gz,Aretha_Franklin,14119,62059,718,76896,24031
hdfs://spark-nn.eemcs.utwente.nl/user/s1934538/clickstream/clickstream-enwiki-2018-07.tsv.gz,Cecil_Hotel_(Los_Angeles),5494,27106,39,32639,10420
hdfs://spark-nn.eemcs.utwente.nl/user/s1934538/clickstream/clickstream-enwiki-2018-07.tsv.gz,Google_logo,841,15443,10,16294,1887
hdfs://spark-nn.eemcs.utwente.nl/user/s1934538/clickstream/clickstream-enwiki-2018-07.tsv.gz,YouTube,105185,718515,7655,831355,120028
hdfs://spark-nn.eemcs.utwente.nl/user/s1934538/clickstream/clickstream-enwiki-2018-07.tsv.gz,Rihanna,55795,312709,3612,372116,146054
hdfs://spark-nn.eemcs.utwente.nl/user/s1934538/clickstream/clickstream-enwiki-2018-07.tsv.gz,"Prince_Philip,_Duke_of_Edinburgh",239264,411780,7555,658599,349478
hdfs://spark-nn.eemcs.utwente.nl/user/s1934538/clickstream/clickstream-enwiki-2018-07.tsv.gz,Johnny_Depp,97820,349039,3060,449919,265807
hdfs://spark-nn.eemcs.utwente.nl/user/s1934538/clickstream/clickstream-enwiki-2018-07.tsv.gz,Cristiano_Ronaldo,298028,3033952,21603,3353583,781271
hdfs://spark-nn.eemcs.utwente.nl/user/s1934538/clickstream/clickstream-enwiki-2018-07.tsv.gz,IPv4,11503,45210,171,56884,9952
hdfs://spark-nn.eemcs.utwente.nl/user/s1934538/clickstream/clickstream-enwiki-2018-07.tsv.gz,Khabib_Nurmagomedov,26344,119556,1146,147046,60357
hdfs://spark-nn.eemcs.utwente.nl/user/s1934538/clickstream/clickstream-enwiki-2018-07.tsv.gz,2018_FIFA_World_Cup,1050774,7082144,423153,8556071,3580664
hdfs://spark-nn.eemcs.utwente.nl/user/s1934538/clickstream/clickstream-enwiki-2018-07.tsv.gz,2018_Asian_Games,32116,240640,2120,274876,176943
hdfs://spark-nn.eemcs.utwente.nl/user/s1934538/clickstream/clickstream-enwiki-2018-07.tsv.gz,Aaron_Hernandez,6220,62543,234,68997,17177
hdfs://spark-nn.eemcs.utwente.nl/user/s1934538/clickstream/clickstream-enwiki-2018-07.tsv.gz,"Meghan,_Duchess_of_Sussex",128842,618688,4451,751981,254685
hdfs://spark-nn.eemcs.utwente.nl/user/s1934538/clickstream/clickstream-enwiki-2018-07.tsv.gz,Adele,19029,160036,2209,181274,52027
hdfs://spark-nn.eemcs.utwente.nl/user/s1934538/clickstream/clickstream-enwiki-2018-07.tsv.gz,Jenna_Ortega,9363,33562,247,43172,5863
hdfs://spark-nn.eemcs.utwente.nl/user/s1934538/clickstream/clickstream-enwiki-2018-07.tsv.gz,Matthew_Perry,63152,170490,725,234367,102837
hdfs://spark-nn.eemcs.utwente.nl/user/s1934538/clickstream/clickstream-enwiki-2018-07.tsv.gz,Top_Gun:_Maverick,115548,65173,830,181551,115580
hdfs://spark-nn.eemcs.utwente.nl/user/s1934538/clickstream/clickstream-enwiki-2018-07.tsv.gz,Bipin_Rawat,4547,17873,13,22433,5979
hdfs://spark-nn.eemcs.utwente.nl/user/s1934538/clickstream/clickstream-enwiki-2018-07.tsv.gz,Queen_(band),72001,282861,3486,358348,328581
hdfs://spark-nn.eemcs.utwente.nl/user/s1934538/clickstream/clickstream-enwiki-2018-07.tsv.gz,Bird_Box_(film),14166,6649,331,21146,8553
hdfs://spark-nn.eemcs.utwente.nl/user/s1934538/clickstream/clickstream-enwiki-2018-07.tsv.gz,Tina_Turner,18606,407523,4578,430707,110085
hdfs://spark-nn.eemcs.utwente.nl/user/s1934538/clickstream/clickstream-enwiki-2018-07.tsv.gz,Kim_Jong-un,29687,133242,1091,164020,68052
hdfs://spark-nn.eemcs.utwente.nl/user/s1934538/clickstream/clickstream-enwiki-2018-07.tsv.gz,Indian_Premier_League,8863,41246,559,50668,21267
hdfs://spark-nn.eemcs.utwente.nl/user/s1934538/clickstream/clickstream-enwiki-2018-07.tsv.gz,Critical_race_theory,1428,10127,15,11570,2256
hdfs://spark-nn.eemcs.utwente.nl/user/s1934538/clickstream/clickstream-enwiki-2018-07.tsv.gz,Hamilton_(musical),31823,285837,1828,319488,164701
hdfs://spark-nn.eemcs.utwente.nl/user/s1934538/clickstream/clickstream-enwiki-2018-07.tsv.gz,2022_FIFA_World_Cup,553174,972887,10716,1536777,657652
hdfs://spark-nn.eemcs.utwente.nl/user/s1934538/clickstream/clickstream-enwiki-2018-07.tsv.gz,Jeffrey_Epstein,11192,41234,222,52648,16774
hdfs://spark-nn.eemcs.utwente.nl/user/s1934538/clickstream/clickstream-enwiki-2018-07.tsv.gz,Tom_Brady,29555,151061,1388,182004,57817
hdfs://spark-nn.eemcs.utwente.nl/user/s1934538/clickstream/clickstream-enwiki-2018-07.tsv.gz,State_of_Palestine,40108,70980,239,111327,46864
hdfs://spark-nn.eemcs.utwente.nl/user/s1934538/clickstream/clickstream-enwiki-2018-07.tsv.gz,The_Nun_(2018_film),67489,201401,1509,270399,117372
hdfs://spark-nn.eemcs.utwente.nl/user/s1934538/clickstream/clickstream-enwiki-2018-07.tsv.gz,Antifa_(United_States),16347,210885,501,227733,31739
hdfs://spark-nn.eemcs.utwente.nl/user/s1934538/clickstream/clickstream-enwiki-2018-07.tsv.gz,List_of_Marvel_Cinematic_Universe_films,148423,1017247,2645,1168315,367651
hdfs://spark-nn.eemcs.utwente.nl/user/s1934538/clickstream/clickstream-enwiki-2018-07.tsv.gz,Louis_Tomlinson,34161,5016348,1195,5051704,14948
hdfs://spark-nn.eemcs.utwente.nl/user/s1934538/clickstream/clickstream-enwiki-2018-07.tsv.gz,Qasem_Soleimani,3003,17320,93,20416,10330
hdfs://spark-nn.eemcs.utwente.nl/user/s1934538/clickstream/clickstream-enwiki-2018-07.tsv.gz,United_States_Senate,46667,62957,938,110562,42931
hdfs://spark-nn.eemcs.utwente.nl/user/s1934538/clickstream/clickstream-enwiki-2018-07.tsv.gz,Deaths_in_2018,1268380,2071743,8387,3348510,1845043
hdfs://spark-nn.eemcs.utwente.nl/user/s1934538/clickstream/clickstream-enwiki-2018-07.tsv.gz,Fantastic_Beasts:_The_Crimes_of_Grindelwald,111923,181366,3005,296294,210033
hdfs://spark-nn.eemcs.utwente.nl/user/s1934538/clickstream/clickstream-enwiki-2018-07.tsv.gz,Rishi_Sunak,3276,2516,14,5806,920
hdfs://spark-nn.eemcs.utwente.nl/user/s1934538/clickstream/clickstream-enwiki-2018-07.tsv.gz,Chernobyl_(miniseries),3073,2074,20,5167,1859
hdfs://spark-nn.eemcs.utwente.nl/user/s1934538/clickstream/clickstream-enwiki-2018-07.tsv.gz,Elizabeth_II,467463,889245,3908,1360616,1011798
hdfs://spark-nn.eemcs.utwente.nl/user/s1934538/clickstream/clickstream-enwiki-2018-07.tsv.gz,Main_Page,22366,447191826,3003742,450217934,33270436
hdfs://spark-nn.eemcs.utwente.nl/user/s1934538/clickstream/clickstream-enwiki-2018-10.tsv.gz,2018_Asian_Games,17905,135094,647,153646,49995
hdfs://spark-nn.eemcs.utwente.nl/user/s1934538/clickstream/clickstream-enwiki-2018-10.tsv.gz,Salman_Rushdie,19631,64475,475,84581,36889
hdfs://spark-nn.eemcs.utwente.nl/user/s1934538/clickstream/clickstream-enwiki-2018-10.tsv.gz,Israel,67757,281511,4681,353949,151228
hdfs://spark-nn.eemcs.utwente.nl/user/s1934538/clickstream/clickstream-enwiki-2018-10.tsv.gz,Shakira,12929,200885,1708,215522,82294
hdfs://spark-nn.eemcs.utwente.nl/user/s1934538/clickstream/clickstream-enwiki-2018-10.tsv.gz,Amy_Coney_Barrett,13254,106666,4009,123929,20224
hdfs://spark-nn.eemcs.utwente.nl/user/s1934538/clickstream/clickstream-enwiki-2018-10.tsv.gz,Crazy_Rich_Asians_(film),79042,385962,4847,469851,356222
hdfs://spark-nn.eemcs.utwente.nl/user/s1934538/clickstream/clickstream-enwiki-2018-10.tsv.gz,Bird_Box_(film),30640,107191,1478,139309,60096
hdfs://spark-nn.eemcs.utwente.nl/user/s1934538/clickstream/clickstream-enwiki-2018-10.tsv.gz,Once_Upon_a_Time_in_Hollywood,139485,78910,713,219108,221822
hdfs://spark-nn.eemcs.utwente.nl/user/s1934538/clickstream/clickstream-enwiki-2018-10.tsv.gz,DMX_(rapper),13704,67874,813,82391,31356
hdfs://spark-nn.eemcs.utwente.nl/user/s1934538/clickstream/clickstream-enwiki-2018-10.tsv.gz,Eddie_Van_Halen,26338,41267,340,67945,27696
hdfs://spark-nn.eemcs.utwente.nl/user/s1934538/clickstream/clickstream-enwiki-2018-10.tsv.gz,Matthew_Perry,59557,172132,644,232333,118773
hdfs://spark-nn.eemcs.utwente.nl/user/s1934538/clickstream/clickstream-enwiki-2018-10.tsv.gz,The_Lion_King_(2019_film),66100,108866,1297,176263,162074
hdfs://spark-nn.eemcs.utwente.nl/user/s1934538/clickstream/clickstream-enwiki-2018-10.tsv.gz,John_McCain,35542,280505,1960,318007,75028
hdfs://spark-nn.eemcs.utwente.nl/user/s1934538/clickstream/clickstream-enwiki-2018-10.tsv.gz,September_11_attacks,69797,335124,3739,408660,159761
hdfs://spark-nn.eemcs.utwente.nl/user/s1934538/clickstream/clickstream-enwiki-2018-10.tsv.gz,Meat_Loaf,20554,95981,900,117435,38568
hdfs://spark-nn.eemcs.utwente.nl/user/s1934538/clickstream/clickstream-enwiki-2018-10.tsv.gz,Jeffrey_Epstein,16964,32105,112,49181,12265
hdfs://spark-nn.eemcs.utwente.nl/user/s1934538/clickstream/clickstream-enwiki-2018-10.tsv.gz,Tom_Brady,97615,509179,5332,612126,190015
hdfs://spark-nn.eemcs.utwente.nl/user/s1934538/clickstream/clickstream-enwiki-2018-10.tsv.gz,The_Shape_of_Water,35937,175773,2728,214438,111963
hdfs://spark-nn.eemcs.utwente.nl/user/s1934538/clickstream/clickstream-enwiki-2018-10.tsv.gz,Priyanka_Chopra,110032,356145,1546,467723,186646
hdfs://spark-nn.eemcs.utwente.nl/user/s1934538/clickstream/clickstream-enwiki-2018-10.tsv.gz,Google_logo,959,17198,10,18167,2197
hdfs://spark-nn.eemcs.utwente.nl/user/s1934538/clickstream/clickstream-enwiki-2018-10.tsv.gz,Charles_III,109,260,61,430,303
hdfs://spark-nn.eemcs.utwente.nl/user/s1934538/clickstream/clickstream-enwiki-2018-10.tsv.gz,Microsoft_Office,11695,98005,878,110578,30169
hdfs://spark-nn.eemcs.utwente.nl/user/s1934538/clickstream/clickstream-enwiki-2018-10.tsv.gz,Cook's_Country,270,8383493,22,8383785,40
hdfs://spark-nn.eemcs.utwente.nl/user/s1934538/clickstream/clickstream-enwiki-2018-10.tsv.gz,Qasem_Soleimani,1902,5795,32,7729,3362
hdfs://spark-nn.eemcs.utwente.nl/user/s1934538/clickstream/clickstream-enwiki-2018-10.tsv.gz,Juice_Wrld,16813,204627,2580,224020,52391
hdfs://spark-nn.eemcs.utwente.nl/user/s1934538/clickstream/clickstream-enwiki-2018-10.tsv.gz,Ukraine,41839,139154,2909,183902,81073
hdfs://spark-nn.eemcs.utwente.nl/user/s1934538/clickstream/clickstream-enwiki-2018-10.tsv.gz,Bible,18015,94433,1681,114129,35448
hdfs://spark-nn.eemcs.utwente.nl/user/s1934538/clickstream/clickstream-enwiki-2018-10.tsv.gz,William_Murdoch,601,1483,14,2098,299
hdfs://spark-nn.eemcs.utwente.nl/user/s1934538/clickstream/clickstream-enwiki-2018-10.tsv.gz,Chernobyl_disaster,30145,498685,1664,530494,98720
hdfs://spark-nn.eemcs.utwente.nl/user/s1934538/clickstream/clickstream-enwiki-2018-10.tsv.gz,Bob_Saget,16720,64536,431,81687,12245
hdfs://spark-nn.eemcs.utwente.nl/user/s1934538/clickstream/clickstream-enwiki-2018-10.tsv.gz,Game_of_Thrones_(season_8),52785,391448,1032,445265,137656
hdfs://spark-nn.eemcs.utwente.nl/user/s1934538/clickstream/clickstream-enwiki-2018-10.tsv.gz,Puneeth_Rajkumar,10560,20325,23,30908,14769
hdfs://spark-nn.eemcs.utwente.nl/user/s1934538/clickstream/clickstream-enwiki-2018-10.tsv.gz,Juneteenth,2280,17691,55,20026,2122
hdfs://spark-nn.eemcs.utwente.nl/user/s1934538/clickstream/clickstream-enwiki-2018-10.tsv.gz,Stan_Lee,68231,199735,2108,270074,88500
hdfs://spark-nn.eemcs.utwente.nl/user/s1934538/clickstream/clickstream-enwiki-2018-10.tsv.gz,George_VI,318904,189653,645,509202,347428
hdfs://spark-nn.eemcs.utwente.nl/user/s1934538/clickstream/clickstream-enwiki-2018-10.tsv.gz,Grover,1381,8839,55,10275,1514
hdfs://spark-nn.eemcs.utwente.nl/user/s1934538/clickstream/clickstream-enwiki-2018-10.tsv.gz,Gaza_Strip,12626,44036,262,56924,19471
hdfs://spark-nn.eemcs.utwente.nl/user/s1934538/clickstream/clickstream-enwiki-2018-10.tsv.gz,2018_FIFA_World_Cup,63468,1304162,3159,1370789,145603
hdfs://spark-nn.eemcs.utwente.nl/user/s1934538/clickstream/clickstream-enwiki-2018-10.tsv.gz,Amber_Heard,108394,166850,982,276226,145547
hdfs://spark-nn.eemcs.utwente.nl/user/s1934538/clickstream/clickstream-enwiki-2018-10.tsv.gz,Stranger_Things,56741,387589,10978,455308,289557
hdfs://spark-nn.eemcs.utwente.nl/user/s1934538/clickstream/clickstream-enwiki-2018-10.tsv.gz,IPv4,14092,54364,176,68632,11857
hdfs://spark-nn.eemcs.utwente.nl/user/s1934538/clickstream/clickstream-enwiki-2018-10.tsv.gz,Mac_Miller,70863,557952,6402,635217,157571
hdfs://spark-nn.eemcs.utwente.nl/user/s1934538/clickstream/clickstream-enwiki-2018-10.tsv.gz,List_of_FIFA_World_Cup_finals,1497,45847,54,47398,11196
hdfs://spark-nn.eemcs.utwente.nl/user/s1934538/clickstream/clickstream-enwiki-2018-10.tsv.gz,Cecil_Hotel_(Los_Angeles),8825,35287,73,44185,15148
hdfs://spark-nn.eemcs.utwente.nl/user/s1934538/clickstream/clickstream-enwiki-2018-10.tsv.gz,21_Savage,19583,67160,925,87668,32400
hdfs://spark-nn.eemcs.utwente.nl/user/s1934538/clickstream/clickstream-enwiki-2018-10.tsv.gz,Alexander_Hamilton,72783,341579,2076,416438,156164
hdfs://spark-nn.eemcs.utwente.nl/user/s1934538/clickstream/clickstream-enwiki-2018-10.tsv.gz,Line_shaft,666,1189,24,1879,137
hdfs://spark-nn.eemcs.utwente.nl/user/s1934538/clickstream/clickstream-enwiki-2018-10.tsv.gz,XHamster,7647,4458633,2240,4468520,29077
hdfs://spark-nn.eemcs.utwente.nl/user/s1934538/clickstream/clickstream-enwiki-2018-10.tsv.gz,1234,94,1633,15,1742,203
hdfs://spark-nn.eemcs.utwente.nl/user/s1934538/clickstream/clickstream-enwiki-2018-10.tsv.gz,Cardi_B,78306,1122499,13154,1213959,354247
hdfs://spark-nn.eemcs.utwente.nl/user/s1934538/clickstream/clickstream-enwiki-2018-10.tsv.gz,2.0_(film),50081,168021,1075,219177,72363
hdfs://spark-nn.eemcs.utwente.nl/user/s1934538/clickstream/clickstream-enwiki-2018-10.tsv.gz,Avicii,19015,241371,2667,263053,56326
hdfs://spark-nn.eemcs.utwente.nl/user/s1934538/clickstream/clickstream-enwiki-2018-10.tsv.gz,Mulan_(2020_film),31819,36216,432,68467,78875
hdfs://spark-nn.eemcs.utwente.nl/user/s1934538/clickstream/clickstream-enwiki-2018-10.tsv.gz,Naomi_Osaka,9349,93631,639,103619,17734
hdfs://spark-nn.eemcs.utwente.nl/user/s1934538/clickstream/clickstream-enwiki-2018-10.tsv.gz,Deadpool_2,85292,225709,6094,317095,261052
hdfs://spark-nn.eemcs.utwente.nl/user/s1934538/clickstream/clickstream-enwiki-2018-10.tsv.gz,JSON_Web_Token,1153,21990,26,23169,2160
hdfs://spark-nn.eemcs.utwente.nl/user/s1934538/clickstream/clickstream-enwiki-2018-10.tsv.gz,Fyre_Festival,6435,88857,674,95966,49750
hdfs://spark-nn.eemcs.utwente.nl/user/s1934538/clickstream/clickstream-enwiki-2018-10.tsv.gz,"Princess_Margaret,_Countess_of_Snowdon",131852,346653,2109,480614,289190
hdfs://spark-nn.eemcs.utwente.nl/user/s1934538/clickstream/clickstream-enwiki-2018-10.tsv.gz,WrestleMania_34,36473,35566,686,72725,51246
hdfs://spark-nn.eemcs.utwente.nl/user/s1934538/clickstream/clickstream-enwiki-2018-10.tsv.gz,Simone_Biles,11458,62257,665,74380,24230
hdfs://spark-nn.eemcs.utwente.nl/user/s1934538/clickstream/clickstream-enwiki-2018-10.tsv.gz,FIFA_World_Cup,28367,124508,1527,154402,93357
hdfs://spark-nn.eemcs.utwente.nl/user/s1934538/clickstream/clickstream-enwiki-2018-10.tsv.gz,A_Quiet_Place_(film),38232,341792,3602,383626,97564
hdfs://spark-nn.eemcs.utwente.nl/user/s1934538/clickstream/clickstream-enwiki-2018-10.tsv.gz,Vladimir_Putin,63575,266737,3042,333354,149206
hdfs://spark-nn.eemcs.utwente.nl/user/s1934538/clickstream/clickstream-enwiki-2018-10.tsv.gz,David_Beckham,27566,185186,1285,214037,59300
hdfs://spark-nn.eemcs.utwente.nl/user/s1934538/clickstream/clickstream-enwiki-2018-10.tsv.gz,The_Irishman_(2019_film),52141,44479,420,97040,78696
hdfs://spark-nn.eemcs.utwente.nl/user/s1934538/clickstream/clickstream-enwiki-2018-10.tsv.gz,Keanu_Reeves,67213,426706,2596,496515,226978
hdfs://spark-nn.eemcs.utwente.nl/user/s1934538/clickstream/clickstream-enwiki-2018-10.tsv.gz,Chadwick_Boseman,48605,94340,800,143745,42329
hdfs://spark-nn.eemcs.utwente.nl/user/s1934538/clickstream/clickstream-enwiki-2018-10.tsv.gz,Johnny_Depp,111169,360885,3760,475814,302564
hdfs://spark-nn.eemcs.utwente.nl/user/s1934538/clickstream/clickstream-enwiki-2018-10.tsv.gz,Tasuku_Honjo,24288,74039,15705,114032,35433
hdfs://spark-nn.eemcs.utwente.nl/user/s1934538/clickstream/clickstream-enwiki-2018-10.tsv.gz,Anne_Heche,26348,66184,332,92864,23610
hdfs://spark-nn.eemcs.utwente.nl/user/s1934538/clickstream/clickstream-enwiki-2018-10.tsv.gz,List_of_awards_and_nominations_received_by_Meryl_Streep,10160,7108,53,17321,5720
hdfs://spark-nn.eemcs.utwente.nl/user/s1934538/clickstream/clickstream-enwiki-2018-10.tsv.gz,Anthony_Bourdain,18292,372509,3240,394041,104295
hdfs://spark-nn.eemcs.utwente.nl/user/s1934538/clickstream/clickstream-enwiki-2018-10.tsv.gz,Pornhub,33425,533169,9980,576574,93445
hdfs://spark-nn.eemcs.utwente.nl/user/s1934538/clickstream/clickstream-enwiki-2018-10.tsv.gz,Black_Panther_(film),75183,287945,5635,368763,247926
hdfs://spark-nn.eemcs.utwente.nl/user/s1934538/clickstream/clickstream-enwiki-2018-10.tsv.gz,Jimmy_Buffett,6484,45523,569,52576,17668
hdfs://spark-nn.eemcs.utwente.nl/user/s1934538/clickstream/clickstream-enwiki-2018-10.tsv.gz,Adele,21452,169079,2628,193159,58397
hdfs://spark-nn.eemcs.utwente.nl/user/s1934538/clickstream/clickstream-enwiki-2018-10.tsv.gz,Brett_Kavanaugh,222451,1997169,26467,2246087,757258
hdfs://spark-nn.eemcs.utwente.nl/user/s1934538/clickstream/clickstream-enwiki-2018-10.tsv.gz,Sylvester_Stallone,76703,764283,4211,845197,300697
hdfs://spark-nn.eemcs.utwente.nl/user/s1934538/clickstream/clickstream-enwiki-2018-10.tsv.gz,Elizabeth_II,564122,722598,3819,1290539,1051111
hdfs://spark-nn.eemcs.utwente.nl/user/s1934538/clickstream/clickstream-enwiki-2018-10.tsv.gz,Henry_V_of_England,41243,29851,1750,72844,46538
hdfs://spark-nn.eemcs.utwente.nl/user/s1934538/clickstream/clickstream-enwiki-2018-10.tsv.gz,2022_FIFA_World_Cup,42143,76486,1023,119652,59808
hdfs://spark-nn.eemcs.utwente.nl/user/s1934538/clickstream/clickstream-enwiki-2018-10.tsv.gz,List_of_James_Bond_films,11460,188855,220,200535,76391
hdfs://spark-nn.eemcs.utwente.nl/user/s1934538/clickstream/clickstream-enwiki-2018-10.tsv.gz,Simple_Mail_Transfer_Protocol,5503,46320,188,52011,6492
hdfs://spark-nn.eemcs.utwente.nl/user/s1934538/clickstream/clickstream-enwiki-2018-10.tsv.gz,Venom_(2018_film),265946,4087241,93012,4446199,2144792
hdfs://spark-nn.eemcs.utwente.nl/user/s1934538/clickstream/clickstream-enwiki-2018-10.tsv.gz,List_of_highest-grossing_Indian_films,55857,293482,893,350232,164125
hdfs://spark-nn.eemcs.utwente.nl/user/s1934538/clickstream/clickstream-enwiki-2018-10.tsv.gz,Olivia_Newton-John,19720,86453,890,107063,42451
hdfs://spark-nn.eemcs.utwente.nl/user/s1934538/clickstream/clickstream-enwiki-2018-10.tsv.gz,Media,63,65720,385,66168,3133
hdfs://spark-nn.eemcs.utwente.nl/user/s1934538/clickstream/clickstream-enwiki-2018-10.tsv.gz,Brie_Larson,91229,122655,930,214814,79754
hdfs://spark-nn.eemcs.utwente.nl/user/s1934538/clickstream/clickstream-enwiki-2018-10.tsv.gz,The_Mandalorian,26964,27030,1078,55072,19968
hdfs://spark-nn.eemcs.utwente.nl/user/s1934538/clickstream/clickstream-enwiki-2018-10.tsv.gz,Ruth_Bader_Ginsburg,207768,757056,4198,969022,294834
hdfs://spark-nn.eemcs.utwente.nl/user/s1934538/clickstream/clickstream-enwiki-2018-10.tsv.gz,Murder_of_Dee_Dee_Blanchard,4867,282040,298,287205,38642
hdfs://spark-nn.eemcs.utwente.nl/user/s1934538/clickstream/clickstream-enwiki-2018-10.tsv.gz,R._Kelly,23235,105025,750,129010,58085
hdfs://spark-nn.eemcs.utwente.nl/user/s1934538/clickstream/clickstream-enwiki-2018-10.tsv.gz,Irrfan_Khan,37071,71110,716,108897,44322
hdfs://spark-nn.eemcs.utwente.nl/user/s1934538/clickstream/clickstream-enwiki-2018-10.tsv.gz,Louis_Tomlinson,50766,172596,548,223910,26375
hdfs://spark-nn.eemcs.utwente.nl/user/s1934538/clickstream/clickstream-enwiki-2018-10.tsv.gz,Tunnel,3764,10155582,168,10159514,4297
hdfs://spark-nn.eemcs.utwente.nl/user/s1934538/clickstream/clickstream-enwiki-2018-10.tsv.gz,Lionel_Messi,56844,553794,6414,617052,118034
hdfs://spark-nn.eemcs.utwente.nl/user/s1934538/clickstream/clickstream-enwiki-2018-10.tsv.gz,Spider-Man:_Far_From_Home,173975,167965,5952,347892,206284
hdfs://spark-nn.eemcs.utwente.nl/user/s1934538/clickstream/clickstream-enwiki-2018-10.tsv.gz,Fantastic_Beasts:_The_Crimes_of_Grindelwald,128331,253686,4386,386403,231516
hdfs://spark-nn.eemcs.utwente.nl/user/s1934538/clickstream/clickstream-enwiki-2018-10.tsv.gz,Manti_Te'o,6618,48546,125,55289,2589
hdfs://spark-nn.eemcs.utwente.nl/user/s1934538/clickstream/clickstream-enwiki-2018-10.tsv.gz,Deion_Sanders,11722,124864,687,137273,37558
hdfs://spark-nn.eemcs.utwente.nl/user/s1934538/clickstream/clickstream-enwiki-2018-10.tsv.gz,Sridevi,25773,98883,443,125099,40479
hdfs://spark-nn.eemcs.utwente.nl/user/s1934538/clickstream/clickstream-enwiki-2018-10.tsv.gz,Jason_Momoa,95120,379842,1536,476498,176844
hdfs://spark-nn.eemcs.utwente.nl/user/s1934538/clickstream/clickstream-enwiki-2018-10.tsv.gz,State_of_Palestine,38634,73108,180,111922,46728
hdfs://spark-nn.eemcs.utwente.nl/user/s1934538/clickstream/clickstream-enwiki-2018-10.tsv.gz,Royal_Rumble_(2018),16078,25960,275,42313,24498
hdfs://spark-nn.eemcs.utwente.nl/user/s1934538/clickstream/clickstream-enwiki-2018-10.tsv.gz,Christopher_Scarver,76627,26008,30,102665,33042
hdfs://spark-nn.eemcs.utwente.nl/user/s1934538/clickstream/clickstream-enwiki-2018-10.tsv.gz,A_Star_Is_Born_(2018_film),294112,4040553,52558,4387223,2082315
hdfs://spark-nn.eemcs.utwente.nl/user/s1934538/clickstream/clickstream-enwiki-2018-10.tsv.gz,Cleopatra,44811,209777,2428,257016,93808
hdfs://spark-nn.eemcs.utwente.nl/user/s1934538/clickstream/clickstream-enwiki-2018-10.tsv.gz,Cricket_World_Cup,7405,77506,501,85412,46027
hdfs://spark-nn.eemcs.utwente.nl/user/s1934538/clickstream/clickstream-enwiki-2018-10.tsv.gz,Kobe_Bryant,35199,236864,2141,274204,66661
hdfs://spark-nn.eemcs.utwente.nl/user/s1934538/clickstream/clickstream-enwiki-2018-10.tsv.gz,QAnon,8235,162154,769,171158,39530
hdfs://spark-nn.eemcs.utwente.nl/user/s1934538/clickstream/clickstream-enwiki-2018-10.tsv.gz,Coronavirus,908,7585,33,8526,1149
hdfs://spark-nn.eemcs.utwente.nl/user/s1934538/clickstream/clickstream-enwiki-2018-10.tsv.gz,United_States_Senate,107976,185588,2584,296148,126697
hdfs://spark-nn.eemcs.utwente.nl/user/s1934538/clickstream/clickstream-enwiki-2018-10.tsv.gz,Darth_Vader,18378,3250228,707,3269313,49296
hdfs://spark-nn.eemcs.utwente.nl/user/s1934538/clickstream/clickstream-enwiki-2018-10.tsv.gz,"Meghan,_Duchess_of_Sussex",174417,1115681,7257,1297355,559836
hdfs://spark-nn.eemcs.utwente.nl/user/s1934538/clickstream/clickstream-enwiki-2018-10.tsv.gz,2020_Summer_Olympics,38091,133399,1530,173020,92150
hdfs://spark-nn.eemcs.utwente.nl/user/s1934538/clickstream/clickstream-enwiki-2018-10.tsv.gz,Jimmy_Hoffa,19865,88009,779,108653,33713
hdfs://spark-nn.eemcs.utwente.nl/user/s1934538/clickstream/clickstream-enwiki-2018-10.tsv.gz,Hamilton_(musical),32142,259467,1859,293468,161406
hdfs://spark-nn.eemcs.utwente.nl/user/s1934538/clickstream/clickstream-enwiki-2018-10.tsv.gz,Nipsey_Hussle,19517,51631,162,71310,30592
hdfs://spark-nn.eemcs.utwente.nl/user/s1934538/clickstream/clickstream-enwiki-2018-10.tsv.gz,Aaron_Hernandez,18505,253319,1853,273677,76010
hdfs://spark-nn.eemcs.utwente.nl/user/s1934538/clickstream/clickstream-enwiki-2018-10.tsv.gz,Antifa_(United_States),21934,262815,707,285456,35021
hdfs://spark-nn.eemcs.utwente.nl/user/s1934538/clickstream/clickstream-enwiki-2018-10.tsv.gz,Lists_of_deaths_by_year,6910,105987,281,113178,106587
hdfs://spark-nn.eemcs.utwente.nl/user/s1934538/clickstream/clickstream-enwiki-2018-10.tsv.gz,Deaths_in_2018,1202372,1944262,7416,3154050,1672844
hdfs://spark-nn.eemcs.utwente.nl/user/s1934538/clickstream/clickstream-enwiki-2018-10.tsv.gz,Luke_Perry,31982,58067,801,90850,15563
hdfs://spark-nn.eemcs.utwente.nl/user/s1934538/clickstream/clickstream-enwiki-2018-10.tsv.gz,Joker_(2019_film),85010,114588,961,200559,151855
hdfs://spark-nn.eemcs.utwente.nl/user/s1934538/clickstream/clickstream-enwiki-2018-10.tsv.gz,Taliban,16277,115964,449,132690,40750
hdfs://spark-nn.eemcs.utwente.nl/user/s1934538/clickstream/clickstream-enwiki-2018-10.tsv.gz,Asia_Cup,5504,52031,4051,61586,17533
hdfs://spark-nn.eemcs.utwente.nl/user/s1934538/clickstream/clickstream-enwiki-2018-10.tsv.gz,Tonya_Harding,40271,251808,1147,293226,59260
hdfs://spark-nn.eemcs.utwente.nl/user/s1934538/clickstream/clickstream-enwiki-2018-10.tsv.gz,Godzilla_vs._Kong,29294,6634,26,35954,23861
hdfs://spark-nn.eemcs.utwente.nl/user/s1934538/clickstream/clickstream-enwiki-2018-10.tsv.gz,Bonnie_and_Clyde,14435,165700,992,181127,34975
hdfs://spark-nn.eemcs.utwente.nl/user/s1934538/clickstream/clickstream-enwiki-2018-10.tsv.gz,Stephen_Hawking,29957,563176,4875,598008,194242
hdfs://spark-nn.eemcs.utwente.nl/user/s1934538/clickstream/clickstream-enwiki-2018-10.tsv.gz,Rihanna,53383,285201,3499,342083,157050
hdfs://spark-nn.eemcs.utwente.nl/user/s1934538/clickstream/clickstream-enwiki-2018-10.tsv.gz,Cristiano_Ronaldo,144503,939539,7191,1091233,204493
hdfs://spark-nn.eemcs.utwente.nl/user/s1934538/clickstream/clickstream-enwiki-2018-10.tsv.gz,Saaho,52510,145009,791,198310,172181
hdfs://spark-nn.eemcs.utwente.nl/user/s1934538/clickstream/clickstream-enwiki-2018-10.tsv.gz,Kate_Spade,18739,58020,528,77287,23864
hdfs://spark-nn.eemcs.utwente.nl/user/s1934538/clickstream/clickstream-enwiki-2018-10.tsv.gz,Grimes_(musician),50022,57239,383,107644,24561
hdfs://spark-nn.eemcs.utwente.nl/user/s1934538/clickstream/clickstream-enwiki-2018-10.tsv.gz,"Prince_Philip,_Duke_of_Edinburgh",249456,308201,6037,563694,333594
hdfs://spark-nn.eemcs.utwente.nl/user/s1934538/clickstream/clickstream-enwiki-2019-07.tsv.gz,Spanish_flu,20459,66522,679,87660,19497
hdfs://spark-nn.eemcs.utwente.nl/user/s1934538/clickstream/clickstream-enwiki-2019-07.tsv.gz,Michael_Jordan,90821,407028,3646,501495,181786
hdfs://spark-nn.eemcs.utwente.nl/user/s1934538/clickstream/clickstream-enwiki-2019-07.tsv.gz,Mulan_(2020_film),127382,464304,7854,599540,796244
hdfs://spark-nn.eemcs.utwente.nl/user/s1934538/clickstream/clickstream-enwiki-2019-07.tsv.gz,Roe_v._Wade,10136,60820,397,71353,21992
hdfs://spark-nn.eemcs.utwente.nl/user/s1934538/clickstream/clickstream-enwiki-2019-07.tsv.gz,Indian_Premier_League,34809,82378,588,117775,77378
hdfs://spark-nn.eemcs.utwente.nl/user/s1934538/clickstream/clickstream-enwiki-2019-07.tsv.gz,Cecil_Hotel_(Los_Angeles),5602,17739,33,23374,8932
hdfs://spark-nn.eemcs.utwente.nl/user/s1934538/clickstream/clickstream-enwiki-2019-07.tsv.gz,2018_Asian_Games,11200,24104,118,35422,22964
hdfs://spark-nn.eemcs.utwente.nl/user/s1934538/clickstream/clickstream-enwiki-2019-07.tsv.gz,Fantastic_Beasts:_The_Crimes_of_Grindelwald,98660,292782,4138,395580,239397
hdfs://spark-nn.eemcs.utwente.nl/user/s1934538/clickstream/clickstream-enwiki-2019-07.tsv.gz,UEFA_Euro_2020,48730,145252,2716,196698,56649
hdfs://spark-nn.eemcs.utwente.nl/user/s1934538/clickstream/clickstream-enwiki-2019-07.tsv.gz,2023_Cricket_World_Cup,192705,621574,597,814876,225391
hdfs://spark-nn.eemcs.utwente.nl/user/s1934538/clickstream/clickstream-enwiki-2019-07.tsv.gz,Deion_Sanders,9842,81227,424,91493,25020
hdfs://spark-nn.eemcs.utwente.nl/user/s1934538/clickstream/clickstream-enwiki-2019-07.tsv.gz,Mötley_Crüe,57038,226674,1835,285547,373701
hdfs://spark-nn.eemcs.utwente.nl/user/s1934538/clickstream/clickstream-enwiki-2019-07.tsv.gz,Cleopatra,40608,166393,1999,209000,95615
hdfs://spark-nn.eemcs.utwente.nl/user/s1934538/clickstream/clickstream-enwiki-2019-07.tsv.gz,2020_Summer_Olympics,88907,284054,6107,379068,302053
hdfs://spark-nn.eemcs.utwente.nl/user/s1934538/clickstream/clickstream-enwiki-2019-07.tsv.gz,Aretha_Franklin,20156,81521,736,102413,36099
hdfs://spark-nn.eemcs.utwente.nl/user/s1934538/clickstream/clickstream-enwiki-2019-07.tsv.gz,List_of_highest-grossing_Indian_films,86612,375947,6818,469377,230624
hdfs://spark-nn.eemcs.utwente.nl/user/s1934538/clickstream/clickstream-enwiki-2019-07.tsv.gz,Bird_Box_(film),27907,113978,1222,143107,47255
hdfs://spark-nn.eemcs.utwente.nl/user/s1934538/clickstream/clickstream-enwiki-2019-07.tsv.gz,Hamilton_(musical),34288,250889,1703,286880,148693
hdfs://spark-nn.eemcs.utwente.nl/user/s1934538/clickstream/clickstream-enwiki-2019-07.tsv.gz,DMX_(rapper),13739,64894,455,79088,31362
hdfs://spark-nn.eemcs.utwente.nl/user/s1934538/clickstream/clickstream-enwiki-2019-07.tsv.gz,2.0_(film),32935,129350,592,162877,37776
hdfs://spark-nn.eemcs.utwente.nl/user/s1934538/clickstream/clickstream-enwiki-2019-07.tsv.gz,Captain_Marvel_(film),146957,433874,8628,589459,337416
hdfs://spark-nn.eemcs.utwente.nl/user/s1934538/clickstream/clickstream-enwiki-2019-07.tsv.gz,Adele,22821,149341,2025,174187,56077
hdfs://spark-nn.eemcs.utwente.nl/user/s1934538/clickstream/clickstream-enwiki-2019-07.tsv.gz,Deadpool_2,78208,160113,2698,241019,142792
hdfs://spark-nn.eemcs.utwente.nl/user/s1934538/clickstream/clickstream-enwiki-2019-07.tsv.gz,Coronavirus,725,4718,42,5485,807
hdfs://spark-nn.eemcs.utwente.nl/user/s1934538/clickstream/clickstream-enwiki-2019-07.tsv.gz,Hamas,15393,28046,630,44069,15187
hdfs://spark-nn.eemcs.utwente.nl/user/s1934538/clickstream/clickstream-enwiki-2019-07.tsv.gz,Puneeth_Rajkumar,10487,16578,21,27086,13550
hdfs://spark-nn.eemcs.utwente.nl/user/s1934538/clickstream/clickstream-enwiki-2019-07.tsv.gz,A_Quiet_Place_(film),29945,159243,2312,191500,60643
hdfs://spark-nn.eemcs.utwente.nl/user/s1934538/clickstream/clickstream-enwiki-2019-07.tsv.gz,Stan_Lee,81679,229291,2292,313262,104627
hdfs://spark-nn.eemcs.utwente.nl/user/s1934538/clickstream/clickstream-enwiki-2019-07.tsv.gz,Bipin_Rawat,6088,24296,205,30589,13027
hdfs://spark-nn.eemcs.utwente.nl/user/s1934538/clickstream/clickstream-enwiki-2019-07.tsv.gz,Area_51,102369,4532961,19316,4654646,959023
hdfs://spark-nn.eemcs.utwente.nl/user/s1934538/clickstream/clickstream-enwiki-2019-07.tsv.gz,Atal_Bihari_Vajpayee,21017,51403,51,72471,16081
hdfs://spark-nn.eemcs.utwente.nl/user/s1934538/clickstream/clickstream-enwiki-2019-07.tsv.gz,Avengers:_Endgame,728673,2938540,109861,3777074,2089042
hdfs://spark-nn.eemcs.utwente.nl/user/s1934538/clickstream/clickstream-enwiki-2019-07.tsv.gz,Kobe_Bryant,53940,248673,1623,304236,85371
hdfs://spark-nn.eemcs.utwente.nl/user/s1934538/clickstream/clickstream-enwiki-2019-07.tsv.gz,The_Mandalorian,42036,71723,731,114490,85305
hdfs://spark-nn.eemcs.utwente.nl/user/s1934538/clickstream/clickstream-enwiki-2019-07.tsv.gz,The_Umbrella_Academy_(TV_series),34498,203350,2827,240675,131723
hdfs://spark-nn.eemcs.utwente.nl/user/s1934538/clickstream/clickstream-enwiki-2019-07.tsv.gz,Juice_Wrld,13782,78887,729,93398,30702
hdfs://spark-nn.eemcs.utwente.nl/user/s1934538/clickstream/clickstream-enwiki-2019-07.tsv.gz,Meat_Loaf,20879,73635,732,95246,33035
hdfs://spark-nn.eemcs.utwente.nl/user/s1934538/clickstream/clickstream-enwiki-2019-07.tsv.gz,Richard_Ramirez,10422,145179,1214,156815,49676
hdfs://spark-nn.eemcs.utwente.nl/user/s1934538/clickstream/clickstream-enwiki-2019-07.tsv.gz,Jason_Momoa,220573,536899,2912,760384,306972
hdfs://spark-nn.eemcs.utwente.nl/user/s1934538/clickstream/clickstream-enwiki-2019-07.tsv.gz,Khabib_Nurmagomedov,76495,160681,1834,239010,121459
hdfs://spark-nn.eemcs.utwente.nl/user/s1934538/clickstream/clickstream-enwiki-2019-07.tsv.gz,Rihanna,72894,418337,4481,495712,226824
hdfs://spark-nn.eemcs.utwente.nl/user/s1934538/clickstream/clickstream-enwiki-2019-07.tsv.gz,Joaquin_Phoenix,148260,169099,953,318312,219909
hdfs://spark-nn.eemcs.utwente.nl/user/s1934538/clickstream/clickstream-enwiki-2019-07.tsv.gz,Aquaman_(film),72857,212973,3547,289377,154456
hdfs://spark-nn.eemcs.utwente.nl/user/s1934538/clickstream/clickstream-enwiki-2019-07.tsv.gz,Johnny_Depp,165715,324152,2401,492268,301293
hdfs://spark-nn.eemcs.utwente.nl/user/s1934538/clickstream/clickstream-enwiki-2019-07.tsv.gz,XHamster,14779,62199,2421,79399,16899
hdfs://spark-nn.eemcs.utwente.nl/user/s1934538/clickstream/clickstream-enwiki-2019-07.tsv.gz,Anna_Sorokin,11989,74576,246,86811,20154
hdfs://spark-nn.eemcs.utwente.nl/user/s1934538/clickstream/clickstream-enwiki-2019-07.tsv.gz,Naya_Rivera,69342,91025,154,160521,31183
hdfs://spark-nn.eemcs.utwente.nl/user/s1934538/clickstream/clickstream-enwiki-2019-07.tsv.gz,NATO,37975,123861,1676,163512,57206
hdfs://spark-nn.eemcs.utwente.nl/user/s1934538/clickstream/clickstream-enwiki-2019-07.tsv.gz,List_of_highest-grossing_films,1066258,2686837,65719,3818814,908509
hdfs://spark-nn.eemcs.utwente.nl/user/s1934538/clickstream/clickstream-enwiki-2019-07.tsv.gz,JSON_Web_Token,1059,22635,56,23750,2105
hdfs://spark-nn.eemcs.utwente.nl/user/s1934538/clickstream/clickstream-enwiki-2019-07.tsv.gz,Priyanka_Chopra,160362,404249,1690,566301,211050
hdfs://spark-nn.eemcs.utwente.nl/user/s1934538/clickstream/clickstream-enwiki-2019-07.tsv.gz,Us_(2019_film),64319,545849,3820,613988,180190
hdfs://spark-nn.eemcs.utwente.nl/user/s1934538/clickstream/clickstream-enwiki-2019-07.tsv.gz,Cristiano_Ronaldo,130338,569665,3827,703830,169489
hdfs://spark-nn.eemcs.utwente.nl/user/s1934538/clickstream/clickstream-enwiki-2019-07.tsv.gz,Gaza_Strip,13681,30598,219,44498,15534
hdfs://spark-nn.eemcs.utwente.nl/user/s1934538/clickstream/clickstream-enwiki-2019-07.tsv.gz,Henry_V_of_England,46222,29208,3165,78595,51273
hdfs://spark-nn.eemcs.utwente.nl/user/s1934538/clickstream/clickstream-enwiki-2019-07.tsv.gz,Michael_Bloomberg,41130,42954,244,84328,35173
hdfs://spark-nn.eemcs.utwente.nl/user/s1934538/clickstream/clickstream-enwiki-2019-07.tsv.gz,Kylian_Mbappé,38976,134716,1582,175274,33724
hdfs://spark-nn.eemcs.utwente.nl/user/s1934538/clickstream/clickstream-enwiki-2019-07.tsv.gz,Ruth_Bader_Ginsburg,31900,166597,1348,199845,77148
hdfs://spark-nn.eemcs.utwente.nl/user/s1934538/clickstream/clickstream-enwiki-2019-07.tsv.gz,Media,74,17557,312,17943,1760
hdfs://spark-nn.eemcs.utwente.nl/user/s1934538/clickstream/clickstream-enwiki-2019-07.tsv.gz,Murder_of_Dee_Dee_Blanchard,52488,583270,1117,636875,100832
hdfs://spark-nn.eemcs.utwente.nl/user/s1934538/clickstream/clickstream-enwiki-2019-07.tsv.gz,Sushma_Swaraj,13306,28552,56,41914,10695
hdfs://spark-nn.eemcs.utwente.nl/user/s1934538/clickstream/clickstream-enwiki-2019-07.tsv.gz,Bonnie_and_Clyde,36930,402149,2641,441720,109682
hdfs://spark-nn.eemcs.utwente.nl/user/s1934538/clickstream/clickstream-enwiki-2019-07.tsv.gz,J._Robert_Oppenheimer,19579,76847,257,96683,33363
hdfs://spark-nn.eemcs.utwente.nl/user/s1934538/clickstream/clickstream-enwiki-2019-07.tsv.gz,Jeffrey_Dahmer,28071,285601,3140,316812,135215
hdfs://spark-nn.eemcs.utwente.nl/user/s1934538/clickstream/clickstream-enwiki-2019-07.tsv.gz,21_Savage,28102,90683,1388,120173,37403
hdfs://spark-nn.eemcs.utwente.nl/user/s1934538/clickstream/clickstream-enwiki-2019-07.tsv.gz,September_11_attacks,81672,304315,5043,391030,183273
hdfs://spark-nn.eemcs.utwente.nl/user/s1934538/clickstream/clickstream-enwiki-2019-07.tsv.gz,Brie_Larson,115361,291613,2337,409311,160682
hdfs://spark-nn.eemcs.utwente.nl/user/s1934538/clickstream/clickstream-enwiki-2019-07.tsv.gz,Amber_Heard,116426,214927,964,332317,156745
hdfs://spark-nn.eemcs.utwente.nl/user/s1934538/clickstream/clickstream-enwiki-2019-07.tsv.gz,Bob_Saget,19858,39856,264,59978,10782
hdfs://spark-nn.eemcs.utwente.nl/user/s1934538/clickstream/clickstream-enwiki-2019-07.tsv.gz,Sushant_Singh_Rajput,25163,54989,170,80322,48111
hdfs://spark-nn.eemcs.utwente.nl/user/s1934538/clickstream/clickstream-enwiki-2019-07.tsv.gz,Chadwick_Boseman,35234,79642,696,115572,41353
hdfs://spark-nn.eemcs.utwente.nl/user/s1934538/clickstream/clickstream-enwiki-2019-07.tsv.gz,Cardi_B,66171,488217,8187,562575,224866
hdfs://spark-nn.eemcs.utwente.nl/user/s1934538/clickstream/clickstream-enwiki-2019-07.tsv.gz,Chernobyl_disaster,208639,2158299,15840,2382778,948118
hdfs://spark-nn.eemcs.utwente.nl/user/s1934538/clickstream/clickstream-enwiki-2019-07.tsv.gz,Exo_(band),25080,153093,769,178942,248596
hdfs://spark-nn.eemcs.utwente.nl/user/s1934538/clickstream/clickstream-enwiki-2019-07.tsv.gz,Wikipedia,35144,1109584,628,1145356,181126
hdfs://spark-nn.eemcs.utwente.nl/user/s1934538/clickstream/clickstream-enwiki-2019-07.tsv.gz,QAnon,8339,298394,1531,308264,72912
hdfs://spark-nn.eemcs.utwente.nl/user/s1934538/clickstream/clickstream-enwiki-2019-07.tsv.gz,Christopher_Scarver,50347,19325,32,69704,24225
hdfs://spark-nn.eemcs.utwente.nl/user/s1934538/clickstream/clickstream-enwiki-2019-07.tsv.gz,Deaths_in_2019,1276245,2450292,9228,3735765,1981771
hdfs://spark-nn.eemcs.utwente.nl/user/s1934538/clickstream/clickstream-enwiki-2019-07.tsv.gz,Dark_Phoenix_(film),129147,422649,8021,559817,231738
hdfs://spark-nn.eemcs.utwente.nl/user/s1934538/clickstream/clickstream-enwiki-2019-07.tsv.gz,Israel,69735,244975,5248,319958,148459
hdfs://spark-nn.eemcs.utwente.nl/user/s1934538/clickstream/clickstream-enwiki-2019-07.tsv.gz,List_of_James_Bond_films,28603,237359,570,266532,126211
hdfs://spark-nn.eemcs.utwente.nl/user/s1934538/clickstream/clickstream-enwiki-2019-07.tsv.gz,Once_Upon_a_Time_in_Hollywood,418645,2142272,49653,2610570,2479584
hdfs://spark-nn.eemcs.utwente.nl/user/s1934538/clickstream/clickstream-enwiki-2019-07.tsv.gz,Avengers:_Infinity_War,138430,194895,2843,336168,189039
hdfs://spark-nn.eemcs.utwente.nl/user/s1934538/clickstream/clickstream-enwiki-2019-07.tsv.gz,Stephen_Hawking,33374,434973,2895,471242,176669
hdfs://spark-nn.eemcs.utwente.nl/user/s1934538/clickstream/clickstream-enwiki-2019-07.tsv.gz,2016_United_States_presidential_election,109184,232229,3273,344686,263574
hdfs://spark-nn.eemcs.utwente.nl/user/s1934538/clickstream/clickstream-enwiki-2019-07.tsv.gz,Tonya_Harding,31185,116226,488,147899,35267
hdfs://spark-nn.eemcs.utwente.nl/user/s1934538/clickstream/clickstream-enwiki-2019-07.tsv.gz,Simple_Mail_Transfer_Protocol,4379,29682,157,34218,4325
hdfs://spark-nn.eemcs.utwente.nl/user/s1934538/clickstream/clickstream-enwiki-2019-07.tsv.gz,HTTP_cookie,5903,263877,110,269890,64093
hdfs://spark-nn.eemcs.utwente.nl/user/s1934538/clickstream/clickstream-enwiki-2019-07.tsv.gz,2022_FIFA_World_Cup,123527,244256,4184,371967,173277
hdfs://spark-nn.eemcs.utwente.nl/user/s1934538/clickstream/clickstream-enwiki-2019-07.tsv.gz,Jeffrey_Epstein,90838,3873380,30389,3994607,1340353
hdfs://spark-nn.eemcs.utwente.nl/user/s1934538/clickstream/clickstream-enwiki-2019-07.tsv.gz,Pelé,32679,277050,1668,311397,58335
hdfs://spark-nn.eemcs.utwente.nl/user/s1934538/clickstream/clickstream-enwiki-2019-07.tsv.gz,Louis_Tomlinson,27482,50148,293,77923,12305
hdfs://spark-nn.eemcs.utwente.nl/user/s1934538/clickstream/clickstream-enwiki-2019-07.tsv.gz,Stranger_Things_(season_3),537687,3215709,60965,3814361,2963976
hdfs://spark-nn.eemcs.utwente.nl/user/s1934538/clickstream/clickstream-enwiki-2019-07.tsv.gz,"Meghan,_Duchess_of_Sussex",119565,396661,2704,518930,303668
hdfs://spark-nn.eemcs.utwente.nl/user/s1934538/clickstream/clickstream-enwiki-2019-07.tsv.gz,Bible,17011,848898,1551,867460,30795
hdfs://spark-nn.eemcs.utwente.nl/user/s1934538/clickstream/clickstream-enwiki-2019-07.tsv.gz,Sinéad_O'Connor,11375,98122,829,110326,25255
hdfs://spark-nn.eemcs.utwente.nl/user/s1934538/clickstream/clickstream-enwiki-2019-07.tsv.gz,John_McCain,36930,94952,1103,132985,61480
hdfs://spark-nn.eemcs.utwente.nl/user/s1934538/clickstream/clickstream-enwiki-2019-07.tsv.gz,Microsoft_Office,7963,98917,612,107492,22318
hdfs://spark-nn.eemcs.utwente.nl/user/s1934538/clickstream/clickstream-enwiki-2019-07.tsv.gz,Saaho,66536,251099,8697,326332,171057
hdfs://spark-nn.eemcs.utwente.nl/user/s1934538/clickstream/clickstream-enwiki-2019-07.tsv.gz,Ukraine,50453,148301,3626,202380,94563
hdfs://spark-nn.eemcs.utwente.nl/user/s1934538/clickstream/clickstream-enwiki-2019-07.tsv.gz,IPv4,12821,41983,140,54944,9805
hdfs://spark-nn.eemcs.utwente.nl/user/s1934538/clickstream/clickstream-enwiki-2019-07.tsv.gz,United_States_Senate,53341,63679,1716,118736,49440
hdfs://spark-nn.eemcs.utwente.nl/user/s1934538/clickstream/clickstream-enwiki-2019-07.tsv.gz,Rami_Malek,131329,346886,1617,479832,163085
hdfs://spark-nn.eemcs.utwente.nl/user/s1934538/clickstream/clickstream-enwiki-2019-07.tsv.gz,A_Star_Is_Born_(2018_film),62362,511933,3501,577796,278774
hdfs://spark-nn.eemcs.utwente.nl/user/s1934538/clickstream/clickstream-enwiki-2019-07.tsv.gz,Ghislaine_Maxwell,278759,250085,3400,532244,138545
hdfs://spark-nn.eemcs.utwente.nl/user/s1934538/clickstream/clickstream-enwiki-2019-07.tsv.gz,The_Irishman,127,1369,515,2011,2622
hdfs://spark-nn.eemcs.utwente.nl/user/s1934538/clickstream/clickstream-enwiki-2019-07.tsv.gz,Fyre_Festival,15985,164287,954,181226,85483
hdfs://spark-nn.eemcs.utwente.nl/user/s1934538/clickstream/clickstream-enwiki-2019-07.tsv.gz,Critical_race_theory,1677,11995,29,13701,3065
hdfs://spark-nn.eemcs.utwente.nl/user/s1934538/clickstream/clickstream-enwiki-2019-07.tsv.gz,Taliban,22221,64091,467,86779,56661
hdfs://spark-nn.eemcs.utwente.nl/user/s1934538/clickstream/clickstream-enwiki-2019-07.tsv.gz,XNXX,3325,360657,10801,374783,97882
hdfs://spark-nn.eemcs.utwente.nl/user/s1934538/clickstream/clickstream-enwiki-2019-07.tsv.gz,The_Shape_of_Water,26578,60979,842,88399,39820
hdfs://spark-nn.eemcs.utwente.nl/user/s1934538/clickstream/clickstream-enwiki-2019-07.tsv.gz,Manti_Te'o,3680,19166,91,22937,2627
hdfs://spark-nn.eemcs.utwente.nl/user/s1934538/clickstream/clickstream-enwiki-2019-07.tsv.gz,Tom_Brady,49010,188725,1733,239468,82779
hdfs://spark-nn.eemcs.utwente.nl/user/s1934538/clickstream/clickstream-enwiki-2019-07.tsv.gz,Wonder_Woman_1984,90642,46746,644,138032,79949
hdfs://spark-nn.eemcs.utwente.nl/user/s1934538/clickstream/clickstream-enwiki-2019-07.tsv.gz,Croatia,45081,194641,2209,241931,73011
hdfs://spark-nn.eemcs.utwente.nl/user/s1934538/clickstream/clickstream-enwiki-2019-07.tsv.gz,Lisa_Marie_Presley,120582,71341,283,192206,108076
hdfs://spark-nn.eemcs.utwente.nl/user/s1934538/clickstream/clickstream-enwiki-2019-07.tsv.gz,RRR_(film),41062,40210,457,81729,50130
hdfs://spark-nn.eemcs.utwente.nl/user/s1934538/clickstream/clickstream-enwiki-2019-07.tsv.gz,Luke_Perry,123282,393895,2531,519708,140575
hdfs://spark-nn.eemcs.utwente.nl/user/s1934538/clickstream/clickstream-enwiki-2019-07.tsv.gz,Venom_(2018_film),55678,262886,3813,322377,179186
hdfs://spark-nn.eemcs.utwente.nl/user/s1934538/clickstream/clickstream-enwiki-2019-07.tsv.gz,Richard_Jewell,8282,15479,106,23867,8577
hdfs://spark-nn.eemcs.utwente.nl/user/s1934538/clickstream/clickstream-enwiki-2019-07.tsv.gz,The_Weeknd,38973,96875,1021,136869,63996
hdfs://spark-nn.eemcs.utwente.nl/user/s1934538/clickstream/clickstream-enwiki-2019-07.tsv.gz,Qasem_Soleimani,4485,9212,45,13742,6568
hdfs://spark-nn.eemcs.utwente.nl/user/s1934538/clickstream/clickstream-enwiki-2019-07.tsv.gz,William_Murdoch,559,1158,24,1741,243
hdfs://spark-nn.eemcs.utwente.nl/user/s1934538/clickstream/clickstream-enwiki-2019-07.tsv.gz,Hyphen-minus,5791,47117307,8096862,55219960,900
hdfs://spark-nn.eemcs.utwente.nl/user/s1934538/clickstream/clickstream-enwiki-2019-07.tsv.gz,Game_of_Thrones_(season_8),32990,153116,3016,189122,71313
hdfs://spark-nn.eemcs.utwente.nl/user/s1934538/clickstream/clickstream-enwiki-2019-07.tsv.gz,Antifa_(United_States),27509,602880,2110,632499,75635
hdfs://spark-nn.eemcs.utwente.nl/user/s1934538/clickstream/clickstream-enwiki-2019-07.tsv.gz,Anthony_Bourdain,17537,207712,1778,227027,65610
hdfs://spark-nn.eemcs.utwente.nl/user/s1934538/clickstream/clickstream-enwiki-2019-07.tsv.gz,Afghanistan,47863,155211,2200,205274,107867
hdfs://spark-nn.eemcs.utwente.nl/user/s1934538/clickstream/clickstream-enwiki-2019-07.tsv.gz,R._Kelly,31224,252463,2952,286639,127663
hdfs://spark-nn.eemcs.utwente.nl/user/s1934538/clickstream/clickstream-enwiki-2019-07.tsv.gz,1917_(2019_film),47380,12217,320,59917,24201
hdfs://spark-nn.eemcs.utwente.nl/user/s1934538/clickstream/clickstream-enwiki-2019-07.tsv.gz,The_Nun_(2018_film),54398,167735,1224,223357,149712
hdfs://spark-nn.eemcs.utwente.nl/user/s1934538/clickstream/clickstream-enwiki-2020-03.tsv.gz,Murder_of_Dee_Dee_Blanchard,25574,219627,546,245747,46980
hdfs://spark-nn.eemcs.utwente.nl/user/s1934538/clickstream/clickstream-enwiki-2020-03.tsv.gz,Lionel_Messi,61684,367142,4264,433090,96035
hdfs://spark-nn.eemcs.utwente.nl/user/s1934538/clickstream/clickstream-enwiki-2020-03.tsv.gz,Juneteenth,1141,32683,55,33879,2705
hdfs://spark-nn.eemcs.utwente.nl/user/s1934538/clickstream/clickstream-enwiki-2020-03.tsv.gz,Sridevi,29340,115416,173,144929,44754
hdfs://spark-nn.eemcs.utwente.nl/user/s1934538/clickstream/clickstream-enwiki-2020-03.tsv.gz,Bipin_Rawat,5567,16484,102,22153,9363
hdfs://spark-nn.eemcs.utwente.nl/user/s1934538/clickstream/clickstream-enwiki-2020-03.tsv.gz,Afghanistan,58696,177682,2353,238731,125088
hdfs://spark-nn.eemcs.utwente.nl/user/s1934538/clickstream/clickstream-enwiki-2020-03.tsv.gz,Kylian_Mbappé,20564,127094,1409,149067,29286
hdfs://spark-nn.eemcs.utwente.nl/user/s1934538/clickstream/clickstream-enwiki-2020-03.tsv.gz,Stephen_Hawking,36349,457388,2645,496382,193666
hdfs://spark-nn.eemcs.utwente.nl/user/s1934538/clickstream/clickstream-enwiki-2020-03.tsv.gz,Simone_Biles,12376,88188,526,101090,28893
hdfs://spark-nn.eemcs.utwente.nl/user/s1934538/clickstream/clickstream-enwiki-2020-03.tsv.gz,Sylvester_Stallone,91187,413786,2514,507487,352993
hdfs://spark-nn.eemcs.utwente.nl/user/s1934538/clickstream/clickstream-enwiki-2020-03.tsv.gz,The_Nun_(2018_film),20637,69792,405,90834,53170
hdfs://spark-nn.eemcs.utwente.nl/user/s1934538/clickstream/clickstream-enwiki-2020-03.tsv.gz,Coronavirus_disease_2019,2766075,5525046,118982,8410103,3461254
hdfs://spark-nn.eemcs.utwente.nl/user/s1934538/clickstream/clickstream-enwiki-2020-03.tsv.gz,Charles_Sobhraj,5851,27809,99,33759,7735
hdfs://spark-nn.eemcs.utwente.nl/user/s1934538/clickstream/clickstream-enwiki-2020-03.tsv.gz,ICC_Men's_T20_World_Cup,9631,106561,336,116528,48790
hdfs://spark-nn.eemcs.utwente.nl/user/s1934538/clickstream/clickstream-enwiki-2020-03.tsv.gz,A_Quiet_Place_(film),86292,686911,6137,779340,245496
hdfs://spark-nn.eemcs.utwente.nl/user/s1934538/clickstream/clickstream-enwiki-2020-03.tsv.gz,Taliban,34278,156556,11671,202505,122343
hdfs://spark-nn.eemcs.utwente.nl/user/s1934538/clickstream/clickstream-enwiki-2020-03.tsv.gz,Cristiano_Ronaldo,87373,641051,3918,732342,167043
hdfs://spark-nn.eemcs.utwente.nl/user/s1934538/clickstream/clickstream-enwiki-2020-03.tsv.gz,Notre-Dame_de_Paris,13208,83297,885,97390,19851
hdfs://spark-nn.eemcs.utwente.nl/user/s1934538/clickstream/clickstream-enwiki-2020-03.tsv.gz,XHamster,11937,67223,2763,81923,15249
hdfs://spark-nn.eemcs.utwente.nl/user/s1934538/clickstream/clickstream-enwiki-2020-03.tsv.gz,Bible,18509,2294950,1663,2315122,34270
hdfs://spark-nn.eemcs.utwente.nl/user/s1934538/clickstream/clickstream-enwiki-2020-03.tsv.gz,2023_Cricket_World_Cup,9212,14241,26,23479,7752
hdfs://spark-nn.eemcs.utwente.nl/user/s1934538/clickstream/clickstream-enwiki-2020-03.tsv.gz,2018_Asian_Games,4953,8249,23,13225,10063
hdfs://spark-nn.eemcs.utwente.nl/user/s1934538/clickstream/clickstream-enwiki-2020-03.tsv.gz,"Prince_Philip,_Duke_of_Edinburgh",352636,512355,9987,874978,521581
hdfs://spark-nn.eemcs.utwente.nl/user/s1934538/clickstream/clickstream-enwiki-2020-03.tsv.gz,Joe_Exotic,949820,2673166,14216,3637202,420561
hdfs://spark-nn.eemcs.utwente.nl/user/s1934538/clickstream/clickstream-enwiki-2020-03.tsv.gz,YouTube,127133,874062,8960,1010155,124371
hdfs://spark-nn.eemcs.utwente.nl/user/s1934538/clickstream/clickstream-enwiki-2020-03.tsv.gz,List_of_FIFA_World_Cup_finals,2598,46619,128,49345,17029
hdfs://spark-nn.eemcs.utwente.nl/user/s1934538/clickstream/clickstream-enwiki-2020-03.tsv.gz,Cricket_World_Cup,7434,58312,241,65987,29695
hdfs://spark-nn.eemcs.utwente.nl/user/s1934538/clickstream/clickstream-enwiki-2020-03.tsv.gz,Priyanka_Chopra,186172,332496,864,519532,169853
hdfs://spark-nn.eemcs.utwente.nl/user/s1934538/clickstream/clickstream-enwiki-2020-03.tsv.gz,1917_(2019_film),66355,841334,13803,921492,516994
hdfs://spark-nn.eemcs.utwente.nl/user/s1934538/clickstream/clickstream-enwiki-2020-03.tsv.gz,Keanu_Reeves,101833,470514,2761,575108,325536
hdfs://spark-nn.eemcs.utwente.nl/user/s1934538/clickstream/clickstream-enwiki-2020-03.tsv.gz,Kamala_Harris,34445,186207,2663,223315,69400
hdfs://spark-nn.eemcs.utwente.nl/user/s1934538/clickstream/clickstream-enwiki-2020-03.tsv.gz,List_of_awards_and_nominations_received_by_Meryl_Streep,13673,11851,41,25565,8969
hdfs://spark-nn.eemcs.utwente.nl/user/s1934538/clickstream/clickstream-enwiki-2020-03.tsv.gz,Game_of_Thrones,71992,255459,6827,334278,225258
hdfs://spark-nn.eemcs.utwente.nl/user/s1934538/clickstream/clickstream-enwiki-2020-03.tsv.gz,Chadwick_Boseman,35179,89326,481,124986,40684
hdfs://spark-nn.eemcs.utwente.nl/user/s1934538/clickstream/clickstream-enwiki-2020-03.tsv.gz,When_They_See_Us,23391,98195,452,122038,58184
hdfs://spark-nn.eemcs.utwente.nl/user/s1934538/clickstream/clickstream-enwiki-2020-03.tsv.gz,Luke_Perry,57853,206794,1073,265720,72068
hdfs://spark-nn.eemcs.utwente.nl/user/s1934538/clickstream/clickstream-enwiki-2020-03.tsv.gz,Stranger_Things,58326,314485,6189,379000,305537
hdfs://spark-nn.eemcs.utwente.nl/user/s1934538/clickstream/clickstream-enwiki-2020-03.tsv.gz,2018_Winter_Olympics,26761,20652,316,47729,33961
hdfs://spark-nn.eemcs.utwente.nl/user/s1934538/clickstream/clickstream-enwiki-2020-03.tsv.gz,Freddie_Mercury,93726,631557,4021,729304,260039
hdfs://spark-nn.eemcs.utwente.nl/user/s1934538/clickstream/clickstream-enwiki-2020-03.tsv.gz,Royal_Rumble_(2018),12177,7052,358,19587,13540
hdfs://spark-nn.eemcs.utwente.nl/user/s1934538/clickstream/clickstream-enwiki-2020-03.tsv.gz,Ukraine,46205,176119,2702,225026,76228
hdfs://spark-nn.eemcs.utwente.nl/user/s1934538/clickstream/clickstream-enwiki-2020-03.tsv.gz,Bonnie_and_Clyde,24930,264209,1633,290772,67358
hdfs://spark-nn.eemcs.utwente.nl/user/s1934538/clickstream/clickstream-enwiki-2020-03.tsv.gz,Parasite_(2019_film),98305,1560347,11286,1669938,658860
hdfs://spark-nn.eemcs.utwente.nl/user/s1934538/clickstream/clickstream-enwiki-2020-03.tsv.gz,Joaquin_Phoenix,175699,333730,1543,510972,326005
hdfs://spark-nn.eemcs.utwente.nl/user/s1934538/clickstream/clickstream-enwiki-2020-03.tsv.gz,Meat_Loaf,22453,75355,748,98556,33750
hdfs://spark-nn.eemcs.utwente.nl/user/s1934538/clickstream/clickstream-enwiki-2020-03.tsv.gz,Central_Park_jogger_case,35687,156128,279,192094,21952
hdfs://spark-nn.eemcs.utwente.nl/user/s1934538/clickstream/clickstream-enwiki-2020-03.tsv.gz,Richard_Ramirez,21622,175635,788,198045,62764
hdfs://spark-nn.eemcs.utwente.nl/user/s1934538/clickstream/clickstream-enwiki-2020-03.tsv.gz,R._Kelly,31505,215571,1720,248796,100197
hdfs://spark-nn.eemcs.utwente.nl/user/s1934538/clickstream/clickstream-enwiki-2020-03.tsv.gz,Anthony_Bourdain,17748,143882,1169,162799,46921
hdfs://spark-nn.eemcs.utwente.nl/user/s1934538/clickstream/clickstream-enwiki-2020-03.tsv.gz,Us_(2019_film),57349,273711,892,331952,97725
hdfs://spark-nn.eemcs.utwente.nl/user/s1934538/clickstream/clickstream-enwiki-2020-03.tsv.gz,David_Beckham,55859,288472,2006,346337,132086
hdfs://spark-nn.eemcs.utwente.nl/user/s1934538/clickstream/clickstream-enwiki-2020-03.tsv.gz,Cleopatra,43658,541282,1998,586938,106159
hdfs://spark-nn.eemcs.utwente.nl/user/s1934538/clickstream/clickstream-enwiki-2020-03.tsv.gz,Death_of_Elisa_Lam,8360,70589,628,79577,20359
hdfs://spark-nn.eemcs.utwente.nl/user/s1934538/clickstream/clickstream-enwiki-2020-03.tsv.gz,Article_370_of_the_Constitution_of_India,3793,65415,242,69450,5519
hdfs://spark-nn.eemcs.utwente.nl/user/s1934538/clickstream/clickstream-enwiki-2020-03.tsv.gz,The_Irishman,82155,377856,5058,465069,365298
hdfs://spark-nn.eemcs.utwente.nl/user/s1934538/clickstream/clickstream-enwiki-2020-03.tsv.gz,Tina_Turner,21642,156281,1496,179419,53036
hdfs://spark-nn.eemcs.utwente.nl/user/s1934538/clickstream/clickstream-enwiki-2020-03.tsv.gz,Amy_Coney_Barrett,1062,3227,23,4312,878
hdfs://spark-nn.eemcs.utwente.nl/user/s1934538/clickstream/clickstream-enwiki-2020-03.tsv.gz,Greta_Thunberg,15445,334371,2691,352507,81667
hdfs://spark-nn.eemcs.utwente.nl/user/s1934538/clickstream/clickstream-enwiki-2020-03.tsv.gz,Donald_Trump,406096,2839337,17925,3263358,1253979
hdfs://spark-nn.eemcs.utwente.nl/user/s1934538/clickstream/clickstream-enwiki-2020-03.tsv.gz,List_of_Queen_of_the_South_episodes,9766,6121,72,15959,373
hdfs://spark-nn.eemcs.utwente.nl/user/s1934538/clickstream/clickstream-enwiki-2020-03.tsv.gz,Joe_Biden,280714,1722403,27931,2031048,713662
hdfs://spark-nn.eemcs.utwente.nl/user/s1934538/clickstream/clickstream-enwiki-2020-03.tsv.gz,Chernobyl_disaster,69936,544724,4179,618839,215686
hdfs://spark-nn.eemcs.utwente.nl/user/s1934538/clickstream/clickstream-enwiki-2020-03.tsv.gz,Cecil_Hotel_(Los_Angeles),5142,22475,69,27686,10529
hdfs://spark-nn.eemcs.utwente.nl/user/s1934538/clickstream/clickstream-enwiki-2020-03.tsv.gz,State_of_Palestine,35775,99225,207,135207,53316
hdfs://spark-nn.eemcs.utwente.nl/user/s1934538/clickstream/clickstream-enwiki-2020-03.tsv.gz,Lance_Reddick,42552,38625,170,81347,15892
hdfs://spark-nn.eemcs.utwente.nl/user/s1934538/clickstream/clickstream-enwiki-2020-03.tsv.gz,Bird_Box_(film),20710,134114,1341,156165,46192
hdfs://spark-nn.eemcs.utwente.nl/user/s1934538/clickstream/clickstream-enwiki-2020-03.tsv.gz,Richard_Jewell,75320,640476,2581,718377,238880
hdfs://spark-nn.eemcs.utwente.nl/user/s1934538/clickstream/clickstream-enwiki-2020-03.tsv.gz,Mac_Miller,38611,219005,1888,259504,81283
hdfs://spark-nn.eemcs.utwente.nl/user/s1934538/clickstream/clickstream-enwiki-2020-03.tsv.gz,Michael_Bloomberg,159277,743146,7030,909453,373942
hdfs://spark-nn.eemcs.utwente.nl/user/s1934538/clickstream/clickstream-enwiki-2020-03.tsv.gz,Bob_Saget,19366,42419,402,62187,11273
hdfs://spark-nn.eemcs.utwente.nl/user/s1934538/clickstream/clickstream-enwiki-2020-03.tsv.gz,Grover,1374,6461,46,7881,1415
hdfs://spark-nn.eemcs.utwente.nl/user/s1934538/clickstream/clickstream-enwiki-2020-03.tsv.gz,Dark_Phoenix_(film),67702,217018,2640,287360,168867
hdfs://spark-nn.eemcs.utwente.nl/user/s1934538/clickstream/clickstream-enwiki-2020-03.tsv.gz,Avengers:_Endgame,155410,329646,5524,490580,314688
hdfs://spark-nn.eemcs.utwente.nl/user/s1934538/clickstream/clickstream-enwiki-2020-03.tsv.gz,List_of_highest-grossing_Indian_films,67802,190818,1129,259749,175985
hdfs://spark-nn.eemcs.utwente.nl/user/s1934538/clickstream/clickstream-enwiki-2020-03.tsv.gz,Adele,22248,168679,8865,199792,58254
hdfs://spark-nn.eemcs.utwente.nl/user/s1934538/clickstream/clickstream-enwiki-2020-03.tsv.gz,Asia_Cup,1315,17894,169,19378,11149
hdfs://spark-nn.eemcs.utwente.nl/user/s1934538/clickstream/clickstream-enwiki-2020-03.tsv.gz,The_Falcon_and_the_Winter_Soldier,54801,56052,554,111407,60573
hdfs://spark-nn.eemcs.utwente.nl/user/s1934538/clickstream/clickstream-enwiki-2020-03.tsv.gz,Gaza_Strip,14020,38250,289,52559,16670
hdfs://spark-nn.eemcs.utwente.nl/user/s1934538/clickstream/clickstream-enwiki-2020-03.tsv.gz,Critical_race_theory,1878,13907,30,15815,3051
hdfs://spark-nn.eemcs.utwente.nl/user/s1934538/clickstream/clickstream-enwiki-2020-03.tsv.gz,WandaVision,43759,40321,354,84434,42079
hdfs://spark-nn.eemcs.utwente.nl/user/s1934538/clickstream/clickstream-enwiki-2020-03.tsv.gz,Shinzo_Abe,36485,52637,935,90057,44570
hdfs://spark-nn.eemcs.utwente.nl/user/s1934538/clickstream/clickstream-enwiki-2020-03.tsv.gz,JSON_Web_Token,858,29940,25,30823,2301
hdfs://spark-nn.eemcs.utwente.nl/user/s1934538/clickstream/clickstream-enwiki-2020-03.tsv.gz,2.0_(film),20750,47149,125,68024,16416
hdfs://spark-nn.eemcs.utwente.nl/user/s1934538/clickstream/clickstream-enwiki-2020-03.tsv.gz,Salman_Rushdie,36935,64820,348,102103,41189
hdfs://spark-nn.eemcs.utwente.nl/user/s1934538/clickstream/clickstream-enwiki-2020-03.tsv.gz,HTTP_cookie,4529,537571,115,542215,26405
hdfs://spark-nn.eemcs.utwente.nl/user/s1934538/clickstream/clickstream-enwiki-2020-03.tsv.gz,IPv4,11606,53594,152,65352,10145
hdfs://spark-nn.eemcs.utwente.nl/user/s1934538/clickstream/clickstream-enwiki-2020-03.tsv.gz,Spanish_flu,514794,7983420,78165,8576379,1915512
hdfs://spark-nn.eemcs.utwente.nl/user/s1934538/clickstream/clickstream-enwiki-2020-03.tsv.gz,Hyphen-minus,4549,47552781,7725969,55283299,709
hdfs://spark-nn.eemcs.utwente.nl/user/s1934538/clickstream/clickstream-enwiki-2020-03.tsv.gz,Lisa_Marie_Presley,115549,68870,239,184658,102281
hdfs://spark-nn.eemcs.utwente.nl/user/s1934538/clickstream/clickstream-enwiki-2020-03.tsv.gz,Nipsey_Hussle,34366,274773,1589,310728,84541
hdfs://spark-nn.eemcs.utwente.nl/user/s1934538/clickstream/clickstream-enwiki-2020-03.tsv.gz,Venom_(2018_film),29229,120426,1515,151170,75616
hdfs://spark-nn.eemcs.utwente.nl/user/s1934538/clickstream/clickstream-enwiki-2020-03.tsv.gz,Shakira,22386,217065,1972,241423,112660
hdfs://spark-nn.eemcs.utwente.nl/user/s1934538/clickstream/clickstream-enwiki-2020-03.tsv.gz,Loki_(TV_series),34849,22318,195,57362,22488
hdfs://spark-nn.eemcs.utwente.nl/user/s1934538/clickstream/clickstream-enwiki-2020-03.tsv.gz,Jimmy_Buffett,8574,49029,479,58082,20186
hdfs://spark-nn.eemcs.utwente.nl/user/s1934538/clickstream/clickstream-enwiki-2020-03.tsv.gz,Dennis_Nilsen,5277,21013,133,26423,5529
hdfs://spark-nn.eemcs.utwente.nl/user/s1934538/clickstream/clickstream-enwiki-2020-03.tsv.gz,Laal_Singh_Chaddha,42770,48452,746,91968,47266
hdfs://spark-nn.eemcs.utwente.nl/user/s1934538/clickstream/clickstream-enwiki-2020-03.tsv.gz,Stranger_Things_(season_4),29474,96574,516,126564,74922
hdfs://spark-nn.eemcs.utwente.nl/user/s1934538/clickstream/clickstream-enwiki-2020-03.tsv.gz,Pornhub,43167,506058,18362,567587,115421
hdfs://spark-nn.eemcs.utwente.nl/user/s1934538/clickstream/clickstream-enwiki-2020-03.tsv.gz,Kate_Spade,36846,58749,318,95913,32499
hdfs://spark-nn.eemcs.utwente.nl/user/s1934538/clickstream/clickstream-enwiki-2020-03.tsv.gz,21_Savage,19956,75197,813,95966,34809
hdfs://spark-nn.eemcs.utwente.nl/user/s1934538/clickstream/clickstream-enwiki-2020-03.tsv.gz,XXX:_Return_of_Xander_Cage,38595,111079,744,150418,45403
hdfs://spark-nn.eemcs.utwente.nl/user/s1934538/clickstream/clickstream-enwiki-2020-03.tsv.gz,Charles_III,72,330,85,487,367
hdfs://spark-nn.eemcs.utwente.nl/user/s1934538/clickstream/clickstream-enwiki-2020-03.tsv.gz,Star_Wars:_The_Rise_of_Skywalker,184448,561589,15925,761962,401642
hdfs://spark-nn.eemcs.utwente.nl/user/s1934538/clickstream/clickstream-enwiki-2020-03.tsv.gz,Israel,82023,292869,5129,380021,171409
hdfs://spark-nn.eemcs.utwente.nl/user/s1934538/clickstream/clickstream-enwiki-2020-03.tsv.gz,Kelly_Preston,77568,41542,222,119332,32574
hdfs://spark-nn.eemcs.utwente.nl/user/s1934538/clickstream/clickstream-enwiki-2020-03.tsv.gz,Jenna_Ortega,23597,28409,3463,55469,9138
hdfs://spark-nn.eemcs.utwente.nl/user/s1934538/clickstream/clickstream-enwiki-2020-03.tsv.gz,J._Robert_Oppenheimer,22242,103750,322,126314,38533
hdfs://spark-nn.eemcs.utwente.nl/user/s1934538/clickstream/clickstream-enwiki-2020-03.tsv.gz,Henry_V_of_England,82266,140037,565,222868,152332
hdfs://spark-nn.eemcs.utwente.nl/user/s1934538/clickstream/clickstream-enwiki-2020-03.tsv.gz,Queen_(band),64579,271502,2703,338784,278862
hdfs://spark-nn.eemcs.utwente.nl/user/s1934538/clickstream/clickstream-enwiki-2020-03.tsv.gz,Valentine's_Day,5063,46201,377,51641,5361
hdfs://spark-nn.eemcs.utwente.nl/user/s1934538/clickstream/clickstream-enwiki-2020-03.tsv.gz,The_Umbrella_Academy_(TV_series),23159,139213,2187,164559,81813
hdfs://spark-nn.eemcs.utwente.nl/user/s1934538/clickstream/clickstream-enwiki-2020-03.tsv.gz,Jeffrey_Epstein,29998,286406,1994,318398,103641
hdfs://spark-nn.eemcs.utwente.nl/user/s1934538/clickstream/clickstream-enwiki-2020-03.tsv.gz,The_Queen's_Gambit_(miniseries),3135,814,10,3959,718
hdfs://spark-nn.eemcs.utwente.nl/user/s1934538/clickstream/clickstream-enwiki-2020-03.tsv.gz,Johnny_Depp,138622,350388,2659,491669,367501
hdfs://spark-nn.eemcs.utwente.nl/user/s1934538/clickstream/clickstream-enwiki-2020-03.tsv.gz,Hamilton_(musical),31419,187116,1281,219816,112812
hdfs://spark-nn.eemcs.utwente.nl/user/s1934538/clickstream/clickstream-enwiki-2020-03.tsv.gz,Wonder_Woman_1984,85520,98080,4607,188207,108231
hdfs://spark-nn.eemcs.utwente.nl/user/s1934538/clickstream/clickstream-enwiki-2020-03.tsv.gz,Jason_Momoa,90863,349149,1665,441677,192387
hdfs://spark-nn.eemcs.utwente.nl/user/s1934538/clickstream/clickstream-enwiki-2020-03.tsv.gz,Brie_Larson,80133,191723,1532,273388,103507
hdfs://spark-nn.eemcs.utwente.nl/user/s1934538/clickstream/clickstream-enwiki-2020-03.tsv.gz,Jeffrey_Dahmer,34597,428142,3318,466057,188066
hdfs://spark-nn.eemcs.utwente.nl/user/s1934538/clickstream/clickstream-enwiki-2020-03.tsv.gz,Army_of_the_Dead,31392,8399,33,39824,21744
hdfs://spark-nn.eemcs.utwente.nl/user/s1934538/clickstream/clickstream-enwiki-2020-03.tsv.gz,Microsoft_Office,9652,955599,717,965968,23034
hdfs://spark-nn.eemcs.utwente.nl/user/s1934538/clickstream/clickstream-enwiki-2020-03.tsv.gz,Jimmy_Hoffa,72333,371667,2684,446684,148689
hdfs://spark-nn.eemcs.utwente.nl/user/s1934538/clickstream/clickstream-enwiki-2020-03.tsv.gz,Exo_(band),20533,104566,428,125527,122939
hdfs://spark-nn.eemcs.utwente.nl/user/s1934538/clickstream/clickstream-enwiki-2020-03.tsv.gz,Simple_Mail_Transfer_Protocol,4207,43850,142,48199,3899
hdfs://spark-nn.eemcs.utwente.nl/user/s1934538/clickstream/clickstream-enwiki-2020-03.tsv.gz,No_Time_to_Die,197073,316115,10737,523925,343927
hdfs://spark-nn.eemcs.utwente.nl/user/s1934538/clickstream/clickstream-enwiki-2020-03.tsv.gz,Deaths_in_2020,1720483,2285137,13408,4019028,2715709
hdfs://spark-nn.eemcs.utwente.nl/user/s1934538/clickstream/clickstream-enwiki-2020-03.tsv.gz,Michael_Jordan,108219,713921,4973,827113,326157
hdfs://spark-nn.eemcs.utwente.nl/user/s1934538/clickstream/clickstream-enwiki-2020-03.tsv.gz,Joker_(2019_film),92427,615408,7169,715004,269363
hdfs://spark-nn.eemcs.utwente.nl/user/s1934538/clickstream/clickstream-enwiki-2020-03.tsv.gz,Olivia_Newton-John,28383,96439,898,125720,58715
hdfs://spark-nn.eemcs.utwente.nl/user/s1934538/clickstream/clickstream-enwiki-2020-03.tsv.gz,Roe_v._Wade,15887,85123,462,101472,28224
hdfs://spark-nn.eemcs.utwente.nl/user/s1934538/clickstream/clickstream-enwiki-2020-03.tsv.gz,Aaron_Carter,27475,59623,380,87478,26179
hdfs://spark-nn.eemcs.utwente.nl/user/s1934538/clickstream/clickstream-enwiki-2020-03.tsv.gz,2018_FIFA_World_Cup,65387,121117,1511,188015,104140
hdfs://spark-nn.eemcs.utwente.nl/user/s1934538/clickstream/clickstream-enwiki-2020-03.tsv.gz,Avengers:_Infinity_War,68539,112519,1498,182556,104048
hdfs://spark-nn.eemcs.utwente.nl/user/s1934538/clickstream/clickstream-enwiki-2020-03.tsv.gz,Spider-Man:_Far_From_Home,92438,214187,2833,309458,154433
hdfs://spark-nn.eemcs.utwente.nl/user/s1934538/clickstream/clickstream-enwiki-2020-03.tsv.gz,The_Lion_King_(2019_film),61326,263663,2388,327377,207999
hdfs://spark-nn.eemcs.utwente.nl/user/s1934538/clickstream/clickstream-enwiki-2020-03.tsv.gz,Once_Upon_a_Time_in_Hollywood,155529,804865,10084,970478,1046933
hdfs://spark-nn.eemcs.utwente.nl/user/s1934538/clickstream/clickstream-enwiki-2020-03.tsv.gz,Rihanna,69044,240823,3489,313356,151312
hdfs://spark-nn.eemcs.utwente.nl/user/s1934538/clickstream/clickstream-enwiki-2020-03.tsv.gz,Stranger_Things_(season_3),21146,66861,626,88633,53901
hdfs://spark-nn.eemcs.utwente.nl/user/s1934538/clickstream/clickstream-enwiki-2020-03.tsv.gz,Indian_Premier_League,15506,148828,209,164543,95568
hdfs://spark-nn.eemcs.utwente.nl/user/s1934538/clickstream/clickstream-enwiki-2020-03.tsv.gz,Brett_Kavanaugh,29758,43495,256,73509,26497
hdfs://spark-nn.eemcs.utwente.nl/user/s1934538/clickstream/clickstream-enwiki-2020-03.tsv.gz,Main_Page,37114,295982744,4977147,300997005,36256404
hdfs://spark-nn.eemcs.utwente.nl/user/s1934538/clickstream/clickstream-enwiki-2020-03.tsv.gz,Naya_Rivera,27764,36241,92,64097,12256
hdfs://spark-nn.eemcs.utwente.nl/user/s1934538/clickstream/clickstream-enwiki-2020-03.tsv.gz,XXXTentacion,92397,397057,4372,493826,95859
hdfs://spark-nn.eemcs.utwente.nl/user/s1934538/clickstream/clickstream-enwiki-2020-05.tsv.gz,Adele,36752,489102,5449,531303,160176
hdfs://spark-nn.eemcs.utwente.nl/user/s1934538/clickstream/clickstream-enwiki-2020-05.tsv.gz,JSON_Web_Token,851,32480,60,33391,2178
hdfs://spark-nn.eemcs.utwente.nl/user/s1934538/clickstream/clickstream-enwiki-2020-05.tsv.gz,The_Batman_(film),141330,127997,1774,271101,291282
hdfs://spark-nn.eemcs.utwente.nl/user/s1934538/clickstream/clickstream-enwiki-2020-05.tsv.gz,Antifa_(United_States),88831,2896852,2364,2988047,225123
hdfs://spark-nn.eemcs.utwente.nl/user/s1934538/clickstream/clickstream-enwiki-2020-05.tsv.gz,Roe_v._Wade,36997,292238,2312,331547,103321
hdfs://spark-nn.eemcs.utwente.nl/user/s1934538/clickstream/clickstream-enwiki-2020-05.tsv.gz,United_States_Electoral_College,34521,201300,361,236182,32169
hdfs://spark-nn.eemcs.utwente.nl/user/s1934538/clickstream/clickstream-enwiki-2020-05.tsv.gz,A_Star_Is_Born_(2018_film),43523,176737,818,221078,98648
hdfs://spark-nn.eemcs.utwente.nl/user/s1934538/clickstream/clickstream-enwiki-2020-05.tsv.gz,Critical_race_theory,2635,17212,85,19932,4485
hdfs://spark-nn.eemcs.utwente.nl/user/s1934538/clickstream/clickstream-enwiki-2020-05.tsv.gz,Aaron_Hernandez,9464,170609,816,180889,52801
hdfs://spark-nn.eemcs.utwente.nl/user/s1934538/clickstream/clickstream-enwiki-2020-05.tsv.gz,"Diana,_Princess_of_Wales",140900,350555,2557,494012,306620
hdfs://spark-nn.eemcs.utwente.nl/user/s1934538/clickstream/clickstream-enwiki-2020-05.tsv.gz,Afghanistan,59887,160586,2149,222622,126880
hdfs://spark-nn.eemcs.utwente.nl/user/s1934538/clickstream/clickstream-enwiki-2020-05.tsv.gz,Kylian_Mbappé,24909,126274,1821,153004,32107
hdfs://spark-nn.eemcs.utwente.nl/user/s1934538/clickstream/clickstream-enwiki-2020-05.tsv.gz,COVID-19_pandemic,2104229,5029860,21561,7155650,4253925
hdfs://spark-nn.eemcs.utwente.nl/user/s1934538/clickstream/clickstream-enwiki-2020-05.tsv.gz,Captain_Marvel_(film),64340,226252,1925,292517,140270
hdfs://spark-nn.eemcs.utwente.nl/user/s1934538/clickstream/clickstream-enwiki-2020-05.tsv.gz,Notre-Dame_de_Paris,14264,96579,913,111756,24615
hdfs://spark-nn.eemcs.utwente.nl/user/s1934538/clickstream/clickstream-enwiki-2020-05.tsv.gz,Central_Park_jogger_case,45547,213954,974,260475,30266
hdfs://spark-nn.eemcs.utwente.nl/user/s1934538/clickstream/clickstream-enwiki-2020-05.tsv.gz,WandaVision,51936,35380,221,87537,47184
hdfs://spark-nn.eemcs.utwente.nl/user/s1934538/clickstream/clickstream-enwiki-2020-05.tsv.gz,Coronavirus,56212,1203922,22789,1282923,328776
hdfs://spark-nn.eemcs.utwente.nl/user/s1934538/clickstream/clickstream-enwiki-2020-05.tsv.gz,Taliban,32800,100047,635,133482,85410
hdfs://spark-nn.eemcs.utwente.nl/user/s1934538/clickstream/clickstream-enwiki-2020-05.tsv.gz,Wikipedia,78277,548754,1221,628252,439455
hdfs://spark-nn.eemcs.utwente.nl/user/s1934538/clickstream/clickstream-enwiki-2020-05.tsv.gz,Shang-Chi_and_the_Legend_of_the_Ten_Rings,102574,34297,262,137133,89711
hdfs://spark-nn.eemcs.utwente.nl/user/s1934538/clickstream/clickstream-enwiki-2020-05.tsv.gz,List_of_highest-grossing_Indian_films,79742,227330,421,307493,213727
hdfs://spark-nn.eemcs.utwente.nl/user/s1934538/clickstream/clickstream-enwiki-2020-05.tsv.gz,Chernobyl_disaster,74875,532588,3913,611376,238706
hdfs://spark-nn.eemcs.utwente.nl/user/s1934538/clickstream/clickstream-enwiki-2020-05.tsv.gz,Lance_Reddick,46029,68226,303,114558,22834
hdfs://spark-nn.eemcs.utwente.nl/user/s1934538/clickstream/clickstream-enwiki-2020-05.tsv.gz,"Prince_Philip,_Duke_of_Edinburgh",254384,325962,12108,592454,378108
hdfs://spark-nn.eemcs.utwente.nl/user/s1934538/clickstream/clickstream-enwiki-2020-05.tsv.gz,Exo_(band),35282,154701,537,190520,217940
hdfs://spark-nn.eemcs.utwente.nl/user/s1934538/clickstream/clickstream-enwiki-2020-05.tsv.gz,Murder_of_Dee_Dee_Blanchard,18342,167940,588,186870,33047
hdfs://spark-nn.eemcs.utwente.nl/user/s1934538/clickstream/clickstream-enwiki-2020-05.tsv.gz,Fyre_Festival,14703,136030,709,151442,80439
hdfs://spark-nn.eemcs.utwente.nl/user/s1934538/clickstream/clickstream-enwiki-2020-05.tsv.gz,Coronavirus_disease_2019,435924,1231249,25315,1692488,593106
hdfs://spark-nn.eemcs.utwente.nl/user/s1934538/clickstream/clickstream-enwiki-2020-05.tsv.gz,Brett_Kavanaugh,38962,77439,595,116996,40457
hdfs://spark-nn.eemcs.utwente.nl/user/s1934538/clickstream/clickstream-enwiki-2020-05.tsv.gz,Alexander_Hamilton,65135,189456,1635,256226,115075
hdfs://spark-nn.eemcs.utwente.nl/user/s1934538/clickstream/clickstream-enwiki-2020-05.tsv.gz,Hyphen-minus,4794,28154827,8718108,36877729,924
hdfs://spark-nn.eemcs.utwente.nl/user/s1934538/clickstream/clickstream-enwiki-2020-05.tsv.gz,The_Shape_of_Water,34736,94810,1312,130858,51823
hdfs://spark-nn.eemcs.utwente.nl/user/s1934538/clickstream/clickstream-enwiki-2020-05.tsv.gz,It_Chapter_Two,49576,149610,1786,200972,141016
hdfs://spark-nn.eemcs.utwente.nl/user/s1934538/clickstream/clickstream-enwiki-2020-05.tsv.gz,Key_frame,851,6755,15,7621,597
hdfs://spark-nn.eemcs.utwente.nl/user/s1934538/clickstream/clickstream-enwiki-2020-05.tsv.gz,Avengers:_Endgame,195613,485831,5344,686788,459139
hdfs://spark-nn.eemcs.utwente.nl/user/s1934538/clickstream/clickstream-enwiki-2020-05.tsv.gz,A_Quiet_Place_(film),36088,158331,964,195383,61830
hdfs://spark-nn.eemcs.utwente.nl/user/s1934538/clickstream/clickstream-enwiki-2020-05.tsv.gz,The_Falcon_and_the_Winter_Soldier,61530,45585,457,107572,64780
hdfs://spark-nn.eemcs.utwente.nl/user/s1934538/clickstream/clickstream-enwiki-2020-05.tsv.gz,Bird_Box_(film),24623,134695,1217,160535,49135
hdfs://spark-nn.eemcs.utwente.nl/user/s1934538/clickstream/clickstream-enwiki-2020-05.tsv.gz,War_(2019_film),35031,175501,193,210725,52549
hdfs://spark-nn.eemcs.utwente.nl/user/s1934538/clickstream/clickstream-enwiki-2020-05.tsv.gz,Bible,22397,5746079,1819,5770295,44790
hdfs://spark-nn.eemcs.utwente.nl/user/s1934538/clickstream/clickstream-enwiki-2020-05.tsv.gz,Game_of_Thrones,100472,405312,9513,515297,349501
hdfs://spark-nn.eemcs.utwente.nl/user/s1934538/clickstream/clickstream-enwiki-2020-05.tsv.gz,2018_Asian_Games,6505,9068,32,15605,14385
hdfs://spark-nn.eemcs.utwente.nl/user/s1934538/clickstream/clickstream-enwiki-2020-05.tsv.gz,QAnon,50055,989932,5371,1045358,174401
hdfs://spark-nn.eemcs.utwente.nl/user/s1934538/clickstream/clickstream-enwiki-2020-05.tsv.gz,Crazy_Rich_Asians_(film),42999,182761,2002,227762,232995
hdfs://spark-nn.eemcs.utwente.nl/user/s1934538/clickstream/clickstream-enwiki-2020-05.tsv.gz,Charles_III,92,237,48,377,286
hdfs://spark-nn.eemcs.utwente.nl/user/s1934538/clickstream/clickstream-enwiki-2020-05.tsv.gz,ICC_Men's_T20_World_Cup,5541,75318,228,81087,38643
hdfs://spark-nn.eemcs.utwente.nl/user/s1934538/clickstream/clickstream-enwiki-2020-05.tsv.gz,"Citizenship_(Amendment)_Act,_2019",5764,56359,47,62170,8327
hdfs://spark-nn.eemcs.utwente.nl/user/s1934538/clickstream/clickstream-enwiki-2020-05.tsv.gz,Christopher_Scarver,112800,62422,49,175271,53819
hdfs://spark-nn.eemcs.utwente.nl/user/s1934538/clickstream/clickstream-enwiki-2020-05.tsv.gz,Tina_Turner,24802,182353,1730,208885,65233
hdfs://spark-nn.eemcs.utwente.nl/user/s1934538/clickstream/clickstream-enwiki-2020-05.tsv.gz,Zack_Snyder's_Justice_League,95251,24606,10321,130178,74327
hdfs://spark-nn.eemcs.utwente.nl/user/s1934538/clickstream/clickstream-enwiki-2020-05.tsv.gz,Anne_Heche,43339,105033,455,148827,45465
hdfs://spark-nn.eemcs.utwente.nl/user/s1934538/clickstream/clickstream-enwiki-2020-05.tsv.gz,Stranger_Things,70927,370084,6642,447653,346475
hdfs://spark-nn.eemcs.utwente.nl/user/s1934538/clickstream/clickstream-enwiki-2020-05.tsv.gz,Loki_(TV_series),37053,21682,125,58860,22958
hdfs://spark-nn.eemcs.utwente.nl/user/s1934538/clickstream/clickstream-enwiki-2020-05.tsv.gz,YouTube,168616,1207658,13434,1389708,190779
hdfs://spark-nn.eemcs.utwente.nl/user/s1934538/clickstream/clickstream-enwiki-2020-05.tsv.gz,Ruth_Bader_Ginsburg,43319,278328,1548,323195,109675
hdfs://spark-nn.eemcs.utwente.nl/user/s1934538/clickstream/clickstream-enwiki-2020-05.tsv.gz,The_Umbrella_Academy_(TV_series),34700,196327,3386,234413,148076
hdfs://spark-nn.eemcs.utwente.nl/user/s1934538/clickstream/clickstream-enwiki-2020-05.tsv.gz,Cameron_Boyce,47506,448031,1801,497338,126855
hdfs://spark-nn.eemcs.utwente.nl/user/s1934538/clickstream/clickstream-enwiki-2020-05.tsv.gz,Wonder_Woman_1984,88554,117975,3109,209638,107404
hdfs://spark-nn.eemcs.utwente.nl/user/s1934538/clickstream/clickstream-enwiki-2020-05.tsv.gz,Sridevi,53498,191779,1942,247219,94432
hdfs://spark-nn.eemcs.utwente.nl/user/s1934538/clickstream/clickstream-enwiki-2020-05.tsv.gz,Mac_Miller,43313,218438,1795,263546,91760
hdfs://spark-nn.eemcs.utwente.nl/user/s1934538/clickstream/clickstream-enwiki-2020-05.tsv.gz,The_Mandalorian,133009,626037,11072,770118,562502
hdfs://spark-nn.eemcs.utwente.nl/user/s1934538/clickstream/clickstream-enwiki-2020-05.tsv.gz,September_11_attacks,104176,393477,3292,500945,215342
hdfs://spark-nn.eemcs.utwente.nl/user/s1934538/clickstream/clickstream-enwiki-2020-05.tsv.gz,Naya_Rivera,40761,50358,96,91215,18672
hdfs://spark-nn.eemcs.utwente.nl/user/s1934538/clickstream/clickstream-enwiki-2020-05.tsv.gz,Naomi_Osaka,10431,90966,612,102009,30656
hdfs://spark-nn.eemcs.utwente.nl/user/s1934538/clickstream/clickstream-enwiki-2020-05.tsv.gz,DMX_(rapper),22426,82124,559,105109,50995
hdfs://spark-nn.eemcs.utwente.nl/user/s1934538/clickstream/clickstream-enwiki-2020-05.tsv.gz,Saaho,27691,93477,257,121425,39583
hdfs://spark-nn.eemcs.utwente.nl/user/s1934538/clickstream/clickstream-enwiki-2020-05.tsv.gz,Pornhub,50379,568278,16187,634844,118285
hdfs://spark-nn.eemcs.utwente.nl/user/s1934538/clickstream/clickstream-enwiki-2020-05.tsv.gz,Tonya_Harding,36527,198617,735,235879,59245
hdfs://spark-nn.eemcs.utwente.nl/user/s1934538/clickstream/clickstream-enwiki-2020-05.tsv.gz,Spider-Man:_Far_From_Home,114912,217897,2616,335425,167163
hdfs://spark-nn.eemcs.utwente.nl/user/s1934538/clickstream/clickstream-enwiki-2020-05.tsv.gz,George_H._W._Bush,204904,174950,1061,380915,225673
hdfs://spark-nn.eemcs.utwente.nl/user/s1934538/clickstream/clickstream-enwiki-2020-05.tsv.gz,Stephen_Hawking,41643,449786,2715,494144,197737
hdfs://spark-nn.eemcs.utwente.nl/user/s1934538/clickstream/clickstream-enwiki-2020-05.tsv.gz,1234,38,1819,14,1871,175
hdfs://spark-nn.eemcs.utwente.nl/user/s1934538/clickstream/clickstream-enwiki-2020-05.tsv.gz,"Meghan,_Duchess_of_Sussex",105245,293648,2729,401622,215358
hdfs://spark-nn.eemcs.utwente.nl/user/s1934538/clickstream/clickstream-enwiki-2020-05.tsv.gz,Ghislaine_Maxwell,256790,619812,3571,880173,304974
hdfs://spark-nn.eemcs.utwente.nl/user/s1934538/clickstream/clickstream-enwiki-2020-05.tsv.gz,Hamas,30988,45967,303,77258,33768
hdfs://spark-nn.eemcs.utwente.nl/user/s1934538/clickstream/clickstream-enwiki-2020-05.tsv.gz,"Princess_Margaret,_Countess_of_Snowdon",153910,487011,3115,644036,384834
hdfs://spark-nn.eemcs.utwente.nl/user/s1934538/clickstream/clickstream-enwiki-2020-05.tsv.gz,The_Lion_King_(2019_film),60710,212078,1282,274070,131368
hdfs://spark-nn.eemcs.utwente.nl/user/s1934538/clickstream/clickstream-enwiki-2020-05.tsv.gz,State_of_Palestine,54096,156591,134,210821,91321
hdfs://spark-nn.eemcs.utwente.nl/user/s1934538/clickstream/clickstream-enwiki-2020-05.tsv.gz,Aquaman_(film),51112,149348,2121,202581,112718
hdfs://spark-nn.eemcs.utwente.nl/user/s1934538/clickstream/clickstream-enwiki-2020-05.tsv.gz,Joe_Exotic,152671,790868,4001,947540,269326
hdfs://spark-nn.eemcs.utwente.nl/user/s1934538/clickstream/clickstream-enwiki-2020-05.tsv.gz,Star_Wars:_The_Rise_of_Skywalker,216286,569030,12556,797872,530816
hdfs://spark-nn.eemcs.utwente.nl/user/s1934538/clickstream/clickstream-enwiki-2020-05.tsv.gz,Deadpool_2,60320,118361,2000,180681,128810
hdfs://spark-nn.eemcs.utwente.nl/user/s1934538/clickstream/clickstream-enwiki-2020-05.tsv.gz,Brie_Larson,106262,222320,1659,330241,129664
hdfs://spark-nn.eemcs.utwente.nl/user/s1934538/clickstream/clickstream-enwiki-2020-05.tsv.gz,HTTP_cookie,4757,380224,106,385087,24360
hdfs://spark-nn.eemcs.utwente.nl/user/s1934538/clickstream/clickstream-enwiki-2020-05.tsv.gz,List_of_awards_and_nominations_received_by_Meryl_Streep,23348,17397,263,41008,14934
hdfs://spark-nn.eemcs.utwente.nl/user/s1934538/clickstream/clickstream-enwiki-2020-05.tsv.gz,List_of_Queen_of_the_South_episodes,20230,11344,76,31650,916
hdfs://spark-nn.eemcs.utwente.nl/user/s1934538/clickstream/clickstream-enwiki-2020-05.tsv.gz,Charles_Sobhraj,4544,24547,73,29164,6658
hdfs://spark-nn.eemcs.utwente.nl/user/s1934538/clickstream/clickstream-enwiki-2020-05.tsv.gz,Avengers:_Infinity_War,92559,178402,1939,272900,156720
hdfs://spark-nn.eemcs.utwente.nl/user/s1934538/clickstream/clickstream-enwiki-2020-05.tsv.gz,Pelé,34132,161422,1246,196800,63140
hdfs://spark-nn.eemcs.utwente.nl/user/s1934538/clickstream/clickstream-enwiki-2020-05.tsv.gz,Darth_Vader,68114,414837,1117,484068,156725
hdfs://spark-nn.eemcs.utwente.nl/user/s1934538/clickstream/clickstream-enwiki-2020-05.tsv.gz,Bob_Saget,26126,39668,270,66064,12505
hdfs://spark-nn.eemcs.utwente.nl/user/s1934538/clickstream/clickstream-enwiki-2020-05.tsv.gz,Jimmy_Buffett,11607,65814,598,78019,31150
hdfs://spark-nn.eemcs.utwente.nl/user/s1934538/clickstream/clickstream-enwiki-2020-05.tsv.gz,2020_Summer_Olympics,49788,117522,2070,169380,104825
hdfs://spark-nn.eemcs.utwente.nl/user/s1934538/clickstream/clickstream-enwiki-2020-05.tsv.gz,Lisa_Marie_Presley,149617,88082,243,237942,131617
hdfs://spark-nn.eemcs.utwente.nl/user/s1934538/clickstream/clickstream-enwiki-2020-05.tsv.gz,Jimmy_Hoffa,47597,221830,1567,270994,90652
hdfs://spark-nn.eemcs.utwente.nl/user/s1934538/clickstream/clickstream-enwiki-2020-05.tsv.gz,Bipin_Rawat,13598,41105,65,54768,30223
hdfs://spark-nn.eemcs.utwente.nl/user/s1934538/clickstream/clickstream-enwiki-2020-05.tsv.gz,Glass_(2019_film),60880,96471,671,158022,52557
hdfs://spark-nn.eemcs.utwente.nl/user/s1934538/clickstream/clickstream-enwiki-2020-05.tsv.gz,Fantastic_Beasts:_The_Crimes_of_Grindelwald,76641,119140,1142,196923,102008
hdfs://spark-nn.eemcs.utwente.nl/user/s1934538/clickstream/clickstream-enwiki-2020-05.tsv.gz,WrestleMania_34,37407,29199,359,66965,41758
hdfs://spark-nn.eemcs.utwente.nl/user/s1934538/clickstream/clickstream-enwiki-2020-05.tsv.gz,Kobe_Bryant,197783,960023,10357,1168163,350635
hdfs://spark-nn.eemcs.utwente.nl/user/s1934538/clickstream/clickstream-enwiki-2020-05.tsv.gz,David_Beckham,44582,377795,2174,424551,128359
hdfs://spark-nn.eemcs.utwente.nl/user/s1934538/clickstream/clickstream-enwiki-2020-05.tsv.gz,Ted_Bundy,47879,556650,5058,609587,134652
hdfs://spark-nn.eemcs.utwente.nl/user/s1934538/clickstream/clickstream-enwiki-2020-05.tsv.gz,2016_United_States_presidential_election,174697,372083,4366,551146,400513
hdfs://spark-nn.eemcs.utwente.nl/user/s1934538/clickstream/clickstream-enwiki-2020-05.tsv.gz,No_Time_to_Die,146967,166250,1869,315086,179576
hdfs://spark-nn.eemcs.utwente.nl/user/s1934538/clickstream/clickstream-enwiki-2020-05.tsv.gz,Us_(2019_film),37577,199894,834,238305,72325
hdfs://spark-nn.eemcs.utwente.nl/user/s1934538/clickstream/clickstream-enwiki-2020-05.tsv.gz,Tunnel,3151,12131,222,15504,4404
hdfs://spark-nn.eemcs.utwente.nl/user/s1934538/clickstream/clickstream-enwiki-2020-05.tsv.gz,When_They_See_Us,27343,112485,550,140378,73979
hdfs://spark-nn.eemcs.utwente.nl/user/s1934538/clickstream/clickstream-enwiki-2020-05.tsv.gz,IPv4,12050,58558,156,70764,10978
hdfs://spark-nn.eemcs.utwente.nl/user/s1934538/clickstream/clickstream-enwiki-2020-05.tsv.gz,Asia_Cup,1000,12748,151,13899,9073
hdfs://spark-nn.eemcs.utwente.nl/user/s1934538/clickstream/clickstream-enwiki-2020-05.tsv.gz,Jeffrey_Dahmer,42069,645845,5244,693158,306308
hdfs://spark-nn.eemcs.utwente.nl/user/s1934538/clickstream/clickstream-enwiki-2020-05.tsv.gz,Death_of_George_Floyd,227894,4813377,8990,5050261,951755
hdfs://spark-nn.eemcs.utwente.nl/user/s1934538/clickstream/clickstream-enwiki-2020-05.tsv.gz,Godzilla_vs._Kong,83168,80464,1494,165126,93780
hdfs://spark-nn.eemcs.utwente.nl/user/s1934538/clickstream/clickstream-enwiki-2020-05.tsv.gz,Shinzo_Abe,38094,43408,481,81983,44155
hdfs://spark-nn.eemcs.utwente.nl/user/s1934538/clickstream/clickstream-enwiki-2020-05.tsv.gz,Army_of_the_Dead,49073,13013,54,62140,34753
hdfs://spark-nn.eemcs.utwente.nl/user/s1934538/clickstream/clickstream-enwiki-2020-05.tsv.gz,2020_United_States_presidential_election,145067,467086,8504,620657,424750
hdfs://spark-nn.eemcs.utwente.nl/user/s1934538/clickstream/clickstream-enwiki-2020-05.tsv.gz,Avicii,23336,224148,1918,249402,74711
hdfs://spark-nn.eemcs.utwente.nl/user/s1934538/clickstream/clickstream-enwiki-2020-05.tsv.gz,XXXTentacion,92302,448544,6024,546870,114618
hdfs://spark-nn.eemcs.utwente.nl/user/s1934538/clickstream/clickstream-enwiki-2020-05.tsv.gz,Kamala_Harris,26710,202943,2571,232224,76947
hdfs://spark-nn.eemcs.utwente.nl/user/s1934538/clickstream/clickstream-enwiki-2020-05.tsv.gz,Louis_Tomlinson,44103,93771,409,138283,21510
hdfs://spark-nn.eemcs.utwente.nl/user/s1934538/clickstream/clickstream-enwiki-2020-05.tsv.gz,Royal_Rumble_(2018),13007,9027,204,22238,14635
hdfs://spark-nn.eemcs.utwente.nl/user/s1934538/clickstream/clickstream-enwiki-2020-05.tsv.gz,List_of_James_Bond_films,73600,583187,1260,658047,349683
hdfs://spark-nn.eemcs.utwente.nl/user/s1934538/clickstream/clickstream-enwiki-2020-05.tsv.gz,Freddie_Mercury,96006,635407,4567,735980,264343
hdfs://spark-nn.eemcs.utwente.nl/user/s1934538/clickstream/clickstream-enwiki-2020-05.tsv.gz,Sushma_Swaraj,7175,26099,33,33307,8810
hdfs://spark-nn.eemcs.utwente.nl/user/s1934538/clickstream/clickstream-enwiki-2020-05.tsv.gz,Area_51,21477,225357,1664,248498,49797
hdfs://spark-nn.eemcs.utwente.nl/user/s1934538/clickstream/clickstream-enwiki-2020-05.tsv.gz,The_Nun_(2018_film),24851,96251,582,121684,75443
hdfs://spark-nn.eemcs.utwente.nl/user/s1934538/clickstream/clickstream-enwiki-2020-05.tsv.gz,XHamster,11354,87105,3021,101480,17862
hdfs://spark-nn.eemcs.utwente.nl/user/s1934538/clickstream/clickstream-enwiki-2020-05.tsv.gz,Anthony_Bourdain,20800,278319,2062,301181,79208
hdfs://spark-nn.eemcs.utwente.nl/user/s1934538/clickstream/clickstream-enwiki-2020-05.tsv.gz,Olivia_Newton-John,33703,102667,1062,137432,60524
hdfs://spark-nn.eemcs.utwente.nl/user/s1934538/clickstream/clickstream-enwiki-2020-05.tsv.gz,Ray_Liotta,47308,60283,389,107980,36829
hdfs://spark-nn.eemcs.utwente.nl/user/s1934538/clickstream/clickstream-enwiki-2020-05.tsv.gz,Stan_Lee,56250,170759,1225,228234,71087
hdfs://spark-nn.eemcs.utwente.nl/user/s1934538/clickstream/clickstream-enwiki-2020-05.tsv.gz,Laal_Singh_Chaddha,37923,28379,41,66343,35101
hdfs://spark-nn.eemcs.utwente.nl/user/s1934538/clickstream/clickstream-enwiki-2020-05.tsv.gz,Kobe_Bryant_sexual_assault_case,9854,58861,151,68866,5103
hdfs://spark-nn.eemcs.utwente.nl/user/s1934538/clickstream/clickstream-enwiki-2020-05.tsv.gz,Dennis_Nilsen,7862,66004,1082,74948,15820
hdfs://spark-nn.eemcs.utwente.nl/user/s1934538/clickstream/clickstream-enwiki-2020-05.tsv.gz,Burt_Reynolds,66638,163693,1277,231608,98743
hdfs://spark-nn.eemcs.utwente.nl/user/s1934538/clickstream/clickstream-enwiki-2020-05.tsv.gz,Cecil_Hotel_(Los_Angeles),6742,29087,40,35869,14459
hdfs://spark-nn.eemcs.utwente.nl/user/s1934538/clickstream/clickstream-enwiki-2020-05.tsv.gz,Lionel_Messi,73092,402562,5021,480675,111720
hdfs://spark-nn.eemcs.utwente.nl/user/s1934538/clickstream/clickstream-enwiki-2020-05.tsv.gz,Sinéad_O'Connor,15220,117081,792,133093,32944
hdfs://spark-nn.eemcs.utwente.nl/user/s1934538/clickstream/clickstream-enwiki-2020-05.tsv.gz,2018_Winter_Olympics,19803,20538,270,40611,28289
hdfs://spark-nn.eemcs.utwente.nl/user/s1934538/clickstream/clickstream-enwiki-2020-05.tsv.gz,Joker_(2019_film),96410,690483,7080,793973,320005
hdfs://spark-nn.eemcs.utwente.nl/user/s1934538/clickstream/clickstream-enwiki-2020-05.tsv.gz,Aretha_Franklin,28232,116454,997,145683,52190
hdfs://spark-nn.eemcs.utwente.nl/user/s1934538/clickstream/clickstream-enwiki-2020-05.tsv.gz,Stranger_Things_(season_3),24020,76044,635,100699,59186
hdfs://spark-nn.eemcs.utwente.nl/user/s1934538/clickstream/clickstream-enwiki-2020-05.tsv.gz,Richard_Jewell,27068,193784,738,221590,76527
hdfs://spark-nn.eemcs.utwente.nl/user/s1934538/clickstream/clickstream-enwiki-2020-05.tsv.gz,Matthew_Perry,90750,241586,866,333202,185959
hdfs://spark-nn.eemcs.utwente.nl/user/s1934538/clickstream/clickstream-enwiki-2020-05.tsv.gz,Juneteenth,2612,158879,336,161827,13849
hdfs://spark-nn.eemcs.utwente.nl/user/s1934538/clickstream/clickstream-enwiki-2020-05.tsv.gz,Simple_Mail_Transfer_Protocol,4226,34672,165,39063,4011
hdfs://spark-nn.eemcs.utwente.nl/user/s1934538/clickstream/clickstream-enwiki-2020-05.tsv.gz,Grover,1794,7591,54,9439,2238
hdfs://spark-nn.eemcs.utwente.nl/user/s1934538/clickstream/clickstream-enwiki-2020-05.tsv.gz,2.0_(film),26366,54378,122,80866,23004
hdfs://spark-nn.eemcs.utwente.nl/user/s1934538/clickstream/clickstream-enwiki-2020-05.tsv.gz,2018_FIFA_World_Cup,95111,228360,2725,326196,166351
hdfs://spark-nn.eemcs.utwente.nl/user/s1934538/clickstream/clickstream-enwiki-2020-05.tsv.gz,Queen_(band),73280,265692,3396,342368,309598
hdfs://spark-nn.eemcs.utwente.nl/user/s1934538/clickstream/clickstream-enwiki-2020-05.tsv.gz,Cardi_B,51163,301412,6018,358593,116094
hdfs://spark-nn.eemcs.utwente.nl/user/s1934538/clickstream/clickstream-enwiki-2020-05.tsv.gz,The_Witcher_(TV_series),44593,316084,4604,365281,224444
hdfs://spark-nn.eemcs.utwente.nl/user/s1934538/clickstream/clickstream-enwiki-2020-05.tsv.gz,FIFA_World_Cup,46099,195090,2676,243865,183054
hdfs://spark-nn.eemcs.utwente.nl/user/s1934538/clickstream/clickstream-enwiki-2020-06.tsv.gz,Jimmy_Hoffa,39684,161398,1335,202417,73017
hdfs://spark-nn.eemcs.utwente.nl/user/s1934538/clickstream/clickstream-enwiki-2020-06.tsv.gz,Indian_Premier_League,9472,44383,180,54035,34331
hdfs://spark-nn.eemcs.utwente.nl/user/s1934538/clickstream/clickstream-enwiki-2020-06.tsv.gz,IPv4,10465,47758,133,58356,9833
hdfs://spark-nn.eemcs.utwente.nl/user/s1934538/clickstream/clickstream-enwiki-2020-06.tsv.gz,Anthony_Bourdain,24936,486785,2991,514712,156989
hdfs://spark-nn.eemcs.utwente.nl/user/s1934538/clickstream/clickstream-enwiki-2020-06.tsv.gz,Aretha_Franklin,29855,110846,968,141669,62194
hdfs://spark-nn.eemcs.utwente.nl/user/s1934538/clickstream/clickstream-enwiki-2020-06.tsv.gz,Shakira,20643,204295,1840,226778,112007
hdfs://spark-nn.eemcs.utwente.nl/user/s1934538/clickstream/clickstream-enwiki-2020-06.tsv.gz,Cecil_Hotel_(Los_Angeles),5007,18140,30,23177,9249
hdfs://spark-nn.eemcs.utwente.nl/user/s1934538/clickstream/clickstream-enwiki-2020-06.tsv.gz,War_(2019_film),30027,113501,202,143730,35632
hdfs://spark-nn.eemcs.utwente.nl/user/s1934538/clickstream/clickstream-enwiki-2020-06.tsv.gz,Cook's_Country,356,2385,16,2757,713
hdfs://spark-nn.eemcs.utwente.nl/user/s1934538/clickstream/clickstream-enwiki-2020-06.tsv.gz,Jenna_Ortega,15573,20936,1268,37777,7611
hdfs://spark-nn.eemcs.utwente.nl/user/s1934538/clickstream/clickstream-enwiki-2020-06.tsv.gz,Rihanna,69009,243315,3233,315557,148865
hdfs://spark-nn.eemcs.utwente.nl/user/s1934538/clickstream/clickstream-enwiki-2020-06.tsv.gz,Hyphen-minus,4104,6450817,7719212,14174133,705
hdfs://spark-nn.eemcs.utwente.nl/user/s1934538/clickstream/clickstream-enwiki-2020-06.tsv.gz,The_Haunting_of_Bly_Manor,31609,22477,176,54262,30578
hdfs://spark-nn.eemcs.utwente.nl/user/s1934538/clickstream/clickstream-enwiki-2020-06.tsv.gz,Tunnel,2576,7921,95,10592,2981
hdfs://spark-nn.eemcs.utwente.nl/user/s1934538/clickstream/clickstream-enwiki-2020-06.tsv.gz,Mulan_(2020_film),44729,209718,6751,261198,120612
hdfs://spark-nn.eemcs.utwente.nl/user/s1934538/clickstream/clickstream-enwiki-2020-06.tsv.gz,Deion_Sanders,9258,103073,523,112854,30670
hdfs://spark-nn.eemcs.utwente.nl/user/s1934538/clickstream/clickstream-enwiki-2020-06.tsv.gz,David_Beckham,35259,182333,1106,218698,73230
hdfs://spark-nn.eemcs.utwente.nl/user/s1934538/clickstream/clickstream-enwiki-2020-06.tsv.gz,Freddie_Mercury,85819,551431,3787,641037,233160
hdfs://spark-nn.eemcs.utwente.nl/user/s1934538/clickstream/clickstream-enwiki-2020-06.tsv.gz,K.G.F:_Chapter_2,27039,69892,133,97064,47918
hdfs://spark-nn.eemcs.utwente.nl/user/s1934538/clickstream/clickstream-enwiki-2020-06.tsv.gz,United_States_Electoral_College,54693,292402,371,347466,52161
hdfs://spark-nn.eemcs.utwente.nl/user/s1934538/clickstream/clickstream-enwiki-2020-06.tsv.gz,Taliban,24962,57872,689,83523,52145
hdfs://spark-nn.eemcs.utwente.nl/user/s1934538/clickstream/clickstream-enwiki-2020-06.tsv.gz,Ukraine,45245,115670,2675,163590,77039
hdfs://spark-nn.eemcs.utwente.nl/user/s1934538/clickstream/clickstream-enwiki-2020-06.tsv.gz,Bible,17776,5023640,1693,5043109,35995
hdfs://spark-nn.eemcs.utwente.nl/user/s1934538/clickstream/clickstream-enwiki-2020-06.tsv.gz,Khabib_Nurmagomedov,83070,209769,2109,294948,158450
hdfs://spark-nn.eemcs.utwente.nl/user/s1934538/clickstream/clickstream-enwiki-2020-06.tsv.gz,Notre-Dame_de_Paris,10625,69367,728,80720,17862
hdfs://spark-nn.eemcs.utwente.nl/user/s1934538/clickstream/clickstream-enwiki-2020-06.tsv.gz,Rami_Malek,79787,166649,835,247271,90819
hdfs://spark-nn.eemcs.utwente.nl/user/s1934538/clickstream/clickstream-enwiki-2020-06.tsv.gz,Joe_Exotic,55545,385331,2072,442948,116372
hdfs://spark-nn.eemcs.utwente.nl/user/s1934538/clickstream/clickstream-enwiki-2020-06.tsv.gz,Deaths_in_2020,1310791,2060857,12241,3383889,2017333
hdfs://spark-nn.eemcs.utwente.nl/user/s1934538/clickstream/clickstream-enwiki-2020-06.tsv.gz,21_Savage,14973,67756,699,83428,28569
hdfs://spark-nn.eemcs.utwente.nl/user/s1934538/clickstream/clickstream-enwiki-2020-06.tsv.gz,Tenet_(film),131581,408470,7168,547219,310632
hdfs://spark-nn.eemcs.utwente.nl/user/s1934538/clickstream/clickstream-enwiki-2020-06.tsv.gz,Antifa_(United_States),218356,4323237,12858,4554451,578196
hdfs://spark-nn.eemcs.utwente.nl/user/s1934538/clickstream/clickstream-enwiki-2020-06.tsv.gz,A_Quiet_Place_(film),27729,119577,782,148088,46063
hdfs://spark-nn.eemcs.utwente.nl/user/s1934538/clickstream/clickstream-enwiki-2020-06.tsv.gz,Jeffrey_Epstein,196860,3389511,14887,3601258,1495007
hdfs://spark-nn.eemcs.utwente.nl/user/s1934538/clickstream/clickstream-enwiki-2020-06.tsv.gz,Rishi_Sunak,21436,124193,625,146254,62083
hdfs://spark-nn.eemcs.utwente.nl/user/s1934538/clickstream/clickstream-enwiki-2020-06.tsv.gz,YouTube,152421,960936,10119,1123476,153799
hdfs://spark-nn.eemcs.utwente.nl/user/s1934538/clickstream/clickstream-enwiki-2020-06.tsv.gz,Kobe_Bryant,81291,458729,5517,545537,167032
hdfs://spark-nn.eemcs.utwente.nl/user/s1934538/clickstream/clickstream-enwiki-2020-06.tsv.gz,Grimes_(musician),219032,265260,711,485003,113831
hdfs://spark-nn.eemcs.utwente.nl/user/s1934538/clickstream/clickstream-enwiki-2020-06.tsv.gz,Richard_Ramirez,22281,110477,817,133575,44697
hdfs://spark-nn.eemcs.utwente.nl/user/s1934538/clickstream/clickstream-enwiki-2020-06.tsv.gz,The_Falcon_and_the_Winter_Soldier,50459,46416,454,97329,58128
hdfs://spark-nn.eemcs.utwente.nl/user/s1934538/clickstream/clickstream-enwiki-2020-06.tsv.gz,Alexander_Hamilton,102506,335351,2147,440004,184585
hdfs://spark-nn.eemcs.utwente.nl/user/s1934538/clickstream/clickstream-enwiki-2020-06.tsv.gz,Murder_of_Dee_Dee_Blanchard,13593,110775,440,124808,23518
hdfs://spark-nn.eemcs.utwente.nl/user/s1934538/clickstream/clickstream-enwiki-2020-06.tsv.gz,Venom_(2018_film),23633,110731,1149,135513,65754
hdfs://spark-nn.eemcs.utwente.nl/user/s1934538/clickstream/clickstream-enwiki-2020-06.tsv.gz,The_Witcher_(TV_series),33289,225951,3839,263079,163561
hdfs://spark-nn.eemcs.utwente.nl/user/s1934538/clickstream/clickstream-enwiki-2020-06.tsv.gz,Michael_Bloomberg,57092,60330,425,117847,51517
hdfs://spark-nn.eemcs.utwente.nl/user/s1934538/clickstream/clickstream-enwiki-2020-06.tsv.gz,List_of_Marvel_Cinematic_Universe_films,83863,956370,1854,1042087,364089
hdfs://spark-nn.eemcs.utwente.nl/user/s1934538/clickstream/clickstream-enwiki-2020-06.tsv.gz,Parasite_(2019_film),62849,487036,4639,554524,230071
hdfs://spark-nn.eemcs.utwente.nl/user/s1934538/clickstream/clickstream-enwiki-2020-06.tsv.gz,List_of_Queen_of_the_South_episodes,63939,35319,64,99322,3136
hdfs://spark-nn.eemcs.utwente.nl/user/s1934538/clickstream/clickstream-enwiki-2020-06.tsv.gz,Us_(2019_film),37399,291922,994,330315,85394
hdfs://spark-nn.eemcs.utwente.nl/user/s1934538/clickstream/clickstream-enwiki-2020-06.tsv.gz,Stranger_Things_(season_3),20114,57367,590,78071,45623
hdfs://spark-nn.eemcs.utwente.nl/user/s1934538/clickstream/clickstream-enwiki-2020-06.tsv.gz,Irrfan_Khan,59974,183066,515,243555,76417
hdfs://spark-nn.eemcs.utwente.nl/user/s1934538/clickstream/clickstream-enwiki-2020-06.tsv.gz,COVID-19_pandemic,1303687,2887824,16009,4207520,2943173
hdfs://spark-nn.eemcs.utwente.nl/user/s1934538/clickstream/clickstream-enwiki-2020-06.tsv.gz,Main_Page,50049,155522559,4507914,160080522,33539890
hdfs://spark-nn.eemcs.utwente.nl/user/s1934538/clickstream/clickstream-enwiki-2020-06.tsv.gz,Anna_Sorokin,8119,26808,103,35030,8554
hdfs://spark-nn.eemcs.utwente.nl/user/s1934538/clickstream/clickstream-enwiki-2020-06.tsv.gz,Amy_Coney_Barrett,2154,5303,34,7491,1613
hdfs://spark-nn.eemcs.utwente.nl/user/s1934538/clickstream/clickstream-enwiki-2020-06.tsv.gz,Dennis_Nilsen,5866,33905,544,40315,8686
hdfs://spark-nn.eemcs.utwente.nl/user/s1934538/clickstream/clickstream-enwiki-2020-06.tsv.gz,Amber_Heard,122490,259553,3148,385191,176719
hdfs://spark-nn.eemcs.utwente.nl/user/s1934538/clickstream/clickstream-enwiki-2020-06.tsv.gz,Aquaman_(film),38821,138982,1648,179451,94349
hdfs://spark-nn.eemcs.utwente.nl/user/s1934538/clickstream/clickstream-enwiki-2020-06.tsv.gz,J._Robert_Oppenheimer,22134,88261,353,110748,36672
hdfs://spark-nn.eemcs.utwente.nl/user/s1934538/clickstream/clickstream-enwiki-2020-06.tsv.gz,Ted_Bundy,40816,472400,4286,517502,117413
hdfs://spark-nn.eemcs.utwente.nl/user/s1934538/clickstream/clickstream-enwiki-2020-06.tsv.gz,Cleopatra,49930,999960,2144,1052034,151388
hdfs://spark-nn.eemcs.utwente.nl/user/s1934538/clickstream/clickstream-enwiki-2020-06.tsv.gz,Laal_Singh_Chaddha,35254,28248,51,63553,36796
hdfs://spark-nn.eemcs.utwente.nl/user/s1934538/clickstream/clickstream-enwiki-2020-06.tsv.gz,Army_of_the_Dead,37852,10494,67,48413,30669
hdfs://spark-nn.eemcs.utwente.nl/user/s1934538/clickstream/clickstream-enwiki-2020-06.tsv.gz,Killing_of_George_Floyd,482753,6455424,130909,7069086,1370993
hdfs://spark-nn.eemcs.utwente.nl/user/s1934538/clickstream/clickstream-enwiki-2020-06.tsv.gz,Chadwick_Boseman,75630,118148,771,194549,69763
hdfs://spark-nn.eemcs.utwente.nl/user/s1934538/clickstream/clickstream-enwiki-2020-06.tsv.gz,The_Batman_(film),113535,103236,1700,218471,232203
hdfs://spark-nn.eemcs.utwente.nl/user/s1934538/clickstream/clickstream-enwiki-2020-06.tsv.gz,Avengers:_Infinity_War,65618,168079,1861,235558,123674
hdfs://spark-nn.eemcs.utwente.nl/user/s1934538/clickstream/clickstream-enwiki-2020-06.tsv.gz,A_Star_Is_Born_(2018_film),42758,187304,853,230915,97114
hdfs://spark-nn.eemcs.utwente.nl/user/s1934538/clickstream/clickstream-enwiki-2020-06.tsv.gz,HTTP_cookie,3855,358478,81,362414,24142
hdfs://spark-nn.eemcs.utwente.nl/user/s1934538/clickstream/clickstream-enwiki-2020-06.tsv.gz,QAnon,57901,981236,20502,1059639,182071
hdfs://spark-nn.eemcs.utwente.nl/user/s1934538/clickstream/clickstream-enwiki-2020-06.tsv.gz,Brie_Larson,104469,201085,1532,307086,118362
hdfs://spark-nn.eemcs.utwente.nl/user/s1934538/clickstream/clickstream-enwiki-2020-06.tsv.gz,Glass_(2019_film),55329,92714,611,148654,50303
hdfs://spark-nn.eemcs.utwente.nl/user/s1934538/clickstream/clickstream-enwiki-2020-06.tsv.gz,Jeffrey_Dahmer,44188,470285,3790,518263,243423
hdfs://spark-nn.eemcs.utwente.nl/user/s1934538/clickstream/clickstream-enwiki-2020-06.tsv.gz,The_Weeknd,69608,219955,2859,292422,125131
hdfs://spark-nn.eemcs.utwente.nl/user/s1934538/clickstream/clickstream-enwiki-2020-06.tsv.gz,Coronavirus,26507,673352,9673,709532,173868
hdfs://spark-nn.eemcs.utwente.nl/user/s1934538/clickstream/clickstream-enwiki-2020-06.tsv.gz,List_of_FIFA_World_Cup_finals,3254,65139,95,68488,24049
hdfs://spark-nn.eemcs.utwente.nl/user/s1934538/clickstream/clickstream-enwiki-2020-06.tsv.gz,Avengers:_Endgame,141569,331788,4112,477469,294378
hdfs://spark-nn.eemcs.utwente.nl/user/s1934538/clickstream/clickstream-enwiki-2020-06.tsv.gz,Sylvester_Stallone,94611,282177,1998,378786,283239
hdfs://spark-nn.eemcs.utwente.nl/user/s1934538/clickstream/clickstream-enwiki-2020-06.tsv.gz,Lionel_Messi,83772,498772,5631,588175,129090
hdfs://spark-nn.eemcs.utwente.nl/user/s1934538/clickstream/clickstream-enwiki-2020-06.tsv.gz,"Princess_Margaret,_Countess_of_Snowdon",117648,323555,2121,443324,268322
hdfs://spark-nn.eemcs.utwente.nl/user/s1934538/clickstream/clickstream-enwiki-2020-06.tsv.gz,Vladimir_Putin,88742,293962,18512,401216,250082
hdfs://spark-nn.eemcs.utwente.nl/user/s1934538/clickstream/clickstream-enwiki-2020-06.tsv.gz,ICC_Men's_T20_World_Cup,4984,71593,136,76713,35085
hdfs://spark-nn.eemcs.utwente.nl/user/s1934538/clickstream/clickstream-enwiki-2020-06.tsv.gz,2020_Summer_Olympics,43984,111026,2210,157220,95811
hdfs://spark-nn.eemcs.utwente.nl/user/s1934538/clickstream/clickstream-enwiki-2020-06.tsv.gz,Keanu_Reeves,118880,555985,3603,678468,433461
hdfs://spark-nn.eemcs.utwente.nl/user/s1934538/clickstream/clickstream-enwiki-2020-06.tsv.gz,Lisa_Marie_Presley,131195,69708,180,201083,113351
hdfs://spark-nn.eemcs.utwente.nl/user/s1934538/clickstream/clickstream-enwiki-2020-06.tsv.gz,1234,31,1290,20,1341,111
hdfs://spark-nn.eemcs.utwente.nl/user/s1934538/clickstream/clickstream-enwiki-2020-06.tsv.gz,Godzilla_vs._Kong,68938,79289,4079,152306,88834
hdfs://spark-nn.eemcs.utwente.nl/user/s1934538/clickstream/clickstream-enwiki-2020-06.tsv.gz,Tasuku_Honjo,1385,1147066,94,1148545,33549
hdfs://spark-nn.eemcs.utwente.nl/user/s1934538/clickstream/clickstream-enwiki-2020-06.tsv.gz,The_Mandalorian,66664,282830,5198,354692,247060
hdfs://spark-nn.eemcs.utwente.nl/user/s1934538/clickstream/clickstream-enwiki-2020-06.tsv.gz,Naya_Rivera,40718,90143,343,131204,33789
hdfs://spark-nn.eemcs.utwente.nl/user/s1934538/clickstream/clickstream-enwiki-2020-06.tsv.gz,Captain_Marvel_(film),45793,145142,1663,192598,98106
hdfs://spark-nn.eemcs.utwente.nl/user/s1934538/clickstream/clickstream-enwiki-2020-06.tsv.gz,George_H._W._Bush,245227,182541,1374,429142,262916
hdfs://spark-nn.eemcs.utwente.nl/user/s1934538/clickstream/clickstream-enwiki-2020-06.tsv.gz,Kate_Spade,35679,63021,383,99083,35665
hdfs://spark-nn.eemcs.utwente.nl/user/s1934538/clickstream/clickstream-enwiki-2020-06.tsv.gz,Loki_(TV_series),29010,21134,97,50241,19462
hdfs://spark-nn.eemcs.utwente.nl/user/s1934538/clickstream/clickstream-enwiki-2020-06.tsv.gz,Sridevi,36432,113153,471,150056,62323
hdfs://spark-nn.eemcs.utwente.nl/user/s1934538/clickstream/clickstream-enwiki-2020-06.tsv.gz,Eddie_Van_Halen,32911,44338,425,77674,34708
hdfs://spark-nn.eemcs.utwente.nl/user/s1934538/clickstream/clickstream-enwiki-2020-06.tsv.gz,Black_Panther_(film),61551,180064,2708,244323,157239
hdfs://spark-nn.eemcs.utwente.nl/user/s1934538/clickstream/clickstream-enwiki-2020-06.tsv.gz,Michael_Jordan,167232,1285798,9837,1462867,653149
hdfs://spark-nn.eemcs.utwente.nl/user/s1934538/clickstream/clickstream-enwiki-2020-06.tsv.gz,Shooting_of_Breonna_Taylor,86326,4023943,8273,4118542,358469
hdfs://spark-nn.eemcs.utwente.nl/user/s1934538/clickstream/clickstream-enwiki-2020-06.tsv.gz,Game_of_Thrones,72051,298971,7057,378079,255076
hdfs://spark-nn.eemcs.utwente.nl/user/s1934538/clickstream/clickstream-enwiki-2020-06.tsv.gz,Pornhub,52845,553881,14588,621314,113729
hdfs://spark-nn.eemcs.utwente.nl/user/s1934538/clickstream/clickstream-enwiki-2020-06.tsv.gz,The_Irishman,62264,173533,2400,238197,200662
hdfs://spark-nn.eemcs.utwente.nl/user/s1934538/clickstream/clickstream-enwiki-2020-06.tsv.gz,Olivia_Newton-John,35010,127217,1067,163294,65897
hdfs://spark-nn.eemcs.utwente.nl/user/s1934538/clickstream/clickstream-enwiki-2020-06.tsv.gz,List_of_highest-grossing_Indian_films,64380,205811,684,270875,170901
hdfs://spark-nn.eemcs.utwente.nl/user/s1934538/clickstream/clickstream-enwiki-2020-06.tsv.gz,Louis_Tomlinson,35357,88807,506,124670,20675
hdfs://spark-nn.eemcs.utwente.nl/user/s1934538/clickstream/clickstream-enwiki-2020-06.tsv.gz,List_of_James_Bond_films,61543,469957,549,532049,290481
hdfs://spark-nn.eemcs.utwente.nl/user/s1934538/clickstream/clickstream-enwiki-2020-06.tsv.gz,Simple_Mail_Transfer_Protocol,3599,29119,98,32816,3389
hdfs://spark-nn.eemcs.utwente.nl/user/s1934538/clickstream/clickstream-enwiki-2020-06.tsv.gz,Mortal_Kombat_(2021_film),31062,47457,142,78661,129742
hdfs://spark-nn.eemcs.utwente.nl/user/s1934538/clickstream/clickstream-enwiki-2020-06.tsv.gz,Coronavirus_disease_2019,267424,694443,10260,972127,316837
hdfs://spark-nn.eemcs.utwente.nl/user/s1934538/clickstream/clickstream-enwiki-2020-06.tsv.gz,Russo-Ukrainian_War,11722,22176,55,33953,9731
hdfs://spark-nn.eemcs.utwente.nl/user/s1934538/clickstream/clickstream-enwiki-2020-06.tsv.gz,Fyre_Festival,11009,67336,583,78928,43166
hdfs://spark-nn.eemcs.utwente.nl/user/s1934538/clickstream/clickstream-enwiki-2020-06.tsv.gz,Media,59,3037,264,3360,1620
hdfs://spark-nn.eemcs.utwente.nl/user/s1934538/clickstream/clickstream-enwiki-2020-06.tsv.gz,"Meghan,_Duchess_of_Sussex",88796,272665,1648,363109,186532
hdfs://spark-nn.eemcs.utwente.nl/user/s1934538/clickstream/clickstream-enwiki-2020-06.tsv.gz,Microsoft_Office,8498,1289389,634,1298521,21751
hdfs://spark-nn.eemcs.utwente.nl/user/s1934538/clickstream/clickstream-enwiki-2020-06.tsv.gz,NATO,50182,113068,1674,164924,61774
hdfs://spark-nn.eemcs.utwente.nl/user/s1934538/clickstream/clickstream-enwiki-2020-06.tsv.gz,Joker_(2019_film),70622,410420,4227,485269,215566
hdfs://spark-nn.eemcs.utwente.nl/user/s1934538/clickstream/clickstream-enwiki-2020-06.tsv.gz,Qasem_Soleimani,13104,55133,395,68632,32048
hdfs://spark-nn.eemcs.utwente.nl/user/s1934538/clickstream/clickstream-enwiki-2020-06.tsv.gz,DMX_(rapper),16327,65566,371,82264,35383
hdfs://spark-nn.eemcs.utwente.nl/user/s1934538/clickstream/clickstream-enwiki-2020-06.tsv.gz,Elizabeth_II,546507,754237,7179,1307923,976652
hdfs://spark-nn.eemcs.utwente.nl/user/s1934538/clickstream/clickstream-enwiki-2020-06.tsv.gz,JSON_Web_Token,903,29566,54,30523,2076
hdfs://spark-nn.eemcs.utwente.nl/user/s1934538/clickstream/clickstream-enwiki-2020-06.tsv.gz,Spanish_flu,59515,763058,8118,830691,152679
hdfs://spark-nn.eemcs.utwente.nl/user/s1934538/clickstream/clickstream-enwiki-2020-06.tsv.gz,UEFA_Euro_2020,46068,165162,2630,213860,90495
hdfs://spark-nn.eemcs.utwente.nl/user/s1934538/clickstream/clickstream-enwiki-2020-06.tsv.gz,Chernobyl_(miniseries),22424,153306,2714,178444,163701
hdfs://spark-nn.eemcs.utwente.nl/user/s1934538/clickstream/clickstream-enwiki-2020-06.tsv.gz,Charles_III,105,204,63,372,348
hdfs://spark-nn.eemcs.utwente.nl/user/s1934538/clickstream/clickstream-enwiki-2020-06.tsv.gz,Jason_Momoa,94734,299585,1410,395729,184926
hdfs://spark-nn.eemcs.utwente.nl/user/s1934538/clickstream/clickstream-enwiki-2020-06.tsv.gz,The_Nun_(2018_film),23252,83568,386,107206,67752
hdfs://spark-nn.eemcs.utwente.nl/user/s1934538/clickstream/clickstream-enwiki-2020-06.tsv.gz,Wikipedia,238693,539693,908,779294,198024
hdfs://spark-nn.eemcs.utwente.nl/user/s1934538/clickstream/clickstream-enwiki-2020-06.tsv.gz,Burt_Reynolds,55923,171383,1407,228713,100542
hdfs://spark-nn.eemcs.utwente.nl/user/s1934538/clickstream/clickstream-enwiki-2020-06.tsv.gz,Kobe_Bryant_sexual_assault_case,5806,44187,76,50069,3466
hdfs://spark-nn.eemcs.utwente.nl/user/s1934538/clickstream/clickstream-enwiki-2020-06.tsv.gz,Kelly_Preston,78966,41268,219,120453,33024
hdfs://spark-nn.eemcs.utwente.nl/user/s1934538/clickstream/clickstream-enwiki-2020-06.tsv.gz,Tom_Brady,52027,160140,1620,213787,78080
hdfs://spark-nn.eemcs.utwente.nl/user/s1934538/clickstream/clickstream-enwiki-2020-06.tsv.gz,Shinzo_Abe,34883,31042,320,66245,37097
hdfs://spark-nn.eemcs.utwente.nl/user/s1934538/clickstream/clickstream-enwiki-2020-06.tsv.gz,2022_FIFA_World_Cup,56488,91731,1510,149729,83920
hdfs://spark-nn.eemcs.utwente.nl/user/s1934538/clickstream/clickstream-enwiki-2020-06.tsv.gz,Naomi_Osaka,9228,47653,380,57261,17172
hdfs://spark-nn.eemcs.utwente.nl/user/s1934538/clickstream/clickstream-enwiki-2020-06.tsv.gz,2020_United_States_presidential_election,207515,725146,12613,945274,633473
hdfs://spark-nn.eemcs.utwente.nl/user/s1934538/clickstream/clickstream-enwiki-2020-06.tsv.gz,List_of_highest-grossing_films,126716,380444,1845,509005,218050
hdfs://spark-nn.eemcs.utwente.nl/user/s1934538/clickstream/clickstream-enwiki-2020-06.tsv.gz,Cameron_Boyce,41911,290725,1091,333727,90069
hdfs://spark-nn.eemcs.utwente.nl/user/s1934538/clickstream/clickstream-enwiki-2020-06.tsv.gz,The_Suicide_Squad_(film),112491,58136,773,171400,152552
hdfs://spark-nn.eemcs.utwente.nl/user/s1934538/clickstream/clickstream-enwiki-2020-06.tsv.gz,Star_Wars:_The_Rise_of_Skywalker,108110,191635,4264,304009,174761
hdfs://spark-nn.eemcs.utwente.nl/user/s1934538/clickstream/clickstream-enwiki-2020-06.tsv.gz,Cardi_B,41067,274190,4379,319636,101958
hdfs://spark-nn.eemcs.utwente.nl/user/s1934538/clickstream/clickstream-enwiki-2020-06.tsv.gz,Gaza_Strip,19629,42747,708,63084,24811
hdfs://spark-nn.eemcs.utwente.nl/user/s1934538/clickstream/clickstream-enwiki-2020-06.tsv.gz,Asia_Cup,976,15273,114,16363,9954
hdfs://spark-nn.eemcs.utwente.nl/user/s1934538/clickstream/clickstream-enwiki-2020-06.tsv.gz,Game_of_Thrones_(season_8),17738,69167,946,87851,31701
hdfs://spark-nn.eemcs.utwente.nl/user/s1934538/clickstream/clickstream-enwiki-2020-06.tsv.gz,Kylian_Mbappé,26033,110751,1424,138208,29854
hdfs://spark-nn.eemcs.utwente.nl/user/s1934538/clickstream/clickstream-enwiki-2020-06.tsv.gz,Saaho,30772,74813,203,105788,33982
hdfs://spark-nn.eemcs.utwente.nl/user/s1934538/clickstream/clickstream-enwiki-2020-06.tsv.gz,Greta_Thunberg,10849,169229,1371,181449,42539
hdfs://spark-nn.eemcs.utwente.nl/user/s1934538/clickstream/clickstream-enwiki-2020-06.tsv.gz,Kamala_Harris,53365,610034,7930,671329,231767
hdfs://spark-nn.eemcs.utwente.nl/user/s1934538/clickstream/clickstream-enwiki-2020-06.tsv.gz,Sushma_Swaraj,5816,20051,22,25889,6500
hdfs://spark-nn.eemcs.utwente.nl/user/s1934538/clickstream/clickstream-enwiki-2020-06.tsv.gz,Chernobyl_disaster,62585,449631,3472,515688,198492
hdfs://spark-nn.eemcs.utwente.nl/user/s1934538/clickstream/clickstream-enwiki-2020-06.tsv.gz,No_Time_to_Die,148698,139073,3023,290794,198226
hdfs://spark-nn.eemcs.utwente.nl/user/s1934538/clickstream/clickstream-enwiki-2020-06.tsv.gz,Nipsey_Hussle,35849,165783,1037,202669,61719
hdfs://spark-nn.eemcs.utwente.nl/user/s1934538/clickstream/clickstream-enwiki-2020-06.tsv.gz,Johnny_Depp,140114,460694,2942,603750,439545
hdfs://spark-nn.eemcs.utwente.nl/user/s1934538/clickstream/clickstream-enwiki-2020-06.tsv.gz,Central_Park_jogger_case,135772,678402,1818,815992,97962
hdfs://spark-nn.eemcs.utwente.nl/user/s1934538/clickstream/clickstream-enwiki-2021-03.tsv.gz,R._Kelly,39857,188165,2202,230224,103987
hdfs://spark-nn.eemcs.utwente.nl/user/s1934538/clickstream/clickstream-enwiki-2021-03.tsv.gz,Doctor_Strange_in_the_Multiverse_of_Madness,293530,313815,2075,609420,389371
hdfs://spark-nn.eemcs.utwente.nl/user/s1934538/clickstream/clickstream-enwiki-2021-03.tsv.gz,Dune_(2021_film),89076,157151,2479,248706,161445
hdfs://spark-nn.eemcs.utwente.nl/user/s1934538/clickstream/clickstream-enwiki-2021-03.tsv.gz,Mulan_(2020_film),35310,148381,3175,186866,115063
hdfs://spark-nn.eemcs.utwente.nl/user/s1934538/clickstream/clickstream-enwiki-2021-03.tsv.gz,Killing_of_George_Floyd,85886,230244,541,316671,102924
hdfs://spark-nn.eemcs.utwente.nl/user/s1934538/clickstream/clickstream-enwiki-2021-03.tsv.gz,Jenna_Ortega,81734,191347,2299,275380,66133
hdfs://spark-nn.eemcs.utwente.nl/user/s1934538/clickstream/clickstream-enwiki-2021-03.tsv.gz,Zack_Snyder's_Justice_League,941292,5235473,75344,6252109,3468814
hdfs://spark-nn.eemcs.utwente.nl/user/s1934538/clickstream/clickstream-enwiki-2021-03.tsv.gz,1234,118,1670,18,1806,300
hdfs://spark-nn.eemcs.utwente.nl/user/s1934538/clickstream/clickstream-enwiki-2021-03.tsv.gz,Fantastic_Beasts:_The_Crimes_of_Grindelwald,57967,85294,1261,144522,84438
hdfs://spark-nn.eemcs.utwente.nl/user/s1934538/clickstream/clickstream-enwiki-2021-03.tsv.gz,UEFA_Euro_2020,85717,313470,5035,404222,158410
hdfs://spark-nn.eemcs.utwente.nl/user/s1934538/clickstream/clickstream-enwiki-2021-03.tsv.gz,Saaho,16975,48151,123,65249,23461
hdfs://spark-nn.eemcs.utwente.nl/user/s1934538/clickstream/clickstream-enwiki-2021-03.tsv.gz,21_Savage,16369,58656,893,75918,28288
hdfs://spark-nn.eemcs.utwente.nl/user/s1934538/clickstream/clickstream-enwiki-2021-03.tsv.gz,Area_51,16434,156640,1290,174364,40728
hdfs://spark-nn.eemcs.utwente.nl/user/s1934538/clickstream/clickstream-enwiki-2021-03.tsv.gz,Wonder_Woman_1984,137961,383152,8637,529750,265282
hdfs://spark-nn.eemcs.utwente.nl/user/s1934538/clickstream/clickstream-enwiki-2021-03.tsv.gz,Crazy_Rich_Asians_(film),44943,149225,2057,196225,177107
hdfs://spark-nn.eemcs.utwente.nl/user/s1934538/clickstream/clickstream-enwiki-2021-03.tsv.gz,Bob_Saget,27658,74843,354,102855,17471
hdfs://spark-nn.eemcs.utwente.nl/user/s1934538/clickstream/clickstream-enwiki-2021-03.tsv.gz,Burt_Reynolds,59990,155683,1501,217174,100180
hdfs://spark-nn.eemcs.utwente.nl/user/s1934538/clickstream/clickstream-enwiki-2021-03.tsv.gz,Royal_Rumble_(2018),10196,6476,142,16814,11987
hdfs://spark-nn.eemcs.utwente.nl/user/s1934538/clickstream/clickstream-enwiki-2021-03.tsv.gz,Central_Park_jogger_case,17753,60291,202,78246,11467
hdfs://spark-nn.eemcs.utwente.nl/user/s1934538/clickstream/clickstream-enwiki-2021-03.tsv.gz,Cameron_Boyce,39176,230936,1178,271290,71403
hdfs://spark-nn.eemcs.utwente.nl/user/s1934538/clickstream/clickstream-enwiki-2021-03.tsv.gz,Aquaman_(film),107190,270640,4671,382501,233117
hdfs://spark-nn.eemcs.utwente.nl/user/s1934538/clickstream/clickstream-enwiki-2021-03.tsv.gz,Laal_Singh_Chaddha,56168,44723,58,100949,44882
hdfs://spark-nn.eemcs.utwente.nl/user/s1934538/clickstream/clickstream-enwiki-2021-03.tsv.gz,Charles_Sobhraj,46747,197714,946,245407,62444
hdfs://spark-nn.eemcs.utwente.nl/user/s1934538/clickstream/clickstream-enwiki-2021-03.tsv.gz,Glass_(2019_film),56767,60505,471,117743,41705
hdfs://spark-nn.eemcs.utwente.nl/user/s1934538/clickstream/clickstream-enwiki-2021-03.tsv.gz,"Meghan,_Duchess_of_Sussex",641245,3719908,34511,4395664,2782351
hdfs://spark-nn.eemcs.utwente.nl/user/s1934538/clickstream/clickstream-enwiki-2021-03.tsv.gz,Queen_(band),81915,268578,3880,354373,332900
hdfs://spark-nn.eemcs.utwente.nl/user/s1934538/clickstream/clickstream-enwiki-2021-03.tsv.gz,Game_of_Thrones_(season_8),21085,47247,841,69173,27434
hdfs://spark-nn.eemcs.utwente.nl/user/s1934538/clickstream/clickstream-enwiki-2021-03.tsv.gz,Chernobyl_(miniseries),30755,140598,3102,174455,163833
hdfs://spark-nn.eemcs.utwente.nl/user/s1934538/clickstream/clickstream-enwiki-2021-03.tsv.gz,Lance_Reddick,34559,41844,224,76627,16813
hdfs://spark-nn.eemcs.utwente.nl/user/s1934538/clickstream/clickstream-enwiki-2021-03.tsv.gz,Main_Page,78300,183641188,5296227,189015715,41780808
hdfs://spark-nn.eemcs.utwente.nl/user/s1934538/clickstream/clickstream-enwiki-2021-03.tsv.gz,Bird_Box_(film),19006,76748,837,96591,31511
hdfs://spark-nn.eemcs.utwente.nl/user/s1934538/clickstream/clickstream-enwiki-2021-03.tsv.gz,Afghanistan,69743,152322,3306,225371,130140
hdfs://spark-nn.eemcs.utwente.nl/user/s1934538/clickstream/clickstream-enwiki-2021-03.tsv.gz,Aaron_Hernandez,10491,181656,1654,193801,66437
hdfs://spark-nn.eemcs.utwente.nl/user/s1934538/clickstream/clickstream-enwiki-2021-03.tsv.gz,Elon_Musk,170516,1630676,14558,1815750,967499
hdfs://spark-nn.eemcs.utwente.nl/user/s1934538/clickstream/clickstream-enwiki-2021-03.tsv.gz,David_Beckham,44553,221759,1694,268006,99233
hdfs://spark-nn.eemcs.utwente.nl/user/s1934538/clickstream/clickstream-enwiki-2021-03.tsv.gz,J._Robert_Oppenheimer,23862,100617,438,124917,41911
hdfs://spark-nn.eemcs.utwente.nl/user/s1934538/clickstream/clickstream-enwiki-2021-03.tsv.gz,William_Murdoch,691,1668,18,2377,320
hdfs://spark-nn.eemcs.utwente.nl/user/s1934538/clickstream/clickstream-enwiki-2021-03.tsv.gz,Avengers:_Infinity_War,120645,173721,3058,297424,179081
hdfs://spark-nn.eemcs.utwente.nl/user/s1934538/clickstream/clickstream-enwiki-2021-03.tsv.gz,Croatia,49747,130365,1961,182073,68333
hdfs://spark-nn.eemcs.utwente.nl/user/s1934538/clickstream/clickstream-enwiki-2021-03.tsv.gz,Kobe_Bryant,71949,429819,5756,507524,138670
hdfs://spark-nn.eemcs.utwente.nl/user/s1934538/clickstream/clickstream-enwiki-2021-03.tsv.gz,Johnny_Depp,186072,438314,3920,628306,458767
hdfs://spark-nn.eemcs.utwente.nl/user/s1934538/clickstream/clickstream-enwiki-2021-03.tsv.gz,Parasite_(2019_film),48778,244468,3167,296413,122824
hdfs://spark-nn.eemcs.utwente.nl/user/s1934538/clickstream/clickstream-enwiki-2021-03.tsv.gz,Pornhub,41128,380294,15331,436753,94242
hdfs://spark-nn.eemcs.utwente.nl/user/s1934538/clickstream/clickstream-enwiki-2021-03.tsv.gz,Sridevi,41792,113346,312,155450,67808
hdfs://spark-nn.eemcs.utwente.nl/user/s1934538/clickstream/clickstream-enwiki-2021-03.tsv.gz,Tom_Brady,76999,378719,4052,459770,165376
hdfs://spark-nn.eemcs.utwente.nl/user/s1934538/clickstream/clickstream-enwiki-2021-03.tsv.gz,Article_370_of_the_Constitution_of_India,2867,38917,24,41808,2582
hdfs://spark-nn.eemcs.utwente.nl/user/s1934538/clickstream/clickstream-enwiki-2021-03.tsv.gz,Chadwick_Boseman,137947,581829,5906,725682,209674
hdfs://spark-nn.eemcs.utwente.nl/user/s1934538/clickstream/clickstream-enwiki-2021-03.tsv.gz,Indian_Premier_League,28460,123367,337,152164,106055
hdfs://spark-nn.eemcs.utwente.nl/user/s1934538/clickstream/clickstream-enwiki-2021-03.tsv.gz,Sushma_Swaraj,6568,21140,61,27769,6897
hdfs://spark-nn.eemcs.utwente.nl/user/s1934538/clickstream/clickstream-enwiki-2021-03.tsv.gz,Gaza_Strip,23257,37368,285,60910,25600
hdfs://spark-nn.eemcs.utwente.nl/user/s1934538/clickstream/clickstream-enwiki-2021-03.tsv.gz,XHamster,6985,178084,4441,189510,23330
hdfs://spark-nn.eemcs.utwente.nl/user/s1934538/clickstream/clickstream-enwiki-2021-03.tsv.gz,Tasuku_Honjo,1811,1564224,309,1566344,47321
hdfs://spark-nn.eemcs.utwente.nl/user/s1934538/clickstream/clickstream-enwiki-2021-03.tsv.gz,The_Shape_of_Water,33379,117219,1538,152136,76156
hdfs://spark-nn.eemcs.utwente.nl/user/s1934538/clickstream/clickstream-enwiki-2021-03.tsv.gz,Israel,115056,267919,7508,390483,204977
hdfs://spark-nn.eemcs.utwente.nl/user/s1934538/clickstream/clickstream-enwiki-2021-03.tsv.gz,Cleopatra,58245,3008672,2832,3069749,266022
hdfs://spark-nn.eemcs.utwente.nl/user/s1934538/clickstream/clickstream-enwiki-2021-03.tsv.gz,Bridgerton,54923,664214,9571,728708,495241
hdfs://spark-nn.eemcs.utwente.nl/user/s1934538/clickstream/clickstream-enwiki-2021-03.tsv.gz,Dennis_Nilsen,19565,90702,532,110799,28441
hdfs://spark-nn.eemcs.utwente.nl/user/s1934538/clickstream/clickstream-enwiki-2021-03.tsv.gz,Murder_of_Dee_Dee_Blanchard,19458,146102,600,166160,31880
hdfs://spark-nn.eemcs.utwente.nl/user/s1934538/clickstream/clickstream-enwiki-2021-03.tsv.gz,Deadpool_2,73236,107447,2783,183466,146842
hdfs://spark-nn.eemcs.utwente.nl/user/s1934538/clickstream/clickstream-enwiki-2021-03.tsv.gz,Jeffrey_Dahmer,37751,436643,5003,479397,213860
hdfs://spark-nn.eemcs.utwente.nl/user/s1934538/clickstream/clickstream-enwiki-2021-03.tsv.gz,Cook's_Country,524,2300,13,2837,840
hdfs://spark-nn.eemcs.utwente.nl/user/s1934538/clickstream/clickstream-enwiki-2021-03.tsv.gz,List_of_highest-grossing_films,182012,488810,2783,673605,302696
hdfs://spark-nn.eemcs.utwente.nl/user/s1934538/clickstream/clickstream-enwiki-2021-03.tsv.gz,Spider-Man:_Far_From_Home,100580,145348,2509,248437,143730
hdfs://spark-nn.eemcs.utwente.nl/user/s1934538/clickstream/clickstream-enwiki-2021-03.tsv.gz,Cardi_B,69549,489168,8777,567494,196425
hdfs://spark-nn.eemcs.utwente.nl/user/s1934538/clickstream/clickstream-enwiki-2021-03.tsv.gz,The_Nun_(2018_film),29800,100777,667,131244,83410
hdfs://spark-nn.eemcs.utwente.nl/user/s1934538/clickstream/clickstream-enwiki-2021-03.tsv.gz,Khabib_Nurmagomedov,96191,321103,12650,429944,223860
hdfs://spark-nn.eemcs.utwente.nl/user/s1934538/clickstream/clickstream-enwiki-2021-03.tsv.gz,Meat_Loaf,30423,110082,1217,141722,52625
hdfs://spark-nn.eemcs.utwente.nl/user/s1934538/clickstream/clickstream-enwiki-2021-03.tsv.gz,XXX:_Return_of_Xander_Cage,51611,605844,1015,658470,96421
hdfs://spark-nn.eemcs.utwente.nl/user/s1934538/clickstream/clickstream-enwiki-2021-03.tsv.gz,Critical_race_theory,10505,451966,2792,465263,75162
hdfs://spark-nn.eemcs.utwente.nl/user/s1934538/clickstream/clickstream-enwiki-2021-03.tsv.gz,Amber_Heard,220648,426567,2749,649964,274813
hdfs://spark-nn.eemcs.utwente.nl/user/s1934538/clickstream/clickstream-enwiki-2021-03.tsv.gz,Cricket_World_Cup,13161,92810,447,106418,55295
hdfs://spark-nn.eemcs.utwente.nl/user/s1934538/clickstream/clickstream-enwiki-2021-03.tsv.gz,2.0_(film),16737,28197,80,45014,15033
hdfs://spark-nn.eemcs.utwente.nl/user/s1934538/clickstream/clickstream-enwiki-2021-03.tsv.gz,2020_Summer_Olympics,87900,196246,8308,292454,300090
hdfs://spark-nn.eemcs.utwente.nl/user/s1934538/clickstream/clickstream-enwiki-2021-03.tsv.gz,Joe_Exotic,25966,138444,789,165199,44073
hdfs://spark-nn.eemcs.utwente.nl/user/s1934538/clickstream/clickstream-enwiki-2021-03.tsv.gz,COVID-19_pandemic_by_country_and_territory,231522,454117,10463,696102,458859
hdfs://spark-nn.eemcs.utwente.nl/user/s1934538/clickstream/clickstream-enwiki-2021-03.tsv.gz,ICC_Men's_T20_World_Cup,14984,175609,452,191045,92786
hdfs://spark-nn.eemcs.utwente.nl/user/s1934538/clickstream/clickstream-enwiki-2021-03.tsv.gz,Lisa_Marie_Presley,182436,91047,547,274030,143184
hdfs://spark-nn.eemcs.utwente.nl/user/s1934538/clickstream/clickstream-enwiki-2021-03.tsv.gz,Amy_Coney_Barrett,35493,52185,441,88119,29467
hdfs://spark-nn.eemcs.utwente.nl/user/s1934538/clickstream/clickstream-enwiki-2021-03.tsv.gz,Lionel_Messi,111280,577643,6976,695899,171298
hdfs://spark-nn.eemcs.utwente.nl/user/s1934538/clickstream/clickstream-enwiki-2021-03.tsv.gz,September_11_attacks,103398,298384,3526,405308,205983
hdfs://spark-nn.eemcs.utwente.nl/user/s1934538/clickstream/clickstream-enwiki-2021-03.tsv.gz,Tonya_Harding,32621,120267,609,153497,42482
hdfs://spark-nn.eemcs.utwente.nl/user/s1934538/clickstream/clickstream-enwiki-2021-03.tsv.gz,Ukraine,61401,148325,4402,214128,110546
hdfs://spark-nn.eemcs.utwente.nl/user/s1934538/clickstream/clickstream-enwiki-2021-03.tsv.gz,Media,72,4062,554,4688,2017
hdfs://spark-nn.eemcs.utwente.nl/user/s1934538/clickstream/clickstream-enwiki-2021-03.tsv.gz,John_McCain,45669,81826,1145,128640,62943
hdfs://spark-nn.eemcs.utwente.nl/user/s1934538/clickstream/clickstream-enwiki-2021-03.tsv.gz,Simone_Biles,14723,82097,708,97528,27509
hdfs://spark-nn.eemcs.utwente.nl/user/s1934538/clickstream/clickstream-enwiki-2021-03.tsv.gz,Cecil_Hotel_(Los_Angeles),35108,395881,1499,432488,121277
hdfs://spark-nn.eemcs.utwente.nl/user/s1934538/clickstream/clickstream-enwiki-2021-03.tsv.gz,The_Lion_King_(2019_film),51175,64158,745,116078,56213
hdfs://spark-nn.eemcs.utwente.nl/user/s1934538/clickstream/clickstream-enwiki-2021-03.tsv.gz,Kylian_Mbappé,33054,219654,2202,254910,52309
hdfs://spark-nn.eemcs.utwente.nl/user/s1934538/clickstream/clickstream-enwiki-2021-03.tsv.gz,Deion_Sanders,22076,129594,858,152528,49077
hdfs://spark-nn.eemcs.utwente.nl/user/s1934538/clickstream/clickstream-enwiki-2021-03.tsv.gz,Dark_Phoenix_(film),66118,84718,1049,151885,91929
hdfs://spark-nn.eemcs.utwente.nl/user/s1934538/clickstream/clickstream-enwiki-2021-03.tsv.gz,Stephen_Hawking,39453,482751,3415,525619,205374
hdfs://spark-nn.eemcs.utwente.nl/user/s1934538/clickstream/clickstream-enwiki-2021-03.tsv.gz,The_Weeknd,79167,348959,4792,432918,188786
hdfs://spark-nn.eemcs.utwente.nl/user/s1934538/clickstream/clickstream-enwiki-2021-03.tsv.gz,Olivia_Newton-John,29413,93229,1387,124029,55763
hdfs://spark-nn.eemcs.utwente.nl/user/s1934538/clickstream/clickstream-enwiki-2021-03.tsv.gz,Watts_family_murders,21964,202374,819,225157,52304
hdfs://spark-nn.eemcs.utwente.nl/user/s1934538/clickstream/clickstream-enwiki-2021-03.tsv.gz,Don't_Look_Up_(2021_film),99905,32945,228,133078,59952
hdfs://spark-nn.eemcs.utwente.nl/user/s1934538/clickstream/clickstream-enwiki-2021-03.tsv.gz,Venom_(2018_film),31552,114766,1695,148013,82670
hdfs://spark-nn.eemcs.utwente.nl/user/s1934538/clickstream/clickstream-enwiki-2021-03.tsv.gz,Anna_Sorokin,11272,61818,271,73361,18927
hdfs://spark-nn.eemcs.utwente.nl/user/s1934538/clickstream/clickstream-enwiki-2021-03.tsv.gz,"Diana,_Princess_of_Wales",863304,2148996,15263,3027563,2093790
hdfs://spark-nn.eemcs.utwente.nl/user/s1934538/clickstream/clickstream-enwiki-2021-03.tsv.gz,Jimmy_Hoffa,33860,138513,1158,173531,65899
hdfs://spark-nn.eemcs.utwente.nl/user/s1934538/clickstream/clickstream-enwiki-2021-03.tsv.gz,Hyphen-minus,4792,6605722,8298260,14908774,899
hdfs://spark-nn.eemcs.utwente.nl/user/s1934538/clickstream/clickstream-enwiki-2021-03.tsv.gz,George_VI,1183785,498210,5115,1687110,1286675
hdfs://spark-nn.eemcs.utwente.nl/user/s1934538/clickstream/clickstream-enwiki-2021-03.tsv.gz,HTTP_cookie,3915,428119,190,432224,30657
hdfs://spark-nn.eemcs.utwente.nl/user/s1934538/clickstream/clickstream-enwiki-2021-03.tsv.gz,2018_Winter_Olympics,31103,22385,376,53864,43732
hdfs://spark-nn.eemcs.utwente.nl/user/s1934538/clickstream/clickstream-enwiki-2021-03.tsv.gz,List_of_Marvel_Cinematic_Universe_films,216857,1059775,3297,1279929,683360
hdfs://spark-nn.eemcs.utwente.nl/user/s1934538/clickstream/clickstream-enwiki-2021-03.tsv.gz,List_of_awards_and_nominations_received_by_Meryl_Streep,20499,12292,250,33041,13653
hdfs://spark-nn.eemcs.utwente.nl/user/s1934538/clickstream/clickstream-enwiki-2021-03.tsv.gz,Donald_Trump,311622,930733,13021,1255376,533502
hdfs://spark-nn.eemcs.utwente.nl/user/s1934538/clickstream/clickstream-enwiki-2021-03.tsv.gz,Hamilton_(musical),51037,253568,2291,306896,195978
hdfs://spark-nn.eemcs.utwente.nl/user/s1934538/clickstream/clickstream-enwiki-2021-03.tsv.gz,WandaVision,345222,3004272,79281,3428775,1847097
hdfs://spark-nn.eemcs.utwente.nl/user/s1934538/clickstream/clickstream-enwiki-2021-03.tsv.gz,United_States_Senate,86482,96316,2254,185052,92583
hdfs://spark-nn.eemcs.utwente.nl/user/s1934538/clickstream/clickstream-enwiki-2021-03.tsv.gz,RRR_(film),51536,105277,242,157055,98442
hdfs://spark-nn.eemcs.utwente.nl/user/s1934538/clickstream/clickstream-enwiki-2021-03.tsv.gz,XXXTentacion,71389,501298,6797,579484,102785
hdfs://spark-nn.eemcs.utwente.nl/user/s1934538/clickstream/clickstream-enwiki-2021-03.tsv.gz,Alexander_Hamilton,89773,305570,2779,398122,202780
hdfs://spark-nn.eemcs.utwente.nl/user/s1934538/clickstream/clickstream-enwiki-2021-03.tsv.gz,Joe_Biden,348500,822081,18184,1188765,585313
hdfs://spark-nn.eemcs.utwente.nl/user/s1934538/clickstream/clickstream-enwiki-2021-03.tsv.gz,Spanish_flu,50006,338505,16406,404917,98414
hdfs://spark-nn.eemcs.utwente.nl/user/s1934538/clickstream/clickstream-enwiki-2021-03.tsv.gz,Godzilla_vs._Kong,254883,2827819,53780,3136482,1071723
hdfs://spark-nn.eemcs.utwente.nl/user/s1934538/clickstream/clickstream-enwiki-2021-03.tsv.gz,Kamala_Harris,175500,517941,5551,698992,303026
hdfs://spark-nn.eemcs.utwente.nl/user/s1934538/clickstream/clickstream-enwiki-2021-03.tsv.gz,Charles_III,133,393,120,646,497
hdfs://spark-nn.eemcs.utwente.nl/user/s1934538/clickstream/clickstream-enwiki-2021-03.tsv.gz,Stranger_Things_(season_3),18513,39986,457,58956,32082
hdfs://spark-nn.eemcs.utwente.nl/user/s1934538/clickstream/clickstream-enwiki-2021-03.tsv.gz,Roe_v._Wade,14820,78678,744,94242,28206
hdfs://spark-nn.eemcs.utwente.nl/user/s1934538/clickstream/clickstream-enwiki-2021-03.tsv.gz,NATO,58714,136430,2307,197451,76355
hdfs://spark-nn.eemcs.utwente.nl/user/s1934538/clickstream/clickstream-enwiki-2021-03.tsv.gz,Richard_Ramirez,42110,646308,3402,691820,198022
hdfs://spark-nn.eemcs.utwente.nl/user/s1934538/clickstream/clickstream-enwiki-2021-03.tsv.gz,Atal_Bihari_Vajpayee,32216,52421,205,84842,29517
hdfs://spark-nn.eemcs.utwente.nl/user/s1934538/clickstream/clickstream-enwiki-2021-03.tsv.gz,Taliban,37981,89384,1611,128976,90081
hdfs://spark-nn.eemcs.utwente.nl/user/s1934538/clickstream/clickstream-enwiki-2021-03.tsv.gz,Pelé,37736,256962,2683,297381,101393
hdfs://spark-nn.eemcs.utwente.nl/user/s1934538/clickstream/clickstream-enwiki-2021-03.tsv.gz,Hamas,28876,29269,1525,59670,25004
hdfs://spark-nn.eemcs.utwente.nl/user/s1934538/clickstream/clickstream-enwiki-2021-03.tsv.gz,Jeffrey_Epstein,60166,315516,2728,378410,170286
hdfs://spark-nn.eemcs.utwente.nl/user/s1934538/clickstream/clickstream-enwiki-2021-03.tsv.gz,The_Suicide_Squad_(film),410722,717853,14761,1143336,1318090
hdfs://spark-nn.eemcs.utwente.nl/user/s1934538/clickstream/clickstream-enwiki-2021-03.tsv.gz,Freddie_Mercury,117194,730697,5625,853516,312285
hdfs://spark-nn.eemcs.utwente.nl/user/s1934538/clickstream/clickstream-enwiki-2021-03.tsv.gz,Louis_Tomlinson,44578,74615,1429,120622,26312
hdfs://spark-nn.eemcs.utwente.nl/user/s1934538/clickstream/clickstream-enwiki-2021-03.tsv.gz,2018_Asian_Games,7692,9565,93,17350,14812
hdfs://spark-nn.eemcs.utwente.nl/user/s1934538/clickstream/clickstream-enwiki-2021-03.tsv.gz,JSON_Web_Token,1017,30163,49,31229,2217
hdfs://spark-nn.eemcs.utwente.nl/user/s1934538/clickstream/clickstream-enwiki-2021-03.tsv.gz,No_Time_to_Die,162291,156027,2792,321110,176737
hdfs://spark-nn.eemcs.utwente.nl/user/s1934538/clickstream/clickstream-enwiki-2021-03.tsv.gz,Keanu_Reeves,111206,597858,4180,713244,416353
hdfs://spark-nn.eemcs.utwente.nl/user/s1934538/clickstream/clickstream-enwiki-2021-03.tsv.gz,Stan_Lee,79899,186161,1728,267788,96759
hdfs://spark-nn.eemcs.utwente.nl/user/s1934538/clickstream/clickstream-enwiki-2021-03.tsv.gz,Shang-Chi_and_the_Legend_of_the_Ten_Rings,247475,111833,756,360064,245761
hdfs://spark-nn.eemcs.utwente.nl/user/s1934538/clickstream/clickstream-enwiki-2021-03.tsv.gz,A_Star_Is_Born_(2018_film),35762,138208,1053,175023,84489
hdfs://spark-nn.eemcs.utwente.nl/user/s1934538/clickstream/clickstream-enwiki-2021-03.tsv.gz,Ted_Bundy,43416,438579,5612,487607,110285
hdfs://spark-nn.eemcs.utwente.nl/user/s1934538/clickstream/clickstream-enwiki-2021-03.tsv.gz,Key_frame,793,7921,14,8728,573
hdfs://spark-nn.eemcs.utwente.nl/user/s1934538/clickstream/clickstream-enwiki-2021-03.tsv.gz,Shakira,26249,193585,2235,222069,99917
hdfs://spark-nn.eemcs.utwente.nl/user/s1934538/clickstream/clickstream-enwiki-2021-03.tsv.gz,Qasem_Soleimani,16225,30397,194,46816,24493
hdfs://spark-nn.eemcs.utwente.nl/user/s1934538/clickstream/clickstream-enwiki-2021-03.tsv.gz,The_Sandman_(TV_series),17167,15929,149,33245,22929
hdfs://spark-nn.eemcs.utwente.nl/user/s1934538/clickstream/clickstream-enwiki-2021-03.tsv.gz,Grimes_(musician),177754,227725,922,406401,134230
hdfs://spark-nn.eemcs.utwente.nl/user/s1934538/clickstream/clickstream-enwiki-2021-03.tsv.gz,The_Falcon_and_the_Winter_Soldier,320662,1976412,56335,2353409,1639743
hdfs://spark-nn.eemcs.utwente.nl/user/s1934538/clickstream/clickstream-enwiki-2021-03.tsv.gz,When_They_See_Us,17856,44616,437,62909,28917
hdfs://spark-nn.eemcs.utwente.nl/user/s1934538/clickstream/clickstream-enwiki-2021-03.tsv.gz,Tina_Turner,66427,1003717,10003,1080147,395068
hdfs://spark-nn.eemcs.utwente.nl/user/s1934538/clickstream/clickstream-enwiki-2021-03.tsv.gz,2023_Cricket_World_Cup,21723,40073,124,61920,22182
hdfs://spark-nn.eemcs.utwente.nl/user/s1934538/clickstream/clickstream-enwiki-2021-03.tsv.gz,FIFA_World_Cup,61304,259451,5101,325856,218898
hdfs://spark-nn.eemcs.utwente.nl/user/s1934538/clickstream/clickstream-enwiki-2021-03.tsv.gz,Elizabeth_II,1735894,2625949,9164,4371007,3755797
hdfs://spark-nn.eemcs.utwente.nl/user/s1934538/clickstream/clickstream-enwiki-2021-03.tsv.gz,"Princess_Margaret,_Countess_of_Snowdon",453761,1231564,7527,1692852,940649
hdfs://spark-nn.eemcs.utwente.nl/user/s1934538/clickstream/clickstream-enwiki-2021-03.tsv.gz,Manti_Te'o,3279,16951,61,20291,2387
hdfs://spark-nn.eemcs.utwente.nl/user/s1934538/clickstream/clickstream-enwiki-2021-03.tsv.gz,Adipurush,40243,31937,143,72323,47402
hdfs://spark-nn.eemcs.utwente.nl/user/s1934538/clickstream/clickstream-enwiki-2021-03.tsv.gz,Bonnie_and_Clyde,30926,297971,1960,330857,83330
hdfs://spark-nn.eemcs.utwente.nl/user/s1934538/clickstream/clickstream-enwiki-2021-03.tsv.gz,Star_Wars:_The_Rise_of_Skywalker,91154,87074,2444,180672,95844
hdfs://spark-nn.eemcs.utwente.nl/user/s1934538/clickstream/clickstream-enwiki-2021-03.tsv.gz,State_of_Palestine,55614,113373,149,169136,76681
hdfs://spark-nn.eemcs.utwente.nl/user/s1934538/clickstream/clickstream-enwiki-2021-03.tsv.gz,Nipsey_Hussle,30375,186355,1628,218358,66448
hdfs://spark-nn.eemcs.utwente.nl/user/s1934538/clickstream/clickstream-enwiki-2021-03.tsv.gz,The_Witcher_(TV_series),54470,182890,4255,241615,129904
hdfs://spark-nn.eemcs.utwente.nl/user/s1934538/clickstream/clickstream-enwiki-2021-03.tsv.gz,Priyanka_Chopra,204788,477790,1926,684504,224822
hdfs://spark-nn.eemcs.utwente.nl/user/s1934538/clickstream/clickstream-enwiki-2021-03.tsv.gz,Aaron_Carter,21539,61876,422,83837,35630
hdfs://spark-nn.eemcs.utwente.nl/user/s1934538/clickstream/clickstream-enwiki-2023-03.tsv.gz,Vikram_(2022_film),53051,155995,348,209394,89498
hdfs://spark-nn.eemcs.utwente.nl/user/s1934538/clickstream/clickstream-enwiki-2023-03.tsv.gz,List_of_awards_and_nominations_received_by_Meryl_Streep,14226,18588,43,32857,14578
hdfs://spark-nn.eemcs.utwente.nl/user/s1934538/clickstream/clickstream-enwiki-2023-03.tsv.gz,Russo-Ukrainian_War,113131,414197,3654,530982,376371
hdfs://spark-nn.eemcs.utwente.nl/user/s1934538/clickstream/clickstream-enwiki-2023-03.tsv.gz,XNXX,16657,588263,7567,612487,40410
hdfs://spark-nn.eemcs.utwente.nl/user/s1934538/clickstream/clickstream-enwiki-2023-03.tsv.gz,Kelly_Preston,134595,142984,722,278301,77345
hdfs://spark-nn.eemcs.utwente.nl/user/s1934538/clickstream/clickstream-enwiki-2023-03.tsv.gz,21_Savage,15904,77424,808,94136,30647
hdfs://spark-nn.eemcs.utwente.nl/user/s1934538/clickstream/clickstream-enwiki-2023-03.tsv.gz,Cameron_Boyce,25537,154024,451,180012,46138
hdfs://spark-nn.eemcs.utwente.nl/user/s1934538/clickstream/clickstream-enwiki-2023-03.tsv.gz,COVID-19_pandemic_by_country_and_territory,9190,30542,871,40603,15093
hdfs://spark-nn.eemcs.utwente.nl/user/s1934538/clickstream/clickstream-enwiki-2023-03.tsv.gz,Godzilla_vs._Kong,46291,85994,1347,133632,79888
hdfs://spark-nn.eemcs.utwente.nl/user/s1934538/clickstream/clickstream-enwiki-2023-03.tsv.gz,Kobe_Bryant,74683,432595,3181,510459,144437
hdfs://spark-nn.eemcs.utwente.nl/user/s1934538/clickstream/clickstream-enwiki-2023-03.tsv.gz,Irrfan_Khan,30773,73249,508,104530,36879
hdfs://spark-nn.eemcs.utwente.nl/user/s1934538/clickstream/clickstream-enwiki-2023-03.tsv.gz,Bible,23607,105721,1676,131004,39233
hdfs://spark-nn.eemcs.utwente.nl/user/s1934538/clickstream/clickstream-enwiki-2023-03.tsv.gz,Jenna_Ortega,233827,1527304,15807,1776938,534510
hdfs://spark-nn.eemcs.utwente.nl/user/s1934538/clickstream/clickstream-enwiki-2023-03.tsv.gz,Rishi_Sunak,135213,380401,3051,518665,254660
hdfs://spark-nn.eemcs.utwente.nl/user/s1934538/clickstream/clickstream-enwiki-2023-03.tsv.gz,Kate_Spade,32664,73317,381,106362,38505
hdfs://spark-nn.eemcs.utwente.nl/user/s1934538/clickstream/clickstream-enwiki-2023-03.tsv.gz,Star_Wars:_The_Rise_of_Skywalker,74227,61215,1146,136588,71231
hdfs://spark-nn.eemcs.utwente.nl/user/s1934538/clickstream/clickstream-enwiki-2023-03.tsv.gz,Spanish_flu,20020,59502,688,80210,21912
hdfs://spark-nn.eemcs.utwente.nl/user/s1934538/clickstream/clickstream-enwiki-2023-03.tsv.gz,R._Kelly,35224,182989,1753,219966,109459
hdfs://spark-nn.eemcs.utwente.nl/user/s1934538/clickstream/clickstream-enwiki-2023-03.tsv.gz,Spider-Man:_No_Way_Home,86584,164682,2223,253489,110157
hdfs://spark-nn.eemcs.utwente.nl/user/s1934538/clickstream/clickstream-enwiki-2023-03.tsv.gz,Donald_Glover,80743,215040,1791,297574,124870
hdfs://spark-nn.eemcs.utwente.nl/user/s1934538/clickstream/clickstream-enwiki-2023-03.tsv.gz,Juice_Wrld,30193,175807,1828,207828,78372
hdfs://spark-nn.eemcs.utwente.nl/user/s1934538/clickstream/clickstream-enwiki-2023-03.tsv.gz,NATO,77534,268640,8085,354259,173307
hdfs://spark-nn.eemcs.utwente.nl/user/s1934538/clickstream/clickstream-enwiki-2023-03.tsv.gz,"Princess_Margaret,_Countess_of_Snowdon",71506,187236,1136,259878,144230
hdfs://spark-nn.eemcs.utwente.nl/user/s1934538/clickstream/clickstream-enwiki-2023-03.tsv.gz,Line_shaft,374,1327,22,1723,137
hdfs://spark-nn.eemcs.utwente.nl/user/s1934538/clickstream/clickstream-enwiki-2023-03.tsv.gz,Jawan_(film),103605,194158,5245,303008,214211
hdfs://spark-nn.eemcs.utwente.nl/user/s1934538/clickstream/clickstream-enwiki-2023-03.tsv.gz,2023_Cricket_World_Cup,66477,571066,519,638062,186804
hdfs://spark-nn.eemcs.utwente.nl/user/s1934538/clickstream/clickstream-enwiki-2023-03.tsv.gz,2022_FIFA_World_Cup,158278,382777,4020,545075,296701
hdfs://spark-nn.eemcs.utwente.nl/user/s1934538/clickstream/clickstream-enwiki-2023-03.tsv.gz,FIFA_World_Cup,67236,247307,3812,318355,212975
hdfs://spark-nn.eemcs.utwente.nl/user/s1934538/clickstream/clickstream-enwiki-2023-03.tsv.gz,WandaVision,22283,58529,1004,81816,32988
hdfs://spark-nn.eemcs.utwente.nl/user/s1934538/clickstream/clickstream-enwiki-2023-03.tsv.gz,Johnny_Depp,108244,325434,2439,436117,273031
hdfs://spark-nn.eemcs.utwente.nl/user/s1934538/clickstream/clickstream-enwiki-2023-03.tsv.gz,The_Matrix_Resurrections,96097,85609,1112,182818,82614
hdfs://spark-nn.eemcs.utwente.nl/user/s1934538/clickstream/clickstream-enwiki-2023-03.tsv.gz,Anna_Sorokin,13885,151293,320,165498,60187
hdfs://spark-nn.eemcs.utwente.nl/user/s1934538/clickstream/clickstream-enwiki-2023-03.tsv.gz,Tina_Turner,30471,324313,2121,356905,96658
hdfs://spark-nn.eemcs.utwente.nl/user/s1934538/clickstream/clickstream-enwiki-2023-03.tsv.gz,Bird_Box_(film),13719,87035,706,101460,36054
hdfs://spark-nn.eemcs.utwente.nl/user/s1934538/clickstream/clickstream-enwiki-2023-03.tsv.gz,Amber_Heard,72584,195751,1029,269364,111344
hdfs://spark-nn.eemcs.utwente.nl/user/s1934538/clickstream/clickstream-enwiki-2023-03.tsv.gz,Shinzo_Abe,51187,93066,1319,145572,104375
hdfs://spark-nn.eemcs.utwente.nl/user/s1934538/clickstream/clickstream-enwiki-2023-03.tsv.gz,Black_Adam_(film),96074,309748,4553,410375,201508
hdfs://spark-nn.eemcs.utwente.nl/user/s1934538/clickstream/clickstream-enwiki-2023-03.tsv.gz,The_Nun_(2018_film),16615,54022,275,70912,37193
hdfs://spark-nn.eemcs.utwente.nl/user/s1934538/clickstream/clickstream-enwiki-2023-03.tsv.gz,Area_51,16360,129816,1081,147257,46694
hdfs://spark-nn.eemcs.utwente.nl/user/s1934538/clickstream/clickstream-enwiki-2023-03.tsv.gz,Anthony_Bourdain,19919,184740,1231,205890,84016
hdfs://spark-nn.eemcs.utwente.nl/user/s1934538/clickstream/clickstream-enwiki-2023-03.tsv.gz,HTTP_cookie,2482,304527,210,307219,15171
hdfs://spark-nn.eemcs.utwente.nl/user/s1934538/clickstream/clickstream-enwiki-2023-03.tsv.gz,Tunnel,4013,8341,100,12454,3452
hdfs://spark-nn.eemcs.utwente.nl/user/s1934538/clickstream/clickstream-enwiki-2023-03.tsv.gz,The_Sandman_(TV_series),37729,92841,1522,132092,85476
hdfs://spark-nn.eemcs.utwente.nl/user/s1934538/clickstream/clickstream-enwiki-2023-03.tsv.gz,Cook's_Country,350,1764,31,2145,443
hdfs://spark-nn.eemcs.utwente.nl/user/s1934538/clickstream/clickstream-enwiki-2023-03.tsv.gz,Stranger_Things_(season_3),11568,21616,322,33506,18231
hdfs://spark-nn.eemcs.utwente.nl/user/s1934538/clickstream/clickstream-enwiki-2023-03.tsv.gz,UEFA_Euro_2020,63699,65298,946,129943,75739
hdfs://spark-nn.eemcs.utwente.nl/user/s1934538/clickstream/clickstream-enwiki-2023-03.tsv.gz,Aaron_Hernandez,7646,119610,715,127971,45437
hdfs://spark-nn.eemcs.utwente.nl/user/s1934538/clickstream/clickstream-enwiki-2023-03.tsv.gz,The_Queen's_Gambit_(miniseries),19137,88920,1112,109169,52822
hdfs://spark-nn.eemcs.utwente.nl/user/s1934538/clickstream/clickstream-enwiki-2023-03.tsv.gz,Greta_Thunberg,15855,251622,1922,269399,64311
hdfs://spark-nn.eemcs.utwente.nl/user/s1934538/clickstream/clickstream-enwiki-2023-03.tsv.gz,Naya_Rivera,49751,77479,184,127414,53032
hdfs://spark-nn.eemcs.utwente.nl/user/s1934538/clickstream/clickstream-enwiki-2023-03.tsv.gz,Jeffrey_Dahmer,34502,597660,5403,637565,246632
hdfs://spark-nn.eemcs.utwente.nl/user/s1934538/clickstream/clickstream-enwiki-2023-03.tsv.gz,Wikipedia,200099,910419,1625,1112143,395386
hdfs://spark-nn.eemcs.utwente.nl/user/s1934538/clickstream/clickstream-enwiki-2023-03.tsv.gz,Afghanistan,117971,210447,4223,332641,229876
hdfs://spark-nn.eemcs.utwente.nl/user/s1934538/clickstream/clickstream-enwiki-2023-03.tsv.gz,Sushma_Swaraj,11631,22255,31,33917,9592
hdfs://spark-nn.eemcs.utwente.nl/user/s1934538/clickstream/clickstream-enwiki-2023-03.tsv.gz,Chadwick_Boseman,57062,306203,1338,364603,81061
hdfs://spark-nn.eemcs.utwente.nl/user/s1934538/clickstream/clickstream-enwiki-2023-03.tsv.gz,Cleopatra,68377,4984741,2354,5055472,386224
hdfs://spark-nn.eemcs.utwente.nl/user/s1934538/clickstream/clickstream-enwiki-2023-03.tsv.gz,Deion_Sanders,19582,119853,605,140040,35204
hdfs://spark-nn.eemcs.utwente.nl/user/s1934538/clickstream/clickstream-enwiki-2023-03.tsv.gz,Roe_v._Wade,15344,102929,833,119106,37316
hdfs://spark-nn.eemcs.utwente.nl/user/s1934538/clickstream/clickstream-enwiki-2023-03.tsv.gz,Bonnie_and_Clyde,23007,206873,1337,231217,59619
hdfs://spark-nn.eemcs.utwente.nl/user/s1934538/clickstream/clickstream-enwiki-2023-03.tsv.gz,Alexander_Hamilton,70832,227012,1572,299416,174914
hdfs://spark-nn.eemcs.utwente.nl/user/s1934538/clickstream/clickstream-enwiki-2023-03.tsv.gz,Game_of_Thrones,82665,284160,6297,373122,205943
hdfs://spark-nn.eemcs.utwente.nl/user/s1934538/clickstream/clickstream-enwiki-2023-03.tsv.gz,"Meghan,_Duchess_of_Sussex",92817,364641,1867,459325,244586
hdfs://spark-nn.eemcs.utwente.nl/user/s1934538/clickstream/clickstream-enwiki-2023-03.tsv.gz,Emma_Raducanu,8543,122026,823,131392,19441
hdfs://spark-nn.eemcs.utwente.nl/user/s1934538/clickstream/clickstream-enwiki-2023-03.tsv.gz,Stephen_Hawking,27788,344590,2353,374731,137516
hdfs://spark-nn.eemcs.utwente.nl/user/s1934538/clickstream/clickstream-enwiki-2023-03.tsv.gz,Jeffrey_Epstein,47101,205049,1509,253659,114163
hdfs://spark-nn.eemcs.utwente.nl/user/s1934538/clickstream/clickstream-enwiki-2023-03.tsv.gz,United_States_Senate,51489,47326,4943,103758,48420
hdfs://spark-nn.eemcs.utwente.nl/user/s1934538/clickstream/clickstream-enwiki-2023-03.tsv.gz,Jimmy_Hoffa,28613,104791,837,134241,54190
hdfs://spark-nn.eemcs.utwente.nl/user/s1934538/clickstream/clickstream-enwiki-2023-03.tsv.gz,Keanu_Reeves,323449,1513159,8917,1845525,1308508
hdfs://spark-nn.eemcs.utwente.nl/user/s1934538/clickstream/clickstream-enwiki-2023-03.tsv.gz,Elon_Musk,109107,1048529,7544,1165180,517753
hdfs://spark-nn.eemcs.utwente.nl/user/s1934538/clickstream/clickstream-enwiki-2023-03.tsv.gz,List_of_Marvel_Cinematic_Universe_films,177943,513783,1868,693594,461427
hdfs://spark-nn.eemcs.utwente.nl/user/s1934538/clickstream/clickstream-enwiki-2023-03.tsv.gz,Leave_the_World_Behind_(film),13404,4188,40,17632,5650
hdfs://spark-nn.eemcs.utwente.nl/user/s1934538/clickstream/clickstream-enwiki-2023-03.tsv.gz,Hamas,29998,32793,255,63046,34532
hdfs://spark-nn.eemcs.utwente.nl/user/s1934538/clickstream/clickstream-enwiki-2023-03.tsv.gz,Joker_(2019_film),55302,161281,2130,218713,105998
hdfs://spark-nn.eemcs.utwente.nl/user/s1934538/clickstream/clickstream-enwiki-2023-03.tsv.gz,Ant-Man_and_the_Wasp:_Quantumania,292398,972574,35703,1300675,571905
hdfs://spark-nn.eemcs.utwente.nl/user/s1934538/clickstream/clickstream-enwiki-2023-03.tsv.gz,Hamilton_(musical),26532,203511,1421,231464,126794
hdfs://spark-nn.eemcs.utwente.nl/user/s1934538/clickstream/clickstream-enwiki-2023-03.tsv.gz,Media,54,2344,289,2687,1204
hdfs://spark-nn.eemcs.utwente.nl/user/s1934538/clickstream/clickstream-enwiki-2023-03.tsv.gz,Coronavirus,6670,31574,636,38880,13541
hdfs://spark-nn.eemcs.utwente.nl/user/s1934538/clickstream/clickstream-enwiki-2023-03.tsv.gz,Doctor_Strange_in_the_Multiverse_of_Madness,62923,125306,2144,190373,98400
hdfs://spark-nn.eemcs.utwente.nl/user/s1934538/clickstream/clickstream-enwiki-2023-03.tsv.gz,Charles_Sobhraj,8185,53518,79,61782,10377
hdfs://spark-nn.eemcs.utwente.nl/user/s1934538/clickstream/clickstream-enwiki-2023-03.tsv.gz,Freddie_Mercury,74196,402165,3031,479392,183500
hdfs://spark-nn.eemcs.utwente.nl/user/s1934538/clickstream/clickstream-enwiki-2023-03.tsv.gz,Priyanka_Chopra,126866,429600,1118,557584,228847
hdfs://spark-nn.eemcs.utwente.nl/user/s1934538/clickstream/clickstream-enwiki-2023-03.tsv.gz,Notre-Dame_de_Paris,14089,99930,1061,115080,26001
hdfs://spark-nn.eemcs.utwente.nl/user/s1934538/clickstream/clickstream-enwiki-2023-03.tsv.gz,September_11_attacks,121584,312098,4822,438504,278740
hdfs://spark-nn.eemcs.utwente.nl/user/s1934538/clickstream/clickstream-enwiki-2023-03.tsv.gz,The_Irishman,51977,85958,1370,139305,114040
hdfs://spark-nn.eemcs.utwente.nl/user/s1934538/clickstream/clickstream-enwiki-2023-03.tsv.gz,Avicii,19308,172017,1298,192623,56094
hdfs://spark-nn.eemcs.utwente.nl/user/s1934538/clickstream/clickstream-enwiki-2023-03.tsv.gz,Simone_Biles,12624,74039,448,87111,21439
hdfs://spark-nn.eemcs.utwente.nl/user/s1934538/clickstream/clickstream-enwiki-2023-03.tsv.gz,XHamster,7271,204352,5415,217038,23128
hdfs://spark-nn.eemcs.utwente.nl/user/s1934538/clickstream/clickstream-enwiki-2023-03.tsv.gz,Valentine's_Day,6651,123011,696,130358,8385
hdfs://spark-nn.eemcs.utwente.nl/user/s1934538/clickstream/clickstream-enwiki-2023-03.tsv.gz,The_Batman_(film),100729,265949,4518,371196,194871
hdfs://spark-nn.eemcs.utwente.nl/user/s1934538/clickstream/clickstream-enwiki-2023-03.tsv.gz,Charles_III,458961,345767,7816,812544,550053
hdfs://spark-nn.eemcs.utwente.nl/user/s1934538/clickstream/clickstream-enwiki-2023-03.tsv.gz,No_Time_to_Die,88259,110588,1610,200457,107781
hdfs://spark-nn.eemcs.utwente.nl/user/s1934538/clickstream/clickstream-enwiki-2023-03.tsv.gz,Volodymyr_Zelenskyy,80570,184898,2073,267541,147081
hdfs://spark-nn.eemcs.utwente.nl/user/s1934538/clickstream/clickstream-enwiki-2023-03.tsv.gz,The_Suicide_Squad_(film),75971,87703,1050,164724,93669
hdfs://spark-nn.eemcs.utwente.nl/user/s1934538/clickstream/clickstream-enwiki-2023-03.tsv.gz,Key_frame,672,3399,11,4082,295
hdfs://spark-nn.eemcs.utwente.nl/user/s1934538/clickstream/clickstream-enwiki-2023-03.tsv.gz,Salman_Rushdie,35425,85872,593,121890,66004
hdfs://spark-nn.eemcs.utwente.nl/user/s1934538/clickstream/clickstream-enwiki-2023-03.tsv.gz,Stranger_Things,74979,269091,5879,349949,270365
hdfs://spark-nn.eemcs.utwente.nl/user/s1934538/clickstream/clickstream-enwiki-2023-03.tsv.gz,United_States_Electoral_College,11674,28077,199,39950,6919
hdfs://spark-nn.eemcs.utwente.nl/user/s1934538/clickstream/clickstream-enwiki-2023-03.tsv.gz,The_Idol_(TV_series),53545,121615,1216,176376,129165
hdfs://spark-nn.eemcs.utwente.nl/user/s1934538/clickstream/clickstream-enwiki-2023-03.tsv.gz,Christopher_Scarver,71525,37592,32,109149,36616
hdfs://spark-nn.eemcs.utwente.nl/user/s1934538/clickstream/clickstream-enwiki-2023-03.tsv.gz,Cricket_World_Cup,18673,87228,648,106549,73650
hdfs://spark-nn.eemcs.utwente.nl/user/s1934538/clickstream/clickstream-enwiki-2023-03.tsv.gz,Khabib_Nurmagomedov,74777,252146,2675,329598,194283
hdfs://spark-nn.eemcs.utwente.nl/user/s1934538/clickstream/clickstream-enwiki-2023-03.tsv.gz,Jurassic_World_Dominion,64640,121497,1950,188087,129617
hdfs://spark-nn.eemcs.utwente.nl/user/s1934538/clickstream/clickstream-enwiki-2023-03.tsv.gz,Betty_White,43593,119282,987,163862,40698
hdfs://spark-nn.eemcs.utwente.nl/user/s1934538/clickstream/clickstream-enwiki-2023-03.tsv.gz,Deadpool_2,86361,49667,1472,137500,84164
hdfs://spark-nn.eemcs.utwente.nl/user/s1934538/clickstream/clickstream-enwiki-2023-03.tsv.gz,Dune_(2021_film),59732,163093,3558,226383,153603
hdfs://spark-nn.eemcs.utwente.nl/user/s1934538/clickstream/clickstream-enwiki-2023-03.tsv.gz,Bob_Saget,26268,96534,650,123452,22990
hdfs://spark-nn.eemcs.utwente.nl/user/s1934538/clickstream/clickstream-enwiki-2023-03.tsv.gz,ICC_Men's_T20_World_Cup,16425,70460,702,87587,43336
hdfs://spark-nn.eemcs.utwente.nl/user/s1934538/clickstream/clickstream-enwiki-2023-03.tsv.gz,2016_United_States_presidential_election,102608,70084,1166,173858,153048
hdfs://spark-nn.eemcs.utwente.nl/user/s1934538/clickstream/clickstream-enwiki-2023-03.tsv.gz,Thor:_Love_and_Thunder,68893,129690,1748,200331,96766
hdfs://spark-nn.eemcs.utwente.nl/user/s1934538/clickstream/clickstream-enwiki-2023-03.tsv.gz,The_Haunting_of_Bly_Manor,20235,38897,313,59445,29709
hdfs://spark-nn.eemcs.utwente.nl/user/s1934538/clickstream/clickstream-enwiki-2023-03.tsv.gz,Mission:_Impossible_–_Dead_Reckoning_Part_One,87835,74500,1071,163406,116288
hdfs://spark-nn.eemcs.utwente.nl/user/s1934538/clickstream/clickstream-enwiki-2023-03.tsv.gz,Asia_Cup,4654,35230,105,39989,22337
hdfs://spark-nn.eemcs.utwente.nl/user/s1934538/clickstream/clickstream-enwiki-2023-03.tsv.gz,Microsoft_Office,7015,262300,593,269908,19775
hdfs://spark-nn.eemcs.utwente.nl/user/s1934538/clickstream/clickstream-enwiki-2023-03.tsv.gz,Chernobyl_disaster,52315,379265,3069,434649,188510
hdfs://spark-nn.eemcs.utwente.nl/user/s1934538/clickstream/clickstream-enwiki-2023-03.tsv.gz,Saaho,23693,33843,53,57589,15206
hdfs://spark-nn.eemcs.utwente.nl/user/s1934538/clickstream/clickstream-enwiki-2023-03.tsv.gz,Top_Gun:_Maverick,176289,439680,9432,625401,449705
hdfs://spark-nn.eemcs.utwente.nl/user/s1934538/clickstream/clickstream-enwiki-2023-03.tsv.gz,Shakira,37733,426518,3495,467746,205421
hdfs://spark-nn.eemcs.utwente.nl/user/s1934538/clickstream/clickstream-enwiki-2023-03.tsv.gz,Article_370_of_the_Constitution_of_India,6067,74707,23,80797,3346
hdfs://spark-nn.eemcs.utwente.nl/user/s1934538/clickstream/clickstream-enwiki-2023-03.tsv.gz,J._Robert_Oppenheimer,69356,216246,524,286126,103590
hdfs://spark-nn.eemcs.utwente.nl/user/s1934538/clickstream/clickstream-enwiki-2023-03.tsv.gz,XXX:_Return_of_Xander_Cage,67405,2828279,1640,2897324,132508
hdfs://spark-nn.eemcs.utwente.nl/user/s1934538/clickstream/clickstream-enwiki-2023-03.tsv.gz,Dark_Phoenix_(film),40300,36348,343,76991,40200
hdfs://spark-nn.eemcs.utwente.nl/user/s1934538/clickstream/clickstream-enwiki-2023-03.tsv.gz,WrestleMania_34,43096,24819,241,68156,47859
hdfs://spark-nn.eemcs.utwente.nl/user/s1934538/clickstream/clickstream-enwiki-2023-03.tsv.gz,1917_(2019_film),22535,69258,1319,93112,42999
hdfs://spark-nn.eemcs.utwente.nl/user/s1934538/clickstream/clickstream-enwiki-2023-03.tsv.gz,Naomi_Osaka,13695,53803,264,67762,19316
hdfs://spark-nn.eemcs.utwente.nl/user/s1934538/clickstream/clickstream-enwiki-2023-03.tsv.gz,K.G.F:_Chapter_2,47670,214723,669,263062,69989
hdfs://spark-nn.eemcs.utwente.nl/user/s1934538/clickstream/clickstream-enwiki-2023-03.tsv.gz,QAnon,42790,171005,1817,215612,58603
hdfs://spark-nn.eemcs.utwente.nl/user/s1934538/clickstream/clickstream-enwiki-2023-03.tsv.gz,Mac_Miller,22020,140218,971,163209,51896
hdfs://spark-nn.eemcs.utwente.nl/user/s1934538/clickstream/clickstream-enwiki-2023-03.tsv.gz,2020_United_States_presidential_election,134116,168934,4060,307110,306702
hdfs://spark-nn.eemcs.utwente.nl/user/s1934538/clickstream/clickstream-enwiki-2023-03.tsv.gz,Kobe_Bryant_sexual_assault_case,9367,46028,57,55452,4805
hdfs://spark-nn.eemcs.utwente.nl/user/s1934538/clickstream/clickstream-enwiki-2023-03.tsv.gz,Pelé,35275,194233,1768,231276,71880
hdfs://spark-nn.eemcs.utwente.nl/user/s1934538/clickstream/clickstream-enwiki-2023-03.tsv.gz,Ted_Bundy,27230,284018,3903,315151,75590
hdfs://spark-nn.eemcs.utwente.nl/user/s1934538/clickstream/clickstream-enwiki-2023-03.tsv.gz,Sylvester_Stallone,229868,977101,4153,1211122,805611
hdfs://spark-nn.eemcs.utwente.nl/user/s1934538/clickstream/clickstream-enwiki-2023-03.tsv.gz,Brahmāstra:_Part_One_–_Shiva,51970,204017,736,256723,63493
hdfs://spark-nn.eemcs.utwente.nl/user/s1934538/clickstream/clickstream-enwiki-2023-03.tsv.gz,Puneeth_Rajkumar,24700,141421,145,166266,51538
hdfs://spark-nn.eemcs.utwente.nl/user/s1934538/clickstream/clickstream-enwiki-2023-03.tsv.gz,Crazy_Rich_Asians_(film),72720,96607,1304,170631,128918
hdfs://spark-nn.eemcs.utwente.nl/user/s1934538/clickstream/clickstream-enwiki-2023-03.tsv.gz,The_Mandalorian,229217,1300041,34726,1563984,1061586
hdfs://spark-nn.eemcs.utwente.nl/user/s1934538/clickstream/clickstream-enwiki-2023-03.tsv.gz,Adipurush,47279,110578,220,158077,88641
hdfs://spark-nn.eemcs.utwente.nl/user/s1934538/clickstream/clickstream-enwiki-2023-03.tsv.gz,2018_Asian_Games,6426,5479,57,11962,11607
hdfs://spark-nn.eemcs.utwente.nl/user/s1934538/clickstream/clickstream-enwiki-2023-03.tsv.gz,Glass_(2019_film),46696,66161,469,113326,37477
hdfs://spark-nn.eemcs.utwente.nl/user/s1934538/clickstream/clickstream-enwiki-2023-03.tsv.gz,Watts_family_murders,7330,154305,363,161998,41578
hdfs://spark-nn.eemcs.utwente.nl/user/s1934538/clickstream/clickstream-enwiki-2023-03.tsv.gz,Elliot_Page,62636,218068,1467,282171,117432
hdfs://spark-nn.eemcs.utwente.nl/user/s1934538/clickstream/clickstream-enwiki-2023-03.tsv.gz,Spider-Man:_Across_the_Spider-Verse,69226,89672,1627,160525,91837
hdfs://spark-nn.eemcs.utwente.nl/user/s1934538/clickstream/clickstream-enwiki-2023-03.tsv.gz,Jimmy_Buffett,10287,55485,469,66241,23269
hdfs://spark-nn.eemcs.utwente.nl/user/s1934538/clickstream/clickstream-enwiki-2023-03.tsv.gz,Once_Upon_a_Time_in_Hollywood,128327,185489,3382,317198,326685
hdfs://spark-nn.eemcs.utwente.nl/user/s1934538/clickstream/clickstream-enwiki-2023-03.tsv.gz,The_Flash_(film),99445,165448,6105,270998,177380
hdfs://spark-nn.eemcs.utwente.nl/user/s1934538/clickstream/clickstream-enwiki-2023-03.tsv.gz,A_Star_Is_Born_(2018_film),29668,104756,721,135145,66662
hdfs://spark-nn.eemcs.utwente.nl/user/s1934538/clickstream/clickstream-enwiki-2023-03.tsv.gz,Mulan_(2020_film),23060,48825,419,72304,34083
hdfs://spark-nn.eemcs.utwente.nl/user/s1934538/clickstream/clickstream-enwiki-2023-03.tsv.gz,Olivia_Newton-John,48015,314332,2902,365249,146712
hdfs://spark-nn.eemcs.utwente.nl/user/s1934538/clickstream/clickstream-enwiki-2023-03.tsv.gz,Croatia,50804,175692,2439,228935,70962
hdfs://spark-nn.eemcs.utwente.nl/user/s1934538/clickstream/clickstream-enwiki-2023-03.tsv.gz,It_Chapter_Two,30437,38520,343,69300,39646
hdfs://spark-nn.eemcs.utwente.nl/user/s1934538/clickstream/clickstream-enwiki-2023-03.tsv.gz,Joe_Exotic,29984,82741,506,113231,55787
hdfs://spark-nn.eemcs.utwente.nl/user/s1934538/clickstream/clickstream-enwiki-2023-03.tsv.gz,Eddie_Van_Halen,46586,77991,701,125278,54392
hdfs://spark-nn.eemcs.utwente.nl/user/s1934538/clickstream/clickstream-enwiki-2023-03.tsv.gz,Vivek_Ramaswamy,33747,313510,1307,348564,68858
hdfs://spark-nn.eemcs.utwente.nl/user/s1934538/clickstream/clickstream-enwiki-2023-03.tsv.gz,Taliban,38756,63238,742,102736,75063
hdfs://spark-nn.eemcs.utwente.nl/user/s1934538/clickstream/clickstream-enwiki-2023-03.tsv.gz,Michael_Jordan,122182,656975,4993,784150,251043
hdfs://spark-nn.eemcs.utwente.nl/user/s1934538/clickstream/clickstream-enwiki-2023-03.tsv.gz,Bridgerton,35445,139890,2174,177509,134180
hdfs://spark-nn.eemcs.utwente.nl/user/s1934538/clickstream/clickstream-enwiki-2023-03.tsv.gz,Spider-Man:_Far_From_Home,35504,45542,348,81394,31551
hdfs://spark-nn.eemcs.utwente.nl/user/s1934538/clickstream/clickstream-enwiki-2023-03.tsv.gz,Ruth_Bader_Ginsburg,16983,112018,8852,137853,44723
hdfs://spark-nn.eemcs.utwente.nl/user/s1934538/clickstream/clickstream-enwiki-2023-03.tsv.gz,Ray_Liotta,152787,532411,4897,690095,179320
hdfs://spark-nn.eemcs.utwente.nl/user/s1934538/clickstream/clickstream-enwiki-2023-03.tsv.gz,Avatar:_The_Way_of_Water,209277,1104314,23799,1337390,563249
hdfs://spark-nn.eemcs.utwente.nl/user/s1934538/clickstream/clickstream-enwiki-2023-03.tsv.gz,Murder_of_Dee_Dee_Blanchard,15619,131842,376,147837,29463
hdfs://spark-nn.eemcs.utwente.nl/user/s1934538/clickstream/clickstream-enwiki-2023-03.tsv.gz,Nipsey_Hussle,33076,128217,675,161968,49653
hdfs://spark-nn.eemcs.utwente.nl/user/s1934538/clickstream/clickstream-enwiki-2023-03.tsv.gz,Donald_Trump,226973,815540,11171,1053684,584423
hdfs://spark-nn.eemcs.utwente.nl/user/s1934538/clickstream/clickstream-enwiki-2023-03.tsv.gz,Lists_of_deaths_by_year,15045,284833,1089,300967,322517
hdfs://spark-nn.eemcs.utwente.nl/user/s1934538/clickstream/clickstream-enwiki-2023-03.tsv.gz,Manti_Te'o,3594,70726,143,74463,8672
hdfs://spark-nn.eemcs.utwente.nl/user/s1934538/clickstream/clickstream-enwiki-2023-03.tsv.gz,"Diana,_Princess_of_Wales",134130,304109,2874,441113,239174
hdfs://spark-nn.eemcs.utwente.nl/user/s1934538/clickstream/clickstream-enwiki-2023-03.tsv.gz,Kylian_Mbappé,67176,557400,3822,628398,120990
hdfs://spark-nn.eemcs.utwente.nl/user/s1934538/clickstream/clickstream-enwiki-2023-03.tsv.gz,Matthew_Perry,50584,168634,1064,220282,104776
hdfs://spark-nn.eemcs.utwente.nl/user/s1934538/clickstream/clickstream-enwiki-2023-03.tsv.gz,XXXTentacion,59958,1558078,5994,1624030,140845
hdfs://spark-nn.eemcs.utwente.nl/user/s1934538/clickstream/clickstream-enwiki-2023-03.tsv.gz,Venom_(2018_film),13334,64446,578,78358,27796
hdfs://spark-nn.eemcs.utwente.nl/user/s1934538/clickstream/clickstream-enwiki-2023-04.tsv.gz,Avicii,21137,269551,1582,292270,75309
hdfs://spark-nn.eemcs.utwente.nl/user/s1934538/clickstream/clickstream-enwiki-2023-04.tsv.gz,The_Witcher_(TV_series),30852,146808,3320,180980,94257
hdfs://spark-nn.eemcs.utwente.nl/user/s1934538/clickstream/clickstream-enwiki-2023-04.tsv.gz,Richard_Ramirez,13580,127854,1136,142570,40238
hdfs://spark-nn.eemcs.utwente.nl/user/s1934538/clickstream/clickstream-enwiki-2023-04.tsv.gz,Avengers:_Endgame,173045,128329,2828,304202,124461
hdfs://spark-nn.eemcs.utwente.nl/user/s1934538/clickstream/clickstream-enwiki-2023-04.tsv.gz,Rami_Malek,77496,135115,693,213304,84030
hdfs://spark-nn.eemcs.utwente.nl/user/s1934538/clickstream/clickstream-enwiki-2023-04.tsv.gz,Anna_Sorokin,11308,98158,241,109707,40065
hdfs://spark-nn.eemcs.utwente.nl/user/s1934538/clickstream/clickstream-enwiki-2023-04.tsv.gz,Black_Widow_(2021_film),38275,62758,796,101829,45552
hdfs://spark-nn.eemcs.utwente.nl/user/s1934538/clickstream/clickstream-enwiki-2023-04.tsv.gz,Cardi_B,29774,151401,1484,182659,58222
hdfs://spark-nn.eemcs.utwente.nl/user/s1934538/clickstream/clickstream-enwiki-2023-04.tsv.gz,Joaquin_Phoenix,172770,243996,1594,418360,306108
hdfs://spark-nn.eemcs.utwente.nl/user/s1934538/clickstream/clickstream-enwiki-2023-04.tsv.gz,Cameron_Boyce,23575,150910,511,174996,45717
hdfs://spark-nn.eemcs.utwente.nl/user/s1934538/clickstream/clickstream-enwiki-2023-04.tsv.gz,Juneteenth,6078,84232,232,90542,7357
hdfs://spark-nn.eemcs.utwente.nl/user/s1934538/clickstream/clickstream-enwiki-2023-04.tsv.gz,The_Last_of_Us_(TV_series),117792,791120,12348,921260,401514
hdfs://spark-nn.eemcs.utwente.nl/user/s1934538/clickstream/clickstream-enwiki-2023-04.tsv.gz,Spider-Man:_No_Way_Home,88601,137883,2028,228512,103069
hdfs://spark-nn.eemcs.utwente.nl/user/s1934538/clickstream/clickstream-enwiki-2023-04.tsv.gz,Rishi_Sunak,132822,279067,2251,414140,219738
hdfs://spark-nn.eemcs.utwente.nl/user/s1934538/clickstream/clickstream-enwiki-2023-04.tsv.gz,Ray_Liotta,92699,398951,2706,494356,168983
hdfs://spark-nn.eemcs.utwente.nl/user/s1934538/clickstream/clickstream-enwiki-2023-04.tsv.gz,Manti_Te'o,3427,41102,94,44623,5242
hdfs://spark-nn.eemcs.utwente.nl/user/s1934538/clickstream/clickstream-enwiki-2023-04.tsv.gz,Aretha_Franklin,28098,141296,834,170228,79411
hdfs://spark-nn.eemcs.utwente.nl/user/s1934538/clickstream/clickstream-enwiki-2023-04.tsv.gz,Joe_Biden,240016,856752,13002,1109770,539188
hdfs://spark-nn.eemcs.utwente.nl/user/s1934538/clickstream/clickstream-enwiki-2023-04.tsv.gz,List_of_highest-grossing_Indian_films,103245,238182,566,341993,201431
hdfs://spark-nn.eemcs.utwente.nl/user/s1934538/clickstream/clickstream-enwiki-2023-04.tsv.gz,Salman_Rushdie,32247,69155,503,101905,58720
hdfs://spark-nn.eemcs.utwente.nl/user/s1934538/clickstream/clickstream-enwiki-2023-04.tsv.gz,Adele,40400,334493,2904,377797,138954
hdfs://spark-nn.eemcs.utwente.nl/user/s1934538/clickstream/clickstream-enwiki-2023-04.tsv.gz,William_Murdoch,593,1185,15,1793,334
hdfs://spark-nn.eemcs.utwente.nl/user/s1934538/clickstream/clickstream-enwiki-2023-04.tsv.gz,Kamala_Harris,84020,158540,1344,243904,114180
hdfs://spark-nn.eemcs.utwente.nl/user/s1934538/clickstream/clickstream-enwiki-2023-04.tsv.gz,Bird_Box_(film),12494,68495,534,81523,31429
hdfs://spark-nn.eemcs.utwente.nl/user/s1934538/clickstream/clickstream-enwiki-2023-04.tsv.gz,Christopher_Scarver,57781,29100,55,86936,30705
hdfs://spark-nn.eemcs.utwente.nl/user/s1934538/clickstream/clickstream-enwiki-2023-04.tsv.gz,Queen_(band),51037,173311,3082,227430,222632
hdfs://spark-nn.eemcs.utwente.nl/user/s1934538/clickstream/clickstream-enwiki-2023-04.tsv.gz,Lists_of_deaths_by_year,20127,238473,2129,260729,285100
hdfs://spark-nn.eemcs.utwente.nl/user/s1934538/clickstream/clickstream-enwiki-2023-04.tsv.gz,Aaron_Hernandez,7031,75936,401,83368,27621
hdfs://spark-nn.eemcs.utwente.nl/user/s1934538/clickstream/clickstream-enwiki-2023-04.tsv.gz,Cleopatra,106208,5308271,8912,5423391,729866
hdfs://spark-nn.eemcs.utwente.nl/user/s1934538/clickstream/clickstream-enwiki-2023-04.tsv.gz,United_States_Senate,53731,47612,667,102010,48603
hdfs://spark-nn.eemcs.utwente.nl/user/s1934538/clickstream/clickstream-enwiki-2023-04.tsv.gz,Charles_III,449606,424368,7085,881059,567481
hdfs://spark-nn.eemcs.utwente.nl/user/s1934538/clickstream/clickstream-enwiki-2023-04.tsv.gz,Crazy_Rich_Asians_(film),30858,91131,1390,123379,105044
hdfs://spark-nn.eemcs.utwente.nl/user/s1934538/clickstream/clickstream-enwiki-2023-04.tsv.gz,No_Time_to_Die,100908,125477,2151,228536,130841
hdfs://spark-nn.eemcs.utwente.nl/user/s1934538/clickstream/clickstream-enwiki-2023-04.tsv.gz,Antifa_(United_States),7153,59040,234,66427,12075
hdfs://spark-nn.eemcs.utwente.nl/user/s1934538/clickstream/clickstream-enwiki-2023-04.tsv.gz,The_Matrix_Resurrections,75402,75948,900,152250,72274
hdfs://spark-nn.eemcs.utwente.nl/user/s1934538/clickstream/clickstream-enwiki-2023-04.tsv.gz,Deaths_in_2023,1525755,2443218,16195,3985168,2430645
hdfs://spark-nn.eemcs.utwente.nl/user/s1934538/clickstream/clickstream-enwiki-2023-04.tsv.gz,Us_(2019_film),26878,67594,271,94743,29123
hdfs://spark-nn.eemcs.utwente.nl/user/s1934538/clickstream/clickstream-enwiki-2023-04.tsv.gz,XXX:_Return_of_Xander_Cage,61949,3017586,1473,3081008,179085
hdfs://spark-nn.eemcs.utwente.nl/user/s1934538/clickstream/clickstream-enwiki-2023-04.tsv.gz,Oppenheimer_(film),141332,282124,12107,435563,347805
hdfs://spark-nn.eemcs.utwente.nl/user/s1934538/clickstream/clickstream-enwiki-2023-04.tsv.gz,List_of_Queen_of_the_South_episodes,3971,3144,82,7197,169
hdfs://spark-nn.eemcs.utwente.nl/user/s1934538/clickstream/clickstream-enwiki-2023-04.tsv.gz,The_Falcon_and_the_Winter_Soldier,17169,22971,464,40604,24012
hdfs://spark-nn.eemcs.utwente.nl/user/s1934538/clickstream/clickstream-enwiki-2023-04.tsv.gz,Afghanistan,113428,209971,4168,327567,233905
hdfs://spark-nn.eemcs.utwente.nl/user/s1934538/clickstream/clickstream-enwiki-2023-04.tsv.gz,Ruth_Bader_Ginsburg,20313,78810,472,99595,39677
hdfs://spark-nn.eemcs.utwente.nl/user/s1934538/clickstream/clickstream-enwiki-2023-04.tsv.gz,Jurassic_World_Dominion,64873,114735,1887,181495,125523
hdfs://spark-nn.eemcs.utwente.nl/user/s1934538/clickstream/clickstream-enwiki-2023-04.tsv.gz,Army_of_the_Dead,44207,38041,364,82612,42398
hdfs://spark-nn.eemcs.utwente.nl/user/s1934538/clickstream/clickstream-enwiki-2023-04.tsv.gz,Godzilla_vs._Kong,60756,105518,2322,168596,106454
hdfs://spark-nn.eemcs.utwente.nl/user/s1934538/clickstream/clickstream-enwiki-2023-04.tsv.gz,September_11_attacks,117987,305402,4200,427589,278083
hdfs://spark-nn.eemcs.utwente.nl/user/s1934538/clickstream/clickstream-enwiki-2023-04.tsv.gz,Lionel_Messi,105629,882085,6526,994240,209185
hdfs://spark-nn.eemcs.utwente.nl/user/s1934538/clickstream/clickstream-enwiki-2023-04.tsv.gz,Juice_Wrld,28144,156379,2170,186693,72810
hdfs://spark-nn.eemcs.utwente.nl/user/s1934538/clickstream/clickstream-enwiki-2023-04.tsv.gz,Richard_Jewell,12546,89630,348,102524,43041
hdfs://spark-nn.eemcs.utwente.nl/user/s1934538/clickstream/clickstream-enwiki-2023-04.tsv.gz,Saaho,17992,24309,48,42349,12491
hdfs://spark-nn.eemcs.utwente.nl/user/s1934538/clickstream/clickstream-enwiki-2023-04.tsv.gz,Lisa_Marie_Presley,274607,229010,837,504454,263929
hdfs://spark-nn.eemcs.utwente.nl/user/s1934538/clickstream/clickstream-enwiki-2023-04.tsv.gz,Line_shaft,286,692,26,1004,88
hdfs://spark-nn.eemcs.utwente.nl/user/s1934538/clickstream/clickstream-enwiki-2023-04.tsv.gz,Tenet_(film),50303,107888,1294,159485,85668
hdfs://spark-nn.eemcs.utwente.nl/user/s1934538/clickstream/clickstream-enwiki-2023-04.tsv.gz,Stranger_Things_(season_4),23551,73311,937,97799,58231
hdfs://spark-nn.eemcs.utwente.nl/user/s1934538/clickstream/clickstream-enwiki-2023-04.tsv.gz,George_VI,298647,108639,977,408263,297212
hdfs://spark-nn.eemcs.utwente.nl/user/s1934538/clickstream/clickstream-enwiki-2023-04.tsv.gz,Tunnel,4029,7710,93,11832,3076
hdfs://spark-nn.eemcs.utwente.nl/user/s1934538/clickstream/clickstream-enwiki-2023-04.tsv.gz,Brie_Larson,76529,225918,1701,304148,136567
hdfs://spark-nn.eemcs.utwente.nl/user/s1934538/clickstream/clickstream-enwiki-2023-04.tsv.gz,Amy_Coney_Barrett,26755,23353,143,50251,17727
hdfs://spark-nn.eemcs.utwente.nl/user/s1934538/clickstream/clickstream-enwiki-2023-04.tsv.gz,K.G.F:_Chapter_2,33969,146788,540,181297,50238
hdfs://spark-nn.eemcs.utwente.nl/user/s1934538/clickstream/clickstream-enwiki-2023-04.tsv.gz,Gaza_Strip,23528,49149,347,73024,31621
hdfs://spark-nn.eemcs.utwente.nl/user/s1934538/clickstream/clickstream-enwiki-2023-04.tsv.gz,Hamas,35175,41862,364,77401,47114
hdfs://spark-nn.eemcs.utwente.nl/user/s1934538/clickstream/clickstream-enwiki-2023-04.tsv.gz,Dark_Phoenix_(film),45693,43747,480,89920,55944
hdfs://spark-nn.eemcs.utwente.nl/user/s1934538/clickstream/clickstream-enwiki-2023-04.tsv.gz,Jawan_(film),88758,158844,8355,255957,158530
hdfs://spark-nn.eemcs.utwente.nl/user/s1934538/clickstream/clickstream-enwiki-2023-04.tsv.gz,Stranger_Things,64560,221975,5784,292319,245500
hdfs://spark-nn.eemcs.utwente.nl/user/s1934538/clickstream/clickstream-enwiki-2023-04.tsv.gz,Key_frame,589,2825,12,3426,271
hdfs://spark-nn.eemcs.utwente.nl/user/s1934538/clickstream/clickstream-enwiki-2023-04.tsv.gz,Olivia_Newton-John,32031,135102,1118,168251,68688
hdfs://spark-nn.eemcs.utwente.nl/user/s1934538/clickstream/clickstream-enwiki-2023-04.tsv.gz,Tom_Brady,49241,232374,1957,283572,95081
hdfs://spark-nn.eemcs.utwente.nl/user/s1934538/clickstream/clickstream-enwiki-2023-04.tsv.gz,XNXX,13857,495564,6900,516321,37457
hdfs://spark-nn.eemcs.utwente.nl/user/s1934538/clickstream/clickstream-enwiki-2023-04.tsv.gz,Star_Wars:_The_Rise_of_Skywalker,99543,74022,1782,175347,98677
hdfs://spark-nn.eemcs.utwente.nl/user/s1934538/clickstream/clickstream-enwiki-2023-04.tsv.gz,1234,71,1841,21,1933,294
hdfs://spark-nn.eemcs.utwente.nl/user/s1934538/clickstream/clickstream-enwiki-2023-04.tsv.gz,Joker_(2019_film),52822,127165,1889,181876,96030
hdfs://spark-nn.eemcs.utwente.nl/user/s1934538/clickstream/clickstream-enwiki-2023-04.tsv.gz,Kylian_Mbappé,47107,302031,2397,351535,67495
hdfs://spark-nn.eemcs.utwente.nl/user/s1934538/clickstream/clickstream-enwiki-2023-04.tsv.gz,Black_Adam_(film),62747,157043,2535,222325,108975
hdfs://spark-nn.eemcs.utwente.nl/user/s1934538/clickstream/clickstream-enwiki-2023-04.tsv.gz,Kelly_Preston,102436,104903,443,207782,62840
hdfs://spark-nn.eemcs.utwente.nl/user/s1934538/clickstream/clickstream-enwiki-2023-04.tsv.gz,Murder_of_Dee_Dee_Blanchard,18631,148280,341,167252,40791
hdfs://spark-nn.eemcs.utwente.nl/user/s1934538/clickstream/clickstream-enwiki-2023-04.tsv.gz,Luke_Perry,37657,129690,530,167877,66807
hdfs://spark-nn.eemcs.utwente.nl/user/s1934538/clickstream/clickstream-enwiki-2023-04.tsv.gz,Sushma_Swaraj,9903,15608,11,25522,7717
hdfs://spark-nn.eemcs.utwente.nl/user/s1934538/clickstream/clickstream-enwiki-2023-04.tsv.gz,John_Wick:_Chapter_4,378465,1809540,47550,2235555,1300187
hdfs://spark-nn.eemcs.utwente.nl/user/s1934538/clickstream/clickstream-enwiki-2023-04.tsv.gz,The_Lion_King_(2019_film),81239,77368,719,159326,56912
hdfs://spark-nn.eemcs.utwente.nl/user/s1934538/clickstream/clickstream-enwiki-2023-04.tsv.gz,Michael_Jordan,144884,747314,10477,902675,319899
hdfs://spark-nn.eemcs.utwente.nl/user/s1934538/clickstream/clickstream-enwiki-2023-04.tsv.gz,Death_of_Elisa_Lam,9974,97795,623,108392,30247
hdfs://spark-nn.eemcs.utwente.nl/user/s1934538/clickstream/clickstream-enwiki-2023-04.tsv.gz,Charles_Sobhraj,7310,40643,78,48031,9121
hdfs://spark-nn.eemcs.utwente.nl/user/s1934538/clickstream/clickstream-enwiki-2023-04.tsv.gz,Jimmy_Buffett,11291,63248,576,75115,26955
hdfs://spark-nn.eemcs.utwente.nl/user/s1934538/clickstream/clickstream-enwiki-2023-04.tsv.gz,George_H._W._Bush,162542,101207,834,264583,166365
hdfs://spark-nn.eemcs.utwente.nl/user/s1934538/clickstream/clickstream-enwiki-2023-04.tsv.gz,Vladimir_Putin,110455,290860,4961,406276,247351
hdfs://spark-nn.eemcs.utwente.nl/user/s1934538/clickstream/clickstream-enwiki-2023-04.tsv.gz,Media,41,1796,232,2069,1052
hdfs://spark-nn.eemcs.utwente.nl/user/s1934538/clickstream/clickstream-enwiki-2023-04.tsv.gz,Meat_Loaf,23186,100298,1029,124513,46579
hdfs://spark-nn.eemcs.utwente.nl/user/s1934538/clickstream/clickstream-enwiki-2023-04.tsv.gz,Chadwick_Boseman,39376,164541,658,204575,51071
hdfs://spark-nn.eemcs.utwente.nl/user/s1934538/clickstream/clickstream-enwiki-2023-04.tsv.gz,Hyphen-minus,809,5760361,19309,5780479,883
hdfs://spark-nn.eemcs.utwente.nl/user/s1934538/clickstream/clickstream-enwiki-2023-04.tsv.gz,Jimmy_Hoffa,27159,90744,723,118626,49485
hdfs://spark-nn.eemcs.utwente.nl/user/s1934538/clickstream/clickstream-enwiki-2023-04.tsv.gz,Elizabeth_II,359490,535917,4809,900216,593645
hdfs://spark-nn.eemcs.utwente.nl/user/s1934538/clickstream/clickstream-enwiki-2023-04.tsv.gz,The_Irishman,48999,75169,1194,125362,109299
hdfs://spark-nn.eemcs.utwente.nl/user/s1934538/clickstream/clickstream-enwiki-2023-04.tsv.gz,Darth_Vader,37877,74438,666,112981,75231
hdfs://spark-nn.eemcs.utwente.nl/user/s1934538/clickstream/clickstream-enwiki-2023-04.tsv.gz,Venom_(2018_film),12941,51827,764,65532,26516
hdfs://spark-nn.eemcs.utwente.nl/user/s1934538/clickstream/clickstream-enwiki-2023-04.tsv.gz,NATO,140142,588954,75879,804975,412621
hdfs://spark-nn.eemcs.utwente.nl/user/s1934538/clickstream/clickstream-enwiki-2023-04.tsv.gz,Lance_Reddick,138445,447232,3050,588727,134484
hdfs://spark-nn.eemcs.utwente.nl/user/s1934538/clickstream/clickstream-enwiki-2023-04.tsv.gz,Pelé,29493,156472,1388,187353,62048
hdfs://spark-nn.eemcs.utwente.nl/user/s1934538/clickstream/clickstream-enwiki-2023-04.tsv.gz,Deadpool_2,106086,63854,2767,172707,120093
hdfs://spark-nn.eemcs.utwente.nl/user/s1934538/clickstream/clickstream-enwiki-2023-04.tsv.gz,Guardians_of_the_Galaxy_Vol._3,186551,658422,22682,867655,452484
hdfs://spark-nn.eemcs.utwente.nl/user/s1934538/clickstream/clickstream-enwiki-2023-04.tsv.gz,2023_Indian_Premier_League,68157,5697372,2611,5768140,166634
hdfs://spark-nn.eemcs.utwente.nl/user/s1934538/clickstream/clickstream-enwiki-2023-04.tsv.gz,United_States_Electoral_College,13372,28608,139,42119,7838
hdfs://spark-nn.eemcs.utwente.nl/user/s1934538/clickstream/clickstream-enwiki-2023-04.tsv.gz,21_Savage,14396,70959,676,86031,29195
hdfs://spark-nn.eemcs.utwente.nl/user/s1934538/clickstream/clickstream-enwiki-2023-04.tsv.gz,Elon_Musk,137220,1346360,11128,1494708,806403
hdfs://spark-nn.eemcs.utwente.nl/user/s1934538/clickstream/clickstream-enwiki-2023-04.tsv.gz,Pornhub,55515,380691,13060,449266,80886
hdfs://spark-nn.eemcs.utwente.nl/user/s1934538/clickstream/clickstream-enwiki-2023-04.tsv.gz,Ghislaine_Maxwell,93407,98843,356,192606,82531
hdfs://spark-nn.eemcs.utwente.nl/user/s1934538/clickstream/clickstream-enwiki-2023-04.tsv.gz,HTTP_cookie,2242,328822,111,331175,16274
hdfs://spark-nn.eemcs.utwente.nl/user/s1934538/clickstream/clickstream-enwiki-2023-04.tsv.gz,Louis_Tomlinson,34673,54134,196,89003,25785
hdfs://spark-nn.eemcs.utwente.nl/user/s1934538/clickstream/clickstream-enwiki-2023-04.tsv.gz,Captain_Marvel_(film),34013,68330,994,103337,52535
hdfs://spark-nn.eemcs.utwente.nl/user/s1934538/clickstream/clickstream-enwiki-2023-04.tsv.gz,Watts_family_murders,6637,157431,293,164361,43792
hdfs://spark-nn.eemcs.utwente.nl/user/s1934538/clickstream/clickstream-enwiki-2023-04.tsv.gz,The_Mandalorian,203191,1026174,26376,1255741,913207
hdfs://spark-nn.eemcs.utwente.nl/user/s1934538/clickstream/clickstream-enwiki-2023-04.tsv.gz,Saltburn_(film),15548,4847,50,20445,11482
hdfs://spark-nn.eemcs.utwente.nl/user/s1934538/clickstream/clickstream-enwiki-2023-04.tsv.gz,Bonnie_and_Clyde,21573,209804,1185,232562,59744
hdfs://spark-nn.eemcs.utwente.nl/user/s1934538/clickstream/clickstream-enwiki-2023-04.tsv.gz,The_Shape_of_Water,20148,41203,351,61702,26454
hdfs://spark-nn.eemcs.utwente.nl/user/s1934538/clickstream/clickstream-enwiki-2023-04.tsv.gz,Eternals_(film),58679,86844,1362,146885,107117
hdfs://spark-nn.eemcs.utwente.nl/user/s1934538/clickstream/clickstream-enwiki-2023-04.tsv.gz,COVID-19_pandemic_by_country_and_territory,7758,22884,537,31179,12149
hdfs://spark-nn.eemcs.utwente.nl/user/s1934538/clickstream/clickstream-enwiki-2023-04.tsv.gz,Freddie_Mercury,82097,426750,3521,512368,206863
hdfs://spark-nn.eemcs.utwente.nl/user/s1934538/clickstream/clickstream-enwiki-2023-04.tsv.gz,Black_Panther:_Wakanda_Forever,68112,186523,3797,258432,180069
hdfs://spark-nn.eemcs.utwente.nl/user/s1934538/clickstream/clickstream-enwiki-2023-04.tsv.gz,Rihanna,63315,298764,3852,365931,202502
hdfs://spark-nn.eemcs.utwente.nl/user/s1934538/clickstream/clickstream-enwiki-2023-04.tsv.gz,Simple_Mail_Transfer_Protocol,2277,23573,124,25974,2508
hdfs://spark-nn.eemcs.utwente.nl/user/s1934538/clickstream/clickstream-enwiki-2023-04.tsv.gz,List_of_awards_and_nominations_received_by_Meryl_Streep,7258,10072,10,17340,7459
hdfs://spark-nn.eemcs.utwente.nl/user/s1934538/clickstream/clickstream-enwiki-2023-04.tsv.gz,Shakira,27196,285557,2016,314769,133901
hdfs://spark-nn.eemcs.utwente.nl/user/s1934538/clickstream/clickstream-enwiki-2023-04.tsv.gz,Donald_Glover,54053,191354,1401,246808,113585
hdfs://spark-nn.eemcs.utwente.nl/user/s1934538/clickstream/clickstream-enwiki-2023-04.tsv.gz,Loki_(TV_series),38587,51545,1120,91252,57316
hdfs://spark-nn.eemcs.utwente.nl/user/s1934538/clickstream/clickstream-enwiki-2023-04.tsv.gz,Area_51,14478,114484,946,129908,41254
hdfs://spark-nn.eemcs.utwente.nl/user/s1934538/clickstream/clickstream-enwiki-2023-04.tsv.gz,2018_Winter_Olympics,8622,6891,106,15619,10664
hdfs://spark-nn.eemcs.utwente.nl/user/s1934538/clickstream/clickstream-enwiki-2023-04.tsv.gz,Coronavirus,4729,24787,466,29982,9623
hdfs://spark-nn.eemcs.utwente.nl/user/s1934538/clickstream/clickstream-enwiki-2023-04.tsv.gz,Priyanka_Chopra,207005,659844,2677,869526,359604
hdfs://spark-nn.eemcs.utwente.nl/user/s1934538/clickstream/clickstream-enwiki-2023-04.tsv.gz,Naomi_Osaka,12566,38341,398,51305,14592
hdfs://spark-nn.eemcs.utwente.nl/user/s1934538/clickstream/clickstream-enwiki-2023-04.tsv.gz,Royal_Rumble_(2018),8005,4582,42,12629,9271
hdfs://spark-nn.eemcs.utwente.nl/user/s1934538/clickstream/clickstream-enwiki-2023-04.tsv.gz,The_Umbrella_Academy_(TV_series),24431,73820,1611,99862,62695
hdfs://spark-nn.eemcs.utwente.nl/user/s1934538/clickstream/clickstream-enwiki-2023-04.tsv.gz,Elliot_Page,58090,201420,1225,260735,115714
hdfs://spark-nn.eemcs.utwente.nl/user/s1934538/clickstream/clickstream-enwiki-2023-04.tsv.gz,Dune_(2021_film),58444,174906,3602,236952,173497
hdfs://spark-nn.eemcs.utwente.nl/user/s1934538/clickstream/clickstream-enwiki-2023-04.tsv.gz,Chernobyl_disaster,47349,279452,3495,330296,151289
hdfs://spark-nn.eemcs.utwente.nl/user/s1934538/clickstream/clickstream-enwiki-2023-04.tsv.gz,Khabib_Nurmagomedov,52452,165210,1389,219051,123530
hdfs://spark-nn.eemcs.utwente.nl/user/s1934538/clickstream/clickstream-enwiki-2023-04.tsv.gz,Naya_Rivera,46649,67634,231,114514,48628
hdfs://spark-nn.eemcs.utwente.nl/user/s1934538/clickstream/clickstream-enwiki-2023-04.tsv.gz,The_Nun_(2018_film),20850,51086,320,72256,43310
hdfs://spark-nn.eemcs.utwente.nl/user/s1934538/clickstream/clickstream-enwiki-2023-04.tsv.gz,Ted_Bundy,25573,258050,3152,286775,70185
hdfs://spark-nn.eemcs.utwente.nl/user/s1934538/clickstream/clickstream-enwiki-2023-04.tsv.gz,Keanu_Reeves,262449,1328297,7705,1598451,1157298
hdfs://spark-nn.eemcs.utwente.nl/user/s1934538/clickstream/clickstream-enwiki-2023-04.tsv.gz,WandaVision,21042,42407,765,64214,30798
hdfs://spark-nn.eemcs.utwente.nl/user/s1934538/clickstream/clickstream-enwiki-2023-04.tsv.gz,J._Robert_Oppenheimer,84368,311577,718,396663,150991
hdfs://spark-nn.eemcs.utwente.nl/user/s1934538/clickstream/clickstream-enwiki-2023-04.tsv.gz,Squid_Game,18292,118055,2038,138385,66369
hdfs://spark-nn.eemcs.utwente.nl/user/s1934538/clickstream/clickstream-enwiki-2023-04.tsv.gz,The_Suicide_Squad_(film),68318,71919,1032,141269,84881
hdfs://spark-nn.eemcs.utwente.nl/user/s1934538/clickstream/clickstream-enwiki-2023-04.tsv.gz,2023_Cricket_World_Cup,56995,493344,613,550952,142143
hdfs://spark-nn.eemcs.utwente.nl/user/s1934538/clickstream/clickstream-enwiki-2023-04.tsv.gz,The_Weeknd,70501,231734,2198,304433,140741
hdfs://spark-nn.eemcs.utwente.nl/user/s1934538/clickstream/clickstream-enwiki-2023-04.tsv.gz,Vivek_Ramaswamy,30053,350724,1927,382704,79104
hdfs://spark-nn.eemcs.utwente.nl/user/s1934538/clickstream/clickstream-enwiki-2023-04.tsv.gz,Matthew_Perry,47004,155700,1077,203781,104684
hdfs://spark-nn.eemcs.utwente.nl/user/s1934538/clickstream/clickstream-enwiki-2023-04.tsv.gz,Thor:_Love_and_Thunder,64147,93243,1715,159105,78712
hdfs://spark-nn.eemcs.utwente.nl/user/s1934538/clickstream/clickstream-enwiki-2023-04.tsv.gz,Hamilton_(musical),27543,193387,1337,222267,131211
hdfs://spark-nn.eemcs.utwente.nl/user/s1934538/clickstream/clickstream-enwiki-2023-04.tsv.gz,Bible,25862,107764,1785,135411,43857
hdfs://spark-nn.eemcs.utwente.nl/user/s1934538/clickstream/clickstream-enwiki-2023-04.tsv.gz,Betty_White,44628,125397,1074,171099,46269
hdfs://spark-nn.eemcs.utwente.nl/user/s1934538/clickstream/clickstream-enwiki-2023-04.tsv.gz,Kate_Spade,50027,63982,345,114354,39400
hdfs://spark-nn.eemcs.utwente.nl/user/s1934538/clickstream/clickstream-enwiki-2023-04.tsv.gz,Carlos_Alcaraz,23962,148642,526,173130,41254
hdfs://spark-nn.eemcs.utwente.nl/user/s1934538/clickstream/clickstream-enwiki-2023-04.tsv.gz,Critical_race_theory,15020,105402,818,121240,13663
hdfs://spark-nn.eemcs.utwente.nl/user/s1934538/clickstream/clickstream-enwiki-2023-04.tsv.gz,Eddie_Van_Halen,45112,78917,723,124752,54542
hdfs://spark-nn.eemcs.utwente.nl/user/s1934538/clickstream/clickstream-enwiki-2023-04.tsv.gz,Top_Gun:_Maverick,115202,282073,5776,403051,329097
hdfs://spark-nn.eemcs.utwente.nl/user/s1934538/clickstream/clickstream-enwiki-2023-04.tsv.gz,2020_United_States_presidential_election,159701,194852,12989,367542,366539
hdfs://spark-nn.eemcs.utwente.nl/user/s1934538/clickstream/clickstream-enwiki-2023-04.tsv.gz,R._Kelly,35719,233752,1792,271263,147003
hdfs://spark-nn.eemcs.utwente.nl/user/s1934538/clickstream/clickstream-enwiki-2023-04.tsv.gz,State_of_Palestine,66955,161376,298,228629,100992
hdfs://spark-nn.eemcs.utwente.nl/user/s1934538/clickstream/clickstream-enwiki-2023-04.tsv.gz,Bipin_Rawat,7516,17866,13,25395,11941
hdfs://spark-nn.eemcs.utwente.nl/user/s1934538/clickstream/clickstream-enwiki-2023-04.tsv.gz,Vikram_(2022_film),40592,105630,280,146502,63791
hdfs://spark-nn.eemcs.utwente.nl/user/s1934538/clickstream/clickstream-enwiki-2023-04.tsv.gz,Ponniyin_Selvan:_I,100233,636602,2901,739736,439697
hdfs://spark-nn.eemcs.utwente.nl/user/s1934538/clickstream/clickstream-enwiki-2023-04.tsv.gz,Mission:_Impossible_–_Dead_Reckoning_Part_One,90106,69700,1251,161057,122791
hdfs://spark-nn.eemcs.utwente.nl/user/s1934538/clickstream/clickstream-enwiki-2023-04.tsv.gz,Grover,1465,5136,29,6630,1255
hdfs://spark-nn.eemcs.utwente.nl/user/s1934538/clickstream/clickstream-enwiki-2023-04.tsv.gz,Michael_Bloomberg,31595,39467,248,71310,36436
hdfs://spark-nn.eemcs.utwente.nl/user/s1934538/clickstream/clickstream-enwiki-2023-04.tsv.gz,1917_(2019_film),19582,55951,1011,76544,37176
hdfs://spark-nn.eemcs.utwente.nl/user/s1934538/clickstream/clickstream-enwiki-2023-04.tsv.gz,Stephen_Hawking,24708,292441,1852,319001,139908
hdfs://spark-nn.eemcs.utwente.nl/user/s1934538/clickstream/clickstream-enwiki-2023-04.tsv.gz,Ant-Man_and_the_Wasp:_Quantumania,217593,578368,16743,812704,438798
hdfs://spark-nn.eemcs.utwente.nl/user/s1934538/clickstream/clickstream-enwiki-2023-05.tsv.gz,Sinéad_O'Connor,19691,130350,809,150850,52853
hdfs://spark-nn.eemcs.utwente.nl/user/s1934538/clickstream/clickstream-enwiki-2023-05.tsv.gz,COVID-19_pandemic,120183,290244,72198,482625,178095
hdfs://spark-nn.eemcs.utwente.nl/user/s1934538/clickstream/clickstream-enwiki-2023-05.tsv.gz,State_of_Palestine,62724,132631,263,195618,86657
hdfs://spark-nn.eemcs.utwente.nl/user/s1934538/clickstream/clickstream-enwiki-2023-05.tsv.gz,2023_Indian_Premier_League,105792,12856300,1284,12963376,174210
hdfs://spark-nn.eemcs.utwente.nl/user/s1934538/clickstream/clickstream-enwiki-2023-05.tsv.gz,Fantastic_Beasts:_The_Crimes_of_Grindelwald,34815,45783,452,81050,45764
hdfs://spark-nn.eemcs.utwente.nl/user/s1934538/clickstream/clickstream-enwiki-2023-05.tsv.gz,Indian_Premier_League,86894,20731162,3017,20821073,455091
hdfs://spark-nn.eemcs.utwente.nl/user/s1934538/clickstream/clickstream-enwiki-2023-05.tsv.gz,The_Flash_(film),129543,503550,17457,650550,401572
hdfs://spark-nn.eemcs.utwente.nl/user/s1934538/clickstream/clickstream-enwiki-2023-05.tsv.gz,Tunnel,4189,9050,88,13327,3110
hdfs://spark-nn.eemcs.utwente.nl/user/s1934538/clickstream/clickstream-enwiki-2023-05.tsv.gz,Eddie_Van_Halen,46129,85705,733,132567,55408
hdfs://spark-nn.eemcs.utwente.nl/user/s1934538/clickstream/clickstream-enwiki-2023-05.tsv.gz,Chadwick_Boseman,36428,151612,682,188722,48946
hdfs://spark-nn.eemcs.utwente.nl/user/s1934538/clickstream/clickstream-enwiki-2023-05.tsv.gz,Jurassic_World_Dominion,63333,131612,1484,196429,95727
hdfs://spark-nn.eemcs.utwente.nl/user/s1934538/clickstream/clickstream-enwiki-2023-05.tsv.gz,Vladimir_Putin,120091,337350,4796,462237,259099
hdfs://spark-nn.eemcs.utwente.nl/user/s1934538/clickstream/clickstream-enwiki-2023-05.tsv.gz,Hyphen-minus,951,6384898,22859,6408708,1101
hdfs://spark-nn.eemcs.utwente.nl/user/s1934538/clickstream/clickstream-enwiki-2023-05.tsv.gz,Gaza_Strip,23596,61261,426,85283,35843
hdfs://spark-nn.eemcs.utwente.nl/user/s1934538/clickstream/clickstream-enwiki-2023-05.tsv.gz,Donald_Trump,205197,602146,7982,815325,430582
hdfs://spark-nn.eemcs.utwente.nl/user/s1934538/clickstream/clickstream-enwiki-2023-05.tsv.gz,Kylian_Mbappé,49384,334434,2616,386434,67853
hdfs://spark-nn.eemcs.utwente.nl/user/s1934538/clickstream/clickstream-enwiki-2023-05.tsv.gz,Khabib_Nurmagomedov,86329,292951,1310,380590,175140
hdfs://spark-nn.eemcs.utwente.nl/user/s1934538/clickstream/clickstream-enwiki-2023-05.tsv.gz,Hamilton_(musical),28309,171523,1615,201447,121129
hdfs://spark-nn.eemcs.utwente.nl/user/s1934538/clickstream/clickstream-enwiki-2023-05.tsv.gz,A_Star_Is_Born_(2018_film),24688,80827,591,106106,49958
hdfs://spark-nn.eemcs.utwente.nl/user/s1934538/clickstream/clickstream-enwiki-2023-05.tsv.gz,Manti_Te'o,2932,42521,101,45554,5663
hdfs://spark-nn.eemcs.utwente.nl/user/s1934538/clickstream/clickstream-enwiki-2023-05.tsv.gz,Israel,97602,294440,5660,397702,196215
hdfs://spark-nn.eemcs.utwente.nl/user/s1934538/clickstream/clickstream-enwiki-2023-05.tsv.gz,Mortal_Kombat_(2021_film),37338,115131,2101,154570,134235
hdfs://spark-nn.eemcs.utwente.nl/user/s1934538/clickstream/clickstream-enwiki-2023-05.tsv.gz,2.0_(film),21062,29710,32,50804,12333
hdfs://spark-nn.eemcs.utwente.nl/user/s1934538/clickstream/clickstream-enwiki-2023-05.tsv.gz,Atal_Bihari_Vajpayee,42929,60323,63,103315,40051
hdfs://spark-nn.eemcs.utwente.nl/user/s1934538/clickstream/clickstream-enwiki-2023-05.tsv.gz,Kamala_Harris,69956,152443,1119,223518,100033
hdfs://spark-nn.eemcs.utwente.nl/user/s1934538/clickstream/clickstream-enwiki-2023-05.tsv.gz,Deaths_in_2023,1558493,2557775,17042,4133310,2512197
hdfs://spark-nn.eemcs.utwente.nl/user/s1934538/clickstream/clickstream-enwiki-2023-05.tsv.gz,Barbie_(film),111793,355328,10399,477520,436708
hdfs://spark-nn.eemcs.utwente.nl/user/s1934538/clickstream/clickstream-enwiki-2023-05.tsv.gz,William_Murdoch,631,1390,27,2048,341
hdfs://spark-nn.eemcs.utwente.nl/user/s1934538/clickstream/clickstream-enwiki-2023-05.tsv.gz,Doctor_Strange_in_the_Multiverse_of_Madness,77912,135455,1779,215146,92668
hdfs://spark-nn.eemcs.utwente.nl/user/s1934538/clickstream/clickstream-enwiki-2023-05.tsv.gz,Crazy_Rich_Asians_(film),30167,84690,1096,115953,96503
hdfs://spark-nn.eemcs.utwente.nl/user/s1934538/clickstream/clickstream-enwiki-2023-05.tsv.gz,Asia_Cup,14771,120640,10136,145547,47540
hdfs://spark-nn.eemcs.utwente.nl/user/s1934538/clickstream/clickstream-enwiki-2023-05.tsv.gz,Dennis_Nilsen,8192,38344,233,46769,11854
hdfs://spark-nn.eemcs.utwente.nl/user/s1934538/clickstream/clickstream-enwiki-2023-05.tsv.gz,Russo-Ukrainian_War,141935,360878,3333,506146,320630
hdfs://spark-nn.eemcs.utwente.nl/user/s1934538/clickstream/clickstream-enwiki-2023-05.tsv.gz,Captain_Marvel_(film),34225,71545,768,106538,43944
hdfs://spark-nn.eemcs.utwente.nl/user/s1934538/clickstream/clickstream-enwiki-2023-05.tsv.gz,Wonder_Woman_1984,30401,44887,700,75988,33201
hdfs://spark-nn.eemcs.utwente.nl/user/s1934538/clickstream/clickstream-enwiki-2023-05.tsv.gz,ChatGPT,55567,7033785,12557,7101909,456454
hdfs://spark-nn.eemcs.utwente.nl/user/s1934538/clickstream/clickstream-enwiki-2023-05.tsv.gz,Bible,22071,103099,1508,126678,38500
hdfs://spark-nn.eemcs.utwente.nl/user/s1934538/clickstream/clickstream-enwiki-2023-05.tsv.gz,Spider-Man:_Far_From_Home,47491,52361,36,99888,40353
hdfs://spark-nn.eemcs.utwente.nl/user/s1934538/clickstream/clickstream-enwiki-2023-05.tsv.gz,Parasite_(2019_film),23988,148494,1919,174401,68649
hdfs://spark-nn.eemcs.utwente.nl/user/s1934538/clickstream/clickstream-enwiki-2023-05.tsv.gz,Alexander_Hamilton,67612,220338,2346,290296,166786
hdfs://spark-nn.eemcs.utwente.nl/user/s1934538/clickstream/clickstream-enwiki-2023-05.tsv.gz,The_Irishman,70837,92565,1402,164804,130864
hdfs://spark-nn.eemcs.utwente.nl/user/s1934538/clickstream/clickstream-enwiki-2023-05.tsv.gz,Royal_Rumble_(2018),5741,3560,46,9347,7136
hdfs://spark-nn.eemcs.utwente.nl/user/s1934538/clickstream/clickstream-enwiki-2023-05.tsv.gz,The_Super_Mario_Bros._Movie,369647,1627808,40688,2038143,988286
hdfs://spark-nn.eemcs.utwente.nl/user/s1934538/clickstream/clickstream-enwiki-2023-05.tsv.gz,2018_FIFA_World_Cup,66768,57168,427,124363,83746
hdfs://spark-nn.eemcs.utwente.nl/user/s1934538/clickstream/clickstream-enwiki-2023-05.tsv.gz,Avatar:_The_Way_of_Water,132510,410514,8826,551850,228392
hdfs://spark-nn.eemcs.utwente.nl/user/s1934538/clickstream/clickstream-enwiki-2023-05.tsv.gz,Cleopatra,180186,6017633,11095,6208914,1113275
hdfs://spark-nn.eemcs.utwente.nl/user/s1934538/clickstream/clickstream-enwiki-2023-05.tsv.gz,Lisa_Marie_Presley,207410,194053,1054,402517,206340
hdfs://spark-nn.eemcs.utwente.nl/user/s1934538/clickstream/clickstream-enwiki-2023-05.tsv.gz,David_Beckham,44617,256972,1885,303474,106245
hdfs://spark-nn.eemcs.utwente.nl/user/s1934538/clickstream/clickstream-enwiki-2023-05.tsv.gz,Elizabeth_II,1126713,1359409,7476,2493598,1804274
hdfs://spark-nn.eemcs.utwente.nl/user/s1934538/clickstream/clickstream-enwiki-2023-05.tsv.gz,"Meghan,_Duchess_of_Sussex",201869,482320,2273,686462,383006
hdfs://spark-nn.eemcs.utwente.nl/user/s1934538/clickstream/clickstream-enwiki-2023-05.tsv.gz,Michael_Bloomberg,30312,38483,229,69024,33112
hdfs://spark-nn.eemcs.utwente.nl/user/s1934538/clickstream/clickstream-enwiki-2023-05.tsv.gz,XNXX,15556,2610049,10802,2636407,133768
hdfs://spark-nn.eemcs.utwente.nl/user/s1934538/clickstream/clickstream-enwiki-2023-05.tsv.gz,Cecil_Hotel_(Los_Angeles),6783,48404,148,55335,14441
hdfs://spark-nn.eemcs.utwente.nl/user/s1934538/clickstream/clickstream-enwiki-2023-05.tsv.gz,Lionel_Messi,118177,1087883,8262,1214322,234114
hdfs://spark-nn.eemcs.utwente.nl/user/s1934538/clickstream/clickstream-enwiki-2023-05.tsv.gz,WrestleMania_34,15175,8884,53,24112,15916
hdfs://spark-nn.eemcs.utwente.nl/user/s1934538/clickstream/clickstream-enwiki-2023-05.tsv.gz,Johnny_Depp,146753,435490,4545,586788,382224
hdfs://spark-nn.eemcs.utwente.nl/user/s1934538/clickstream/clickstream-enwiki-2023-05.tsv.gz,Black_Panther:_Wakanda_Forever,70919,159290,3377,233586,147778
hdfs://spark-nn.eemcs.utwente.nl/user/s1934538/clickstream/clickstream-enwiki-2023-05.tsv.gz,Donald_Glover,40524,125398,762,166684,72027
hdfs://spark-nn.eemcs.utwente.nl/user/s1934538/clickstream/clickstream-enwiki-2023-05.tsv.gz,Critical_race_theory,19333,89834,718,109885,13460
hdfs://spark-nn.eemcs.utwente.nl/user/s1934538/clickstream/clickstream-enwiki-2023-05.tsv.gz,The_Last_of_Us_(TV_series),70306,410289,7141,487736,200999
hdfs://spark-nn.eemcs.utwente.nl/user/s1934538/clickstream/clickstream-enwiki-2023-05.tsv.gz,Joker_(2019_film),45384,117588,1273,164245,70328
hdfs://spark-nn.eemcs.utwente.nl/user/s1934538/clickstream/clickstream-enwiki-2023-05.tsv.gz,Murder_of_Dee_Dee_Blanchard,19115,94580,280,113975,26552
hdfs://spark-nn.eemcs.utwente.nl/user/s1934538/clickstream/clickstream-enwiki-2023-05.tsv.gz,Ant-Man_and_the_Wasp:_Quantumania,236747,746909,16773,1000429,720455
hdfs://spark-nn.eemcs.utwente.nl/user/s1934538/clickstream/clickstream-enwiki-2023-05.tsv.gz,The_Lion_King_(2019_film),97407,97731,755,195893,66124
hdfs://spark-nn.eemcs.utwente.nl/user/s1934538/clickstream/clickstream-enwiki-2023-05.tsv.gz,Jeffrey_Dahmer,31209,502884,4558,538651,205247
hdfs://spark-nn.eemcs.utwente.nl/user/s1934538/clickstream/clickstream-enwiki-2023-05.tsv.gz,The_Batman_(film),78972,199598,2662,281232,125994
hdfs://spark-nn.eemcs.utwente.nl/user/s1934538/clickstream/clickstream-enwiki-2023-05.tsv.gz,2022_FIFA_World_Cup,139162,262117,2566,403845,238723
hdfs://spark-nn.eemcs.utwente.nl/user/s1934538/clickstream/clickstream-enwiki-2023-05.tsv.gz,Stan_Lee,40203,110964,731,151898,45271
hdfs://spark-nn.eemcs.utwente.nl/user/s1934538/clickstream/clickstream-enwiki-2023-05.tsv.gz,George_VI,1068493,328337,1687,1398517,1036499
hdfs://spark-nn.eemcs.utwente.nl/user/s1934538/clickstream/clickstream-enwiki-2023-05.tsv.gz,Deadpool_2,51635,76870,3034,131539,124415
hdfs://spark-nn.eemcs.utwente.nl/user/s1934538/clickstream/clickstream-enwiki-2023-05.tsv.gz,J._Robert_Oppenheimer,197599,935151,2149,1134899,455776
hdfs://spark-nn.eemcs.utwente.nl/user/s1934538/clickstream/clickstream-enwiki-2023-05.tsv.gz,Burt_Reynolds,61665,148749,1158,211572,109026
hdfs://spark-nn.eemcs.utwente.nl/user/s1934538/clickstream/clickstream-enwiki-2023-05.tsv.gz,Aaron_Hernandez,6568,88257,449,95274,32823
hdfs://spark-nn.eemcs.utwente.nl/user/s1934538/clickstream/clickstream-enwiki-2023-05.tsv.gz,Nipsey_Hussle,19702,66457,617,86776,28158
hdfs://spark-nn.eemcs.utwente.nl/user/s1934538/clickstream/clickstream-enwiki-2023-05.tsv.gz,Pathaan_(film),76843,437562,4657,519062,133620
hdfs://spark-nn.eemcs.utwente.nl/user/s1934538/clickstream/clickstream-enwiki-2023-05.tsv.gz,Microsoft_Office,6293,337703,567,344563,18033
hdfs://spark-nn.eemcs.utwente.nl/user/s1934538/clickstream/clickstream-enwiki-2023-05.tsv.gz,Dune_(2021_film),95133,383349,7054,485536,340784
hdfs://spark-nn.eemcs.utwente.nl/user/s1934538/clickstream/clickstream-enwiki-2023-05.tsv.gz,List_of_Marvel_Cinematic_Universe_films,248376,680889,2324,931589,665672
hdfs://spark-nn.eemcs.utwente.nl/user/s1934538/clickstream/clickstream-enwiki-2023-05.tsv.gz,Juice_Wrld,27924,160975,1940,190839,74957
hdfs://spark-nn.eemcs.utwente.nl/user/s1934538/clickstream/clickstream-enwiki-2023-05.tsv.gz,Wikipedia,269393,843752,1451,1114596,390860
hdfs://spark-nn.eemcs.utwente.nl/user/s1934538/clickstream/clickstream-enwiki-2023-05.tsv.gz,Sridevi,31408,82423,204,114035,54506
hdfs://spark-nn.eemcs.utwente.nl/user/s1934538/clickstream/clickstream-enwiki-2023-05.tsv.gz,The_Umbrella_Academy_(TV_series),22594,73346,1348,97288,58700
hdfs://spark-nn.eemcs.utwente.nl/user/s1934538/clickstream/clickstream-enwiki-2023-05.tsv.gz,Jeffrey_Epstein,70564,418056,3917,492537,244532
hdfs://spark-nn.eemcs.utwente.nl/user/s1934538/clickstream/clickstream-enwiki-2023-05.tsv.gz,Avicii,21743,188849,1334,211926,62578
hdfs://spark-nn.eemcs.utwente.nl/user/s1934538/clickstream/clickstream-enwiki-2023-05.tsv.gz,List_of_FIFA_World_Cup_finals,3530,57663,59,61252,15980
hdfs://spark-nn.eemcs.utwente.nl/user/s1934538/clickstream/clickstream-enwiki-2023-05.tsv.gz,Tasuku_Honjo,596,50413,10,51019,1682
hdfs://spark-nn.eemcs.utwente.nl/user/s1934538/clickstream/clickstream-enwiki-2023-05.tsv.gz,Sushant_Singh_Rajput,19161,101753,161,121075,49513
hdfs://spark-nn.eemcs.utwente.nl/user/s1934538/clickstream/clickstream-enwiki-2023-05.tsv.gz,XXX:_Return_of_Xander_Cage,60110,345806,1083,406999,52817
hdfs://spark-nn.eemcs.utwente.nl/user/s1934538/clickstream/clickstream-enwiki-2023-05.tsv.gz,Saaho,16471,27233,51,43755,10969
hdfs://spark-nn.eemcs.utwente.nl/user/s1934538/clickstream/clickstream-enwiki-2023-05.tsv.gz,Rami_Malek,55879,148197,6404,210480,83981
hdfs://spark-nn.eemcs.utwente.nl/user/s1934538/clickstream/clickstream-enwiki-2023-05.tsv.gz,War_(2019_film),26247,51068,115,77430,23215
hdfs://spark-nn.eemcs.utwente.nl/user/s1934538/clickstream/clickstream-enwiki-2023-05.tsv.gz,Richard_Ramirez,14552,142080,1264,157896,40601
hdfs://spark-nn.eemcs.utwente.nl/user/s1934538/clickstream/clickstream-enwiki-2023-05.tsv.gz,Simple_Mail_Transfer_Protocol,2529,26115,106,28750,2918
hdfs://spark-nn.eemcs.utwente.nl/user/s1934538/clickstream/clickstream-enwiki-2023-05.tsv.gz,Kate_Spade,52764,62728,363,115855,38635
hdfs://spark-nn.eemcs.utwente.nl/user/s1934538/clickstream/clickstream-enwiki-2023-05.tsv.gz,Stranger_Things_(season_4),23630,80226,983,104839,57102
hdfs://spark-nn.eemcs.utwente.nl/user/s1934538/clickstream/clickstream-enwiki-2023-05.tsv.gz,List_of_Queen_of_the_South_episodes,4460,5128,24,9612,164
hdfs://spark-nn.eemcs.utwente.nl/user/s1934538/clickstream/clickstream-enwiki-2023-05.tsv.gz,Roe_v._Wade,14481,89956,609,105046,33962
hdfs://spark-nn.eemcs.utwente.nl/user/s1934538/clickstream/clickstream-enwiki-2023-05.tsv.gz,Irrfan_Khan,27779,76208,94,104081,39236
hdfs://spark-nn.eemcs.utwente.nl/user/s1934538/clickstream/clickstream-enwiki-2023-05.tsv.gz,List_of_James_Bond_films,60316,343994,1539,405849,255055
hdfs://spark-nn.eemcs.utwente.nl/user/s1934538/clickstream/clickstream-enwiki-2023-05.tsv.gz,Bird_Box_(film),13609,105530,1101,120240,45129
hdfs://spark-nn.eemcs.utwente.nl/user/s1934538/clickstream/clickstream-enwiki-2023-05.tsv.gz,The_Mandalorian,78510,295325,5707,379542,261190
hdfs://spark-nn.eemcs.utwente.nl/user/s1934538/clickstream/clickstream-enwiki-2023-05.tsv.gz,Article_370_of_the_Constitution_of_India,4626,67630,318,72574,3723
hdfs://spark-nn.eemcs.utwente.nl/user/s1934538/clickstream/clickstream-enwiki-2023-05.tsv.gz,Venom_(2018_film),16659,82577,1142,100378,49026
hdfs://spark-nn.eemcs.utwente.nl/user/s1934538/clickstream/clickstream-enwiki-2023-05.tsv.gz,Tenet_(film),69316,108691,1174,179181,81499
hdfs://spark-nn.eemcs.utwente.nl/user/s1934538/clickstream/clickstream-enwiki-2023-05.tsv.gz,Central_Park_jogger_case,9869,44850,156,54875,9395
hdfs://spark-nn.eemcs.utwente.nl/user/s1934538/clickstream/clickstream-enwiki-2023-05.tsv.gz,Amy_Coney_Barrett,19959,22401,132,42492,14287
hdfs://spark-nn.eemcs.utwente.nl/user/s1934538/clickstream/clickstream-enwiki-2023-05.tsv.gz,Hamas,33034,33753,391,67178,38497
hdfs://spark-nn.eemcs.utwente.nl/user/s1934538/clickstream/clickstream-enwiki-2023-05.tsv.gz,Puneeth_Rajkumar,14769,59434,36,74239,25825
hdfs://spark-nn.eemcs.utwente.nl/user/s1934538/clickstream/clickstream-enwiki-2023-05.tsv.gz,2016_United_States_presidential_election,109833,72195,968,182996,162194
hdfs://spark-nn.eemcs.utwente.nl/user/s1934538/clickstream/clickstream-enwiki-2023-05.tsv.gz,Sidharth_Shukla,7976,43501,209,51686,9126
hdfs://spark-nn.eemcs.utwente.nl/user/s1934538/clickstream/clickstream-enwiki-2023-05.tsv.gz,Bipin_Rawat,6853,16643,11,23507,9721
hdfs://spark-nn.eemcs.utwente.nl/user/s1934538/clickstream/clickstream-enwiki-2023-05.tsv.gz,Bob_Saget,26323,99145,678,126146,25422
hdfs://spark-nn.eemcs.utwente.nl/user/s1934538/clickstream/clickstream-enwiki-2023-05.tsv.gz,Olivia_Newton-John,32714,113092,1529,147335,60355
hdfs://spark-nn.eemcs.utwente.nl/user/s1934538/clickstream/clickstream-enwiki-2023-05.tsv.gz,Brahmāstra:_Part_One_–_Shiva,36912,113804,606,151322,35280
hdfs://spark-nn.eemcs.utwente.nl/user/s1934538/clickstream/clickstream-enwiki-2023-05.tsv.gz,Amber_Heard,85071,341459,2336,428866,177750
hdfs://spark-nn.eemcs.utwente.nl/user/s1934538/clickstream/clickstream-enwiki-2023-05.tsv.gz,Mission:_Impossible_–_Dead_Reckoning_Part_One,136981,183432,4047,324460,249494
hdfs://spark-nn.eemcs.utwente.nl/user/s1934538/clickstream/clickstream-enwiki-2023-05.tsv.gz,Taliban,43262,76724,1092,121078,91258
hdfs://spark-nn.eemcs.utwente.nl/user/s1934538/clickstream/clickstream-enwiki-2023-05.tsv.gz,Juneteenth,8361,239848,929,249138,18278
hdfs://spark-nn.eemcs.utwente.nl/user/s1934538/clickstream/clickstream-enwiki-2023-05.tsv.gz,The_Shape_of_Water,17368,36972,279,54619,21985
hdfs://spark-nn.eemcs.utwente.nl/user/s1934538/clickstream/clickstream-enwiki-2023-05.tsv.gz,Shinzo_Abe,47750,74267,1406,123423,81863
hdfs://spark-nn.eemcs.utwente.nl/user/s1934538/clickstream/clickstream-enwiki-2023-05.tsv.gz,Spanish_flu,18800,45166,525,64491,18157
hdfs://spark-nn.eemcs.utwente.nl/user/s1934538/clickstream/clickstream-enwiki-2023-05.tsv.gz,Saltburn_(film),13438,4831,81,18350,9920
hdfs://spark-nn.eemcs.utwente.nl/user/s1934538/clickstream/clickstream-enwiki-2023-05.tsv.gz,Deion_Sanders,14226,99279,564,114069,31273
hdfs://spark-nn.eemcs.utwente.nl/user/s1934538/clickstream/clickstream-enwiki-2023-05.tsv.gz,Laal_Singh_Chaddha,22291,68150,122,90563,30203
hdfs://spark-nn.eemcs.utwente.nl/user/s1934538/clickstream/clickstream-enwiki-2023-05.tsv.gz,John_Wick:_Chapter_4,218824,1105059,25158,1349041,735538
hdfs://spark-nn.eemcs.utwente.nl/user/s1934538/clickstream/clickstream-enwiki-2023-05.tsv.gz,United_States_Senate,54960,49250,687,104897,48810
hdfs://spark-nn.eemcs.utwente.nl/user/s1934538/clickstream/clickstream-enwiki-2023-05.tsv.gz,Joaquin_Phoenix,135392,172098,1061,308551,204804
hdfs://spark-nn.eemcs.utwente.nl/user/s1934538/clickstream/clickstream-enwiki-2023-05.tsv.gz,Kelly_Preston,87037,92140,445,179622,54156
hdfs://spark-nn.eemcs.utwente.nl/user/s1934538/clickstream/clickstream-enwiki-2023-05.tsv.gz,Media,28,2191,276,2495,1162
hdfs://spark-nn.eemcs.utwente.nl/user/s1934538/clickstream/clickstream-enwiki-2023-05.tsv.gz,Antifa_(United_States),10048,101098,322,111468,17037
hdfs://spark-nn.eemcs.utwente.nl/user/s1934538/clickstream/clickstream-enwiki-2023-05.tsv.gz,Godzilla_vs._Kong,42566,90887,991,134444,65328
hdfs://spark-nn.eemcs.utwente.nl/user/s1934538/clickstream/clickstream-enwiki-2023-05.tsv.gz,Elliot_Page,61180,374604,1784,437568,176720
hdfs://spark-nn.eemcs.utwente.nl/user/s1934538/clickstream/clickstream-enwiki-2023-05.tsv.gz,Adipurush,67220,477981,1375,546576,326440
hdfs://spark-nn.eemcs.utwente.nl/user/s1934538/clickstream/clickstream-enwiki-2023-05.tsv.gz,QAnon,39408,110340,581,150329,47654
hdfs://spark-nn.eemcs.utwente.nl/user/s1934538/clickstream/clickstream-enwiki-2023-05.tsv.gz,Bridgerton,146075,591380,9791,747246,578894
hdfs://spark-nn.eemcs.utwente.nl/user/s1934538/clickstream/clickstream-enwiki-2023-05.tsv.gz,Tonya_Harding,17361,63811,274,81446,21942
hdfs://spark-nn.eemcs.utwente.nl/user/s1934538/clickstream/clickstream-enwiki-2023-05.tsv.gz,Ruth_Bader_Ginsburg,18347,78511,473,97331,35872
hdfs://spark-nn.eemcs.utwente.nl/user/s1934538/clickstream/clickstream-enwiki-2023-05.tsv.gz,Greta_Thunberg,11584,132085,824,144493,32524
hdfs://spark-nn.eemcs.utwente.nl/user/s1934538/clickstream/clickstream-enwiki-2023-05.tsv.gz,"Princess_Margaret,_Countess_of_Snowdon",184655,322724,1845,509224,304857
hdfs://spark-nn.eemcs.utwente.nl/user/s1934538/clickstream/clickstream-enwiki-2023-05.tsv.gz,Jenna_Ortega,105639,607124,7316,720079,192056
hdfs://spark-nn.eemcs.utwente.nl/user/s1934538/clickstream/clickstream-enwiki-2023-05.tsv.gz,RRR_(film),74710,287726,2543,364979,166982
hdfs://spark-nn.eemcs.utwente.nl/user/s1934538/clickstream/clickstream-enwiki-2023-05.tsv.gz,Leave_the_World_Behind_(film),12117,4176,1060,17353,5295
hdfs://spark-nn.eemcs.utwente.nl/user/s1934538/clickstream/clickstream-enwiki-2023-05.tsv.gz,Grover,1428,5354,34,6816,1370
hdfs://spark-nn.eemcs.utwente.nl/user/s1934538/clickstream/clickstream-enwiki-2023-05.tsv.gz,Simone_Biles,19483,107812,604,127899,50683
hdfs://spark-nn.eemcs.utwente.nl/user/s1934538/clickstream/clickstream-enwiki-2023-05.tsv.gz,The_Witcher_(TV_series),27322,143325,2950,173597,83929
hdfs://spark-nn.eemcs.utwente.nl/user/s1934538/clickstream/clickstream-enwiki-2023-05.tsv.gz,ICC_Men's_T20_World_Cup,20485,114357,1467,136309,37984
hdfs://spark-nn.eemcs.utwente.nl/user/s1934538/clickstream/clickstream-enwiki-2023-05.tsv.gz,Michael_Jordan,295464,1619301,10271,1925036,701404
hdfs://spark-nn.eemcs.utwente.nl/user/s1934538/clickstream/clickstream-enwiki-2023-05.tsv.gz,Rihanna,83106,369587,3731,456424,252330
hdfs://spark-nn.eemcs.utwente.nl/user/s1934538/clickstream/clickstream-enwiki-2023-05.tsv.gz,Priyanka_Chopra,258868,1164140,3979,1426987,555657
hdfs://spark-nn.eemcs.utwente.nl/user/s1934538/clickstream/clickstream-enwiki-2023-05.tsv.gz,1917_(2019_film),18647,78753,1393,98793,53547
hdfs://spark-nn.eemcs.utwente.nl/user/s1934538/clickstream/clickstream-enwiki-2023-05.tsv.gz,The_Haunting_of_Bly_Manor,16866,33181,232,50279,25514
hdfs://spark-nn.eemcs.utwente.nl/user/s1934538/clickstream/clickstream-enwiki-2023-05.tsv.gz,Avengers:_Endgame,117845,171767,4680,294292,170019
hdfs://spark-nn.eemcs.utwente.nl/user/s1934538/clickstream/clickstream-enwiki-2023-05.tsv.gz,Kobe_Bryant,112299,551889,4124,668312,201542
hdfs://spark-nn.eemcs.utwente.nl/user/s1934538/clickstream/clickstream-enwiki-2023-05.tsv.gz,Cook's_Country,323,1553,32,1908,511
hdfs://spark-nn.eemcs.utwente.nl/user/s1934538/clickstream/clickstream-enwiki-2023-05.tsv.gz,Loki_(TV_series),46576,72453,1600,120629,76658
hdfs://spark-nn.eemcs.utwente.nl/user/s1934538/clickstream/clickstream-enwiki-2023-05.tsv.gz,Emma_Raducanu,5405,66868,508,72781,12126
hdfs://spark-nn.eemcs.utwente.nl/user/s1934538/clickstream/clickstream-enwiki-2023-05.tsv.gz,List_of_highest-grossing_films,181379,458414,19676,659469,330466
hdfs://spark-nn.eemcs.utwente.nl/user/s1934538/clickstream/clickstream-enwiki-2023-05.tsv.gz,Christopher_Scarver,58853,32476,19,91348,32369
hdfs://spark-nn.eemcs.utwente.nl/user/s1934538/clickstream/clickstream-enwiki-2023-05.tsv.gz,Valentine's_Day,3744,46286,170,50200,3775
hdfs://spark-nn.eemcs.utwente.nl/user/s1934538/clickstream/clickstream-enwiki-2023-05.tsv.gz,Lance_Reddick,109348,291681,1524,402553,88417
hdfs://spark-nn.eemcs.utwente.nl/user/s1934538/clickstream/clickstream-enwiki-2023-05.tsv.gz,Bonnie_and_Clyde,23081,207590,1194,231865,59844
hdfs://spark-nn.eemcs.utwente.nl/user/s1934538/clickstream/clickstream-enwiki-2023-05.tsv.gz,Joe_Exotic,27727,60158,255,88140,39663
hdfs://spark-nn.eemcs.utwente.nl/user/s1934538/clickstream/clickstream-enwiki-2023-05.tsv.gz,Naomi_Osaka,15029,55370,269,70668,20339
hdfs://spark-nn.eemcs.utwente.nl/user/s1934538/clickstream/clickstream-enwiki-2023-05.tsv.gz,Brie_Larson,124656,300556,1823,427035,169259
hdfs://spark-nn.eemcs.utwente.nl/user/s1934538/clickstream/clickstream-enwiki-2023-05.tsv.gz,Anna_Sorokin,11977,103015,331,115323,40557
hdfs://spark-nn.eemcs.utwente.nl/user/s1934538/clickstream/clickstream-enwiki-2023-05.tsv.gz,Jimmy_Hoffa,31980,116441,817,149238,61466
hdfs://spark-nn.eemcs.utwente.nl/user/s1934538/clickstream/clickstream-enwiki-2023-06.tsv.gz,Richard_Jewell,13675,50877,274,64826,23278
hdfs://spark-nn.eemcs.utwente.nl/user/s1934538/clickstream/clickstream-enwiki-2023-06.tsv.gz,Avengers:_Infinity_War,47206,72245,1094,120545,57851
hdfs://spark-nn.eemcs.utwente.nl/user/s1934538/clickstream/clickstream-enwiki-2023-06.tsv.gz,Antifa_(United_States),7871,71849,235,79955,13799
hdfs://spark-nn.eemcs.utwente.nl/user/s1934538/clickstream/clickstream-enwiki-2023-06.tsv.gz,Stranger_Things,60212,249491,5851,315554,239450
hdfs://spark-nn.eemcs.utwente.nl/user/s1934538/clickstream/clickstream-enwiki-2023-06.tsv.gz,2018_Winter_Olympics,8651,6478,102,15231,10582
hdfs://spark-nn.eemcs.utwente.nl/user/s1934538/clickstream/clickstream-enwiki-2023-06.tsv.gz,Puneeth_Rajkumar,12202,58045,25,70272,22729
hdfs://spark-nn.eemcs.utwente.nl/user/s1934538/clickstream/clickstream-enwiki-2023-06.tsv.gz,List_of_highest-grossing_films,220734,466557,5831,693122,373847
hdfs://spark-nn.eemcs.utwente.nl/user/s1934538/clickstream/clickstream-enwiki-2023-06.tsv.gz,Matthew_Perry,40856,120050,6751,167657,78149
hdfs://spark-nn.eemcs.utwente.nl/user/s1934538/clickstream/clickstream-enwiki-2023-06.tsv.gz,R._Kelly,37475,147227,1601,186303,102862
hdfs://spark-nn.eemcs.utwente.nl/user/s1934538/clickstream/clickstream-enwiki-2023-06.tsv.gz,Grover,1180,5263,59,6502,1380
hdfs://spark-nn.eemcs.utwente.nl/user/s1934538/clickstream/clickstream-enwiki-2023-06.tsv.gz,Ray_Liotta,58446,223635,2029,284110,105645
hdfs://spark-nn.eemcs.utwente.nl/user/s1934538/clickstream/clickstream-enwiki-2023-06.tsv.gz,Venom_(2018_film),24293,89119,1704,115116,53843
hdfs://spark-nn.eemcs.utwente.nl/user/s1934538/clickstream/clickstream-enwiki-2023-06.tsv.gz,Cecil_Hotel_(Los_Angeles),8274,82539,183,90996,25253
hdfs://spark-nn.eemcs.utwente.nl/user/s1934538/clickstream/clickstream-enwiki-2023-06.tsv.gz,Indian_Premier_League,26364,400739,472,427575,75833
hdfs://spark-nn.eemcs.utwente.nl/user/s1934538/clickstream/clickstream-enwiki-2023-06.tsv.gz,Mortal_Kombat_(2021_film),39599,98076,2040,139715,137986
hdfs://spark-nn.eemcs.utwente.nl/user/s1934538/clickstream/clickstream-enwiki-2023-06.tsv.gz,Croatia,60118,238020,2966,301104,89573
hdfs://spark-nn.eemcs.utwente.nl/user/s1934538/clickstream/clickstream-enwiki-2023-06.tsv.gz,Glass_(2019_film),41567,47527,304,89398,28361
hdfs://spark-nn.eemcs.utwente.nl/user/s1934538/clickstream/clickstream-enwiki-2023-06.tsv.gz,Jurassic_World_Dominion,68679,122063,1576,192318,108624
hdfs://spark-nn.eemcs.utwente.nl/user/s1934538/clickstream/clickstream-enwiki-2023-06.tsv.gz,Olivia_Newton-John,27285,108151,1098,136534,56386
hdfs://spark-nn.eemcs.utwente.nl/user/s1934538/clickstream/clickstream-enwiki-2023-06.tsv.gz,Pelé,37083,176980,1334,215397,75791
hdfs://spark-nn.eemcs.utwente.nl/user/s1934538/clickstream/clickstream-enwiki-2023-06.tsv.gz,The_Weeknd,191281,509443,4567,705291,288406
hdfs://spark-nn.eemcs.utwente.nl/user/s1934538/clickstream/clickstream-enwiki-2023-06.tsv.gz,Jeffrey_Epstein,50624,317880,3144,371648,178152
hdfs://spark-nn.eemcs.utwente.nl/user/s1934538/clickstream/clickstream-enwiki-2023-06.tsv.gz,Spider-Man:_Across_the_Spider-Verse,971681,4933521,107901,6013103,4401680
hdfs://spark-nn.eemcs.utwente.nl/user/s1934538/clickstream/clickstream-enwiki-2023-06.tsv.gz,Ghislaine_Maxwell,71666,103586,776,176028,75110
hdfs://spark-nn.eemcs.utwente.nl/user/s1934538/clickstream/clickstream-enwiki-2023-06.tsv.gz,Ukraine,97926,363556,8780,470262,213205
hdfs://spark-nn.eemcs.utwente.nl/user/s1934538/clickstream/clickstream-enwiki-2023-06.tsv.gz,ChatGPT,37271,5655893,6573,5699737,303130
hdfs://spark-nn.eemcs.utwente.nl/user/s1934538/clickstream/clickstream-enwiki-2023-06.tsv.gz,The_Shape_of_Water,18324,41778,362,60464,25459
hdfs://spark-nn.eemcs.utwente.nl/user/s1934538/clickstream/clickstream-enwiki-2023-06.tsv.gz,J._Robert_Oppenheimer,210952,900713,2036,1113701,448627
hdfs://spark-nn.eemcs.utwente.nl/user/s1934538/clickstream/clickstream-enwiki-2023-06.tsv.gz,Emma_Raducanu,12269,98362,765,111396,23023
hdfs://spark-nn.eemcs.utwente.nl/user/s1934538/clickstream/clickstream-enwiki-2023-06.tsv.gz,Adele,28314,156920,3339,188573,73311
hdfs://spark-nn.eemcs.utwente.nl/user/s1934538/clickstream/clickstream-enwiki-2023-06.tsv.gz,Alexander_Hamilton,61953,176527,1214,239694,145813
hdfs://spark-nn.eemcs.utwente.nl/user/s1934538/clickstream/clickstream-enwiki-2023-06.tsv.gz,YouTube,129841,4032811,10353,4173005,108410
hdfs://spark-nn.eemcs.utwente.nl/user/s1934538/clickstream/clickstream-enwiki-2023-06.tsv.gz,The_Falcon_and_the_Winter_Soldier,19468,28136,353,47957,27653
hdfs://spark-nn.eemcs.utwente.nl/user/s1934538/clickstream/clickstream-enwiki-2023-06.tsv.gz,Luke_Perry,43972,132644,686,177302,70840
hdfs://spark-nn.eemcs.utwente.nl/user/s1934538/clickstream/clickstream-enwiki-2023-06.tsv.gz,No_Time_to_Die,92563,118302,1949,212814,116020
hdfs://spark-nn.eemcs.utwente.nl/user/s1934538/clickstream/clickstream-enwiki-2023-06.tsv.gz,Shang-Chi_and_the_Legend_of_the_Ten_Rings,46376,106298,1454,154128,82066
hdfs://spark-nn.eemcs.utwente.nl/user/s1934538/clickstream/clickstream-enwiki-2023-06.tsv.gz,HTTP_cookie,2231,265494,127,267852,17616
hdfs://spark-nn.eemcs.utwente.nl/user/s1934538/clickstream/clickstream-enwiki-2023-06.tsv.gz,"Diana,_Princess_of_Wales",115677,234351,1989,352017,196618
hdfs://spark-nn.eemcs.utwente.nl/user/s1934538/clickstream/clickstream-enwiki-2023-06.tsv.gz,Mission:_Impossible_–_Dead_Reckoning_Part_One,157754,262508,6104,426366,274364
hdfs://spark-nn.eemcs.utwente.nl/user/s1934538/clickstream/clickstream-enwiki-2023-06.tsv.gz,Pornhub,56538,277872,13378,347788,72419
hdfs://spark-nn.eemcs.utwente.nl/user/s1934538/clickstream/clickstream-enwiki-2023-06.tsv.gz,When_They_See_Us,15019,18211,133,33363,15848
hdfs://spark-nn.eemcs.utwente.nl/user/s1934538/clickstream/clickstream-enwiki-2023-06.tsv.gz,Gaza_Strip,17653,31164,166,48983,21408
hdfs://spark-nn.eemcs.utwente.nl/user/s1934538/clickstream/clickstream-enwiki-2023-06.tsv.gz,The_Suicide_Squad_(film),77614,109861,1264,188739,105176
hdfs://spark-nn.eemcs.utwente.nl/user/s1934538/clickstream/clickstream-enwiki-2023-06.tsv.gz,QAnon,42295,91537,8115,141947,47633
hdfs://spark-nn.eemcs.utwente.nl/user/s1934538/clickstream/clickstream-enwiki-2023-06.tsv.gz,Lists_of_deaths_by_year,18676,212930,878,232484,259808
hdfs://spark-nn.eemcs.utwente.nl/user/s1934538/clickstream/clickstream-enwiki-2023-06.tsv.gz,United_States_Electoral_College,11667,24943,61,36671,7380
hdfs://spark-nn.eemcs.utwente.nl/user/s1934538/clickstream/clickstream-enwiki-2023-06.tsv.gz,The_Mandalorian,46309,149691,3022,199022,136231
hdfs://spark-nn.eemcs.utwente.nl/user/s1934538/clickstream/clickstream-enwiki-2023-06.tsv.gz,"Princess_Margaret,_Countess_of_Snowdon",62492,132234,2911,197637,114807
hdfs://spark-nn.eemcs.utwente.nl/user/s1934538/clickstream/clickstream-enwiki-2023-06.tsv.gz,List_of_James_Bond_films,62826,348817,1514,413157,276080
hdfs://spark-nn.eemcs.utwente.nl/user/s1934538/clickstream/clickstream-enwiki-2023-06.tsv.gz,Freddie_Mercury,75696,459269,3264,538229,220104
hdfs://spark-nn.eemcs.utwente.nl/user/s1934538/clickstream/clickstream-enwiki-2023-06.tsv.gz,State_of_Palestine,54147,111633,216,165996,74986
hdfs://spark-nn.eemcs.utwente.nl/user/s1934538/clickstream/clickstream-enwiki-2023-06.tsv.gz,Jimmy_Hoffa,32396,129178,969,162543,65643
hdfs://spark-nn.eemcs.utwente.nl/user/s1934538/clickstream/clickstream-enwiki-2023-06.tsv.gz,Stephen_Hawking,20656,314185,2080,336921,118925
hdfs://spark-nn.eemcs.utwente.nl/user/s1934538/clickstream/clickstream-enwiki-2023-06.tsv.gz,The_Witcher_(TV_series),51636,487840,11664,551140,260762
hdfs://spark-nn.eemcs.utwente.nl/user/s1934538/clickstream/clickstream-enwiki-2023-06.tsv.gz,Death_of_Elisa_Lam,16434,75678,402,92514,29230
hdfs://spark-nn.eemcs.utwente.nl/user/s1934538/clickstream/clickstream-enwiki-2023-06.tsv.gz,Everything_Everywhere_All_at_Once,77498,233486,3175,314159,133028
hdfs://spark-nn.eemcs.utwente.nl/user/s1934538/clickstream/clickstream-enwiki-2023-06.tsv.gz,Jimmy_Buffett,9843,64225,706,74774,25220
hdfs://spark-nn.eemcs.utwente.nl/user/s1934538/clickstream/clickstream-enwiki-2023-06.tsv.gz,"Citizenship_(Amendment)_Act,_2019",4218,19336,53,23607,2758
hdfs://spark-nn.eemcs.utwente.nl/user/s1934538/clickstream/clickstream-enwiki-2023-06.tsv.gz,Afghanistan,107402,202728,3496,313626,228893
hdfs://spark-nn.eemcs.utwente.nl/user/s1934538/clickstream/clickstream-enwiki-2023-06.tsv.gz,Crazy_Rich_Asians_(film),27327,76940,988,105255,88184
hdfs://spark-nn.eemcs.utwente.nl/user/s1934538/clickstream/clickstream-enwiki-2023-06.tsv.gz,Cardi_B,31183,178282,1833,211298,64482
hdfs://spark-nn.eemcs.utwente.nl/user/s1934538/clickstream/clickstream-enwiki-2023-06.tsv.gz,2018_FIFA_World_Cup,84534,62917,636,148087,105873
hdfs://spark-nn.eemcs.utwente.nl/user/s1934538/clickstream/clickstream-enwiki-2023-06.tsv.gz,Joe_Exotic,37702,106442,443,144587,68814
hdfs://spark-nn.eemcs.utwente.nl/user/s1934538/clickstream/clickstream-enwiki-2023-06.tsv.gz,Salman_Rushdie,43524,93306,598,137428,75351
hdfs://spark-nn.eemcs.utwente.nl/user/s1934538/clickstream/clickstream-enwiki-2023-06.tsv.gz,House_of_the_Dragon,42348,174096,3948,220392,135796
hdfs://spark-nn.eemcs.utwente.nl/user/s1934538/clickstream/clickstream-enwiki-2023-06.tsv.gz,List_of_Marvel_Cinematic_Universe_films,227213,543651,2349,773213,522558
hdfs://spark-nn.eemcs.utwente.nl/user/s1934538/clickstream/clickstream-enwiki-2023-06.tsv.gz,Lance_Reddick,78686,266589,999,346274,76017
hdfs://spark-nn.eemcs.utwente.nl/user/s1934538/clickstream/clickstream-enwiki-2023-06.tsv.gz,Elon_Musk,99750,1109727,8410,1217887,566349
hdfs://spark-nn.eemcs.utwente.nl/user/s1934538/clickstream/clickstream-enwiki-2023-06.tsv.gz,Brie_Larson,81626,213984,1205,296815,114647
hdfs://spark-nn.eemcs.utwente.nl/user/s1934538/clickstream/clickstream-enwiki-2023-06.tsv.gz,Cleopatra,82386,5683604,3728,5769718,575840
hdfs://spark-nn.eemcs.utwente.nl/user/s1934538/clickstream/clickstream-enwiki-2023-06.tsv.gz,Avicii,19875,189205,1281,210361,63402
hdfs://spark-nn.eemcs.utwente.nl/user/s1934538/clickstream/clickstream-enwiki-2023-06.tsv.gz,David_Beckham,124127,425675,1921,551723,227020
hdfs://spark-nn.eemcs.utwente.nl/user/s1934538/clickstream/clickstream-enwiki-2023-06.tsv.gz,Chernobyl_(miniseries),22828,72468,1704,97000,120904
hdfs://spark-nn.eemcs.utwente.nl/user/s1934538/clickstream/clickstream-enwiki-2023-06.tsv.gz,Dune_(2021_film),67491,250327,4868,322686,224842
hdfs://spark-nn.eemcs.utwente.nl/user/s1934538/clickstream/clickstream-enwiki-2023-06.tsv.gz,Kylian_Mbappé,67318,571384,4490,643192,113560
hdfs://spark-nn.eemcs.utwente.nl/user/s1934538/clickstream/clickstream-enwiki-2023-06.tsv.gz,Army_of_the_Dead,42584,36886,289,79759,39739
hdfs://spark-nn.eemcs.utwente.nl/user/s1934538/clickstream/clickstream-enwiki-2023-06.tsv.gz,NATO,68355,220070,5700,294125,142927
hdfs://spark-nn.eemcs.utwente.nl/user/s1934538/clickstream/clickstream-enwiki-2023-06.tsv.gz,Parasite_(2019_film),21170,119926,1121,142217,55199
hdfs://spark-nn.eemcs.utwente.nl/user/s1934538/clickstream/clickstream-enwiki-2023-06.tsv.gz,Vivek_Ramaswamy,27587,434013,1944,463544,97992
hdfs://spark-nn.eemcs.utwente.nl/user/s1934538/clickstream/clickstream-enwiki-2023-06.tsv.gz,Critical_race_theory,19632,76526,596,96754,11726
hdfs://spark-nn.eemcs.utwente.nl/user/s1934538/clickstream/clickstream-enwiki-2023-06.tsv.gz,Kobe_Bryant_sexual_assault_case,9160,48917,63,58140,6119
hdfs://spark-nn.eemcs.utwente.nl/user/s1934538/clickstream/clickstream-enwiki-2023-06.tsv.gz,XXXTentacion,61047,1335572,5622,1402241,113486
hdfs://spark-nn.eemcs.utwente.nl/user/s1934538/clickstream/clickstream-enwiki-2023-06.tsv.gz,Oppenheimer_(film),189143,911240,19415,1119798,884217
hdfs://spark-nn.eemcs.utwente.nl/user/s1934538/clickstream/clickstream-enwiki-2023-06.tsv.gz,The_Sandman_(TV_series),34846,67466,1146,103458,61815
hdfs://spark-nn.eemcs.utwente.nl/user/s1934538/clickstream/clickstream-enwiki-2023-06.tsv.gz,Us_(2019_film),21281,57104,265,78650,23317
hdfs://spark-nn.eemcs.utwente.nl/user/s1934538/clickstream/clickstream-enwiki-2023-06.tsv.gz,Rishi_Sunak,118110,261753,1949,381812,188720
hdfs://spark-nn.eemcs.utwente.nl/user/s1934538/clickstream/clickstream-enwiki-2023-06.tsv.gz,Chernobyl_disaster,62192,328567,3154,393913,194806
hdfs://spark-nn.eemcs.utwente.nl/user/s1934538/clickstream/clickstream-enwiki-2023-06.tsv.gz,COVID-19_pandemic_by_country_and_territory,6014,19447,644,26105,9890
hdfs://spark-nn.eemcs.utwente.nl/user/s1934538/clickstream/clickstream-enwiki-2023-06.tsv.gz,1917_(2019_film),16051,58758,1142,75951,43032
hdfs://spark-nn.eemcs.utwente.nl/user/s1934538/clickstream/clickstream-enwiki-2023-06.tsv.gz,Tunnel,4103,8254,107,12464,2877
hdfs://spark-nn.eemcs.utwente.nl/user/s1934538/clickstream/clickstream-enwiki-2023-06.tsv.gz,The_Super_Mario_Bros._Movie,248928,977801,15735,1242464,468854
hdfs://spark-nn.eemcs.utwente.nl/user/s1934538/clickstream/clickstream-enwiki-2023-06.tsv.gz,2020_Summer_Olympics,54031,44762,1064,99857,88494
hdfs://spark-nn.eemcs.utwente.nl/user/s1934538/clickstream/clickstream-enwiki-2023-06.tsv.gz,Khabib_Nurmagomedov,57811,201312,1152,260275,128729
hdfs://spark-nn.eemcs.utwente.nl/user/s1934538/clickstream/clickstream-enwiki-2023-06.tsv.gz,Sidharth_Shukla,7421,37338,271,45030,8184
hdfs://spark-nn.eemcs.utwente.nl/user/s1934538/clickstream/clickstream-enwiki-2023-06.tsv.gz,XXX:_Return_of_Xander_Cage,64283,2512857,1230,2578370,164781
hdfs://spark-nn.eemcs.utwente.nl/user/s1934538/clickstream/clickstream-enwiki-2023-06.tsv.gz,Royal_Rumble_(2018),5288,3436,34,8758,7305
hdfs://spark-nn.eemcs.utwente.nl/user/s1934538/clickstream/clickstream-enwiki-2023-06.tsv.gz,Gadar_2,60322,333619,512,394453,102958
hdfs://spark-nn.eemcs.utwente.nl/user/s1934538/clickstream/clickstream-enwiki-2023-06.tsv.gz,George_VI,290480,89587,1228,381295,276174
hdfs://spark-nn.eemcs.utwente.nl/user/s1934538/clickstream/clickstream-enwiki-2023-06.tsv.gz,Key_frame,598,2798,18,3414,293
hdfs://spark-nn.eemcs.utwente.nl/user/s1934538/clickstream/clickstream-enwiki-2023-06.tsv.gz,Aaron_Hernandez,8247,91133,581,99961,39126
hdfs://spark-nn.eemcs.utwente.nl/user/s1934538/clickstream/clickstream-enwiki-2023-06.tsv.gz,Rihanna,68077,269372,2863,340312,194820
hdfs://spark-nn.eemcs.utwente.nl/user/s1934538/clickstream/clickstream-enwiki-2023-06.tsv.gz,Qasem_Soleimani,14832,23523,227,38582,21981
hdfs://spark-nn.eemcs.utwente.nl/user/s1934538/clickstream/clickstream-enwiki-2023-06.tsv.gz,Michael_Bloomberg,30043,31972,152,62167,29623
hdfs://spark-nn.eemcs.utwente.nl/user/s1934538/clickstream/clickstream-enwiki-2023-06.tsv.gz,Black_Widow_(2021_film),38201,77248,836,116285,47129
hdfs://spark-nn.eemcs.utwente.nl/user/s1934538/clickstream/clickstream-enwiki-2023-06.tsv.gz,Sinéad_O'Connor,16625,154999,940,172564,61079
hdfs://spark-nn.eemcs.utwente.nl/user/s1934538/clickstream/clickstream-enwiki-2023-06.tsv.gz,Carlos_Alcaraz,88541,680613,2598,771752,175941
hdfs://spark-nn.eemcs.utwente.nl/user/s1934538/clickstream/clickstream-enwiki-2023-06.tsv.gz,Adipurush,210796,5089102,19892,5319790,2178103
hdfs://spark-nn.eemcs.utwente.nl/user/s1934538/clickstream/clickstream-enwiki-2023-06.tsv.gz,Michael_Jordan,165434,904828,7333,1077595,396398
hdfs://spark-nn.eemcs.utwente.nl/user/s1934538/clickstream/clickstream-enwiki-2023-06.tsv.gz,John_McCain,31458,57699,690,89847,48080
hdfs://spark-nn.eemcs.utwente.nl/user/s1934538/clickstream/clickstream-enwiki-2023-06.tsv.gz,Deion_Sanders,15159,165806,1227,182192,39067
hdfs://spark-nn.eemcs.utwente.nl/user/s1934538/clickstream/clickstream-enwiki-2023-06.tsv.gz,Area_51,19984,134496,1076,155556,52903
hdfs://spark-nn.eemcs.utwente.nl/user/s1934538/clickstream/clickstream-enwiki-2023-06.tsv.gz,Saaho,45105,52343,89,97537,23026
hdfs://spark-nn.eemcs.utwente.nl/user/s1934538/clickstream/clickstream-enwiki-2023-06.tsv.gz,Deaths_in_2023,1496430,2503964,16450,4016844,2399380
hdfs://spark-nn.eemcs.utwente.nl/user/s1934538/clickstream/clickstream-enwiki-2023-06.tsv.gz,Richard_Ramirez,16195,142254,1086,159535,48190
hdfs://spark-nn.eemcs.utwente.nl/user/s1934538/clickstream/clickstream-enwiki-2023-06.tsv.gz,2020_United_States_presidential_election,145324,165404,3987,314715,315949
hdfs://spark-nn.eemcs.utwente.nl/user/s1934538/clickstream/clickstream-enwiki-2023-06.tsv.gz,A_Star_Is_Born_(2018_film),25847,89051,616,115514,57515
hdfs://spark-nn.eemcs.utwente.nl/user/s1934538/clickstream/clickstream-enwiki-2023-06.tsv.gz,Vikram_(2022_film),43800,148410,255,192465,68274
hdfs://spark-nn.eemcs.utwente.nl/user/s1934538/clickstream/clickstream-enwiki-2023-06.tsv.gz,21_Savage,17196,74431,616,92243,30633
hdfs://spark-nn.eemcs.utwente.nl/user/s1934538/clickstream/clickstream-enwiki-2023-06.tsv.gz,Leave_the_World_Behind_(film),14765,4442,39,19246,5922
hdfs://spark-nn.eemcs.utwente.nl/user/s1934538/clickstream/clickstream-enwiki-2023-06.tsv.gz,Fantastic_Beasts:_The_Crimes_of_Grindelwald,37504,43558,361,81423,45199
hdfs://spark-nn.eemcs.utwente.nl/user/s1934538/clickstream/clickstream-enwiki-2023-06.tsv.gz,Wonder_Woman_1984,38927,42627,856,82410,33738
hdfs://spark-nn.eemcs.utwente.nl/user/s1934538/clickstream/clickstream-enwiki-2023-06.tsv.gz,Taliban,38868,60075,697,99640,79593
hdfs://spark-nn.eemcs.utwente.nl/user/s1934538/clickstream/clickstream-enwiki-2023-06.tsv.gz,The_Umbrella_Academy_(TV_series),30843,83719,1514,116076,67633
hdfs://spark-nn.eemcs.utwente.nl/user/s1934538/clickstream/clickstream-enwiki-2023-06.tsv.gz,Bonnie_and_Clyde,21096,189643,1071,211810,54323
hdfs://spark-nn.eemcs.utwente.nl/user/s1934538/clickstream/clickstream-enwiki-2023-06.tsv.gz,Bipin_Rawat,6434,16974,25,23433,9429
hdfs://spark-nn.eemcs.utwente.nl/user/s1934538/clickstream/clickstream-enwiki-2023-06.tsv.gz,United_States_Senate,51483,46518,598,98599,45184
hdfs://spark-nn.eemcs.utwente.nl/user/s1934538/clickstream/clickstream-enwiki-2023-06.tsv.gz,2022_FIFA_World_Cup,181462,230488,3750,415700,273352
hdfs://spark-nn.eemcs.utwente.nl/user/s1934538/clickstream/clickstream-enwiki-2023-06.tsv.gz,Hamilton_(musical),27796,143204,1217,172217,107492
hdfs://spark-nn.eemcs.utwente.nl/user/s1934538/clickstream/clickstream-enwiki-2023-06.tsv.gz,Bible,20306,98108,3736,122150,36500
hdfs://spark-nn.eemcs.utwente.nl/user/s1934538/clickstream/clickstream-enwiki-2023-06.tsv.gz,K.G.F:_Chapter_2,33351,145120,656,179127,41553
hdfs://spark-nn.eemcs.utwente.nl/user/s1934538/clickstream/clickstream-enwiki-2023-06.tsv.gz,Spider-Man:_No_Way_Home,141246,234698,5286,381230,173740
hdfs://spark-nn.eemcs.utwente.nl/user/s1934538/clickstream/clickstream-enwiki-2023-06.tsv.gz,Cricket_World_Cup,65971,205604,1298,272873,119921
hdfs://spark-nn.eemcs.utwente.nl/user/s1934538/clickstream/clickstream-enwiki-2023-06.tsv.gz,George_H._W._Bush,159022,121835,932,281789,171661
hdfs://spark-nn.eemcs.utwente.nl/user/s1934538/clickstream/clickstream-enwiki-2023-06.tsv.gz,Nipsey_Hussle,26264,71915,488,98667,31489
hdfs://spark-nn.eemcs.utwente.nl/user/s1934538/clickstream/clickstream-enwiki-2023-06.tsv.gz,Tom_Brady,46606,237092,1883,285581,105593
hdfs://spark-nn.eemcs.utwente.nl/user/s1934538/clickstream/clickstream-enwiki-2023-06.tsv.gz,Louis_Tomlinson,33934,74251,411,108596,31692
hdfs://spark-nn.eemcs.utwente.nl/user/s1934538/clickstream/clickstream-enwiki-2023-06.tsv.gz,List_of_highest-grossing_Indian_films,78652,283695,1205,363552,208659
hdfs://spark-nn.eemcs.utwente.nl/user/s1934538/clickstream/clickstream-enwiki-2023-06.tsv.gz,The_Flash_(film),347471,3503821,122174,3973466,2187330
hdfs://spark-nn.eemcs.utwente.nl/user/s1934538/clickstream/clickstream-enwiki-2023-06.tsv.gz,Notre-Dame_de_Paris,12691,75522,721,88934,19009
hdfs://spark-nn.eemcs.utwente.nl/user/s1934538/clickstream/clickstream-enwiki-2023-06.tsv.gz,Tonya_Harding,23857,111599,501,135957,35946
hdfs://spark-nn.eemcs.utwente.nl/user/s1934538/clickstream/clickstream-enwiki-2023-06.tsv.gz,Christopher_Scarver,56436,34570,25,91031,33483
hdfs://spark-nn.eemcs.utwente.nl/user/s1934538/clickstream/clickstream-enwiki-2023-06.tsv.gz,COVID-19_pandemic,87237,200775,5344,293356,93743
hdfs://spark-nn.eemcs.utwente.nl/user/s1934538/clickstream/clickstream-enwiki-2023-06.tsv.gz,Simple_Mail_Transfer_Protocol,2310,24242,116,26668,2615
hdfs://spark-nn.eemcs.utwente.nl/user/s1934538/clickstream/clickstream-enwiki-2023-06.tsv.gz,Sushant_Singh_Rajput,21140,195924,201,217265,70078
hdfs://spark-nn.eemcs.utwente.nl/user/s1934538/clickstream/clickstream-enwiki-2023-06.tsv.gz,Saltburn_(film),14092,7221,249,21562,10981
hdfs://spark-nn.eemcs.utwente.nl/user/s1934538/clickstream/clickstream-enwiki-2023-06.tsv.gz,Joaquin_Phoenix,141340,147218,703,289261,183148
hdfs://spark-nn.eemcs.utwente.nl/user/s1934538/clickstream/clickstream-enwiki-2023-06.tsv.gz,Bird_Box_(film),20402,135034,1366,156802,76969
hdfs://spark-nn.eemcs.utwente.nl/user/s1934538/clickstream/clickstream-enwiki-2023-06.tsv.gz,Guardians_of_the_Galaxy_Vol._3,283983,1758389,19915,2062287,554337
hdfs://spark-nn.eemcs.utwente.nl/user/s1934538/clickstream/clickstream-enwiki-2023-06.tsv.gz,War_(2019_film),26445,47190,6173,79808,25138
hdfs://spark-nn.eemcs.utwente.nl/user/s1934538/clickstream/clickstream-enwiki-2023-06.tsv.gz,Top_Gun:_Maverick,109442,204962,4005,318409,223216
hdfs://spark-nn.eemcs.utwente.nl/user/s1934538/clickstream/clickstream-enwiki-2023-06.tsv.gz,Anna_Sorokin,11406,151978,437,163821,54008
hdfs://spark-nn.eemcs.utwente.nl/user/s1934538/clickstream/clickstream-enwiki-2023-06.tsv.gz,2.0_(film),28029,37184,80,65293,14964
hdfs://spark-nn.eemcs.utwente.nl/user/s1934538/clickstream/clickstream-enwiki-2023-06.tsv.gz,Sushma_Swaraj,10649,28053,20,38722,10075
hdfs://spark-nn.eemcs.utwente.nl/user/s1934538/clickstream/clickstream-enwiki-2023-06.tsv.gz,Article_370_of_the_Constitution_of_India,2986,55096,12,58094,2902
hdfs://spark-nn.eemcs.utwente.nl/user/s1934538/clickstream/clickstream-enwiki-2023-06.tsv.gz,Keanu_Reeves,110215,649394,3994,763603,470357
hdfs://spark-nn.eemcs.utwente.nl/user/s1934538/clickstream/clickstream-enwiki-2023-06.tsv.gz,Israel,84276,266901,4509,355686,173020
hdfs://spark-nn.eemcs.utwente.nl/user/s1934538/clickstream/clickstream-enwiki-2023-06.tsv.gz,Aaron_Carter,23403,79068,605,103076,65220
hdfs://spark-nn.eemcs.utwente.nl/user/s1934538/clickstream/clickstream-enwiki-2023-06.tsv.gz,Juice_Wrld,31737,159957,1908,193602,79402
hdfs://spark-nn.eemcs.utwente.nl/user/s1934538/clickstream/clickstream-enwiki-2023-06.tsv.gz,Brahmāstra:_Part_One_–_Shiva,46869,102485,643,149997,36326
hdfs://spark-nn.eemcs.utwente.nl/user/s1934538/clickstream/clickstream-enwiki-2023-06.tsv.gz,Hamas,26304,23763,253,50320,29133
hdfs://spark-nn.eemcs.utwente.nl/user/s1934538/clickstream/clickstream-enwiki-2023-06.tsv.gz,Tenet_(film),75207,116700,1178,193085,87694
hdfs://spark-nn.eemcs.utwente.nl/user/s1934538/clickstream/clickstream-enwiki-2023-06.tsv.gz,2023_Indian_Premier_League,12500,190851,10110,213461,26923
hdfs://spark-nn.eemcs.utwente.nl/user/s1934538/clickstream/clickstream-enwiki-2023-06.tsv.gz,Joker_(2019_film),47006,119191,1197,167394,74547
hdfs://spark-nn.eemcs.utwente.nl/user/s1934538/clickstream/clickstream-enwiki-2023-06.tsv.gz,Captain_Marvel_(film),34445,96026,1374,131845,64548
hdfs://spark-nn.eemcs.utwente.nl/user/s1934538/clickstream/clickstream-enwiki-2023-07.tsv.gz,Tonya_Harding,46533,159554,699,206786,59557
hdfs://spark-nn.eemcs.utwente.nl/user/s1934538/clickstream/clickstream-enwiki-2023-07.tsv.gz,Mulan_(2020_film),28419,99334,1452,129205,74615
hdfs://spark-nn.eemcs.utwente.nl/user/s1934538/clickstream/clickstream-enwiki-2023-07.tsv.gz,Joker_(2019_film),61982,154055,2117,218154,104675
hdfs://spark-nn.eemcs.utwente.nl/user/s1934538/clickstream/clickstream-enwiki-2023-07.tsv.gz,Cardi_B,29391,250355,2702,282448,85865
hdfs://spark-nn.eemcs.utwente.nl/user/s1934538/clickstream/clickstream-enwiki-2023-07.tsv.gz,Qasem_Soleimani,13601,19763,279,33643,21601
hdfs://spark-nn.eemcs.utwente.nl/user/s1934538/clickstream/clickstream-enwiki-2023-07.tsv.gz,Shakira,21610,303492,3163,328265,128602
hdfs://spark-nn.eemcs.utwente.nl/user/s1934538/clickstream/clickstream-enwiki-2023-07.tsv.gz,Sinéad_O'Connor,304932,8525207,17200,8847339,3039439
hdfs://spark-nn.eemcs.utwente.nl/user/s1934538/clickstream/clickstream-enwiki-2023-07.tsv.gz,ICC_Men's_T20_World_Cup,19825,113454,994,134273,79528
hdfs://spark-nn.eemcs.utwente.nl/user/s1934538/clickstream/clickstream-enwiki-2023-07.tsv.gz,Cameron_Boyce,27721,183565,550,211836,55877
hdfs://spark-nn.eemcs.utwente.nl/user/s1934538/clickstream/clickstream-enwiki-2023-07.tsv.gz,Khabib_Nurmagomedov,67778,200214,1225,269217,137932
hdfs://spark-nn.eemcs.utwente.nl/user/s1934538/clickstream/clickstream-enwiki-2023-07.tsv.gz,Johnny_Depp,155968,351724,3057,510749,324538
hdfs://spark-nn.eemcs.utwente.nl/user/s1934538/clickstream/clickstream-enwiki-2023-07.tsv.gz,Charles_Sobhraj,9562,69341,87,78990,14233
hdfs://spark-nn.eemcs.utwente.nl/user/s1934538/clickstream/clickstream-enwiki-2023-07.tsv.gz,United_States_Senate,60465,43517,744,104726,48475
hdfs://spark-nn.eemcs.utwente.nl/user/s1934538/clickstream/clickstream-enwiki-2023-07.tsv.gz,Animal_(2023_film),47002,57333,59,104394,49468
hdfs://spark-nn.eemcs.utwente.nl/user/s1934538/clickstream/clickstream-enwiki-2023-07.tsv.gz,21_Savage,28711,98055,653,127419,39215
hdfs://spark-nn.eemcs.utwente.nl/user/s1934538/clickstream/clickstream-enwiki-2023-07.tsv.gz,Everything_Everywhere_All_at_Once,91043,240110,3435,334588,154204
hdfs://spark-nn.eemcs.utwente.nl/user/s1934538/clickstream/clickstream-enwiki-2023-07.tsv.gz,No_Time_to_Die,119356,128598,1949,249903,132302
hdfs://spark-nn.eemcs.utwente.nl/user/s1934538/clickstream/clickstream-enwiki-2023-07.tsv.gz,Tunnel,5201,9474,1503,16178,4448
hdfs://spark-nn.eemcs.utwente.nl/user/s1934538/clickstream/clickstream-enwiki-2023-07.tsv.gz,The_Kashmir_Files,10654,36100,90,46844,17712
hdfs://spark-nn.eemcs.utwente.nl/user/s1934538/clickstream/clickstream-enwiki-2023-07.tsv.gz,Hyphen-minus,898,6775323,22364,6798585,813
hdfs://spark-nn.eemcs.utwente.nl/user/s1934538/clickstream/clickstream-enwiki-2023-07.tsv.gz,QAnon,236512,552057,2332,790901,188668
hdfs://spark-nn.eemcs.utwente.nl/user/s1934538/clickstream/clickstream-enwiki-2023-07.tsv.gz,Kobe_Bryant,61805,350944,2631,415380,122206
hdfs://spark-nn.eemcs.utwente.nl/user/s1934538/clickstream/clickstream-enwiki-2023-07.tsv.gz,Sylvester_Stallone,123898,526529,3720,654147,473240
hdfs://spark-nn.eemcs.utwente.nl/user/s1934538/clickstream/clickstream-enwiki-2023-07.tsv.gz,Irrfan_Khan,30706,64326,206,95238,35674
hdfs://spark-nn.eemcs.utwente.nl/user/s1934538/clickstream/clickstream-enwiki-2023-07.tsv.gz,Kelly_Preston,92346,115360,567,208273,64705
hdfs://spark-nn.eemcs.utwente.nl/user/s1934538/clickstream/clickstream-enwiki-2023-07.tsv.gz,Lists_of_deaths_by_year,18933,209559,774,229266,254515
hdfs://spark-nn.eemcs.utwente.nl/user/s1934538/clickstream/clickstream-enwiki-2023-07.tsv.gz,Oppenheimer_(film),1733283,11859457,235102,13827842,14713200
hdfs://spark-nn.eemcs.utwente.nl/user/s1934538/clickstream/clickstream-enwiki-2023-07.tsv.gz,XNXX,11619,494175,7974,513768,40073
hdfs://spark-nn.eemcs.utwente.nl/user/s1934538/clickstream/clickstream-enwiki-2023-07.tsv.gz,Doctor_Strange_in_the_Multiverse_of_Madness,71525,108341,1766,181632,81080
hdfs://spark-nn.eemcs.utwente.nl/user/s1934538/clickstream/clickstream-enwiki-2023-07.tsv.gz,Article_370_of_the_Constitution_of_India,3447,69813,60,73320,3914
hdfs://spark-nn.eemcs.utwente.nl/user/s1934538/clickstream/clickstream-enwiki-2023-07.tsv.gz,Dark_Phoenix_(film),48301,41436,501,90238,48939
hdfs://spark-nn.eemcs.utwente.nl/user/s1934538/clickstream/clickstream-enwiki-2023-07.tsv.gz,Spider-Man:_No_Way_Home,111667,161047,1903,274617,118074
hdfs://spark-nn.eemcs.utwente.nl/user/s1934538/clickstream/clickstream-enwiki-2023-07.tsv.gz,Kobe_Bryant_sexual_assault_case,7745,32500,94,40339,4342
hdfs://spark-nn.eemcs.utwente.nl/user/s1934538/clickstream/clickstream-enwiki-2023-07.tsv.gz,Pelé,38836,173713,1766,214315,77759
hdfs://spark-nn.eemcs.utwente.nl/user/s1934538/clickstream/clickstream-enwiki-2023-07.tsv.gz,Elon_Musk,225050,1371325,12808,1609183,943331
hdfs://spark-nn.eemcs.utwente.nl/user/s1934538/clickstream/clickstream-enwiki-2023-07.tsv.gz,The_Nun_(2018_film),51192,173596,1632,226420,153197
hdfs://spark-nn.eemcs.utwente.nl/user/s1934538/clickstream/clickstream-enwiki-2023-07.tsv.gz,R._Kelly,36491,133117,1465,171073,93878
hdfs://spark-nn.eemcs.utwente.nl/user/s1934538/clickstream/clickstream-enwiki-2023-07.tsv.gz,Zack_Snyder's_Justice_League,74794,109015,670,184479,76382
hdfs://spark-nn.eemcs.utwente.nl/user/s1934538/clickstream/clickstream-enwiki-2023-07.tsv.gz,2.0_(film),29865,39001,31,68897,15351
hdfs://spark-nn.eemcs.utwente.nl/user/s1934538/clickstream/clickstream-enwiki-2023-07.tsv.gz,Olivia_Newton-John,39723,130082,1346,171151,71664
hdfs://spark-nn.eemcs.utwente.nl/user/s1934538/clickstream/clickstream-enwiki-2023-07.tsv.gz,2023_Cricket_World_Cup,99859,644994,1308,746161,193390
hdfs://spark-nn.eemcs.utwente.nl/user/s1934538/clickstream/clickstream-enwiki-2023-07.tsv.gz,WandaVision,22655,44967,730,68352,33271
hdfs://spark-nn.eemcs.utwente.nl/user/s1934538/clickstream/clickstream-enwiki-2023-07.tsv.gz,Adele,31005,175382,1905,208292,81902
hdfs://spark-nn.eemcs.utwente.nl/user/s1934538/clickstream/clickstream-enwiki-2023-07.tsv.gz,Black_Panther_(film),33178,89827,799,123804,52671
hdfs://spark-nn.eemcs.utwente.nl/user/s1934538/clickstream/clickstream-enwiki-2023-07.tsv.gz,Freddie_Mercury,92533,506451,3288,602272,247066
hdfs://spark-nn.eemcs.utwente.nl/user/s1934538/clickstream/clickstream-enwiki-2023-07.tsv.gz,Area_51,24136,155410,1644,181190,62017
hdfs://spark-nn.eemcs.utwente.nl/user/s1934538/clickstream/clickstream-enwiki-2023-07.tsv.gz,2020_United_States_presidential_election,147337,167243,3839,318419,326914
hdfs://spark-nn.eemcs.utwente.nl/user/s1934538/clickstream/clickstream-enwiki-2023-07.tsv.gz,Amy_Coney_Barrett,30853,38615,235,69703,24467
hdfs://spark-nn.eemcs.utwente.nl/user/s1934538/clickstream/clickstream-enwiki-2023-07.tsv.gz,Central_Park_jogger_case,12449,71935,445,84829,23374
hdfs://spark-nn.eemcs.utwente.nl/user/s1934538/clickstream/clickstream-enwiki-2023-07.tsv.gz,Betty_White,46317,122876,1043,170236,47049
hdfs://spark-nn.eemcs.utwente.nl/user/s1934538/clickstream/clickstream-enwiki-2023-07.tsv.gz,Star_Wars:_The_Rise_of_Skywalker,86019,49416,1007,136442,68445
hdfs://spark-nn.eemcs.utwente.nl/user/s1934538/clickstream/clickstream-enwiki-2023-07.tsv.gz,Spider-Man:_Far_From_Home,47565,59957,469,107991,46188
hdfs://spark-nn.eemcs.utwente.nl/user/s1934538/clickstream/clickstream-enwiki-2023-07.tsv.gz,List_of_highest-grossing_films,205011,476170,5219,686400,399593
hdfs://spark-nn.eemcs.utwente.nl/user/s1934538/clickstream/clickstream-enwiki-2023-07.tsv.gz,The_Haunting_of_Bly_Manor,16718,36814,296,53828,28787
hdfs://spark-nn.eemcs.utwente.nl/user/s1934538/clickstream/clickstream-enwiki-2023-07.tsv.gz,Naomi_Osaka,54360,152844,957,208161,68102
hdfs://spark-nn.eemcs.utwente.nl/user/s1934538/clickstream/clickstream-enwiki-2023-07.tsv.gz,Joaquin_Phoenix,190979,250401,3357,444737,301793
hdfs://spark-nn.eemcs.utwente.nl/user/s1934538/clickstream/clickstream-enwiki-2023-07.tsv.gz,Pathaan_(film),69761,302263,4492,376516,102107
hdfs://spark-nn.eemcs.utwente.nl/user/s1934538/clickstream/clickstream-enwiki-2023-07.tsv.gz,The_Mandalorian,44971,127827,2420,175218,122057
hdfs://spark-nn.eemcs.utwente.nl/user/s1934538/clickstream/clickstream-enwiki-2023-07.tsv.gz,Hamilton_(musical),25105,140009,1242,166356,115533
hdfs://spark-nn.eemcs.utwente.nl/user/s1934538/clickstream/clickstream-enwiki-2023-07.tsv.gz,Game_of_Thrones,69989,309354,5811,385154,211382
hdfs://spark-nn.eemcs.utwente.nl/user/s1934538/clickstream/clickstream-enwiki-2023-07.tsv.gz,The_Suicide_Squad_(film),100880,126008,1365,228253,119848
hdfs://spark-nn.eemcs.utwente.nl/user/s1934538/clickstream/clickstream-enwiki-2023-07.tsv.gz,Saaho,27069,40229,85,67383,18412
hdfs://spark-nn.eemcs.utwente.nl/user/s1934538/clickstream/clickstream-enwiki-2023-07.tsv.gz,1234,83,2505,28,2616,226
hdfs://spark-nn.eemcs.utwente.nl/user/s1934538/clickstream/clickstream-enwiki-2023-07.tsv.gz,Watts_family_murders,5775,146915,457,153147,47585
hdfs://spark-nn.eemcs.utwente.nl/user/s1934538/clickstream/clickstream-enwiki-2023-07.tsv.gz,Stephen_Hawking,24962,324984,1908,351854,130439
hdfs://spark-nn.eemcs.utwente.nl/user/s1934538/clickstream/clickstream-enwiki-2023-07.tsv.gz,2018_Winter_Olympics,11925,7691,76,19692,13064
hdfs://spark-nn.eemcs.utwente.nl/user/s1934538/clickstream/clickstream-enwiki-2023-07.tsv.gz,Charles_III,360874,238132,3351,602357,392885
hdfs://spark-nn.eemcs.utwente.nl/user/s1934538/clickstream/clickstream-enwiki-2023-07.tsv.gz,Vikram_(2022_film),47718,141414,294,189426,71163
hdfs://spark-nn.eemcs.utwente.nl/user/s1934538/clickstream/clickstream-enwiki-2023-07.tsv.gz,Bonnie_and_Clyde,23695,214261,2114,240070,71857
hdfs://spark-nn.eemcs.utwente.nl/user/s1934538/clickstream/clickstream-enwiki-2023-07.tsv.gz,XHamster,6976,213115,6307,226398,23604
hdfs://spark-nn.eemcs.utwente.nl/user/s1934538/clickstream/clickstream-enwiki-2023-07.tsv.gz,Eternals_(film),59001,95945,1411,156357,104861
hdfs://spark-nn.eemcs.utwente.nl/user/s1934538/clickstream/clickstream-enwiki-2023-07.tsv.gz,Hamas,32586,27856,262,60704,36143
hdfs://spark-nn.eemcs.utwente.nl/user/s1934538/clickstream/clickstream-enwiki-2023-07.tsv.gz,FIFA_World_Cup,92964,423394,4384,520742,228362
hdfs://spark-nn.eemcs.utwente.nl/user/s1934538/clickstream/clickstream-enwiki-2023-07.tsv.gz,Asia_Cup,24133,146320,397,170850,51539
hdfs://spark-nn.eemcs.utwente.nl/user/s1934538/clickstream/clickstream-enwiki-2023-07.tsv.gz,Elliot_Page,76890,293091,1757,371738,169891
hdfs://spark-nn.eemcs.utwente.nl/user/s1934538/clickstream/clickstream-enwiki-2023-07.tsv.gz,Chernobyl_disaster,51294,265759,2888,319941,160636
hdfs://spark-nn.eemcs.utwente.nl/user/s1934538/clickstream/clickstream-enwiki-2023-07.tsv.gz,Chadwick_Boseman,34894,127708,565,163167,45638
hdfs://spark-nn.eemcs.utwente.nl/user/s1934538/clickstream/clickstream-enwiki-2023-07.tsv.gz,COVID-19_pandemic_by_country_and_territory,5820,17172,566,23558,10602
hdfs://spark-nn.eemcs.utwente.nl/user/s1934538/clickstream/clickstream-enwiki-2023-07.tsv.gz,Nipsey_Hussle,22137,76753,569,99459,32633
hdfs://spark-nn.eemcs.utwente.nl/user/s1934538/clickstream/clickstream-enwiki-2023-07.tsv.gz,Mötley_Crüe,31263,102723,1736,135722,162368
hdfs://spark-nn.eemcs.utwente.nl/user/s1934538/clickstream/clickstream-enwiki-2023-07.tsv.gz,War_(2019_film),28142,44037,130,72309,20205
hdfs://spark-nn.eemcs.utwente.nl/user/s1934538/clickstream/clickstream-enwiki-2023-07.tsv.gz,The_Kerala_Story,25524,212316,577,238417,38208
hdfs://spark-nn.eemcs.utwente.nl/user/s1934538/clickstream/clickstream-enwiki-2023-07.tsv.gz,Brett_Kavanaugh,26662,26849,161,53672,21989
hdfs://spark-nn.eemcs.utwente.nl/user/s1934538/clickstream/clickstream-enwiki-2023-07.tsv.gz,Chernobyl_(miniseries),21908,71488,1668,95064,108161
hdfs://spark-nn.eemcs.utwente.nl/user/s1934538/clickstream/clickstream-enwiki-2023-07.tsv.gz,Salaar:_Part_1_–_Ceasefire,81785,413025,1628,496438,155723
hdfs://spark-nn.eemcs.utwente.nl/user/s1934538/clickstream/clickstream-enwiki-2023-07.tsv.gz,Google_logo,1478,22233,202,23913,1584
hdfs://spark-nn.eemcs.utwente.nl/user/s1934538/clickstream/clickstream-enwiki-2023-07.tsv.gz,The_Last_of_Us_(TV_series),60678,331379,5436,397493,168059
hdfs://spark-nn.eemcs.utwente.nl/user/s1934538/clickstream/clickstream-enwiki-2023-07.tsv.gz,The_Sandman_(TV_series),36039,74164,1954,112157,71709
hdfs://spark-nn.eemcs.utwente.nl/user/s1934538/clickstream/clickstream-enwiki-2023-07.tsv.gz,Stranger_Things_(season_3),11300,23434,194,34928,18980
hdfs://spark-nn.eemcs.utwente.nl/user/s1934538/clickstream/clickstream-enwiki-2023-07.tsv.gz,Godzilla_vs._Kong,43442,70430,909,114781,62417
hdfs://spark-nn.eemcs.utwente.nl/user/s1934538/clickstream/clickstream-enwiki-2023-07.tsv.gz,Stan_Lee,46925,150010,848,197783,65587
hdfs://spark-nn.eemcs.utwente.nl/user/s1934538/clickstream/clickstream-enwiki-2023-07.tsv.gz,Rihanna,73911,271527,2989,348427,192587
hdfs://spark-nn.eemcs.utwente.nl/user/s1934538/clickstream/clickstream-enwiki-2023-07.tsv.gz,Spanish_flu,17361,35153,328,52842,15083
hdfs://spark-nn.eemcs.utwente.nl/user/s1934538/clickstream/clickstream-enwiki-2023-07.tsv.gz,ChatGPT,28706,2877934,4748,2911388,184954
hdfs://spark-nn.eemcs.utwente.nl/user/s1934538/clickstream/clickstream-enwiki-2023-07.tsv.gz,Rishi_Sunak,122834,266145,1993,390972,201188
hdfs://spark-nn.eemcs.utwente.nl/user/s1934538/clickstream/clickstream-enwiki-2023-07.tsv.gz,"Meghan,_Duchess_of_Sussex",146573,682048,1799,830420,432459
hdfs://spark-nn.eemcs.utwente.nl/user/s1934538/clickstream/clickstream-enwiki-2023-07.tsv.gz,Lance_Reddick,65372,191172,763,257307,61744
hdfs://spark-nn.eemcs.utwente.nl/user/s1934538/clickstream/clickstream-enwiki-2023-07.tsv.gz,Death_of_Elisa_Lam,10601,51272,307,62180,20122
hdfs://spark-nn.eemcs.utwente.nl/user/s1934538/clickstream/clickstream-enwiki-2023-07.tsv.gz,Tiger_3,79186,72777,655,152618,88154
hdfs://spark-nn.eemcs.utwente.nl/user/s1934538/clickstream/clickstream-enwiki-2023-07.tsv.gz,Valentine's_Day,3580,35315,108,39003,3107
hdfs://spark-nn.eemcs.utwente.nl/user/s1934538/clickstream/clickstream-enwiki-2023-07.tsv.gz,Gadar_2,66572,345142,1041,412755,222920
hdfs://spark-nn.eemcs.utwente.nl/user/s1934538/clickstream/clickstream-enwiki-2023-07.tsv.gz,Donald_Glover,50538,146410,1257,198205,87712
hdfs://spark-nn.eemcs.utwente.nl/user/s1934538/clickstream/clickstream-enwiki-2023-07.tsv.gz,Anna_Sorokin,12690,102418,290,115398,41251
hdfs://spark-nn.eemcs.utwente.nl/user/s1934538/clickstream/clickstream-enwiki-2023-07.tsv.gz,Ant-Man_and_the_Wasp:_Quantumania,107747,175177,4746,287670,164465
hdfs://spark-nn.eemcs.utwente.nl/user/s1934538/clickstream/clickstream-enwiki-2023-07.tsv.gz,Cristiano_Ronaldo,183499,1144135,6190,1333824,333972
hdfs://spark-nn.eemcs.utwente.nl/user/s1934538/clickstream/clickstream-enwiki-2023-07.tsv.gz,It_Chapter_Two,33435,42608,493,76536,45438
hdfs://spark-nn.eemcs.utwente.nl/user/s1934538/clickstream/clickstream-enwiki-2023-07.tsv.gz,Sridevi,38833,95205,176,134214,67637
hdfs://spark-nn.eemcs.utwente.nl/user/s1934538/clickstream/clickstream-enwiki-2023-07.tsv.gz,Meat_Loaf,22869,90843,911,114623,43153
hdfs://spark-nn.eemcs.utwente.nl/user/s1934538/clickstream/clickstream-enwiki-2023-07.tsv.gz,Michael_Bloomberg,33020,32097,197,65314,30525
hdfs://spark-nn.eemcs.utwente.nl/user/s1934538/clickstream/clickstream-enwiki-2023-07.tsv.gz,Cecil_Hotel_(Los_Angeles),6290,43610,94,49994,13228
hdfs://spark-nn.eemcs.utwente.nl/user/s1934538/clickstream/clickstream-enwiki-2023-07.tsv.gz,The_Witcher_(TV_series),132391,1692689,42671,1867751,1019867
hdfs://spark-nn.eemcs.utwente.nl/user/s1934538/clickstream/clickstream-enwiki-2023-07.tsv.gz,Parasite_(2019_film),24797,127225,1207,153229,59585
hdfs://spark-nn.eemcs.utwente.nl/user/s1934538/clickstream/clickstream-enwiki-2023-07.tsv.gz,Dune_(2021_film),93761,369071,7696,470528,336986
hdfs://spark-nn.eemcs.utwente.nl/user/s1934538/clickstream/clickstream-enwiki-2023-07.tsv.gz,The_Super_Mario_Bros._Movie,204070,773726,12593,990389,318616
hdfs://spark-nn.eemcs.utwente.nl/user/s1934538/clickstream/clickstream-enwiki-2023-07.tsv.gz,Richard_Jewell,13831,74590,307,88728,31747
hdfs://spark-nn.eemcs.utwente.nl/user/s1934538/clickstream/clickstream-enwiki-2023-07.tsv.gz,Murder_of_Dee_Dee_Blanchard,18446,74330,305,93081,23063
hdfs://spark-nn.eemcs.utwente.nl/user/s1934538/clickstream/clickstream-enwiki-2023-07.tsv.gz,Anthony_Bourdain,26839,295495,2417,324751,147542
hdfs://spark-nn.eemcs.utwente.nl/user/s1934538/clickstream/clickstream-enwiki-2023-07.tsv.gz,Ukraine,91508,329090,8387,428985,197087
hdfs://spark-nn.eemcs.utwente.nl/user/s1934538/clickstream/clickstream-enwiki-2023-07.tsv.gz,Key_frame,733,2647,17,3397,343
hdfs://spark-nn.eemcs.utwente.nl/user/s1934538/clickstream/clickstream-enwiki-2023-07.tsv.gz,Us_(2019_film),23085,55423,516,79024,23115
hdfs://spark-nn.eemcs.utwente.nl/user/s1934538/clickstream/clickstream-enwiki-2023-07.tsv.gz,Kenosha_unrest_shooting,9214,26918,70,36202,9497
hdfs://spark-nn.eemcs.utwente.nl/user/s1934538/clickstream/clickstream-enwiki-2023-07.tsv.gz,Once_Upon_a_Time_in_Hollywood,150363,182242,2872,335477,336942
hdfs://spark-nn.eemcs.utwente.nl/user/s1934538/clickstream/clickstream-enwiki-2023-07.tsv.gz,The_Idol_(TV_series),105527,3271797,11776,3389100,455911
hdfs://spark-nn.eemcs.utwente.nl/user/s1934538/clickstream/clickstream-enwiki-2023-07.tsv.gz,J._Robert_Oppenheimer,2483815,11789537,60040,14333392,8049098
hdfs://spark-nn.eemcs.utwente.nl/user/s1934538/clickstream/clickstream-enwiki-2023-07.tsv.gz,Kamala_Harris,74126,189034,1351,264511,119896
hdfs://spark-nn.eemcs.utwente.nl/user/s1934538/clickstream/clickstream-enwiki-2023-07.tsv.gz,Jawan_(film),145120,656058,4000,805178,614547
hdfs://spark-nn.eemcs.utwente.nl/user/s1934538/clickstream/clickstream-enwiki-2023-07.tsv.gz,The_Lion_King_(2019_film),75117,73886,1621,150624,50994
hdfs://spark-nn.eemcs.utwente.nl/user/s1934538/clickstream/clickstream-enwiki-2023-07.tsv.gz,2020_Summer_Olympics,76853,57422,1627,135902,118504
hdfs://spark-nn.eemcs.utwente.nl/user/s1934538/clickstream/clickstream-enwiki-2023-07.tsv.gz,Deadpool_2,61018,79358,1221,141597,102601
hdfs://spark-nn.eemcs.utwente.nl/user/s1934538/clickstream/clickstream-enwiki-2023-07.tsv.gz,Simple_Mail_Transfer_Protocol,2297,22516,84,24897,2671
hdfs://spark-nn.eemcs.utwente.nl/user/s1934538/clickstream/clickstream-enwiki-2023-07.tsv.gz,Avengers:_Infinity_War,52599,72794,1028,126421,58190
hdfs://spark-nn.eemcs.utwente.nl/user/s1934538/clickstream/clickstream-enwiki-2023-07.tsv.gz,2023_Indian_Premier_League,7338,86028,72,93438,11770
hdfs://spark-nn.eemcs.utwente.nl/user/s1934538/clickstream/clickstream-enwiki-2023-07.tsv.gz,Adipurush,92056,776654,3729,872439,266597
hdfs://spark-nn.eemcs.utwente.nl/user/s1934538/clickstream/clickstream-enwiki-2023-07.tsv.gz,JSON_Web_Token,767,18483,53,19303,1661
hdfs://spark-nn.eemcs.utwente.nl/user/s1934538/clickstream/clickstream-enwiki-2023-07.tsv.gz,Venom_(2018_film),24668,110869,1369,136906,64559
hdfs://spark-nn.eemcs.utwente.nl/user/s1934538/clickstream/clickstream-enwiki-2023-07.tsv.gz,Deion_Sanders,16632,148740,924,166296,44088
hdfs://spark-nn.eemcs.utwente.nl/user/s1934538/clickstream/clickstream-enwiki-2023-07.tsv.gz,Brahmāstra:_Part_One_–_Shiva,39914,93362,209,133485,34534
hdfs://spark-nn.eemcs.utwente.nl/user/s1934538/clickstream/clickstream-enwiki-2023-07.tsv.gz,David_Beckham,119670,511581,2228,633479,285540
hdfs://spark-nn.eemcs.utwente.nl/user/s1934538/clickstream/clickstream-enwiki-2023-07.tsv.gz,Jenna_Ortega,87347,413574,3401,504322,140063
hdfs://spark-nn.eemcs.utwente.nl/user/s1934538/clickstream/clickstream-enwiki-2023-07.tsv.gz,Black_Widow_(2021_film),49800,86993,1050,137843,57541
hdfs://spark-nn.eemcs.utwente.nl/user/s1934538/clickstream/clickstream-enwiki-2023-07.tsv.gz,Line_shaft,335,864,33,1232,119
hdfs://spark-nn.eemcs.utwente.nl/user/s1934538/clickstream/clickstream-enwiki-2023-07.tsv.gz,Wikipedia,292919,1398080,595,1691594,740219
hdfs://spark-nn.eemcs.utwente.nl/user/s1934538/clickstream/clickstream-enwiki-2023-07.tsv.gz,Grover,1186,7036,37,8259,1306
hdfs://spark-nn.eemcs.utwente.nl/user/s1934538/clickstream/clickstream-enwiki-2023-07.tsv.gz,Juneteenth,9600,85825,351,95776,9865
hdfs://spark-nn.eemcs.utwente.nl/user/s1934538/clickstream/clickstream-enwiki-2023-07.tsv.gz,Greta_Thunberg,13808,250525,2060,266393,77726
hdfs://spark-nn.eemcs.utwente.nl/user/s1934538/clickstream/clickstream-enwiki-2023-07.tsv.gz,The_Queen's_Gambit_(miniseries),16104,76488,674,93266,44148
hdfs://spark-nn.eemcs.utwente.nl/user/s1934538/clickstream/clickstream-enwiki-2023-07.tsv.gz,Tom_Brady,60458,304550,5501,370509,143515
hdfs://spark-nn.eemcs.utwente.nl/user/s1934538/clickstream/clickstream-enwiki-2023-07.tsv.gz,Cook's_Country,426,2453,42,2921,686
hdfs://spark-nn.eemcs.utwente.nl/user/s1934538/clickstream/clickstream-enwiki-2023-07.tsv.gz,House_of_the_Dragon,52570,194966,4754,252290,157523
hdfs://spark-nn.eemcs.utwente.nl/user/s1934538/clickstream/clickstream-enwiki-2023-07.tsv.gz,Ponniyin_Selvan:_I,32292,113580,306,146178,77374
hdfs://spark-nn.eemcs.utwente.nl/user/s1934538/clickstream/clickstream-enwiki-2023-07.tsv.gz,Christopher_Scarver,62148,36231,18,98397,36414
hdfs://spark-nn.eemcs.utwente.nl/user/s1934538/clickstream/clickstream-enwiki-2023-07.tsv.gz,Shang-Chi_and_the_Legend_of_the_Ten_Rings,50161,91155,2536,143852,71444
hdfs://spark-nn.eemcs.utwente.nl/user/s1934538/clickstream/clickstream-enwiki-2023-07.tsv.gz,A_Star_Is_Born_(2018_film),32408,98185,941,131534,65276
hdfs://spark-nn.eemcs.utwente.nl/user/s1934538/clickstream/clickstream-enwiki-2023-07.tsv.gz,"Diana,_Princess_of_Wales",113151,233690,1930,348771,194188
hdfs://spark-nn.eemcs.utwente.nl/user/s1934538/clickstream/clickstream-enwiki-2023-07.tsv.gz,Brie_Larson,70939,164913,1073,236925,96225
hdfs://spark-nn.eemcs.utwente.nl/user/s1934538/clickstream/clickstream-enwiki-2023-07.tsv.gz,XXXTentacion,67260,1369952,5318,1442530,118344
hdfs://spark-nn.eemcs.utwente.nl/user/s1934538/clickstream/clickstream-enwiki-2023-07.tsv.gz,John_Wick:_Chapter_4,101038,416368,32313,549719,365581
hdfs://spark-nn.eemcs.utwente.nl/user/s1934538/clickstream/clickstream-enwiki-2023-07.tsv.gz,State_of_Palestine,70507,136287,245,207039,100492
hdfs://spark-nn.eemcs.utwente.nl/user/s1934538/clickstream/clickstream-enwiki-2023-07.tsv.gz,Game_of_Thrones_(season_8),14302,42749,436,57487,19604
hdfs://spark-nn.eemcs.utwente.nl/user/s1934538/clickstream/clickstream-enwiki-2023-07.tsv.gz,Army_of_the_Dead,45006,39925,438,85369,43185
hdfs://spark-nn.eemcs.utwente.nl/user/s1934538/clickstream/clickstream-enwiki-2023-07.tsv.gz,The_Umbrella_Academy_(TV_series),26752,73616,1596,101964,59604
hdfs://spark-nn.eemcs.utwente.nl/user/s1934538/clickstream/clickstream-enwiki-2023-07.tsv.gz,1917_(2019_film),20850,79071,1582,101503,51007
hdfs://spark-nn.eemcs.utwente.nl/user/s1934538/clickstream/clickstream-enwiki-2023-07.tsv.gz,Media,22,2006,163,2191,957
hdfs://spark-nn.eemcs.utwente.nl/user/s1934538/clickstream/clickstream-enwiki-2023-07.tsv.gz,Michael_Jordan,117272,627710,5690,750672,287493
hdfs://spark-nn.eemcs.utwente.nl/user/s1934538/clickstream/clickstream-enwiki-2023-07.tsv.gz,Taliban,40263,63877,767,104907,84492
hdfs://spark-nn.eemcs.utwente.nl/user/s1934538/clickstream/clickstream-enwiki-2023-07.tsv.gz,2018_FIFA_World_Cup,83933,54726,741,139400,105392
hdfs://spark-nn.eemcs.utwente.nl/user/s1934538/clickstream/clickstream-enwiki-2023-07.tsv.gz,Burt_Reynolds,61516,131250,1079,193845,95506
hdfs://spark-nn.eemcs.utwente.nl/user/s1934538/clickstream/clickstream-enwiki-2023-07.tsv.gz,Avatar:_The_Way_of_Water,145746,475541,8736,630023,334874
hdfs://spark-nn.eemcs.utwente.nl/user/s1934538/clickstream/clickstream-enwiki-2023-07.tsv.gz,Top_Gun:_Maverick,191208,288357,5616,485181,327520
hdfs://spark-nn.eemcs.utwente.nl/user/s1934538/clickstream/clickstream-enwiki-2023-07.tsv.gz,Elizabeth_II,305624,390235,3553,699412,464099
hdfs://spark-nn.eemcs.utwente.nl/user/s1934538/clickstream/clickstream-enwiki-2023-07.tsv.gz,Simone_Biles,27113,70728,437,98278,37546
hdfs://spark-nn.eemcs.utwente.nl/user/s1934538/clickstream/clickstream-enwiki-2023-07.tsv.gz,Coronavirus,4013,30313,413,34739,8552
hdfs://spark-nn.eemcs.utwente.nl/user/s1934538/clickstream/clickstream-enwiki-2023-07.tsv.gz,Microsoft_Office,5693,295646,522,301861,16471
hdfs://spark-nn.eemcs.utwente.nl/user/s1934538/clickstream/clickstream-enwiki-2023-07.tsv.gz,Volodymyr_Zelenskyy,76509,195539,1989,274037,143639
hdfs://spark-nn.eemcs.utwente.nl/user/s1934538/clickstream/clickstream-enwiki-2023-07.tsv.gz,Cricket_World_Cup,48646,162144,1412,212202,107111
hdfs://spark-nn.eemcs.utwente.nl/user/s1934538/clickstream/clickstream-enwiki-2023-07.tsv.gz,Juice_Wrld,34498,159718,2146,196362,81347
hdfs://spark-nn.eemcs.utwente.nl/user/s1934538/clickstream/clickstream-enwiki-2018-04.tsv.gz,Sushma_Swaraj,4890,25449,85,30424,5376
hdfs://spark-nn.eemcs.utwente.nl/user/s1934538/clickstream/clickstream-enwiki-2018-04.tsv.gz,Exo_(band),28821,1741198,830,1770849,185107
hdfs://spark-nn.eemcs.utwente.nl/user/s1934538/clickstream/clickstream-enwiki-2018-04.tsv.gz,Cleopatra,37314,206383,1920,245617,80807
hdfs://spark-nn.eemcs.utwente.nl/user/s1934538/clickstream/clickstream-enwiki-2018-04.tsv.gz,Indian_Premier_League,59079,564453,1188,624720,260185
hdfs://spark-nn.eemcs.utwente.nl/user/s1934538/clickstream/clickstream-enwiki-2018-04.tsv.gz,Alexander_Hamilton,58832,379130,2073,440035,135342
hdfs://spark-nn.eemcs.utwente.nl/user/s1934538/clickstream/clickstream-enwiki-2018-04.tsv.gz,2.0_(film),38452,225308,726,264486,53304
hdfs://spark-nn.eemcs.utwente.nl/user/s1934538/clickstream/clickstream-enwiki-2018-04.tsv.gz,Royal_Rumble_(2018),42229,135736,1155,179120,73058
hdfs://spark-nn.eemcs.utwente.nl/user/s1934538/clickstream/clickstream-enwiki-2018-04.tsv.gz,Coronavirus,846,10188,17,11051,1382
hdfs://spark-nn.eemcs.utwente.nl/user/s1934538/clickstream/clickstream-enwiki-2018-04.tsv.gz,Qasem_Soleimani,3072,10144,69,13285,5816
hdfs://spark-nn.eemcs.utwente.nl/user/s1934538/clickstream/clickstream-enwiki-2018-04.tsv.gz,HTTP_cookie,5677,244422,114,250213,24411
hdfs://spark-nn.eemcs.utwente.nl/user/s1934538/clickstream/clickstream-enwiki-2018-04.tsv.gz,Avengers:_Infinity_War,958992,8098445,216242,9273679,5789552
hdfs://spark-nn.eemcs.utwente.nl/user/s1934538/clickstream/clickstream-enwiki-2018-04.tsv.gz,Shakira,12533,215207,1535,229275,78235
hdfs://spark-nn.eemcs.utwente.nl/user/s1934538/clickstream/clickstream-enwiki-2018-04.tsv.gz,Chadwick_Boseman,162061,391987,2327,556375,131492
hdfs://spark-nn.eemcs.utwente.nl/user/s1934538/clickstream/clickstream-enwiki-2018-04.tsv.gz,Matthew_Perry,46448,198584,1505,246537,83155
hdfs://spark-nn.eemcs.utwente.nl/user/s1934538/clickstream/clickstream-enwiki-2018-04.tsv.gz,Queen_(band),30382,138154,1997,170533,124455
hdfs://spark-nn.eemcs.utwente.nl/user/s1934538/clickstream/clickstream-enwiki-2018-04.tsv.gz,Hyphen-minus,5281,71154991,7586282,78746554,935
hdfs://spark-nn.eemcs.utwente.nl/user/s1934538/clickstream/clickstream-enwiki-2018-04.tsv.gz,Grover,1135,5876,29,7040,963
hdfs://spark-nn.eemcs.utwente.nl/user/s1934538/clickstream/clickstream-enwiki-2018-04.tsv.gz,Freddie_Mercury,45313,330514,2544,378371,103425
hdfs://spark-nn.eemcs.utwente.nl/user/s1934538/clickstream/clickstream-enwiki-2018-04.tsv.gz,Donald_Glover,83215,345047,2044,430306,105779
hdfs://spark-nn.eemcs.utwente.nl/user/s1934538/clickstream/clickstream-enwiki-2018-04.tsv.gz,The_Weeknd,55680,366501,3543,425724,151892
hdfs://spark-nn.eemcs.utwente.nl/user/s1934538/clickstream/clickstream-enwiki-2018-04.tsv.gz,Kobe_Bryant,29326,259190,1705,290221,56126
hdfs://spark-nn.eemcs.utwente.nl/user/s1934538/clickstream/clickstream-enwiki-2018-04.tsv.gz,Game_of_Thrones_(season_8),46995,360832,1107,408934,115712
hdfs://spark-nn.eemcs.utwente.nl/user/s1934538/clickstream/clickstream-enwiki-2018-04.tsv.gz,Kelly_Preston,45657,57242,193,103092,22646
hdfs://spark-nn.eemcs.utwente.nl/user/s1934538/clickstream/clickstream-enwiki-2018-04.tsv.gz,Gaza_Strip,19165,81162,5395,105722,39551
hdfs://spark-nn.eemcs.utwente.nl/user/s1934538/clickstream/clickstream-enwiki-2018-04.tsv.gz,Rihanna,52290,337557,4619,394466,124362
hdfs://spark-nn.eemcs.utwente.nl/user/s1934538/clickstream/clickstream-enwiki-2018-04.tsv.gz,List_of_awards_and_nominations_received_by_Meryl_Streep,9914,11434,198,21546,6806
hdfs://spark-nn.eemcs.utwente.nl/user/s1934538/clickstream/clickstream-enwiki-2018-04.tsv.gz,Tonya_Harding,52111,573758,2014,627883,99398
hdfs://spark-nn.eemcs.utwente.nl/user/s1934538/clickstream/clickstream-enwiki-2018-04.tsv.gz,Main_Page,20170,471112894,3095595,474228659,31979714
hdfs://spark-nn.eemcs.utwente.nl/user/s1934538/clickstream/clickstream-enwiki-2018-04.tsv.gz,Meat_Loaf,17357,75516,646,93519,27311
hdfs://spark-nn.eemcs.utwente.nl/user/s1934538/clickstream/clickstream-enwiki-2018-04.tsv.gz,Kim_Jong-un,84491,488026,990,573507,240694
hdfs://spark-nn.eemcs.utwente.nl/user/s1934538/clickstream/clickstream-enwiki-2018-04.tsv.gz,QAnon,1257,48006,329,49592,9372
hdfs://spark-nn.eemcs.utwente.nl/user/s1934538/clickstream/clickstream-enwiki-2018-04.tsv.gz,Sushant_Singh_Rajput,22916,64768,386,88070,34582
hdfs://spark-nn.eemcs.utwente.nl/user/s1934538/clickstream/clickstream-enwiki-2018-04.tsv.gz,Game_of_Thrones,66340,449886,11383,527609,285822
hdfs://spark-nn.eemcs.utwente.nl/user/s1934538/clickstream/clickstream-enwiki-2018-04.tsv.gz,David_Beckham,31423,226344,1357,259124,59378
hdfs://spark-nn.eemcs.utwente.nl/user/s1934538/clickstream/clickstream-enwiki-2018-04.tsv.gz,Tom_Brady,25435,194491,1794,221720,49437
hdfs://spark-nn.eemcs.utwente.nl/user/s1934538/clickstream/clickstream-enwiki-2018-04.tsv.gz,"Prince_Philip,_Duke_of_Edinburgh",277757,644219,6878,928854,400307
hdfs://spark-nn.eemcs.utwente.nl/user/s1934538/clickstream/clickstream-enwiki-2018-04.tsv.gz,Darth_Vader,19939,2668642,740,2689321,39067
hdfs://spark-nn.eemcs.utwente.nl/user/s1934538/clickstream/clickstream-enwiki-2018-04.tsv.gz,Juneteenth,3133,110549,144,113826,5865
hdfs://spark-nn.eemcs.utwente.nl/user/s1934538/clickstream/clickstream-enwiki-2018-04.tsv.gz,List_of_James_Bond_films,14347,181699,251,196297,67819
hdfs://spark-nn.eemcs.utwente.nl/user/s1934538/clickstream/clickstream-enwiki-2018-04.tsv.gz,Fyre_Festival,2384,57092,279,59755,21678
hdfs://spark-nn.eemcs.utwente.nl/user/s1934538/clickstream/clickstream-enwiki-2018-04.tsv.gz,Cameron_Boyce,10946,40741,96,51783,7476
hdfs://spark-nn.eemcs.utwente.nl/user/s1934538/clickstream/clickstream-enwiki-2018-04.tsv.gz,Captain_Marvel_(film),451765,566099,4974,1022838,646465
hdfs://spark-nn.eemcs.utwente.nl/user/s1934538/clickstream/clickstream-enwiki-2018-04.tsv.gz,Charles_Sobhraj,2568,21410,68,24046,3171
hdfs://spark-nn.eemcs.utwente.nl/user/s1934538/clickstream/clickstream-enwiki-2018-04.tsv.gz,XHamster,7233,7909686,9310,7926229,28387
hdfs://spark-nn.eemcs.utwente.nl/user/s1934538/clickstream/clickstream-enwiki-2018-04.tsv.gz,Anne_Heche,37160,61408,391,98959,21602
hdfs://spark-nn.eemcs.utwente.nl/user/s1934538/clickstream/clickstream-enwiki-2018-04.tsv.gz,Croatia,33302,151982,1877,187161,60538
hdfs://spark-nn.eemcs.utwente.nl/user/s1934538/clickstream/clickstream-enwiki-2018-04.tsv.gz,Khabib_Nurmagomedov,123181,710691,4856,838728,285513
hdfs://spark-nn.eemcs.utwente.nl/user/s1934538/clickstream/clickstream-enwiki-2018-04.tsv.gz,Richard_Ramirez,23239,167817,821,191877,34940
hdfs://spark-nn.eemcs.utwente.nl/user/s1934538/clickstream/clickstream-enwiki-2018-04.tsv.gz,Michael_Jordan,57642,549087,3801,610530,142149
hdfs://spark-nn.eemcs.utwente.nl/user/s1934538/clickstream/clickstream-enwiki-2018-04.tsv.gz,Ghislaine_Maxwell,534,2065,125,2724,670
hdfs://spark-nn.eemcs.utwente.nl/user/s1934538/clickstream/clickstream-enwiki-2018-04.tsv.gz,Hamilton_(musical),34916,417855,2217,454988,180321
hdfs://spark-nn.eemcs.utwente.nl/user/s1934538/clickstream/clickstream-enwiki-2018-04.tsv.gz,Aaron_Hernandez,6293,89371,298,95962,17894
hdfs://spark-nn.eemcs.utwente.nl/user/s1934538/clickstream/clickstream-enwiki-2018-04.tsv.gz,Key_frame,785,6874,17,7676,641
hdfs://spark-nn.eemcs.utwente.nl/user/s1934538/clickstream/clickstream-enwiki-2018-04.tsv.gz,Joe_Biden,26707,94643,931,122281,32825
hdfs://spark-nn.eemcs.utwente.nl/user/s1934538/clickstream/clickstream-enwiki-2018-04.tsv.gz,Asia_Cup,7384,19697,108,27189,9780
hdfs://spark-nn.eemcs.utwente.nl/user/s1934538/clickstream/clickstream-enwiki-2018-04.tsv.gz,Jeffrey_Dahmer,22601,802276,2970,827847,174832
hdfs://spark-nn.eemcs.utwente.nl/user/s1934538/clickstream/clickstream-enwiki-2018-04.tsv.gz,The_Irishman,49,561,32,642,521
hdfs://spark-nn.eemcs.utwente.nl/user/s1934538/clickstream/clickstream-enwiki-2018-04.tsv.gz,Bird_Box_(film),8650,6506,55,15211,5758
hdfs://spark-nn.eemcs.utwente.nl/user/s1934538/clickstream/clickstream-enwiki-2018-04.tsv.gz,Bonnie_and_Clyde,14012,203190,997,218199,35012
hdfs://spark-nn.eemcs.utwente.nl/user/s1934538/clickstream/clickstream-enwiki-2018-04.tsv.gz,Microsoft_Office,8517,78993,688,88198,20702
hdfs://spark-nn.eemcs.utwente.nl/user/s1934538/clickstream/clickstream-enwiki-2018-04.tsv.gz,United_States_Senate,43922,91301,3849,139072,41569
hdfs://spark-nn.eemcs.utwente.nl/user/s1934538/clickstream/clickstream-enwiki-2018-04.tsv.gz,Jenna_Ortega,7063,27344,104,34511,3910
hdfs://spark-nn.eemcs.utwente.nl/user/s1934538/clickstream/clickstream-enwiki-2018-04.tsv.gz,Cricket_World_Cup,8445,84066,395,92906,29000
hdfs://spark-nn.eemcs.utwente.nl/user/s1934538/clickstream/clickstream-enwiki-2018-04.tsv.gz,"Diana,_Princess_of_Wales",211472,489100,2959,703531,320559
hdfs://spark-nn.eemcs.utwente.nl/user/s1934538/clickstream/clickstream-enwiki-2018-04.tsv.gz,List_of_highest-grossing_Indian_films,73519,495656,1253,570428,232620
hdfs://spark-nn.eemcs.utwente.nl/user/s1934538/clickstream/clickstream-enwiki-2018-04.tsv.gz,1234,91,2889,30,3010,372
hdfs://spark-nn.eemcs.utwente.nl/user/s1934538/clickstream/clickstream-enwiki-2018-04.tsv.gz,Eddie_Van_Halen,25976,53786,355,80117,25277
hdfs://spark-nn.eemcs.utwente.nl/user/s1934538/clickstream/clickstream-enwiki-2018-04.tsv.gz,WrestleMania_34,343917,2875137,56601,3275655,1265460
hdfs://spark-nn.eemcs.utwente.nl/user/s1934538/clickstream/clickstream-enwiki-2018-04.tsv.gz,Cardi_B,86410,3346238,25668,3458316,862613
hdfs://spark-nn.eemcs.utwente.nl/user/s1934538/clickstream/clickstream-enwiki-2018-04.tsv.gz,Nipsey_Hussle,9692,51338,172,61202,19779
hdfs://spark-nn.eemcs.utwente.nl/user/s1934538/clickstream/clickstream-enwiki-2018-04.tsv.gz,Fantastic_Beasts:_The_Crimes_of_Grindelwald,55146,70837,836,126819,71084
hdfs://spark-nn.eemcs.utwente.nl/user/s1934538/clickstream/clickstream-enwiki-2018-04.tsv.gz,DMX_(rapper),11570,86566,368,98504,29149
hdfs://spark-nn.eemcs.utwente.nl/user/s1934538/clickstream/clickstream-enwiki-2018-04.tsv.gz,IPv4,13159,54825,223,68207,12272
hdfs://spark-nn.eemcs.utwente.nl/user/s1934538/clickstream/clickstream-enwiki-2018-04.tsv.gz,Valentine's_Day,2449,34404,204,37057,312
hdfs://spark-nn.eemcs.utwente.nl/user/s1934538/clickstream/clickstream-enwiki-2018-04.tsv.gz,Grimes_(musician),10667,36235,217,47119,15633
hdfs://spark-nn.eemcs.utwente.nl/user/s1934538/clickstream/clickstream-enwiki-2018-04.tsv.gz,Prince_Harry,288593,575812,4453,868858,284104
hdfs://spark-nn.eemcs.utwente.nl/user/s1934538/clickstream/clickstream-enwiki-2018-04.tsv.gz,2022_FIFA_World_Cup,54850,63281,550,118681,59580
hdfs://spark-nn.eemcs.utwente.nl/user/s1934538/clickstream/clickstream-enwiki-2018-04.tsv.gz,Taliban,18568,106887,439,125894,41575
hdfs://spark-nn.eemcs.utwente.nl/user/s1934538/clickstream/clickstream-enwiki-2018-04.tsv.gz,Amber_Heard,73045,148325,547,221917,84277
hdfs://spark-nn.eemcs.utwente.nl/user/s1934538/clickstream/clickstream-enwiki-2018-04.tsv.gz,Simple_Mail_Transfer_Protocol,5612,45051,141,50804,6681
hdfs://spark-nn.eemcs.utwente.nl/user/s1934538/clickstream/clickstream-enwiki-2018-04.tsv.gz,List_of_Marvel_Cinematic_Universe_films,291336,2574581,4147,2870064,829242
hdfs://spark-nn.eemcs.utwente.nl/user/s1934538/clickstream/clickstream-enwiki-2018-04.tsv.gz,Ukraine,38078,153679,2543,194300,69824
hdfs://spark-nn.eemcs.utwente.nl/user/s1934538/clickstream/clickstream-enwiki-2018-04.tsv.gz,The_Umbrella_Academy_(TV_series),5688,7568,17,13273,5702
hdfs://spark-nn.eemcs.utwente.nl/user/s1934538/clickstream/clickstream-enwiki-2018-04.tsv.gz,Venom_(2018_film),86855,692797,10846,790498,419212
hdfs://spark-nn.eemcs.utwente.nl/user/s1934538/clickstream/clickstream-enwiki-2018-04.tsv.gz,Jimmy_Hoffa,19472,66995,415,86882,21988
hdfs://spark-nn.eemcs.utwente.nl/user/s1934538/clickstream/clickstream-enwiki-2018-04.tsv.gz,XXXTentacion,29666,301427,5762,336855,79649
hdfs://spark-nn.eemcs.utwente.nl/user/s1934538/clickstream/clickstream-enwiki-2018-04.tsv.gz,Elon_Musk,81818,769332,5243,856393,378038
hdfs://spark-nn.eemcs.utwente.nl/user/s1934538/clickstream/clickstream-enwiki-2018-04.tsv.gz,J._Robert_Oppenheimer,14991,83435,1283,99709,26748
hdfs://spark-nn.eemcs.utwente.nl/user/s1934538/clickstream/clickstream-enwiki-2018-04.tsv.gz,Meghan_Markle,115618,1317362,8095,1441075,297050
hdfs://spark-nn.eemcs.utwente.nl/user/s1934538/clickstream/clickstream-enwiki-2018-04.tsv.gz,Dark_Phoenix_(film),136951,114316,856,252123,6810
hdfs://spark-nn.eemcs.utwente.nl/user/s1934538/clickstream/clickstream-enwiki-2018-04.tsv.gz,Louis_Tomlinson,23578,56085,392,80055,9531
hdfs://spark-nn.eemcs.utwente.nl/user/s1934538/clickstream/clickstream-enwiki-2018-04.tsv.gz,John_McCain,24997,138371,1633,165001,54488
hdfs://spark-nn.eemcs.utwente.nl/user/s1934538/clickstream/clickstream-enwiki-2018-04.tsv.gz,Notre-Dame_de_Paris,8052,82130,335,90517,12955
hdfs://spark-nn.eemcs.utwente.nl/user/s1934538/clickstream/clickstream-enwiki-2018-04.tsv.gz,The_Irishman_(2019_film),50012,75625,428,126065,82317
hdfs://spark-nn.eemcs.utwente.nl/user/s1934538/clickstream/clickstream-enwiki-2018-04.tsv.gz,Tunnel,2916,13842,137,16895,3709
hdfs://spark-nn.eemcs.utwente.nl/user/s1934538/clickstream/clickstream-enwiki-2018-04.tsv.gz,Aaron_Carter,10504,43110,274,53888,12208
hdfs://spark-nn.eemcs.utwente.nl/user/s1934538/clickstream/clickstream-enwiki-2018-04.tsv.gz,Michael_Bloomberg,22984,66612,338,89934,31908
hdfs://spark-nn.eemcs.utwente.nl/user/s1934538/clickstream/clickstream-enwiki-2018-04.tsv.gz,Lance_Reddick,15415,28962,128,44505,7580
hdfs://spark-nn.eemcs.utwente.nl/user/s1934538/clickstream/clickstream-enwiki-2018-04.tsv.gz,Ted_Bundy,33430,334346,3711,371487,69941
hdfs://spark-nn.eemcs.utwente.nl/user/s1934538/clickstream/clickstream-enwiki-2018-04.tsv.gz,Pornhub,36155,331214,8420,375789,56502
hdfs://spark-nn.eemcs.utwente.nl/user/s1934538/clickstream/clickstream-enwiki-2018-04.tsv.gz,NATO,43779,202637,2295,248711,73727
hdfs://spark-nn.eemcs.utwente.nl/user/s1934538/clickstream/clickstream-enwiki-2018-04.tsv.gz,Richard_Jewell,1607,5596,37,7240,1343
hdfs://spark-nn.eemcs.utwente.nl/user/s1934538/clickstream/clickstream-enwiki-2018-04.tsv.gz,Adele,19314,186038,609,205961,47440
hdfs://spark-nn.eemcs.utwente.nl/user/s1934538/clickstream/clickstream-enwiki-2018-04.tsv.gz,Manti_Te'o,3125,15361,58,18544,317
hdfs://spark-nn.eemcs.utwente.nl/user/s1934538/clickstream/clickstream-enwiki-2018-04.tsv.gz,Salman_Rushdie,20156,73669,345,94170,33269
hdfs://spark-nn.eemcs.utwente.nl/user/s1934538/clickstream/clickstream-enwiki-2018-04.tsv.gz,Media,54,14651,374,15079,2985
hdfs://spark-nn.eemcs.utwente.nl/user/s1934538/clickstream/clickstream-enwiki-2018-04.tsv.gz,Article_370_of_the_Constitution_of_India,4331,45533,23,49887,3886
hdfs://spark-nn.eemcs.utwente.nl/user/s1934538/clickstream/clickstream-enwiki-2018-04.tsv.gz,Stranger_Things,45539,447228,8855,501622,258415
hdfs://spark-nn.eemcs.utwente.nl/user/s1934538/clickstream/clickstream-enwiki-2018-04.tsv.gz,JSON_Web_Token,799,19927,25,20751,1851
hdfs://spark-nn.eemcs.utwente.nl/user/s1934538/clickstream/clickstream-enwiki-2018-04.tsv.gz,Critical_race_theory,1677,19030,38,20745,3549
hdfs://spark-nn.eemcs.utwente.nl/user/s1934538/clickstream/clickstream-enwiki-2018-04.tsv.gz,Stephen_Hawking,31300,814160,6753,852213,216966
hdfs://spark-nn.eemcs.utwente.nl/user/s1934538/clickstream/clickstream-enwiki-2018-04.tsv.gz,Henry_V_of_England,33389,37710,191,71290,38296
hdfs://spark-nn.eemcs.utwente.nl/user/s1934538/clickstream/clickstream-enwiki-2019-05.tsv.gz,Wikipedia,38454,1094590,1071,1134115,188482
hdfs://spark-nn.eemcs.utwente.nl/user/s1934538/clickstream/clickstream-enwiki-2019-05.tsv.gz,Stranger_Things_(season_3),21715,162228,1285,185228,86175
hdfs://spark-nn.eemcs.utwente.nl/user/s1934538/clickstream/clickstream-enwiki-2019-05.tsv.gz,2023_Cricket_World_Cup,87947,60310,41,148298,45028
hdfs://spark-nn.eemcs.utwente.nl/user/s1934538/clickstream/clickstream-enwiki-2019-05.tsv.gz,George_H._W._Bush,108624,137778,806,247208,118833
hdfs://spark-nn.eemcs.utwente.nl/user/s1934538/clickstream/clickstream-enwiki-2019-05.tsv.gz,Tonya_Harding,28338,130899,621,159858,29052
hdfs://spark-nn.eemcs.utwente.nl/user/s1934538/clickstream/clickstream-enwiki-2019-05.tsv.gz,Anne_Heche,32120,68832,301,101253,28443
hdfs://spark-nn.eemcs.utwente.nl/user/s1934538/clickstream/clickstream-enwiki-2019-05.tsv.gz,Anna_Sorokin,8036,204423,845,213304,17002
hdfs://spark-nn.eemcs.utwente.nl/user/s1934538/clickstream/clickstream-enwiki-2019-05.tsv.gz,Jenna_Ortega,7102,10186,1251,18539,4021
hdfs://spark-nn.eemcs.utwente.nl/user/s1934538/clickstream/clickstream-enwiki-2019-05.tsv.gz,Dennis_Nilsen,7205,34646,229,42080,8034
hdfs://spark-nn.eemcs.utwente.nl/user/s1934538/clickstream/clickstream-enwiki-2019-05.tsv.gz,Spider-Man:_Far_From_Home,405171,810895,30745,1246811,910693
hdfs://spark-nn.eemcs.utwente.nl/user/s1934538/clickstream/clickstream-enwiki-2019-05.tsv.gz,2022_FIFA_World_Cup,65529,123687,2292,191508,98922
hdfs://spark-nn.eemcs.utwente.nl/user/s1934538/clickstream/clickstream-enwiki-2019-05.tsv.gz,Chernobyl_(miniseries),141029,2526839,80799,2748667,1954590
hdfs://spark-nn.eemcs.utwente.nl/user/s1934538/clickstream/clickstream-enwiki-2019-05.tsv.gz,RRR_(film),52164,37091,1910,91165,57913
hdfs://spark-nn.eemcs.utwente.nl/user/s1934538/clickstream/clickstream-enwiki-2019-05.tsv.gz,Adele,23035,274994,2890,300919,72747
hdfs://spark-nn.eemcs.utwente.nl/user/s1934538/clickstream/clickstream-enwiki-2019-05.tsv.gz,Deaths_in_2019,1302999,2031665,9074,3343738,1852875
hdfs://spark-nn.eemcs.utwente.nl/user/s1934538/clickstream/clickstream-enwiki-2019-05.tsv.gz,United_States_Electoral_College,22285,115358,199,137842,14429
hdfs://spark-nn.eemcs.utwente.nl/user/s1934538/clickstream/clickstream-enwiki-2019-05.tsv.gz,Lisa_Marie_Presley,116365,94436,231,211032,113060
hdfs://spark-nn.eemcs.utwente.nl/user/s1934538/clickstream/clickstream-enwiki-2019-05.tsv.gz,Critical_race_theory,1700,15900,16,17616,3209
hdfs://spark-nn.eemcs.utwente.nl/user/s1934538/clickstream/clickstream-enwiki-2019-05.tsv.gz,Black_Panther_(film),137438,287411,4401,429250,268401
hdfs://spark-nn.eemcs.utwente.nl/user/s1934538/clickstream/clickstream-enwiki-2019-05.tsv.gz,Anthony_Bourdain,13781,197304,1682,212767,56850
hdfs://spark-nn.eemcs.utwente.nl/user/s1934538/clickstream/clickstream-enwiki-2019-05.tsv.gz,Betty_White,52625,268441,3054,324120,72914
hdfs://spark-nn.eemcs.utwente.nl/user/s1934538/clickstream/clickstream-enwiki-2019-05.tsv.gz,Glass_(2019_film),92685,417447,4546,514678,166407
hdfs://spark-nn.eemcs.utwente.nl/user/s1934538/clickstream/clickstream-enwiki-2019-05.tsv.gz,21_Savage,28075,116028,1391,145494,43856
hdfs://spark-nn.eemcs.utwente.nl/user/s1934538/clickstream/clickstream-enwiki-2019-05.tsv.gz,Ukraine,55221,161907,4103,221231,105515
hdfs://spark-nn.eemcs.utwente.nl/user/s1934538/clickstream/clickstream-enwiki-2019-05.tsv.gz,Elon_Musk,115564,757410,4893,877867,496884
hdfs://spark-nn.eemcs.utwente.nl/user/s1934538/clickstream/clickstream-enwiki-2019-05.tsv.gz,Cecil_Hotel_(Los_Angeles),4722,16813,20,21555,8133
hdfs://spark-nn.eemcs.utwente.nl/user/s1934538/clickstream/clickstream-enwiki-2019-05.tsv.gz,WrestleMania_34,18940,11759,231,30930,20574
hdfs://spark-nn.eemcs.utwente.nl/user/s1934538/clickstream/clickstream-enwiki-2019-05.tsv.gz,R._Kelly,25268,135771,2867,163906,74787
hdfs://spark-nn.eemcs.utwente.nl/user/s1934538/clickstream/clickstream-enwiki-2019-05.tsv.gz,A_Star_Is_Born_(2018_film),51256,326328,2223,379807,172119
hdfs://spark-nn.eemcs.utwente.nl/user/s1934538/clickstream/clickstream-enwiki-2019-05.tsv.gz,Queen_(band),97422,400314,4827,502563,476637
hdfs://spark-nn.eemcs.utwente.nl/user/s1934538/clickstream/clickstream-enwiki-2019-05.tsv.gz,Parasite_(2019_film),51572,130541,956,183069,68348
hdfs://spark-nn.eemcs.utwente.nl/user/s1934538/clickstream/clickstream-enwiki-2019-05.tsv.gz,Khabib_Nurmagomedov,44268,106781,1006,152055,76617
hdfs://spark-nn.eemcs.utwente.nl/user/s1934538/clickstream/clickstream-enwiki-2019-05.tsv.gz,Asia_Cup,1494,19785,295,21574,13278
hdfs://spark-nn.eemcs.utwente.nl/user/s1934538/clickstream/clickstream-enwiki-2019-05.tsv.gz,2018_Asian_Games,8071,28224,83,36378,17351
hdfs://spark-nn.eemcs.utwente.nl/user/s1934538/clickstream/clickstream-enwiki-2019-05.tsv.gz,XNXX,3160,222568,8781,234509,62205
hdfs://spark-nn.eemcs.utwente.nl/user/s1934538/clickstream/clickstream-enwiki-2019-05.tsv.gz,Amy_Coney_Barrett,1532,7040,29,8601,2292
hdfs://spark-nn.eemcs.utwente.nl/user/s1934538/clickstream/clickstream-enwiki-2019-05.tsv.gz,Jeffrey_Dahmer,45054,648279,6952,700285,280282
hdfs://spark-nn.eemcs.utwente.nl/user/s1934538/clickstream/clickstream-enwiki-2019-05.tsv.gz,Taliban,21369,65989,412,87770,44399
hdfs://spark-nn.eemcs.utwente.nl/user/s1934538/clickstream/clickstream-enwiki-2019-05.tsv.gz,Simple_Mail_Transfer_Protocol,4995,33632,192,38819,5409
hdfs://spark-nn.eemcs.utwente.nl/user/s1934538/clickstream/clickstream-enwiki-2019-05.tsv.gz,UEFA_Euro_2020,44794,141226,2204,188224,58303
hdfs://spark-nn.eemcs.utwente.nl/user/s1934538/clickstream/clickstream-enwiki-2019-05.tsv.gz,Donald_Glover,69530,237344,1794,308668,97565
hdfs://spark-nn.eemcs.utwente.nl/user/s1934538/clickstream/clickstream-enwiki-2019-05.tsv.gz,Lance_Reddick,101312,63590,273,165175,31968
hdfs://spark-nn.eemcs.utwente.nl/user/s1934538/clickstream/clickstream-enwiki-2019-05.tsv.gz,Richard_Jewell,2678,12257,138,15073,4584
hdfs://spark-nn.eemcs.utwente.nl/user/s1934538/clickstream/clickstream-enwiki-2019-05.tsv.gz,Afghanistan,44381,136839,1831,183051,105969
hdfs://spark-nn.eemcs.utwente.nl/user/s1934538/clickstream/clickstream-enwiki-2019-05.tsv.gz,Mac_Miller,33628,172909,1681,208218,64887
hdfs://spark-nn.eemcs.utwente.nl/user/s1934538/clickstream/clickstream-enwiki-2019-05.tsv.gz,Henry_V_of_England,54541,28190,219,82950,57480
hdfs://spark-nn.eemcs.utwente.nl/user/s1934538/clickstream/clickstream-enwiki-2019-05.tsv.gz,Tenet_(film),48382,59266,227,107875,131755
hdfs://spark-nn.eemcs.utwente.nl/user/s1934538/clickstream/clickstream-enwiki-2019-05.tsv.gz,Cameron_Boyce,14901,37353,136,52390,9899
hdfs://spark-nn.eemcs.utwente.nl/user/s1934538/clickstream/clickstream-enwiki-2019-05.tsv.gz,Charles_Sobhraj,3589,23114,51,26754,6084
hdfs://spark-nn.eemcs.utwente.nl/user/s1934538/clickstream/clickstream-enwiki-2019-05.tsv.gz,"Diana,_Princess_of_Wales",248799,415789,3588,668176,421495
hdfs://spark-nn.eemcs.utwente.nl/user/s1934538/clickstream/clickstream-enwiki-2019-05.tsv.gz,Dark_Phoenix_(film),236658,562563,13478,812699,496455
hdfs://spark-nn.eemcs.utwente.nl/user/s1934538/clickstream/clickstream-enwiki-2019-05.tsv.gz,John_McCain,44693,118923,1439,165055,71849
hdfs://spark-nn.eemcs.utwente.nl/user/s1934538/clickstream/clickstream-enwiki-2019-05.tsv.gz,Sushant_Singh_Rajput,22072,64145,131,86348,44765
hdfs://spark-nn.eemcs.utwente.nl/user/s1934538/clickstream/clickstream-enwiki-2019-05.tsv.gz,Star_Wars:_The_Rise_of_Skywalker,240465,222994,6222,469681,331658
hdfs://spark-nn.eemcs.utwente.nl/user/s1934538/clickstream/clickstream-enwiki-2019-05.tsv.gz,Godzilla_vs._Kong,207413,76084,499,283996,187781
hdfs://spark-nn.eemcs.utwente.nl/user/s1934538/clickstream/clickstream-enwiki-2019-05.tsv.gz,Bob_Saget,19453,42368,436,62257,12232
hdfs://spark-nn.eemcs.utwente.nl/user/s1934538/clickstream/clickstream-enwiki-2019-05.tsv.gz,Death_of_Elisa_Lam,9781,66762,228,76771,18171
hdfs://spark-nn.eemcs.utwente.nl/user/s1934538/clickstream/clickstream-enwiki-2019-05.tsv.gz,Fantastic_Beasts:_The_Crimes_of_Grindelwald,71988,142695,2194,216877,114077
hdfs://spark-nn.eemcs.utwente.nl/user/s1934538/clickstream/clickstream-enwiki-2019-05.tsv.gz,HTTP_cookie,5215,287104,105,292424,32851
hdfs://spark-nn.eemcs.utwente.nl/user/s1934538/clickstream/clickstream-enwiki-2019-05.tsv.gz,Kobe_Bryant_sexual_assault_case,3529,19792,19,23340,2508
hdfs://spark-nn.eemcs.utwente.nl/user/s1934538/clickstream/clickstream-enwiki-2019-05.tsv.gz,George_VI,436586,175195,2600,614381,425122
hdfs://spark-nn.eemcs.utwente.nl/user/s1934538/clickstream/clickstream-enwiki-2019-05.tsv.gz,David_Beckham,45977,310406,2075,358458,111925
hdfs://spark-nn.eemcs.utwente.nl/user/s1934538/clickstream/clickstream-enwiki-2019-05.tsv.gz,List_of_FIFA_World_Cup_finals,1767,67109,175,69051,15015
hdfs://spark-nn.eemcs.utwente.nl/user/s1934538/clickstream/clickstream-enwiki-2019-05.tsv.gz,Crazy_Rich_Asians_(film),61022,290449,3491,354962,352885
hdfs://spark-nn.eemcs.utwente.nl/user/s1934538/clickstream/clickstream-enwiki-2019-05.tsv.gz,The_Nun_(2018_film),35872,141235,948,178055,117896
hdfs://spark-nn.eemcs.utwente.nl/user/s1934538/clickstream/clickstream-enwiki-2019-05.tsv.gz,Vladimir_Putin,75079,239477,2907,317463,161223
hdfs://spark-nn.eemcs.utwente.nl/user/s1934538/clickstream/clickstream-enwiki-2019-05.tsv.gz,Bonnie_and_Clyde,56177,784364,4782,845323,184836
hdfs://spark-nn.eemcs.utwente.nl/user/s1934538/clickstream/clickstream-enwiki-2019-05.tsv.gz,Kim_Jong-un,45662,134281,1348,181291,95583
hdfs://spark-nn.eemcs.utwente.nl/user/s1934538/clickstream/clickstream-enwiki-2019-05.tsv.gz,Manti_Te'o,3545,14917,149,18611,1764
hdfs://spark-nn.eemcs.utwente.nl/user/s1934538/clickstream/clickstream-enwiki-2019-05.tsv.gz,2018_FIFA_World_Cup,86865,181860,1975,270700,127100
hdfs://spark-nn.eemcs.utwente.nl/user/s1934538/clickstream/clickstream-enwiki-2019-05.tsv.gz,Eddie_Van_Halen,32968,52689,479,86136,40545
hdfs://spark-nn.eemcs.utwente.nl/user/s1934538/clickstream/clickstream-enwiki-2019-05.tsv.gz,Area_51,15860,194279,1468,211607,58496
hdfs://spark-nn.eemcs.utwente.nl/user/s1934538/clickstream/clickstream-enwiki-2019-05.tsv.gz,Salman_Rushdie,22071,50236,323,72630,32712
hdfs://spark-nn.eemcs.utwente.nl/user/s1934538/clickstream/clickstream-enwiki-2019-05.tsv.gz,Stan_Lee,160044,464199,3928,628171,216613
hdfs://spark-nn.eemcs.utwente.nl/user/s1934538/clickstream/clickstream-enwiki-2019-05.tsv.gz,Deadpool_2,126469,188450,3692,318611,225924
hdfs://spark-nn.eemcs.utwente.nl/user/s1934538/clickstream/clickstream-enwiki-2019-05.tsv.gz,The_Irishman_(2019_film),70665,75529,746,146940,111510
hdfs://spark-nn.eemcs.utwente.nl/user/s1934538/clickstream/clickstream-enwiki-2019-05.tsv.gz,Kamala_Harris,28787,392373,3136,424296,136143
hdfs://spark-nn.eemcs.utwente.nl/user/s1934538/clickstream/clickstream-enwiki-2019-05.tsv.gz,Charles_III,83,325,73,481,364
hdfs://spark-nn.eemcs.utwente.nl/user/s1934538/clickstream/clickstream-enwiki-2019-05.tsv.gz,Tunnel,3972,12199,115,16286,3626
hdfs://spark-nn.eemcs.utwente.nl/user/s1934538/clickstream/clickstream-enwiki-2019-05.tsv.gz,Top_Gun:_Maverick,65625,50444,369,116438,85551
hdfs://spark-nn.eemcs.utwente.nl/user/s1934538/clickstream/clickstream-enwiki-2019-05.tsv.gz,Gaza_Strip,30271,92619,715,123605,46653
hdfs://spark-nn.eemcs.utwente.nl/user/s1934538/clickstream/clickstream-enwiki-2019-05.tsv.gz,Darth_Vader,34918,196570,836,232324,77664
hdfs://spark-nn.eemcs.utwente.nl/user/s1934538/clickstream/clickstream-enwiki-2019-05.tsv.gz,State_of_Palestine,53592,140905,807,195304,83702
hdfs://spark-nn.eemcs.utwente.nl/user/s1934538/clickstream/clickstream-enwiki-2019-05.tsv.gz,2016_United_States_presidential_election,89968,206147,2560,298675,207172
hdfs://spark-nn.eemcs.utwente.nl/user/s1934538/clickstream/clickstream-enwiki-2019-05.tsv.gz,Michael_Jordan,90660,435608,6137,532405,172411
hdfs://spark-nn.eemcs.utwente.nl/user/s1934538/clickstream/clickstream-enwiki-2019-05.tsv.gz,A_Quiet_Place_(film),32015,174015,1421,207451,60167
hdfs://spark-nn.eemcs.utwente.nl/user/s1934538/clickstream/clickstream-enwiki-2019-05.tsv.gz,Grover,1337,6150,38,7525,1326
hdfs://spark-nn.eemcs.utwente.nl/user/s1934538/clickstream/clickstream-enwiki-2019-05.tsv.gz,Microsoft_Office,8670,78954,674,88298,23853
hdfs://spark-nn.eemcs.utwente.nl/user/s1934538/clickstream/clickstream-enwiki-2019-05.tsv.gz,Wonder_Woman_1984,105184,51138,488,156810,96775
hdfs://spark-nn.eemcs.utwente.nl/user/s1934538/clickstream/clickstream-enwiki-2019-05.tsv.gz,Amber_Heard,133393,229217,1078,363688,185003
hdfs://spark-nn.eemcs.utwente.nl/user/s1934538/clickstream/clickstream-enwiki-2019-05.tsv.gz,When_They_See_Us,15289,120538,1577,137404,72558
hdfs://spark-nn.eemcs.utwente.nl/user/s1934538/clickstream/clickstream-enwiki-2019-05.tsv.gz,Sridevi,19333,89091,339,108763,36000
hdfs://spark-nn.eemcs.utwente.nl/user/s1934538/clickstream/clickstream-enwiki-2019-05.tsv.gz,Avicii,28240,362887,2979,394106,104428
hdfs://spark-nn.eemcs.utwente.nl/user/s1934538/clickstream/clickstream-enwiki-2019-05.tsv.gz,Juice_Wrld,14678,112127,989,127794,35564
hdfs://spark-nn.eemcs.utwente.nl/user/s1934538/clickstream/clickstream-enwiki-2019-05.tsv.gz,List_of_highest-grossing_Indian_films,70771,441454,1561,513786,234534
hdfs://spark-nn.eemcs.utwente.nl/user/s1934538/clickstream/clickstream-enwiki-2019-05.tsv.gz,Israel,91545,359991,6460,457996,202239
hdfs://spark-nn.eemcs.utwente.nl/user/s1934538/clickstream/clickstream-enwiki-2019-05.tsv.gz,Keanu_Reeves,317161,2569579,16812,2903552,1356841
hdfs://spark-nn.eemcs.utwente.nl/user/s1934538/clickstream/clickstream-enwiki-2019-05.tsv.gz,Atal_Bihari_Vajpayee,66326,168783,153,235262,61855
hdfs://spark-nn.eemcs.utwente.nl/user/s1934538/clickstream/clickstream-enwiki-2019-05.tsv.gz,Notre-Dame_de_Paris,22660,219835,2804,245299,57125
hdfs://spark-nn.eemcs.utwente.nl/user/s1934538/clickstream/clickstream-enwiki-2019-05.tsv.gz,Aaron_Hernandez,7598,74799,415,82812,27491
hdfs://spark-nn.eemcs.utwente.nl/user/s1934538/clickstream/clickstream-enwiki-2019-05.tsv.gz,Tina_Turner,19163,211796,1762,232721,54598
hdfs://spark-nn.eemcs.utwente.nl/user/s1934538/clickstream/clickstream-enwiki-2019-05.tsv.gz,Naya_Rivera,23717,29522,93,53332,10359
hdfs://spark-nn.eemcs.utwente.nl/user/s1934538/clickstream/clickstream-enwiki-2019-05.tsv.gz,Exo_(band),23789,115842,714,140345,152994
hdfs://spark-nn.eemcs.utwente.nl/user/s1934538/clickstream/clickstream-enwiki-2019-05.tsv.gz,Fyre_Festival,23438,214760,1198,239396,105864
hdfs://spark-nn.eemcs.utwente.nl/user/s1934538/clickstream/clickstream-enwiki-2019-05.tsv.gz,The_Mandalorian,53993,61560,699,116252,87478
hdfs://spark-nn.eemcs.utwente.nl/user/s1934538/clickstream/clickstream-enwiki-2019-05.tsv.gz,Kobe_Bryant,50132,244986,1805,296923,78962
hdfs://spark-nn.eemcs.utwente.nl/user/s1934538/clickstream/clickstream-enwiki-2019-05.tsv.gz,Google_logo,1104,22281,21,23406,1969
hdfs://spark-nn.eemcs.utwente.nl/user/s1934538/clickstream/clickstream-enwiki-2019-05.tsv.gz,Puneeth_Rajkumar,8955,20731,32,29718,14372
hdfs://spark-nn.eemcs.utwente.nl/user/s1934538/clickstream/clickstream-enwiki-2019-05.tsv.gz,Burt_Reynolds,69643,136787,1450,207880,78308
hdfs://spark-nn.eemcs.utwente.nl/user/s1934538/clickstream/clickstream-enwiki-2019-05.tsv.gz,Freddie_Mercury,147913,1082958,8043,1238914,439151
hdfs://spark-nn.eemcs.utwente.nl/user/s1934538/clickstream/clickstream-enwiki-2019-05.tsv.gz,1917_(2019_film),61290,14800,54,76144,25963
hdfs://spark-nn.eemcs.utwente.nl/user/s1934538/clickstream/clickstream-enwiki-2019-05.tsv.gz,Cricket_World_Cup,37330,516482,5342,559154,337734
hdfs://spark-nn.eemcs.utwente.nl/user/s1934538/clickstream/clickstream-enwiki-2019-05.tsv.gz,NATO,41548,137426,1769,180743,54158
hdfs://spark-nn.eemcs.utwente.nl/user/s1934538/clickstream/clickstream-enwiki-2019-05.tsv.gz,Cleopatra,45267,184070,823,230160,101176
hdfs://spark-nn.eemcs.utwente.nl/user/s1934538/clickstream/clickstream-enwiki-2019-05.tsv.gz,JSON_Web_Token,1185,23363,22,24570,2144
hdfs://spark-nn.eemcs.utwente.nl/user/s1934538/clickstream/clickstream-enwiki-2019-05.tsv.gz,Article_370_of_the_Constitution_of_India,10692,119216,116,130024,8886
hdfs://spark-nn.eemcs.utwente.nl/user/s1934538/clickstream/clickstream-enwiki-2019-05.tsv.gz,Captain_Marvel_(film),330791,1132381,14643,1477815,670686
hdfs://spark-nn.eemcs.utwente.nl/user/s1934538/clickstream/clickstream-enwiki-2019-05.tsv.gz,FIFA_World_Cup,38504,164574,2030,205108,161573
hdfs://spark-nn.eemcs.utwente.nl/user/s1934538/clickstream/clickstream-enwiki-2019-05.tsv.gz,XXXTentacion,69009,624431,6886,700326,129983
hdfs://spark-nn.eemcs.utwente.nl/user/s1934538/clickstream/clickstream-enwiki-2019-05.tsv.gz,Kylian_Mbappé,31589,177967,2760,212316,37917
hdfs://spark-nn.eemcs.utwente.nl/user/s1934538/clickstream/clickstream-enwiki-2019-05.tsv.gz,Shakira,21503,172808,1586,195897,80228
hdfs://spark-nn.eemcs.utwente.nl/user/s1934538/clickstream/clickstream-enwiki-2019-05.tsv.gz,Avengers:_Endgame,1845726,11255181,259066,13359973,7814953
hdfs://spark-nn.eemcs.utwente.nl/user/s1934538/clickstream/clickstream-enwiki-2019-05.tsv.gz,Aquaman_(film),129407,394889,5803,530099,276228
hdfs://spark-nn.eemcs.utwente.nl/user/s1934538/clickstream/clickstream-enwiki-2019-05.tsv.gz,Bird_Box_(film),24283,131201,1476,156960,50418
hdfs://spark-nn.eemcs.utwente.nl/user/s1934538/clickstream/clickstream-enwiki-2019-05.tsv.gz,"Prince_Philip,_Duke_of_Edinburgh",321564,326184,5959,653707,390347
hdfs://spark-nn.eemcs.utwente.nl/user/s1934538/clickstream/clickstream-enwiki-2019-05.tsv.gz,Sushma_Swaraj,17927,127956,1146,147029,34595
hdfs://spark-nn.eemcs.utwente.nl/user/s1934538/clickstream/clickstream-enwiki-2019-05.tsv.gz,Tom_Brady,48302,187000,1920,237222,77810
hdfs://spark-nn.eemcs.utwente.nl/user/s1934538/clickstream/clickstream-enwiki-2019-05.tsv.gz,Rihanna,83548,310629,21870,416047,204245
hdfs://spark-nn.eemcs.utwente.nl/user/s1934538/clickstream/clickstream-enwiki-2019-05.tsv.gz,Joker_(2019_film),100016,130105,1886,232007,144406
hdfs://spark-nn.eemcs.utwente.nl/user/s1934538/clickstream/clickstream-enwiki-2019-05.tsv.gz,Jimmy_Hoffa,21038,58831,769,80638,29424
hdfs://spark-nn.eemcs.utwente.nl/user/s1934538/clickstream/clickstream-enwiki-2019-08.tsv.gz,David_Beckham,41937,151324,1485,194746,68117
hdfs://spark-nn.eemcs.utwente.nl/user/s1934538/clickstream/clickstream-enwiki-2019-08.tsv.gz,2020_United_States_presidential_election,113293,361170,8178,482641,326681
hdfs://spark-nn.eemcs.utwente.nl/user/s1934538/clickstream/clickstream-enwiki-2019-08.tsv.gz,Spanish_flu,20380,64289,710,85379,19855
hdfs://spark-nn.eemcs.utwente.nl/user/s1934538/clickstream/clickstream-enwiki-2019-08.tsv.gz,Aretha_Franklin,23245,113098,1303,137646,47851
hdfs://spark-nn.eemcs.utwente.nl/user/s1934538/clickstream/clickstream-enwiki-2019-08.tsv.gz,Richard_Ramirez,13848,260336,1920,276104,75465
hdfs://spark-nn.eemcs.utwente.nl/user/s1934538/clickstream/clickstream-enwiki-2019-08.tsv.gz,Sushant_Singh_Rajput,23482,59652,150,83284,47849
hdfs://spark-nn.eemcs.utwente.nl/user/s1934538/clickstream/clickstream-enwiki-2019-08.tsv.gz,Godzilla_vs._Kong,140834,77659,714,219207,163012
hdfs://spark-nn.eemcs.utwente.nl/user/s1934538/clickstream/clickstream-enwiki-2019-08.tsv.gz,YouTube,130834,837674,7608,976116,146254
hdfs://spark-nn.eemcs.utwente.nl/user/s1934538/clickstream/clickstream-enwiki-2019-08.tsv.gz,Joker_(2019_film),148552,682828,14184,845564,546827
hdfs://spark-nn.eemcs.utwente.nl/user/s1934538/clickstream/clickstream-enwiki-2019-08.tsv.gz,Joaquin_Phoenix,198689,319581,2310,520580,405403
hdfs://spark-nn.eemcs.utwente.nl/user/s1934538/clickstream/clickstream-enwiki-2019-08.tsv.gz,1917_(2019_film),54241,167070,4847,226158,146308
hdfs://spark-nn.eemcs.utwente.nl/user/s1934538/clickstream/clickstream-enwiki-2019-08.tsv.gz,Article_370_of_the_Constitution_of_India,145712,4690432,48306,4884450,348667
hdfs://spark-nn.eemcs.utwente.nl/user/s1934538/clickstream/clickstream-enwiki-2019-08.tsv.gz,The_Nun_(2018_film),32032,113553,748,146333,95818
hdfs://spark-nn.eemcs.utwente.nl/user/s1934538/clickstream/clickstream-enwiki-2019-08.tsv.gz,Valentine's_Day,2762,26257,180,29199,2459
hdfs://spark-nn.eemcs.utwente.nl/user/s1934538/clickstream/clickstream-enwiki-2019-08.tsv.gz,List_of_awards_and_nominations_received_by_Meryl_Streep,16789,13091,138,30018,9442
hdfs://spark-nn.eemcs.utwente.nl/user/s1934538/clickstream/clickstream-enwiki-2019-08.tsv.gz,War_(2019_film),68734,236781,502,306017,144268
hdfs://spark-nn.eemcs.utwente.nl/user/s1934538/clickstream/clickstream-enwiki-2019-08.tsv.gz,Lisa_Marie_Presley,127686,89631,354,217671,121276
hdfs://spark-nn.eemcs.utwente.nl/user/s1934538/clickstream/clickstream-enwiki-2019-08.tsv.gz,Jimmy_Hoffa,88045,203466,2385,293896,114148
hdfs://spark-nn.eemcs.utwente.nl/user/s1934538/clickstream/clickstream-enwiki-2019-08.tsv.gz,The_Mandalorian,77739,507818,7367,592924,533535
hdfs://spark-nn.eemcs.utwente.nl/user/s1934538/clickstream/clickstream-enwiki-2019-08.tsv.gz,Fantastic_Beasts:_The_Crimes_of_Grindelwald,85126,230607,3550,319283,196923
hdfs://spark-nn.eemcs.utwente.nl/user/s1934538/clickstream/clickstream-enwiki-2019-08.tsv.gz,Lionel_Messi,76986,423992,6129,507107,112281
hdfs://spark-nn.eemcs.utwente.nl/user/s1934538/clickstream/clickstream-enwiki-2019-08.tsv.gz,Sushma_Swaraj,74640,2557871,16624,2649135,590841
hdfs://spark-nn.eemcs.utwente.nl/user/s1934538/clickstream/clickstream-enwiki-2019-08.tsv.gz,Star_Wars:_The_Rise_of_Skywalker,198882,304730,11469,515081,360175
hdfs://spark-nn.eemcs.utwente.nl/user/s1934538/clickstream/clickstream-enwiki-2019-08.tsv.gz,2023_Cricket_World_Cup,14786,30177,181,45144,13609
hdfs://spark-nn.eemcs.utwente.nl/user/s1934538/clickstream/clickstream-enwiki-2019-08.tsv.gz,Tenet_(film),104215,164834,1646,270695,221788
hdfs://spark-nn.eemcs.utwente.nl/user/s1934538/clickstream/clickstream-enwiki-2019-08.tsv.gz,Queen_(band),119846,444762,4956,569564,573599
hdfs://spark-nn.eemcs.utwente.nl/user/s1934538/clickstream/clickstream-enwiki-2019-08.tsv.gz,Irrfan_Khan,25364,40180,95,65639,30261
hdfs://spark-nn.eemcs.utwente.nl/user/s1934538/clickstream/clickstream-enwiki-2019-08.tsv.gz,"Prince_Philip,_Duke_of_Edinburgh",228266,217966,4600,450832,294552
hdfs://spark-nn.eemcs.utwente.nl/user/s1934538/clickstream/clickstream-enwiki-2019-08.tsv.gz,The_Irishman,169,1639,756,2564,3545
hdfs://spark-nn.eemcs.utwente.nl/user/s1934538/clickstream/clickstream-enwiki-2019-08.tsv.gz,K.G.F:_Chapter_2,49326,6647,47,56020,6300
hdfs://spark-nn.eemcs.utwente.nl/user/s1934538/clickstream/clickstream-enwiki-2019-08.tsv.gz,Jeffrey_Epstein,157810,6430860,120238,6708908,1975602
hdfs://spark-nn.eemcs.utwente.nl/user/s1934538/clickstream/clickstream-enwiki-2019-08.tsv.gz,Media,67,13351,283,13701,1864
hdfs://spark-nn.eemcs.utwente.nl/user/s1934538/clickstream/clickstream-enwiki-2019-08.tsv.gz,Simple_Mail_Transfer_Protocol,3996,27694,119,31809,3785
hdfs://spark-nn.eemcs.utwente.nl/user/s1934538/clickstream/clickstream-enwiki-2019-08.tsv.gz,Betty_White,68798,362047,2743,433588,108174
hdfs://spark-nn.eemcs.utwente.nl/user/s1934538/clickstream/clickstream-enwiki-2019-08.tsv.gz,Grover,1231,5232,39,6502,1311
hdfs://spark-nn.eemcs.utwente.nl/user/s1934538/clickstream/clickstream-enwiki-2019-08.tsv.gz,Indian_Premier_League,14566,46980,86,61632,40440
hdfs://spark-nn.eemcs.utwente.nl/user/s1934538/clickstream/clickstream-enwiki-2019-08.tsv.gz,List_of_highest-grossing_Indian_films,98568,367703,869,467140,239558
hdfs://spark-nn.eemcs.utwente.nl/user/s1934538/clickstream/clickstream-enwiki-2019-08.tsv.gz,Juice_Wrld,13886,200102,1377,215365,29325
hdfs://spark-nn.eemcs.utwente.nl/user/s1934538/clickstream/clickstream-enwiki-2019-08.tsv.gz,Jason_Momoa,162283,573209,3094,738586,327599
hdfs://spark-nn.eemcs.utwente.nl/user/s1934538/clickstream/clickstream-enwiki-2019-08.tsv.gz,The_Shape_of_Water,31830,62558,711,95099,42535
hdfs://spark-nn.eemcs.utwente.nl/user/s1934538/clickstream/clickstream-enwiki-2019-08.tsv.gz,Cecil_Hotel_(Los_Angeles),5269,19034,38,24341,9540
hdfs://spark-nn.eemcs.utwente.nl/user/s1934538/clickstream/clickstream-enwiki-2019-08.tsv.gz,Black_Panther_(film),66191,146852,3231,216274,133496
hdfs://spark-nn.eemcs.utwente.nl/user/s1934538/clickstream/clickstream-enwiki-2019-08.tsv.gz,Grimes_(musician),30948,40792,270,72010,27015
hdfs://spark-nn.eemcs.utwente.nl/user/s1934538/clickstream/clickstream-enwiki-2019-08.tsv.gz,Keanu_Reeves,146752,805829,5367,957948,449514
hdfs://spark-nn.eemcs.utwente.nl/user/s1934538/clickstream/clickstream-enwiki-2019-08.tsv.gz,Cristiano_Ronaldo,108648,586757,4021,699426,165203
hdfs://spark-nn.eemcs.utwente.nl/user/s1934538/clickstream/clickstream-enwiki-2019-08.tsv.gz,Kobe_Bryant,34240,251531,1661,287432,71661
hdfs://spark-nn.eemcs.utwente.nl/user/s1934538/clickstream/clickstream-enwiki-2019-08.tsv.gz,List_of_most_popular_websites,27397,72987,190,100574,49391
hdfs://spark-nn.eemcs.utwente.nl/user/s1934538/clickstream/clickstream-enwiki-2019-08.tsv.gz,Saaho,136693,1478281,8198,1623172,714432
hdfs://spark-nn.eemcs.utwente.nl/user/s1934538/clickstream/clickstream-enwiki-2019-08.tsv.gz,Central_Park_jogger_case,102434,335411,916,438761,58519
hdfs://spark-nn.eemcs.utwente.nl/user/s1934538/clickstream/clickstream-enwiki-2019-08.tsv.gz,Michael_Jordan,55547,300852,2781,359180,118855
hdfs://spark-nn.eemcs.utwente.nl/user/s1934538/clickstream/clickstream-enwiki-2019-08.tsv.gz,Juneteenth,2088,19977,53,22118,2371
hdfs://spark-nn.eemcs.utwente.nl/user/s1934538/clickstream/clickstream-enwiki-2019-08.tsv.gz,Kobe_Bryant_sexual_assault_case,3268,22967,19,26254,2871
hdfs://spark-nn.eemcs.utwente.nl/user/s1934538/clickstream/clickstream-enwiki-2019-08.tsv.gz,When_They_See_Us,45618,254724,2026,302368,179696
hdfs://spark-nn.eemcs.utwente.nl/user/s1934538/clickstream/clickstream-enwiki-2019-08.tsv.gz,Croatia,42691,172820,2350,217861,72400
hdfs://spark-nn.eemcs.utwente.nl/user/s1934538/clickstream/clickstream-enwiki-2019-08.tsv.gz,Amber_Heard,136377,276784,792,413953,191847
hdfs://spark-nn.eemcs.utwente.nl/user/s1934538/clickstream/clickstream-enwiki-2019-08.tsv.gz,Christopher_Scarver,76547,31142,20,107709,37653
hdfs://spark-nn.eemcs.utwente.nl/user/s1934538/clickstream/clickstream-enwiki-2019-08.tsv.gz,Priyanka_Chopra,142721,369228,1611,513560,196175
hdfs://spark-nn.eemcs.utwente.nl/user/s1934538/clickstream/clickstream-enwiki-2019-08.tsv.gz,Manti_Te'o,6012,37951,186,44149,5122
hdfs://spark-nn.eemcs.utwente.nl/user/s1934538/clickstream/clickstream-enwiki-2019-08.tsv.gz,Stan_Lee,63570,217541,3394,284505,93188
hdfs://spark-nn.eemcs.utwente.nl/user/s1934538/clickstream/clickstream-enwiki-2019-08.tsv.gz,"Diana,_Princess_of_Wales",131342,297424,2911,431677,269246
hdfs://spark-nn.eemcs.utwente.nl/user/s1934538/clickstream/clickstream-enwiki-2019-08.tsv.gz,1234,90,2025,13,2128,157
hdfs://spark-nn.eemcs.utwente.nl/user/s1934538/clickstream/clickstream-enwiki-2019-08.tsv.gz,Kate_Spade,32931,71429,418,104778,34124
hdfs://spark-nn.eemcs.utwente.nl/user/s1934538/clickstream/clickstream-enwiki-2019-08.tsv.gz,Antifa_(United_States),35533,761381,2640,799554,98564
hdfs://spark-nn.eemcs.utwente.nl/user/s1934538/clickstream/clickstream-enwiki-2019-08.tsv.gz,United_States_Senate,52818,58950,4151,115919,53378
hdfs://spark-nn.eemcs.utwente.nl/user/s1934538/clickstream/clickstream-enwiki-2019-08.tsv.gz,Lists_of_deaths_by_year,7756,143573,501,151830,144546
hdfs://spark-nn.eemcs.utwente.nl/user/s1934538/clickstream/clickstream-enwiki-2019-08.tsv.gz,Death_of_Elisa_Lam,6813,63442,433,70688,18513
hdfs://spark-nn.eemcs.utwente.nl/user/s1934538/clickstream/clickstream-enwiki-2019-08.tsv.gz,Israel,81533,295153,5152,381838,184014
hdfs://spark-nn.eemcs.utwente.nl/user/s1934538/clickstream/clickstream-enwiki-2019-08.tsv.gz,Tom_Brady,75132,357882,3742,436756,150235
hdfs://spark-nn.eemcs.utwente.nl/user/s1934538/clickstream/clickstream-enwiki-2019-08.tsv.gz,The_Lion_King_(2019_film),268853,1391198,21551,1681602,915593
hdfs://spark-nn.eemcs.utwente.nl/user/s1934538/clickstream/clickstream-enwiki-2019-08.tsv.gz,Michael_Bloomberg,45493,55937,384,101814,41035
hdfs://spark-nn.eemcs.utwente.nl/user/s1934538/clickstream/clickstream-enwiki-2019-08.tsv.gz,Asia_Cup,963,11844,69,12876,7850
hdfs://spark-nn.eemcs.utwente.nl/user/s1934538/clickstream/clickstream-enwiki-2019-08.tsv.gz,State_of_Palestine,41326,119694,119,161139,69276
hdfs://spark-nn.eemcs.utwente.nl/user/s1934538/clickstream/clickstream-enwiki-2019-08.tsv.gz,Rami_Malek,90689,250668,1327,342684,126431
hdfs://spark-nn.eemcs.utwente.nl/user/s1934538/clickstream/clickstream-enwiki-2019-08.tsv.gz,"Princess_Margaret,_Countess_of_Snowdon",133319,312374,2160,447853,299612
hdfs://spark-nn.eemcs.utwente.nl/user/s1934538/clickstream/clickstream-enwiki-2019-08.tsv.gz,Puneeth_Rajkumar,9714,22506,24,32244,14996
hdfs://spark-nn.eemcs.utwente.nl/user/s1934538/clickstream/clickstream-enwiki-2019-08.tsv.gz,Jimmy_Buffett,14403,64609,566,79578,25782
hdfs://spark-nn.eemcs.utwente.nl/user/s1934538/clickstream/clickstream-enwiki-2019-08.tsv.gz,Darth_Vader,28420,163921,562,192903,59106
hdfs://spark-nn.eemcs.utwente.nl/user/s1934538/clickstream/clickstream-enwiki-2019-08.tsv.gz,Nipsey_Hussle,36465,250191,1818,288474,99121
hdfs://spark-nn.eemcs.utwente.nl/user/s1934538/clickstream/clickstream-enwiki-2019-08.tsv.gz,Cricket_World_Cup,10181,85179,497,95857,44371
hdfs://spark-nn.eemcs.utwente.nl/user/s1934538/clickstream/clickstream-enwiki-2019-08.tsv.gz,Hamas,18554,28575,309,47438,18204
hdfs://spark-nn.eemcs.utwente.nl/user/s1934538/clickstream/clickstream-enwiki-2019-08.tsv.gz,Brie_Larson,106574,246656,1887,355117,145047
hdfs://spark-nn.eemcs.utwente.nl/user/s1934538/clickstream/clickstream-enwiki-2019-08.tsv.gz,Louis_Tomlinson,26868,46622,331,73821,11842
hdfs://spark-nn.eemcs.utwente.nl/user/s1934538/clickstream/clickstream-enwiki-2019-08.tsv.gz,XHamster,13211,53272,2590,69073,14017
hdfs://spark-nn.eemcs.utwente.nl/user/s1934538/clickstream/clickstream-enwiki-2019-08.tsv.gz,WrestleMania_34,21682,12295,308,34285,22286
hdfs://spark-nn.eemcs.utwente.nl/user/s1934538/clickstream/clickstream-enwiki-2019-08.tsv.gz,Cook's_Country,337,2830,25,3192,720
hdfs://spark-nn.eemcs.utwente.nl/user/s1934538/clickstream/clickstream-enwiki-2019-08.tsv.gz,Chernobyl_disaster,106986,1163462,9450,1279898,479180
hdfs://spark-nn.eemcs.utwente.nl/user/s1934538/clickstream/clickstream-enwiki-2019-08.tsv.gz,Venom_(2018_film),51972,242109,9659,303740,157787
hdfs://spark-nn.eemcs.utwente.nl/user/s1934538/clickstream/clickstream-enwiki-2019-08.tsv.gz,The_Irishman_(2019_film),124812,462660,6821,594293,517107
hdfs://spark-nn.eemcs.utwente.nl/user/s1934538/clickstream/clickstream-enwiki-2019-08.tsv.gz,Anne_Heche,33870,49520,252,83642,25048
hdfs://spark-nn.eemcs.utwente.nl/user/s1934538/clickstream/clickstream-enwiki-2019-08.tsv.gz,Area_51,32085,583619,4224,619928,127035
hdfs://spark-nn.eemcs.utwente.nl/user/s1934538/clickstream/clickstream-enwiki-2019-08.tsv.gz,Gaza_Strip,17038,36030,234,53302,20220
hdfs://spark-nn.eemcs.utwente.nl/user/s1934538/clickstream/clickstream-enwiki-2019-08.tsv.gz,Donald_Trump,281661,813633,13615,1108909,814235
hdfs://spark-nn.eemcs.utwente.nl/user/s1934538/clickstream/clickstream-enwiki-2019-08.tsv.gz,Top_Gun:_Maverick,65796,92144,1621,159561,138174
hdfs://spark-nn.eemcs.utwente.nl/user/s1934538/clickstream/clickstream-enwiki-2019-08.tsv.gz,John_McCain,35078,104460,1544,141082,68531
hdfs://spark-nn.eemcs.utwente.nl/user/s1934538/clickstream/clickstream-enwiki-2019-08.tsv.gz,NATO,41065,102215,2010,145290,56262
hdfs://spark-nn.eemcs.utwente.nl/user/s1934538/clickstream/clickstream-enwiki-2019-08.tsv.gz,Main_Page,25769,465660549,4354212,470040530,34195615
hdfs://spark-nn.eemcs.utwente.nl/user/s1934538/clickstream/clickstream-enwiki-2019-08.tsv.gz,September_11_attacks,89240,331952,3915,425107,197107
hdfs://spark-nn.eemcs.utwente.nl/user/s1934538/clickstream/clickstream-enwiki-2019-08.tsv.gz,Crazy_Rich_Asians_(film),55864,211014,2756,269634,287421
hdfs://spark-nn.eemcs.utwente.nl/user/s1934538/clickstream/clickstream-enwiki-2019-08.tsv.gz,Deaths_in_2019,1222124,2096659,10019,3328802,1762830
hdfs://spark-nn.eemcs.utwente.nl/user/s1934538/clickstream/clickstream-enwiki-2019-08.tsv.gz,Tina_Turner,24149,255382,1848,281379,67992
hdfs://spark-nn.eemcs.utwente.nl/user/s1934538/clickstream/clickstream-enwiki-2019-08.tsv.gz,List_of_James_Bond_films,22315,242105,571,264991,129267
hdfs://spark-nn.eemcs.utwente.nl/user/s1934538/clickstream/clickstream-enwiki-2019-08.tsv.gz,Bipin_Rawat,11570,44401,130,56101,27050
hdfs://spark-nn.eemcs.utwente.nl/user/s1934538/clickstream/clickstream-enwiki-2019-08.tsv.gz,2018_FIFA_World_Cup,65498,116331,1334,183163,89344
hdfs://spark-nn.eemcs.utwente.nl/user/s1934538/clickstream/clickstream-enwiki-2019-08.tsv.gz,J._Robert_Oppenheimer,18745,93927,321,112993,39316
hdfs://spark-nn.eemcs.utwente.nl/user/s1934538/clickstream/clickstream-enwiki-2019-08.tsv.gz,XXX:_Return_of_Xander_Cage,36002,91165,966,128133,49102
hdfs://spark-nn.eemcs.utwente.nl/user/s1934538/clickstream/clickstream-enwiki-2019-08.tsv.gz,Wikipedia,38715,4229944,666,4269325,200706
hdfs://spark-nn.eemcs.utwente.nl/user/s1934538/clickstream/clickstream-enwiki-2019-08.tsv.gz,Parasite_(2019_film),49974,405374,2975,458323,171728
hdfs://spark-nn.eemcs.utwente.nl/user/s1934538/clickstream/clickstream-enwiki-2019-08.tsv.gz,UEFA_Euro_2020,33748,152849,2032,188629,48573
hdfs://spark-nn.eemcs.utwente.nl/user/s1934538/clickstream/clickstream-enwiki-2019-08.tsv.gz,Avicii,24449,269668,2165,296282,143152
hdfs://spark-nn.eemcs.utwente.nl/user/s1934538/clickstream/clickstream-enwiki-2019-08.tsv.gz,William_Murdoch,777,3878978,39,3879794,361
hdfs://spark-nn.eemcs.utwente.nl/user/s1934538/clickstream/clickstream-enwiki-2019-08.tsv.gz,Anna_Sorokin,10630,45351,151,56132,12684
hdfs://spark-nn.eemcs.utwente.nl/user/s1934538/clickstream/clickstream-enwiki-2019-08.tsv.gz,Sylvester_Stallone,110854,525805,3205,639864,428802
hdfs://spark-nn.eemcs.utwente.nl/user/s1934538/clickstream/clickstream-enwiki-2019-08.tsv.gz,Meat_Loaf,24460,82965,974,108399,39287
hdfs://spark-nn.eemcs.utwente.nl/user/s1934538/clickstream/clickstream-enwiki-2019-08.tsv.gz,A_Star_Is_Born_(2018_film),58111,396314,2575,457000,223391
hdfs://spark-nn.eemcs.utwente.nl/user/s1934538/clickstream/clickstream-enwiki-2019-08.tsv.gz,Qasem_Soleimani,3228,6687,22,9937,4919
hdfs://spark-nn.eemcs.utwente.nl/user/s1934538/clickstream/clickstream-enwiki-2019-08.tsv.gz,Tonya_Harding,29740,125654,555,155949,33125
hdfs://spark-nn.eemcs.utwente.nl/user/s1934538/clickstream/clickstream-enwiki-2019-08.tsv.gz,Elizabeth_II,501969,561471,2981,1066421,894899
hdfs://spark-nn.eemcs.utwente.nl/user/s1934538/clickstream/clickstream-enwiki-2019-08.tsv.gz,A_Quiet_Place_(film),29972,147794,1180,178946,60532
hdfs://spark-nn.eemcs.utwente.nl/user/s1934538/clickstream/clickstream-enwiki-2019-08.tsv.gz,Bob_Saget,20951,37420,277,58648,12714
hdfs://spark-nn.eemcs.utwente.nl/user/s1934538/clickstream/clickstream-enwiki-2019-08.tsv.gz,Jeffrey_Dahmer,41001,410683,4916,456600,188461
hdfs://spark-nn.eemcs.utwente.nl/user/s1934538/clickstream/clickstream-enwiki-2019-08.tsv.gz,XNXX,3539,261944,12022,277505,66748
hdfs://spark-nn.eemcs.utwente.nl/user/s1934538/clickstream/clickstream-enwiki-2019-08.tsv.gz,Avengers:_Endgame,401030,1519771,32591,1953392,1251704
hdfs://spark-nn.eemcs.utwente.nl/user/s1934538/clickstream/clickstream-enwiki-2019-08.tsv.gz,Ted_Bundy,84850,1138753,9594,1233197,282740
hdfs://spark-nn.eemcs.utwente.nl/user/s1934538/clickstream/clickstream-enwiki-2019-08.tsv.gz,Captain_Marvel_(film),99014,306055,4664,409733,223870
hdfs://spark-nn.eemcs.utwente.nl/user/s1934538/clickstream/clickstream-enwiki-2019-08.tsv.gz,Matthew_Perry,81162,259486,1322,341970,182284
hdfs://spark-nn.eemcs.utwente.nl/user/s1934538/clickstream/clickstream-enwiki-2019-08.tsv.gz,Microsoft_Office,8310,120789,586,129685,21539
hdfs://spark-nn.eemcs.utwente.nl/user/s1934538/clickstream/clickstream-enwiki-2019-08.tsv.gz,Taliban,31156,99581,2350,133087,83875
hdfs://spark-nn.eemcs.utwente.nl/user/s1934538/clickstream/clickstream-enwiki-2019-08.tsv.gz,Freddie_Mercury,186406,1395882,7853,1590141,571670
hdfs://spark-nn.eemcs.utwente.nl/user/s1934538/clickstream/clickstream-enwiki-2019-08.tsv.gz,Brett_Kavanaugh,23709,39986,298,63993,23613
hdfs://spark-nn.eemcs.utwente.nl/user/s1934538/clickstream/clickstream-enwiki-2019-08.tsv.gz,Glass_(2019_film),66855,130654,1440,198949,70768
hdfs://spark-nn.eemcs.utwente.nl/user/s1934538/clickstream/clickstream-enwiki-2019-08.tsv.gz,Mulan_(2020_film),50678,82609,1981,135268,138054
hdfs://spark-nn.eemcs.utwente.nl/user/s1934538/clickstream/clickstream-enwiki-2019-08.tsv.gz,XXXTentacion,74850,373397,6672,454919,101582
hdfs://spark-nn.eemcs.utwente.nl/user/s1934538/clickstream/clickstream-enwiki-2019-08.tsv.gz,Spider-Man:_Far_From_Home,288602,909572,24447,1222621,599695
hdfs://spark-nn.eemcs.utwente.nl/user/s1934538/clickstream/clickstream-enwiki-2019-08.tsv.gz,List_of_FIFA_World_Cup_finals,1335,46633,85,48053,11914
hdfs://spark-nn.eemcs.utwente.nl/user/s1934538/clickstream/clickstream-enwiki-2019-08.tsv.gz,The_Weeknd,41793,95878,906,138577,68639
hdfs://spark-nn.eemcs.utwente.nl/user/s1934538/clickstream/clickstream-enwiki-2019-08.tsv.gz,Fyre_Festival,15541,168376,1002,184919,87885
hdfs://spark-nn.eemcs.utwente.nl/user/s1934538/clickstream/clickstream-enwiki-2019-08.tsv.gz,Once_Upon_a_Time_in_Hollywood,467640,3080316,65888,3613844,4196765
hdfs://spark-nn.eemcs.utwente.nl/user/s1934538/clickstream/clickstream-enwiki-2019-08.tsv.gz,Khabib_Nurmagomedov,108892,329428,2995,441315,217030
hdfs://spark-nn.eemcs.utwente.nl/user/s1934538/clickstream/clickstream-enwiki-2019-08.tsv.gz,Kylian_Mbappé,31136,124199,1724,157059,29289
hdfs://spark-nn.eemcs.utwente.nl/user/s1934538/clickstream/clickstream-enwiki-2019-08.tsv.gz,Alexander_Hamilton,65826,241537,1679,309042,151426
hdfs://spark-nn.eemcs.utwente.nl/user/s1934538/clickstream/clickstream-enwiki-2019-09.tsv.gz,Hamas,20568,28534,224,49326,18352
hdfs://spark-nn.eemcs.utwente.nl/user/s1934538/clickstream/clickstream-enwiki-2019-09.tsv.gz,Juice_Wrld,14369,69797,665,84831,25536
hdfs://spark-nn.eemcs.utwente.nl/user/s1934538/clickstream/clickstream-enwiki-2019-09.tsv.gz,The_Lion_King_(2019_film),127597,484664,7902,620163,244328
hdfs://spark-nn.eemcs.utwente.nl/user/s1934538/clickstream/clickstream-enwiki-2019-09.tsv.gz,2020_United_States_presidential_election,93994,327850,6611,428455,262141
hdfs://spark-nn.eemcs.utwente.nl/user/s1934538/clickstream/clickstream-enwiki-2019-09.tsv.gz,Top_Gun:_Maverick,54496,58889,1942,115327,88310
hdfs://spark-nn.eemcs.utwente.nl/user/s1934538/clickstream/clickstream-enwiki-2019-09.tsv.gz,DMX_(rapper),16433,96249,586,113268,48879
hdfs://spark-nn.eemcs.utwente.nl/user/s1934538/clickstream/clickstream-enwiki-2019-09.tsv.gz,List_of_Marvel_Cinematic_Universe_films,223994,751254,7148,982396,385498
hdfs://spark-nn.eemcs.utwente.nl/user/s1934538/clickstream/clickstream-enwiki-2019-09.tsv.gz,Avicii,19089,233144,1952,254185,114297
hdfs://spark-nn.eemcs.utwente.nl/user/s1934538/clickstream/clickstream-enwiki-2019-09.tsv.gz,Israel,95607,340116,6518,442241,221399
hdfs://spark-nn.eemcs.utwente.nl/user/s1934538/clickstream/clickstream-enwiki-2019-09.tsv.gz,Jason_Momoa,140316,442843,2141,585300,273984
hdfs://spark-nn.eemcs.utwente.nl/user/s1934538/clickstream/clickstream-enwiki-2019-09.tsv.gz,Parasite_(2019_film),39680,284905,5068,329653,110294
hdfs://spark-nn.eemcs.utwente.nl/user/s1934538/clickstream/clickstream-enwiki-2019-09.tsv.gz,Black_Panther_(film),46984,117679,1939,166602,93005
hdfs://spark-nn.eemcs.utwente.nl/user/s1934538/clickstream/clickstream-enwiki-2019-09.tsv.gz,Anthony_Bourdain,16149,263552,1950,281651,62110
hdfs://spark-nn.eemcs.utwente.nl/user/s1934538/clickstream/clickstream-enwiki-2019-09.tsv.gz,XNXX,4192,279933,11027,295152,57707
hdfs://spark-nn.eemcs.utwente.nl/user/s1934538/clickstream/clickstream-enwiki-2019-09.tsv.gz,Stan_Lee,45134,148001,1476,194611,56708
hdfs://spark-nn.eemcs.utwente.nl/user/s1934538/clickstream/clickstream-enwiki-2019-09.tsv.gz,United_States_Electoral_College,24485,112712,181,137378,16167
hdfs://spark-nn.eemcs.utwente.nl/user/s1934538/clickstream/clickstream-enwiki-2019-09.tsv.gz,Media,56,18970,298,19324,1994
hdfs://spark-nn.eemcs.utwente.nl/user/s1934538/clickstream/clickstream-enwiki-2019-09.tsv.gz,The_Witcher_(TV_series),17507,135644,1492,154643,67120
hdfs://spark-nn.eemcs.utwente.nl/user/s1934538/clickstream/clickstream-enwiki-2019-09.tsv.gz,Mortal_Kombat_(2021_film),16888,5530,101,22519,47092
hdfs://spark-nn.eemcs.utwente.nl/user/s1934538/clickstream/clickstream-enwiki-2019-09.tsv.gz,The_Irishman,208,1786,733,2727,3606
hdfs://spark-nn.eemcs.utwente.nl/user/s1934538/clickstream/clickstream-enwiki-2019-09.tsv.gz,Notre-Dame_de_Paris,14000,94968,1062,110030,22503
hdfs://spark-nn.eemcs.utwente.nl/user/s1934538/clickstream/clickstream-enwiki-2019-09.tsv.gz,Death_of_Elisa_Lam,6729,62516,250,69495,17124
hdfs://spark-nn.eemcs.utwente.nl/user/s1934538/clickstream/clickstream-enwiki-2019-09.tsv.gz,Charles_III,72,290,110,472,330
hdfs://spark-nn.eemcs.utwente.nl/user/s1934538/clickstream/clickstream-enwiki-2019-09.tsv.gz,Asia_Cup,1077,14846,59,15982,9347
hdfs://spark-nn.eemcs.utwente.nl/user/s1934538/clickstream/clickstream-enwiki-2019-09.tsv.gz,Avengers:_Infinity_War,74079,125733,1987,201799,117593
hdfs://spark-nn.eemcs.utwente.nl/user/s1934538/clickstream/clickstream-enwiki-2019-09.tsv.gz,2020_Summer_Olympics,70032,230433,12028,312493,288986
hdfs://spark-nn.eemcs.utwente.nl/user/s1934538/clickstream/clickstream-enwiki-2019-09.tsv.gz,Tenet_(film),107256,127888,1926,237070,208923
hdfs://spark-nn.eemcs.utwente.nl/user/s1934538/clickstream/clickstream-enwiki-2019-09.tsv.gz,Coronavirus,737,5432,40,6209,830
hdfs://spark-nn.eemcs.utwente.nl/user/s1934538/clickstream/clickstream-enwiki-2019-09.tsv.gz,Grover,1258,6144,51,7453,1542
hdfs://spark-nn.eemcs.utwente.nl/user/s1934538/clickstream/clickstream-enwiki-2019-09.tsv.gz,Michael_Bloomberg,46402,61389,397,108188,43142
hdfs://spark-nn.eemcs.utwente.nl/user/s1934538/clickstream/clickstream-enwiki-2019-09.tsv.gz,Murder_of_Dee_Dee_Blanchard,31755,238589,677,271021,46401
hdfs://spark-nn.eemcs.utwente.nl/user/s1934538/clickstream/clickstream-enwiki-2019-09.tsv.gz,Bob_Saget,18481,36418,266,55165,10239
hdfs://spark-nn.eemcs.utwente.nl/user/s1934538/clickstream/clickstream-enwiki-2019-09.tsv.gz,Dennis_Nilsen,5422,29703,172,35297,7031
hdfs://spark-nn.eemcs.utwente.nl/user/s1934538/clickstream/clickstream-enwiki-2019-09.tsv.gz,Tom_Brady,116861,609634,5814,732309,245930
hdfs://spark-nn.eemcs.utwente.nl/user/s1934538/clickstream/clickstream-enwiki-2019-09.tsv.gz,Exo_(band),18701,85189,363,104253,108334
hdfs://spark-nn.eemcs.utwente.nl/user/s1934538/clickstream/clickstream-enwiki-2019-09.tsv.gz,Greta_Thunberg,67192,3079553,24087,3170832,1158734
hdfs://spark-nn.eemcs.utwente.nl/user/s1934538/clickstream/clickstream-enwiki-2019-09.tsv.gz,George_H._W._Bush,126527,126831,799,254157,137840
hdfs://spark-nn.eemcs.utwente.nl/user/s1934538/clickstream/clickstream-enwiki-2019-09.tsv.gz,XXX:_Return_of_Xander_Cage,27417,73116,618,101151,37645
hdfs://spark-nn.eemcs.utwente.nl/user/s1934538/clickstream/clickstream-enwiki-2019-09.tsv.gz,Kelly_Preston,76000,46574,130,122704,34139
hdfs://spark-nn.eemcs.utwente.nl/user/s1934538/clickstream/clickstream-enwiki-2019-09.tsv.gz,Anna_Sorokin,14186,42445,104,56735,12067
hdfs://spark-nn.eemcs.utwente.nl/user/s1934538/clickstream/clickstream-enwiki-2019-09.tsv.gz,Cameron_Boyce,47028,337046,2007,386081,112670
hdfs://spark-nn.eemcs.utwente.nl/user/s1934538/clickstream/clickstream-enwiki-2019-09.tsv.gz,1917_(2019_film),35473,44763,4654,84890,46562
hdfs://spark-nn.eemcs.utwente.nl/user/s1934538/clickstream/clickstream-enwiki-2019-09.tsv.gz,Deaths_in_2019,1185490,2077199,9435,3272124,1908920
hdfs://spark-nn.eemcs.utwente.nl/user/s1934538/clickstream/clickstream-enwiki-2019-09.tsv.gz,List_of_Queen_of_the_South_episodes,6403090,23090,235,6426415,1173
hdfs://spark-nn.eemcs.utwente.nl/user/s1934538/clickstream/clickstream-enwiki-2019-09.tsv.gz,Ted_Bundy,59844,629602,5601,695047,151180
hdfs://spark-nn.eemcs.utwente.nl/user/s1934538/clickstream/clickstream-enwiki-2019-09.tsv.gz,Louis_Tomlinson,25566,68361,542,94469,16762
hdfs://spark-nn.eemcs.utwente.nl/user/s1934538/clickstream/clickstream-enwiki-2019-09.tsv.gz,2016_United_States_presidential_election,92253,249460,2617,344330,219153
hdfs://spark-nn.eemcs.utwente.nl/user/s1934538/clickstream/clickstream-enwiki-2019-09.tsv.gz,Game_of_Thrones,69898,289945,10738,370581,245461
hdfs://spark-nn.eemcs.utwente.nl/user/s1934538/clickstream/clickstream-enwiki-2019-09.tsv.gz,Qasem_Soleimani,4338,8104,17,12459,6146
hdfs://spark-nn.eemcs.utwente.nl/user/s1934538/clickstream/clickstream-enwiki-2019-09.tsv.gz,Shakira,23058,273719,2379,299156,122391
hdfs://spark-nn.eemcs.utwente.nl/user/s1934538/clickstream/clickstream-enwiki-2019-09.tsv.gz,R._Kelly,46699,400669,2641,450009,174933
hdfs://spark-nn.eemcs.utwente.nl/user/s1934538/clickstream/clickstream-enwiki-2019-09.tsv.gz,Rihanna,70441,296659,7095,374195,184715
hdfs://spark-nn.eemcs.utwente.nl/user/s1934538/clickstream/clickstream-enwiki-2019-09.tsv.gz,Glass_(2019_film),87665,151388,2982,242035,84438
hdfs://spark-nn.eemcs.utwente.nl/user/s1934538/clickstream/clickstream-enwiki-2019-09.tsv.gz,Jeffrey_Dahmer,31289,305542,3291,340122,134384
hdfs://spark-nn.eemcs.utwente.nl/user/s1934538/clickstream/clickstream-enwiki-2019-09.tsv.gz,Elon_Musk,79874,688569,4612,773055,411247
hdfs://spark-nn.eemcs.utwente.nl/user/s1934538/clickstream/clickstream-enwiki-2019-09.tsv.gz,List_of_most_popular_websites,24484,150657,201,175342,47898
hdfs://spark-nn.eemcs.utwente.nl/user/s1934538/clickstream/clickstream-enwiki-2019-09.tsv.gz,Anne_Heche,29010,58880,311,88201,25330
hdfs://spark-nn.eemcs.utwente.nl/user/s1934538/clickstream/clickstream-enwiki-2019-09.tsv.gz,The_Umbrella_Academy_(TV_series),26770,135581,2163,164514,83288
hdfs://spark-nn.eemcs.utwente.nl/user/s1934538/clickstream/clickstream-enwiki-2019-09.tsv.gz,2018_Asian_Games,9014,20070,117,29201,17493
hdfs://spark-nn.eemcs.utwente.nl/user/s1934538/clickstream/clickstream-enwiki-2019-09.tsv.gz,Betty_White,59370,383963,3104,446437,100707
hdfs://spark-nn.eemcs.utwente.nl/user/s1934538/clickstream/clickstream-enwiki-2019-09.tsv.gz,Richard_Ramirez,47350,392431,2417,442198,112864
hdfs://spark-nn.eemcs.utwente.nl/user/s1934538/clickstream/clickstream-enwiki-2019-09.tsv.gz,2018_FIFA_World_Cup,71298,124104,1287,196689,94418
hdfs://spark-nn.eemcs.utwente.nl/user/s1934538/clickstream/clickstream-enwiki-2019-09.tsv.gz,September_11_attacks,246402,2163048,24804,2434254,1029972
hdfs://spark-nn.eemcs.utwente.nl/user/s1934538/clickstream/clickstream-enwiki-2019-09.tsv.gz,David_Beckham,36334,157127,1346,194807,62195
hdfs://spark-nn.eemcs.utwente.nl/user/s1934538/clickstream/clickstream-enwiki-2019-09.tsv.gz,Bonnie_and_Clyde,22775,259777,1735,284287,67485
hdfs://spark-nn.eemcs.utwente.nl/user/s1934538/clickstream/clickstream-enwiki-2019-09.tsv.gz,Us_(2019_film),39635,278897,2151,320683,85335
hdfs://spark-nn.eemcs.utwente.nl/user/s1934538/clickstream/clickstream-enwiki-2019-09.tsv.gz,Royal_Rumble_(2018),7156,4910,51,12117,7983
hdfs://spark-nn.eemcs.utwente.nl/user/s1934538/clickstream/clickstream-enwiki-2019-09.tsv.gz,2018_Winter_Olympics,20644,21011,193,41848,23366
hdfs://spark-nn.eemcs.utwente.nl/user/s1934538/clickstream/clickstream-enwiki-2019-09.tsv.gz,"Prince_Philip,_Duke_of_Edinburgh",201624,207697,5089,414410,262064
hdfs://spark-nn.eemcs.utwente.nl/user/s1934538/clickstream/clickstream-enwiki-2019-09.tsv.gz,Ruth_Bader_Ginsburg,23326,154930,959,179215,63255
hdfs://spark-nn.eemcs.utwente.nl/user/s1934538/clickstream/clickstream-enwiki-2019-09.tsv.gz,K.G.F:_Chapter_2,39679,64239,153,104071,51878
hdfs://spark-nn.eemcs.utwente.nl/user/s1934538/clickstream/clickstream-enwiki-2019-09.tsv.gz,Olivia_Newton-John,26981,187861,1617,216459,86102
hdfs://spark-nn.eemcs.utwente.nl/user/s1934538/clickstream/clickstream-enwiki-2019-09.tsv.gz,Hyphen-minus,5553,66594996,7512254,74112803,798
hdfs://spark-nn.eemcs.utwente.nl/user/s1934538/clickstream/clickstream-enwiki-2019-09.tsv.gz,Donald_Trump,266015,914501,12654,1193170,811965
hdfs://spark-nn.eemcs.utwente.nl/user/s1934538/clickstream/clickstream-enwiki-2019-09.tsv.gz,Salman_Rushdie,23992,103817,958,128767,60573
hdfs://spark-nn.eemcs.utwente.nl/user/s1934538/clickstream/clickstream-enwiki-2019-09.tsv.gz,Aaron_Carter,61133,480491,3102,544726,207303
hdfs://spark-nn.eemcs.utwente.nl/user/s1934538/clickstream/clickstream-enwiki-2019-09.tsv.gz,Rami_Malek,108468,228893,1085,338446,111668
hdfs://spark-nn.eemcs.utwente.nl/user/s1934538/clickstream/clickstream-enwiki-2019-09.tsv.gz,Michael_Jordan,56861,324581,2820,384262,120905
hdfs://spark-nn.eemcs.utwente.nl/user/s1934538/clickstream/clickstream-enwiki-2019-09.tsv.gz,Sushma_Swaraj,7964,66394,262,74620,11770
hdfs://spark-nn.eemcs.utwente.nl/user/s1934538/clickstream/clickstream-enwiki-2019-09.tsv.gz,Cardi_B,86603,476612,8178,571393,205226
hdfs://spark-nn.eemcs.utwente.nl/user/s1934538/clickstream/clickstream-enwiki-2019-09.tsv.gz,Chadwick_Boseman,25333,49523,799,75655,24735
hdfs://spark-nn.eemcs.utwente.nl/user/s1934538/clickstream/clickstream-enwiki-2019-09.tsv.gz,Dark_Phoenix_(film),113342,746964,14724,875030,516790
hdfs://spark-nn.eemcs.utwente.nl/user/s1934538/clickstream/clickstream-enwiki-2019-09.tsv.gz,Microsoft_Office,8696,185410,590,194696,21295
hdfs://spark-nn.eemcs.utwente.nl/user/s1934538/clickstream/clickstream-enwiki-2019-09.tsv.gz,Chernobyl_disaster,80776,814916,6209,901901,334881
hdfs://spark-nn.eemcs.utwente.nl/user/s1934538/clickstream/clickstream-enwiki-2019-09.tsv.gz,Once_Upon_a_Time_in_Hollywood,215374,996289,27632,1239295,1257774
hdfs://spark-nn.eemcs.utwente.nl/user/s1934538/clickstream/clickstream-enwiki-2019-09.tsv.gz,WrestleMania_34,16373,9069,256,25698,17096
hdfs://spark-nn.eemcs.utwente.nl/user/s1934538/clickstream/clickstream-enwiki-2019-09.tsv.gz,JSON_Web_Token,978,21406,35,22419,1901
hdfs://spark-nn.eemcs.utwente.nl/user/s1934538/clickstream/clickstream-enwiki-2019-09.tsv.gz,Keanu_Reeves,120785,834671,5365,960821,398806
hdfs://spark-nn.eemcs.utwente.nl/user/s1934538/clickstream/clickstream-enwiki-2019-09.tsv.gz,Crazy_Rich_Asians_(film),52282,149801,1700,203783,191592
hdfs://spark-nn.eemcs.utwente.nl/user/s1934538/clickstream/clickstream-enwiki-2019-09.tsv.gz,Atal_Bihari_Vajpayee,24476,63742,76,88294,18121
hdfs://spark-nn.eemcs.utwente.nl/user/s1934538/clickstream/clickstream-enwiki-2019-09.tsv.gz,Line_shaft,601,1525623,24,1526248,134
hdfs://spark-nn.eemcs.utwente.nl/user/s1934538/clickstream/clickstream-enwiki-2019-09.tsv.gz,21_Savage,23232,76403,979,100614,29942
hdfs://spark-nn.eemcs.utwente.nl/user/s1934538/clickstream/clickstream-enwiki-2019-09.tsv.gz,Jeffrey_Epstein,42575,486711,4074,533360,153599
hdfs://spark-nn.eemcs.utwente.nl/user/s1934538/clickstream/clickstream-enwiki-2019-09.tsv.gz,Indian_Premier_League,12936,46248,64,59248,35044
hdfs://spark-nn.eemcs.utwente.nl/user/s1934538/clickstream/clickstream-enwiki-2019-09.tsv.gz,Priyanka_Chopra,125060,348540,1282,474882,174604
hdfs://spark-nn.eemcs.utwente.nl/user/s1934538/clickstream/clickstream-enwiki-2019-09.tsv.gz,Star_Wars:_The_Rise_of_Skywalker,154612,214769,14323,383704,248561
hdfs://spark-nn.eemcs.utwente.nl/user/s1934538/clickstream/clickstream-enwiki-2019-09.tsv.gz,Bipin_Rawat,8395,37594,109,46098,21222
hdfs://spark-nn.eemcs.utwente.nl/user/s1934538/clickstream/clickstream-enwiki-2019-09.tsv.gz,Area_51,63354,949089,10555,1022998,224613
hdfs://spark-nn.eemcs.utwente.nl/user/s1934538/clickstream/clickstream-enwiki-2019-09.tsv.gz,Ghislaine_Maxwell,29943,76292,627,106862,44202
hdfs://spark-nn.eemcs.utwente.nl/user/s1934538/clickstream/clickstream-enwiki-2019-09.tsv.gz,Cecil_Hotel_(Los_Angeles),5971,19497,46,25514,10120
hdfs://spark-nn.eemcs.utwente.nl/user/s1934538/clickstream/clickstream-enwiki-2019-09.tsv.gz,Stranger_Things_(season_3),38771,180402,2962,222135,147914
hdfs://spark-nn.eemcs.utwente.nl/user/s1934538/clickstream/clickstream-enwiki-2019-09.tsv.gz,List_of_FIFA_World_Cup_finals,1900,49510,74,51484,13253
hdfs://spark-nn.eemcs.utwente.nl/user/s1934538/clickstream/clickstream-enwiki-2019-09.tsv.gz,List_of_awards_and_nominations_received_by_Meryl_Streep,12897,9218,116,22231,7358
hdfs://spark-nn.eemcs.utwente.nl/user/s1934538/clickstream/clickstream-enwiki-2019-09.tsv.gz,Nipsey_Hussle,30017,171924,1757,203698,68082
hdfs://spark-nn.eemcs.utwente.nl/user/s1934538/clickstream/clickstream-enwiki-2019-09.tsv.gz,Manti_Te'o,8722,153441,581,162744,18386
hdfs://spark-nn.eemcs.utwente.nl/user/s1934538/clickstream/clickstream-enwiki-2019-09.tsv.gz,Game_of_Thrones_(season_8),20771,84699,1568,107038,38949
hdfs://spark-nn.eemcs.utwente.nl/user/s1934538/clickstream/clickstream-enwiki-2019-09.tsv.gz,Hamilton_(musical),28943,232487,1473,262903,123888
hdfs://spark-nn.eemcs.utwente.nl/user/s1934538/clickstream/clickstream-enwiki-2019-09.tsv.gz,A_Star_Is_Born_(2018_film),54518,281756,1666,337940,157294
hdfs://spark-nn.eemcs.utwente.nl/user/s1934538/clickstream/clickstream-enwiki-2019-09.tsv.gz,Antifa_(United_States),13371,228326,727,242424,27727
hdfs://spark-nn.eemcs.utwente.nl/user/s1934538/clickstream/clickstream-enwiki-2019-09.tsv.gz,The_Shape_of_Water,26566,61768,661,88995,38418
hdfs://spark-nn.eemcs.utwente.nl/user/s1934538/clickstream/clickstream-enwiki-2019-09.tsv.gz,Naya_Rivera,32563,49774,108,82445,16009
hdfs://spark-nn.eemcs.utwente.nl/user/s1934538/clickstream/clickstream-enwiki-2019-09.tsv.gz,RRR_(film),86207,65259,146,151612,88563
hdfs://spark-nn.eemcs.utwente.nl/user/s1934538/clickstream/clickstream-enwiki-2019-09.tsv.gz,Central_Park_jogger_case,95695,313702,770,410167,50619
hdfs://spark-nn.eemcs.utwente.nl/user/s1934538/clickstream/clickstream-enwiki-2019-09.tsv.gz,Spider-Man:_Far_From_Home,195252,784964,16692,996908,564189
hdfs://spark-nn.eemcs.utwente.nl/user/s1934538/clickstream/clickstream-enwiki-2019-09.tsv.gz,Fantastic_Beasts:_The_Crimes_of_Grindelwald,79254,173661,2461,255376,148531
hdfs://spark-nn.eemcs.utwente.nl/user/s1934538/clickstream/clickstream-enwiki-2019-09.tsv.gz,Sinéad_O'Connor,13690,290176,2382,306248,78986
hdfs://spark-nn.eemcs.utwente.nl/user/s1934538/clickstream/clickstream-enwiki-2019-09.tsv.gz,Kobe_Bryant_sexual_assault_case,3174,27539,20,30733,2986
hdfs://spark-nn.eemcs.utwente.nl/user/s1934538/clickstream/clickstream-enwiki-2019-09.tsv.gz,Critical_race_theory,2046,17574,31,19651,4128
hdfs://spark-nn.eemcs.utwente.nl/user/s1934538/clickstream/clickstream-enwiki-2019-09.tsv.gz,FIFA_World_Cup,38328,163574,2536,204438,149071
hdfs://spark-nn.eemcs.utwente.nl/user/s1934538/clickstream/clickstream-enwiki-2019-09.tsv.gz,The_Nun_(2018_film),27440,92804,700,120944,75745
hdfs://spark-nn.eemcs.utwente.nl/user/s1934538/clickstream/clickstream-enwiki-2019-09.tsv.gz,Meat_Loaf,22691,86278,1004,109973,37837
hdfs://spark-nn.eemcs.utwente.nl/user/s1934538/clickstream/clickstream-enwiki-2019-09.tsv.gz,Mötley_Crüe,35904,129308,1241,166453,200707
hdfs://spark-nn.eemcs.utwente.nl/user/s1934538/clickstream/clickstream-enwiki-2019-09.tsv.gz,Sushant_Singh_Rajput,52940,150417,712,204069,122839
hdfs://spark-nn.eemcs.utwente.nl/user/s1934538/clickstream/clickstream-enwiki-2019-09.tsv.gz,Puneeth_Rajkumar,10695,25059,23,35777,15924
hdfs://spark-nn.eemcs.utwente.nl/user/s1934538/clickstream/clickstream-enwiki-2019-09.tsv.gz,Burt_Reynolds,51508,198080,1684,251272,89795
hdfs://spark-nn.eemcs.utwente.nl/user/s1934538/clickstream/clickstream-enwiki-2019-09.tsv.gz,Richard_Jewell,8697,18049,162,26908,9919
hdfs://spark-nn.eemcs.utwente.nl/user/s1934538/clickstream/clickstream-enwiki-2019-09.tsv.gz,Jimmy_Hoffa,68794,164527,1776,235097,93991
hdfs://spark-nn.eemcs.utwente.nl/user/s1934538/clickstream/clickstream-enwiki-2019-09.tsv.gz,Joker_(2019_film),246090,2588596,78720,2913406,1128119
hdfs://spark-nn.eemcs.utwente.nl/user/s1934538/clickstream/clickstream-enwiki-2019-09.tsv.gz,Joe_Biden,98545,546605,7894,653044,247372
hdfs://spark-nn.eemcs.utwente.nl/user/s1934538/clickstream/clickstream-enwiki-2019-09.tsv.gz,IPv4,13279,47635,147,61061,10164
hdfs://spark-nn.eemcs.utwente.nl/user/s1934538/clickstream/clickstream-enwiki-2019-09.tsv.gz,Stranger_Things,84128,497594,9614,591336,504862
hdfs://spark-nn.eemcs.utwente.nl/user/s1934538/clickstream/clickstream-enwiki-2019-09.tsv.gz,"Princess_Margaret,_Countess_of_Snowdon",111295,249198,1552,362045,240881
hdfs://spark-nn.eemcs.utwente.nl/user/s1934538/clickstream/clickstream-enwiki-2019-09.tsv.gz,Joaquin_Phoenix,346522,863093,6241,1215856,950567
hdfs://spark-nn.eemcs.utwente.nl/user/s1934538/clickstream/clickstream-enwiki-2019-09.tsv.gz,Rishi_Sunak,5418,13747,78,19243,5995
hdfs://spark-nn.eemcs.utwente.nl/user/s1934538/clickstream/clickstream-enwiki-2019-09.tsv.gz,Charles_Sobhraj,4577,25545,98,30220,6830
hdfs://spark-nn.eemcs.utwente.nl/user/s1934538/clickstream/clickstream-enwiki-2019-09.tsv.gz,Fyre_Festival,23088,171981,892,195961,87183
hdfs://spark-nn.eemcs.utwente.nl/user/s1934538/clickstream/clickstream-enwiki-2019-09.tsv.gz,Amy_Coney_Barrett,1484,10390,147,12021,2699
hdfs://spark-nn.eemcs.utwente.nl/user/s1934538/clickstream/clickstream-enwiki-2019-09.tsv.gz,HTTP_cookie,8006,376021,97,384124,44234
hdfs://spark-nn.eemcs.utwente.nl/user/s1934538/clickstream/clickstream-enwiki-2019-09.tsv.gz,Cricket_World_Cup,8141,65123,326,73590,32463
hdfs://spark-nn.eemcs.utwente.nl/user/s1934538/clickstream/clickstream-enwiki-2019-12.tsv.gz,Ray_Liotta,83770,103141,941,187852,62256
hdfs://spark-nn.eemcs.utwente.nl/user/s1934538/clickstream/clickstream-enwiki-2019-12.tsv.gz,Lionel_Messi,104634,655003,8068,767705,183270
hdfs://spark-nn.eemcs.utwente.nl/user/s1934538/clickstream/clickstream-enwiki-2019-12.tsv.gz,Bipin_Rawat,19936,115259,2990,138185,77493
hdfs://spark-nn.eemcs.utwente.nl/user/s1934538/clickstream/clickstream-enwiki-2019-12.tsv.gz,UEFA_Euro_2020,70916,392652,7856,471424,180014
hdfs://spark-nn.eemcs.utwente.nl/user/s1934538/clickstream/clickstream-enwiki-2019-12.tsv.gz,Wikipedia,39601,2019812,1180,2060593,210565
hdfs://spark-nn.eemcs.utwente.nl/user/s1934538/clickstream/clickstream-enwiki-2019-12.tsv.gz,Donald_Trump,344207,1457196,62659,1864062,1070788
hdfs://spark-nn.eemcs.utwente.nl/user/s1934538/clickstream/clickstream-enwiki-2019-12.tsv.gz,Kobe_Bryant,35578,213746,1353,250677,65342
hdfs://spark-nn.eemcs.utwente.nl/user/s1934538/clickstream/clickstream-enwiki-2019-12.tsv.gz,A_Quiet_Place_(film),41413,202064,1810,245287,83398
hdfs://spark-nn.eemcs.utwente.nl/user/s1934538/clickstream/clickstream-enwiki-2019-12.tsv.gz,The_Lion_King_(2019_film),104327,306954,3087,414368,202602
hdfs://spark-nn.eemcs.utwente.nl/user/s1934538/clickstream/clickstream-enwiki-2019-12.tsv.gz,Key_frame,607,5863,25,6495,382
hdfs://spark-nn.eemcs.utwente.nl/user/s1934538/clickstream/clickstream-enwiki-2019-12.tsv.gz,Meat_Loaf,20336,78255,839,99430,32665
hdfs://spark-nn.eemcs.utwente.nl/user/s1934538/clickstream/clickstream-enwiki-2019-12.tsv.gz,Hyphen-minus,4234,41362106,6905439,48271779,755
hdfs://spark-nn.eemcs.utwente.nl/user/s1934538/clickstream/clickstream-enwiki-2019-12.tsv.gz,WrestleMania_34,19688,11084,264,31036,20897
hdfs://spark-nn.eemcs.utwente.nl/user/s1934538/clickstream/clickstream-enwiki-2019-12.tsv.gz,Sushma_Swaraj,7182,26287,76,33545,7035
hdfs://spark-nn.eemcs.utwente.nl/user/s1934538/clickstream/clickstream-enwiki-2019-12.tsv.gz,Joe_Biden,82619,260241,3891,346751,123810
hdfs://spark-nn.eemcs.utwente.nl/user/s1934538/clickstream/clickstream-enwiki-2019-12.tsv.gz,J._Robert_Oppenheimer,24427,331535,1487,357449,93953
hdfs://spark-nn.eemcs.utwente.nl/user/s1934538/clickstream/clickstream-enwiki-2019-12.tsv.gz,K.G.F:_Chapter_2,37083,189362,182,226627,85123
hdfs://spark-nn.eemcs.utwente.nl/user/s1934538/clickstream/clickstream-enwiki-2019-12.tsv.gz,Pelé,23757,103830,853,128440,40197
hdfs://spark-nn.eemcs.utwente.nl/user/s1934538/clickstream/clickstream-enwiki-2019-12.tsv.gz,Kobe_Bryant_sexual_assault_case,2975,20044,16,23035,2645
hdfs://spark-nn.eemcs.utwente.nl/user/s1934538/clickstream/clickstream-enwiki-2019-12.tsv.gz,The_Nun_(2018_film),17594,59927,423,77944,48042
hdfs://spark-nn.eemcs.utwente.nl/user/s1934538/clickstream/clickstream-enwiki-2019-12.tsv.gz,David_Beckham,39092,146451,1084,186627,63291
hdfs://spark-nn.eemcs.utwente.nl/user/s1934538/clickstream/clickstream-enwiki-2019-12.tsv.gz,Black_Panther_(film),50507,122261,2207,174975,103274
hdfs://spark-nn.eemcs.utwente.nl/user/s1934538/clickstream/clickstream-enwiki-2019-12.tsv.gz,Dark_Phoenix_(film),58574,138823,2319,199716,91914
hdfs://spark-nn.eemcs.utwente.nl/user/s1934538/clickstream/clickstream-enwiki-2019-12.tsv.gz,Louis_Tomlinson,62734,86628,741,150103,32609
hdfs://spark-nn.eemcs.utwente.nl/user/s1934538/clickstream/clickstream-enwiki-2019-12.tsv.gz,Croatia,35176,118873,1469,155518,52791
hdfs://spark-nn.eemcs.utwente.nl/user/s1934538/clickstream/clickstream-enwiki-2019-12.tsv.gz,FIFA_World_Cup,32145,146919,1924,180988,118472
hdfs://spark-nn.eemcs.utwente.nl/user/s1934538/clickstream/clickstream-enwiki-2019-12.tsv.gz,Amber_Heard,109750,138077,803,248630,113184
hdfs://spark-nn.eemcs.utwente.nl/user/s1934538/clickstream/clickstream-enwiki-2019-12.tsv.gz,Priyanka_Chopra,133838,277490,1225,412553,152941
hdfs://spark-nn.eemcs.utwente.nl/user/s1934538/clickstream/clickstream-enwiki-2019-12.tsv.gz,Stan_Lee,38301,167909,2076,208286,57282
hdfs://spark-nn.eemcs.utwente.nl/user/s1934538/clickstream/clickstream-enwiki-2019-12.tsv.gz,Ukraine,47048,154719,3672,205439,93779
hdfs://spark-nn.eemcs.utwente.nl/user/s1934538/clickstream/clickstream-enwiki-2019-12.tsv.gz,Avengers:_Endgame,209008,445388,9557,663953,432793
hdfs://spark-nn.eemcs.utwente.nl/user/s1934538/clickstream/clickstream-enwiki-2019-12.tsv.gz,Adele,22683,178328,2752,203763,65196
hdfs://spark-nn.eemcs.utwente.nl/user/s1934538/clickstream/clickstream-enwiki-2019-12.tsv.gz,Anne_Heche,25636,50795,214,76645,22495
hdfs://spark-nn.eemcs.utwente.nl/user/s1934538/clickstream/clickstream-enwiki-2019-12.tsv.gz,Bonnie_and_Clyde,27425,311388,5075,343888,75197
hdfs://spark-nn.eemcs.utwente.nl/user/s1934538/clickstream/clickstream-enwiki-2019-12.tsv.gz,Eddie_Van_Halen,39006,51418,457,90881,40871
hdfs://spark-nn.eemcs.utwente.nl/user/s1934538/clickstream/clickstream-enwiki-2019-12.tsv.gz,Lance_Reddick,32959,25216,145,58320,10751
hdfs://spark-nn.eemcs.utwente.nl/user/s1934538/clickstream/clickstream-enwiki-2019-12.tsv.gz,XHamster,8521,57821,2768,69110,11313
hdfs://spark-nn.eemcs.utwente.nl/user/s1934538/clickstream/clickstream-enwiki-2019-12.tsv.gz,Rami_Malek,138267,270145,1835,410247,150011
hdfs://spark-nn.eemcs.utwente.nl/user/s1934538/clickstream/clickstream-enwiki-2019-12.tsv.gz,Tenet_(film),146626,545388,7492,699506,516257
hdfs://spark-nn.eemcs.utwente.nl/user/s1934538/clickstream/clickstream-enwiki-2019-12.tsv.gz,2020_Summer_Olympics,72279,239991,5043,317313,261584
hdfs://spark-nn.eemcs.utwente.nl/user/s1934538/clickstream/clickstream-enwiki-2019-12.tsv.gz,Aaron_Hernandez,13604,269222,912,283738,106251
hdfs://spark-nn.eemcs.utwente.nl/user/s1934538/clickstream/clickstream-enwiki-2019-12.tsv.gz,Greta_Thunberg,64299,1396811,12643,1473753,416714
hdfs://spark-nn.eemcs.utwente.nl/user/s1934538/clickstream/clickstream-enwiki-2019-12.tsv.gz,It_Chapter_Two,76861,368117,6632,451610,280240
hdfs://spark-nn.eemcs.utwente.nl/user/s1934538/clickstream/clickstream-enwiki-2019-12.tsv.gz,Burt_Reynolds,65801,154665,1279,221745,80664
hdfs://spark-nn.eemcs.utwente.nl/user/s1934538/clickstream/clickstream-enwiki-2019-12.tsv.gz,Lists_of_deaths_by_year,7472,129780,282,137534,129054
hdfs://spark-nn.eemcs.utwente.nl/user/s1934538/clickstream/clickstream-enwiki-2019-12.tsv.gz,The_Witcher_(TV_series),420645,4766920,71617,5259182,3698725
hdfs://spark-nn.eemcs.utwente.nl/user/s1934538/clickstream/clickstream-enwiki-2019-12.tsv.gz,Brett_Kavanaugh,26295,40148,400,66843,23170
hdfs://spark-nn.eemcs.utwente.nl/user/s1934538/clickstream/clickstream-enwiki-2019-12.tsv.gz,Alexander_Hamilton,70404,276964,1746,349114,159061
hdfs://spark-nn.eemcs.utwente.nl/user/s1934538/clickstream/clickstream-enwiki-2019-12.tsv.gz,Ruth_Bader_Ginsburg,28962,143777,1012,173751,57151
hdfs://spark-nn.eemcs.utwente.nl/user/s1934538/clickstream/clickstream-enwiki-2019-12.tsv.gz,Us_(2019_film),56240,339987,2520,398747,126680
hdfs://spark-nn.eemcs.utwente.nl/user/s1934538/clickstream/clickstream-enwiki-2019-12.tsv.gz,Sylvester_Stallone,103708,404206,2768,510682,333379
hdfs://spark-nn.eemcs.utwente.nl/user/s1934538/clickstream/clickstream-enwiki-2019-12.tsv.gz,2018_FIFA_World_Cup,62561,106268,1114,169943,86778
hdfs://spark-nn.eemcs.utwente.nl/user/s1934538/clickstream/clickstream-enwiki-2019-12.tsv.gz,Rishi_Sunak,13272,62834,519,76625,23885
hdfs://spark-nn.eemcs.utwente.nl/user/s1934538/clickstream/clickstream-enwiki-2019-12.tsv.gz,Joaquin_Phoenix,198944,385270,1815,586029,410457
hdfs://spark-nn.eemcs.utwente.nl/user/s1934538/clickstream/clickstream-enwiki-2019-12.tsv.gz,Aquaman_(film),42176,162472,2266,206914,115985
hdfs://spark-nn.eemcs.utwente.nl/user/s1934538/clickstream/clickstream-enwiki-2019-12.tsv.gz,Media,61,2297125,355,2297541,1597
hdfs://spark-nn.eemcs.utwente.nl/user/s1934538/clickstream/clickstream-enwiki-2019-12.tsv.gz,Game_of_Thrones_(season_8),18281,87746,2041,108068,39666
hdfs://spark-nn.eemcs.utwente.nl/user/s1934538/clickstream/clickstream-enwiki-2019-12.tsv.gz,Stranger_Things,58405,305694,5859,369958,279986
hdfs://spark-nn.eemcs.utwente.nl/user/s1934538/clickstream/clickstream-enwiki-2019-12.tsv.gz,Elon_Musk,108510,981277,7408,1097195,622660
hdfs://spark-nn.eemcs.utwente.nl/user/s1934538/clickstream/clickstream-enwiki-2019-12.tsv.gz,Sridevi,24358,115071,277,139706,38632
hdfs://spark-nn.eemcs.utwente.nl/user/s1934538/clickstream/clickstream-enwiki-2019-12.tsv.gz,Manti_Te'o,7497,74627,415,82539,11334
hdfs://spark-nn.eemcs.utwente.nl/user/s1934538/clickstream/clickstream-enwiki-2019-12.tsv.gz,Jimmy_Buffett,7552,39422,450,47424,15507
hdfs://spark-nn.eemcs.utwente.nl/user/s1934538/clickstream/clickstream-enwiki-2019-12.tsv.gz,1234,50,1423,17,1490,197
hdfs://spark-nn.eemcs.utwente.nl/user/s1934538/clickstream/clickstream-enwiki-2019-12.tsv.gz,List_of_James_Bond_films,83871,512950,2412,599233,379719
hdfs://spark-nn.eemcs.utwente.nl/user/s1934538/clickstream/clickstream-enwiki-2019-12.tsv.gz,Chernobyl_disaster,76734,572476,4885,654095,250530
hdfs://spark-nn.eemcs.utwente.nl/user/s1934538/clickstream/clickstream-enwiki-2019-12.tsv.gz,"Princess_Margaret,_Countess_of_Snowdon",408313,1973877,15002,2397192,1412198
hdfs://spark-nn.eemcs.utwente.nl/user/s1934538/clickstream/clickstream-enwiki-2019-12.tsv.gz,Pornhub,36079,398903,12312,447294,75996
hdfs://spark-nn.eemcs.utwente.nl/user/s1934538/clickstream/clickstream-enwiki-2019-12.tsv.gz,Taliban,21801,59740,418,81959,47837
hdfs://spark-nn.eemcs.utwente.nl/user/s1934538/clickstream/clickstream-enwiki-2019-12.tsv.gz,Gaza_Strip,14469,34185,160,48814,17869
hdfs://spark-nn.eemcs.utwente.nl/user/s1934538/clickstream/clickstream-enwiki-2019-12.tsv.gz,Matthew_Perry,67663,159031,677,227371,117793
hdfs://spark-nn.eemcs.utwente.nl/user/s1934538/clickstream/clickstream-enwiki-2019-12.tsv.gz,Tonya_Harding,41404,193842,812,236058,55147
hdfs://spark-nn.eemcs.utwente.nl/user/s1934538/clickstream/clickstream-enwiki-2019-12.tsv.gz,HTTP_cookie,5985,232590,97,238672,30723
hdfs://spark-nn.eemcs.utwente.nl/user/s1934538/clickstream/clickstream-enwiki-2019-12.tsv.gz,Roe_v._Wade,11113,69021,416,80550,20463
hdfs://spark-nn.eemcs.utwente.nl/user/s1934538/clickstream/clickstream-enwiki-2019-12.tsv.gz,List_of_awards_and_nominations_received_by_Meryl_Streep,14783,667926,453,683162,8327
hdfs://spark-nn.eemcs.utwente.nl/user/s1934538/clickstream/clickstream-enwiki-2019-12.tsv.gz,Wonder_Woman_1984,128549,390488,12933,531970,472740
hdfs://spark-nn.eemcs.utwente.nl/user/s1934538/clickstream/clickstream-enwiki-2019-12.tsv.gz,Article_370_of_the_Constitution_of_India,5707,186516,121,192344,13096
hdfs://spark-nn.eemcs.utwente.nl/user/s1934538/clickstream/clickstream-enwiki-2019-12.tsv.gz,United_States_Senate,121602,392815,2672,517089,156779
hdfs://spark-nn.eemcs.utwente.nl/user/s1934538/clickstream/clickstream-enwiki-2019-12.tsv.gz,Tina_Turner,20270,194139,1898,216307,58916
hdfs://spark-nn.eemcs.utwente.nl/user/s1934538/clickstream/clickstream-enwiki-2019-12.tsv.gz,IPv4,11344,44883,160,56387,9135
hdfs://spark-nn.eemcs.utwente.nl/user/s1934538/clickstream/clickstream-enwiki-2019-12.tsv.gz,Venom_(2018_film),28539,110788,1409,140736,68036
hdfs://spark-nn.eemcs.utwente.nl/user/s1934538/clickstream/clickstream-enwiki-2019-12.tsv.gz,Nipsey_Hussle,43446,223201,2451,269098,87952
hdfs://spark-nn.eemcs.utwente.nl/user/s1934538/clickstream/clickstream-enwiki-2019-12.tsv.gz,Michael_Jordan,72325,395655,3229,471209,151473
hdfs://spark-nn.eemcs.utwente.nl/user/s1934538/clickstream/clickstream-enwiki-2019-12.tsv.gz,List_of_Marvel_Cinematic_Universe_films,118146,847355,2151,967652,371747
hdfs://spark-nn.eemcs.utwente.nl/user/s1934538/clickstream/clickstream-enwiki-2019-12.tsv.gz,Mortal_Kombat_(2021_film),24146,49578,291,74015,120056
hdfs://spark-nn.eemcs.utwente.nl/user/s1934538/clickstream/clickstream-enwiki-2019-12.tsv.gz,1917_(2019_film),110961,661175,15591,787727,339969
hdfs://spark-nn.eemcs.utwente.nl/user/s1934538/clickstream/clickstream-enwiki-2019-12.tsv.gz,Anthony_Bourdain,14370,159563,1379,175312,51159
hdfs://spark-nn.eemcs.utwente.nl/user/s1934538/clickstream/clickstream-enwiki-2019-12.tsv.gz,Salman_Rushdie,23258,60860,425,84543,36066
hdfs://spark-nn.eemcs.utwente.nl/user/s1934538/clickstream/clickstream-enwiki-2019-12.tsv.gz,George_VI,712270,380600,1481,1094351,783024
hdfs://spark-nn.eemcs.utwente.nl/user/s1934538/clickstream/clickstream-enwiki-2019-12.tsv.gz,The_Shape_of_Water,28216,80689,913,109818,49350
hdfs://spark-nn.eemcs.utwente.nl/user/s1934538/clickstream/clickstream-enwiki-2019-12.tsv.gz,Anna_Sorokin,11040,64635,492,76167,20501
hdfs://spark-nn.eemcs.utwente.nl/user/s1934538/clickstream/clickstream-enwiki-2019-12.tsv.gz,Tom_Brady,93436,492721,4526,590683,194356
hdfs://spark-nn.eemcs.utwente.nl/user/s1934538/clickstream/clickstream-enwiki-2019-12.tsv.gz,Irrfan_Khan,24274,55946,417,80637,27106
hdfs://spark-nn.eemcs.utwente.nl/user/s1934538/clickstream/clickstream-enwiki-2019-12.tsv.gz,Sinéad_O'Connor,18516,85093,715,104324,26591
hdfs://spark-nn.eemcs.utwente.nl/user/s1934538/clickstream/clickstream-enwiki-2019-12.tsv.gz,Cleopatra,35411,133477,1639,170527,71334
hdfs://spark-nn.eemcs.utwente.nl/user/s1934538/clickstream/clickstream-enwiki-2019-12.tsv.gz,"Prince_Philip,_Duke_of_Edinburgh",580247,1003861,29068,1613176,1117238
hdfs://spark-nn.eemcs.utwente.nl/user/s1934538/clickstream/clickstream-enwiki-2019-12.tsv.gz,Kamala_Harris,35624,280927,2754,319305,113403
hdfs://spark-nn.eemcs.utwente.nl/user/s1934538/clickstream/clickstream-enwiki-2019-12.tsv.gz,The_Falcon_and_the_Winter_Soldier,52801,36135,293,89229,53504
hdfs://spark-nn.eemcs.utwente.nl/user/s1934538/clickstream/clickstream-enwiki-2019-12.tsv.gz,The_Mandalorian,550258,4836452,98102,5484812,2897834
hdfs://spark-nn.eemcs.utwente.nl/user/s1934538/clickstream/clickstream-enwiki-2019-12.tsv.gz,Captain_Marvel_(film),62193,206814,8198,277205,149237
hdfs://spark-nn.eemcs.utwente.nl/user/s1934538/clickstream/clickstream-enwiki-2019-12.tsv.gz,Michael_Bloomberg,89365,509542,3954,602861,201568
hdfs://spark-nn.eemcs.utwente.nl/user/s1934538/clickstream/clickstream-enwiki-2019-12.tsv.gz,Crazy_Rich_Asians_(film),51782,125830,1256,178868,158168
hdfs://spark-nn.eemcs.utwente.nl/user/s1934538/clickstream/clickstream-enwiki-2019-12.tsv.gz,Khabib_Nurmagomedov,85271,208435,2178,295884,145377
hdfs://spark-nn.eemcs.utwente.nl/user/s1934538/clickstream/clickstream-enwiki-2019-12.tsv.gz,Kylian_Mbappé,30974,197704,2709,231387,43377
hdfs://spark-nn.eemcs.utwente.nl/user/s1934538/clickstream/clickstream-enwiki-2019-12.tsv.gz,"Diana,_Princess_of_Wales",270852,390256,3468,664576,397027
hdfs://spark-nn.eemcs.utwente.nl/user/s1934538/clickstream/clickstream-enwiki-2019-12.tsv.gz,DMX_(rapper),14425,94300,544,109269,36750
hdfs://spark-nn.eemcs.utwente.nl/user/s1934538/clickstream/clickstream-enwiki-2019-12.tsv.gz,Bob_Saget,22117,38775,260,61152,11744
hdfs://spark-nn.eemcs.utwente.nl/user/s1934538/clickstream/clickstream-enwiki-2019-12.tsv.gz,Betty_White,43023,292932,3095,339050,70555
hdfs://spark-nn.eemcs.utwente.nl/user/s1934538/clickstream/clickstream-enwiki-2019-12.tsv.gz,2020_United_States_presidential_election,114978,348985,5716,469679,281932
hdfs://spark-nn.eemcs.utwente.nl/user/s1934538/clickstream/clickstream-enwiki-2019-12.tsv.gz,Johnny_Depp,115060,318875,2220,436155,258015
hdfs://spark-nn.eemcs.utwente.nl/user/s1934538/clickstream/clickstream-enwiki-2019-12.tsv.gz,Vladimir_Putin,80344,238983,3247,322574,187395
hdfs://spark-nn.eemcs.utwente.nl/user/s1934538/clickstream/clickstream-enwiki-2019-12.tsv.gz,Richard_Ramirez,14993,130181,1001,146175,46449
hdfs://spark-nn.eemcs.utwente.nl/user/s1934538/clickstream/clickstream-enwiki-2019-12.tsv.gz,Grover,2787,7827,55,10669,2618
hdfs://spark-nn.eemcs.utwente.nl/user/s1934538/clickstream/clickstream-enwiki-2019-12.tsv.gz,The_Irishman,470954,3328781,58388,3858123,1201353
hdfs://spark-nn.eemcs.utwente.nl/user/s1934538/clickstream/clickstream-enwiki-2019-12.tsv.gz,Glass_(2019_film),63338,197020,1869,262227,90715
hdfs://spark-nn.eemcs.utwente.nl/user/s1934538/clickstream/clickstream-enwiki-2019-12.tsv.gz,Chernobyl_(miniseries),32140,191954,3536,227630,188806
hdfs://spark-nn.eemcs.utwente.nl/user/s1934538/clickstream/clickstream-enwiki-2019-12.tsv.gz,Cricket_World_Cup,6968,56067,219,63254,26724
hdfs://spark-nn.eemcs.utwente.nl/user/s1934538/clickstream/clickstream-enwiki-2019-12.tsv.gz,Mulan_(2020_film),65345,216116,4692,286153,346774
hdfs://spark-nn.eemcs.utwente.nl/user/s1934538/clickstream/clickstream-enwiki-2019-12.tsv.gz,Notre-Dame_de_Paris,15414,116212,1501,133127,32637
hdfs://spark-nn.eemcs.utwente.nl/user/s1934538/clickstream/clickstream-enwiki-2019-12.tsv.gz,Chadwick_Boseman,32214,97241,826,130281,39999
hdfs://spark-nn.eemcs.utwente.nl/user/s1934538/clickstream/clickstream-enwiki-2019-12.tsv.gz,Hamilton_(musical),42719,301405,1741,345865,163616
hdfs://spark-nn.eemcs.utwente.nl/user/s1934538/clickstream/clickstream-enwiki-2019-12.tsv.gz,Deadpool_2,56108,126976,1575,184659,83712
hdfs://spark-nn.eemcs.utwente.nl/user/s1934538/clickstream/clickstream-enwiki-2019-12.tsv.gz,Cardi_B,69928,562878,5665,638471,165927
hdfs://spark-nn.eemcs.utwente.nl/user/s1934538/clickstream/clickstream-enwiki-2019-12.tsv.gz,Jeffrey_Dahmer,30934,279720,2896,313550,132460
hdfs://spark-nn.eemcs.utwente.nl/user/s1934538/clickstream/clickstream-enwiki-2019-12.tsv.gz,QAnon,10016,167163,822,178001,36276
hdfs://spark-nn.eemcs.utwente.nl/user/s1934538/clickstream/clickstream-enwiki-2019-12.tsv.gz,Jeffrey_Epstein,63542,697940,4351,765833,258412
hdfs://spark-nn.eemcs.utwente.nl/user/s1934538/clickstream/clickstream-enwiki-2019-12.tsv.gz,Simone_Biles,10451,81324,461,92236,21764
hdfs://spark-nn.eemcs.utwente.nl/user/s1934538/clickstream/clickstream-enwiki-2019-12.tsv.gz,United_States_Electoral_College,33546,160062,228,193836,29371
hdfs://spark-nn.eemcs.utwente.nl/user/s1934538/clickstream/clickstream-enwiki-2019-12.tsv.gz,Darth_Vader,239377,428025,2452,669854,477421
hdfs://spark-nn.eemcs.utwente.nl/user/s1934538/clickstream/clickstream-enwiki-2019-12.tsv.gz,The_Umbrella_Academy_(TV_series),29698,126938,1878,158514,75812
hdfs://spark-nn.eemcs.utwente.nl/user/s1934538/clickstream/clickstream-enwiki-2019-12.tsv.gz,Naomi_Osaka,11279,32173,169,43621,10524
hdfs://spark-nn.eemcs.utwente.nl/user/s1934538/clickstream/clickstream-enwiki-2019-12.tsv.gz,Puneeth_Rajkumar,9691,33812,32,43535,16093
hdfs://spark-nn.eemcs.utwente.nl/user/s1934538/clickstream/clickstream-enwiki-2019-12.tsv.gz,JSON_Web_Token,798,20716,38,21552,1601
hdfs://spark-nn.eemcs.utwente.nl/user/s1934538/clickstream/clickstream-enwiki-2019-12.tsv.gz,Avicii,25571,303417,2621,331609,155594
hdfs://spark-nn.eemcs.utwente.nl/user/s1934538/clickstream/clickstream-enwiki-2019-12.tsv.gz,Ted_Bundy,45957,584426,5181,635564,140507
hdfs://spark-nn.eemcs.utwente.nl/user/s1934538/clickstream/clickstream-enwiki-2019-12.tsv.gz,Aretha_Franklin,26989,116307,973,144269,50219
hdfs://spark-nn.eemcs.utwente.nl/user/s1934538/clickstream/clickstream-enwiki-2019-12.tsv.gz,Lisa_Marie_Presley,121867,74539,219,196625,109343
hdfs://spark-nn.eemcs.utwente.nl/user/s1934538/clickstream/clickstream-enwiki-2019-12.tsv.gz,Mac_Miller,34445,213689,3285,251419,71677
hdfs://spark-nn.eemcs.utwente.nl/user/s1934538/clickstream/clickstream-enwiki-2019-12.tsv.gz,Spider-Man:_Far_From_Home,105908,231681,3708,341297,189662
hdfs://spark-nn.eemcs.utwente.nl/user/s1934538/clickstream/clickstream-enwiki-2019-12.tsv.gz,YouTube,124145,1621667,8183,1753995,152678
hdfs://spark-nn.eemcs.utwente.nl/user/s1934538/clickstream/clickstream-enwiki-2019-12.tsv.gz,Aaron_Carter,33110,86733,554,120397,33193
hdfs://spark-nn.eemcs.utwente.nl/user/s1934538/clickstream/clickstream-enwiki-2019-12.tsv.gz,List_of_highest-grossing_Indian_films,74606,275646,1627,351879,190317
hdfs://spark-nn.eemcs.utwente.nl/user/s1934538/clickstream/clickstream-enwiki-2019-12.tsv.gz,Amy_Coney_Barrett,1960,5797,25,7782,1725
hdfs://spark-nn.eemcs.utwente.nl/user/s1934538/clickstream/clickstream-enwiki-2019-12.tsv.gz,Godzilla_vs._Kong,56961,53709,1272,111942,64268
hdfs://spark-nn.eemcs.utwente.nl/user/s1934538/clickstream/clickstream-enwiki-2019-12.tsv.gz,Atal_Bihari_Vajpayee,29652,114369,158,144179,30595
hdfs://spark-nn.eemcs.utwente.nl/user/s1934538/clickstream/clickstream-enwiki-2019-12.tsv.gz,Donald_Glover,63554,185339,2991,251884,79611
hdfs://spark-nn.eemcs.utwente.nl/user/s1934538/clickstream/clickstream-enwiki-2019-12.tsv.gz,Hamas,16463,29356,204,46023,16288
hdfs://spark-nn.eemcs.utwente.nl/user/s1934538/clickstream/clickstream-enwiki-2019-12.tsv.gz,Microsoft_Office,7547,387115,664,395326,18946
hdfs://spark-nn.eemcs.utwente.nl/user/s1934538/clickstream/clickstream-enwiki-2019-12.tsv.gz,Juice_Wrld,111826,4032232,87640,4231698,750948
hdfs://spark-nn.eemcs.utwente.nl/user/s1934538/clickstream/clickstream-enwiki-2019-12.tsv.gz,Jimmy_Hoffa,508524,3884876,31429,4424829,1624046
hdfs://spark-nn.eemcs.utwente.nl/user/s1934538/clickstream/clickstream-enwiki-2020-01.tsv.gz,Meat_Loaf,24441,127579,1548,153568,50914
hdfs://spark-nn.eemcs.utwente.nl/user/s1934538/clickstream/clickstream-enwiki-2020-01.tsv.gz,RRR_(film),75038,111966,485,187489,119767
hdfs://spark-nn.eemcs.utwente.nl/user/s1934538/clickstream/clickstream-enwiki-2020-01.tsv.gz,Murder_of_Dee_Dee_Blanchard,32368,224132,604,257104,43355
hdfs://spark-nn.eemcs.utwente.nl/user/s1934538/clickstream/clickstream-enwiki-2020-01.tsv.gz,Ukraine,52875,253493,6275,312643,114546
hdfs://spark-nn.eemcs.utwente.nl/user/s1934538/clickstream/clickstream-enwiki-2020-01.tsv.gz,Michael_Bloomberg,96065,816829,5993,918887,304097
hdfs://spark-nn.eemcs.utwente.nl/user/s1934538/clickstream/clickstream-enwiki-2020-01.tsv.gz,United_States_Electoral_College,34519,165424,269,200212,31992
hdfs://spark-nn.eemcs.utwente.nl/user/s1934538/clickstream/clickstream-enwiki-2020-01.tsv.gz,Valentine's_Day,7310,201145,1024,209479,14228
hdfs://spark-nn.eemcs.utwente.nl/user/s1934538/clickstream/clickstream-enwiki-2020-01.tsv.gz,Cristiano_Ronaldo,113791,713617,5810,833218,183516
hdfs://spark-nn.eemcs.utwente.nl/user/s1934538/clickstream/clickstream-enwiki-2020-01.tsv.gz,United_States_Senate,88707,189601,2619,280927,114173
hdfs://spark-nn.eemcs.utwente.nl/user/s1934538/clickstream/clickstream-enwiki-2020-01.tsv.gz,List_of_highest-grossing_films,234903,514633,3641,753177,328374
hdfs://spark-nn.eemcs.utwente.nl/user/s1934538/clickstream/clickstream-enwiki-2020-01.tsv.gz,List_of_awards_and_nominations_received_by_Meryl_Streep,22236,15770,620,38626,14089
hdfs://spark-nn.eemcs.utwente.nl/user/s1934538/clickstream/clickstream-enwiki-2020-01.tsv.gz,Top_Gun:_Maverick,71687,92828,1991,166506,123594
hdfs://spark-nn.eemcs.utwente.nl/user/s1934538/clickstream/clickstream-enwiki-2020-01.tsv.gz,Rishi_Sunak,7607,7316,16,14939,3423
hdfs://spark-nn.eemcs.utwente.nl/user/s1934538/clickstream/clickstream-enwiki-2020-01.tsv.gz,Shinzo_Abe,30482,32757,352,63591,8514
hdfs://spark-nn.eemcs.utwente.nl/user/s1934538/clickstream/clickstream-enwiki-2020-01.tsv.gz,Taliban,35108,76007,1464,112579,69020
hdfs://spark-nn.eemcs.utwente.nl/user/s1934538/clickstream/clickstream-enwiki-2020-01.tsv.gz,Kylian_Mbappé,29763,182222,2175,214160,39715
hdfs://spark-nn.eemcs.utwente.nl/user/s1934538/clickstream/clickstream-enwiki-2020-01.tsv.gz,Cameron_Boyce,42521,318606,1756,362883,90260
hdfs://spark-nn.eemcs.utwente.nl/user/s1934538/clickstream/clickstream-enwiki-2020-01.tsv.gz,Hamas,37876,43253,3652,84781,30947
hdfs://spark-nn.eemcs.utwente.nl/user/s1934538/clickstream/clickstream-enwiki-2020-01.tsv.gz,George_VI,803150,382639,1482,1187271,850052
hdfs://spark-nn.eemcs.utwente.nl/user/s1934538/clickstream/clickstream-enwiki-2020-01.tsv.gz,Parasite_(2019_film),203742,2403343,28135,2635220,991643
hdfs://spark-nn.eemcs.utwente.nl/user/s1934538/clickstream/clickstream-enwiki-2020-01.tsv.gz,Priyanka_Chopra,183119,415073,1577,599769,227359
hdfs://spark-nn.eemcs.utwente.nl/user/s1934538/clickstream/clickstream-enwiki-2020-01.tsv.gz,Laal_Singh_Chaddha,58709,70852,61,129622,71143
hdfs://spark-nn.eemcs.utwente.nl/user/s1934538/clickstream/clickstream-enwiki-2020-01.tsv.gz,Wikipedia,44470,2047857,1089,2093416,237165
hdfs://spark-nn.eemcs.utwente.nl/user/s1934538/clickstream/clickstream-enwiki-2020-01.tsv.gz,Bob_Saget,19938,39959,212,60109,10965
hdfs://spark-nn.eemcs.utwente.nl/user/s1934538/clickstream/clickstream-enwiki-2020-01.tsv.gz,The_Suicide_Squad_(film),149354,54447,607,204408,181241
hdfs://spark-nn.eemcs.utwente.nl/user/s1934538/clickstream/clickstream-enwiki-2020-01.tsv.gz,Tonya_Harding,55181,250622,13788,319591,76894
hdfs://spark-nn.eemcs.utwente.nl/user/s1934538/clickstream/clickstream-enwiki-2020-01.tsv.gz,Rami_Malek,117520,252257,1522,371299,139296
hdfs://spark-nn.eemcs.utwente.nl/user/s1934538/clickstream/clickstream-enwiki-2020-01.tsv.gz,Elon_Musk,172939,1064184,7309,1244432,820720
hdfs://spark-nn.eemcs.utwente.nl/user/s1934538/clickstream/clickstream-enwiki-2020-01.tsv.gz,Sushant_Singh_Rajput,26558,72587,266,99411,52501
hdfs://spark-nn.eemcs.utwente.nl/user/s1934538/clickstream/clickstream-enwiki-2020-01.tsv.gz,"Citizenship_(Amendment)_Act,_2019",88031,653067,458,741556,99170
hdfs://spark-nn.eemcs.utwente.nl/user/s1934538/clickstream/clickstream-enwiki-2020-01.tsv.gz,Game_of_Thrones_(season_8),17182,71796,1521,90499,35401
hdfs://spark-nn.eemcs.utwente.nl/user/s1934538/clickstream/clickstream-enwiki-2020-01.tsv.gz,XXX:_Return_of_Xander_Cage,37423,121137,579,159139,42101
hdfs://spark-nn.eemcs.utwente.nl/user/s1934538/clickstream/clickstream-enwiki-2020-01.tsv.gz,Dennis_Nilsen,7701,33789,176,41666,8593
hdfs://spark-nn.eemcs.utwente.nl/user/s1934538/clickstream/clickstream-enwiki-2020-01.tsv.gz,Pornhub,38489,417157,13002,468648,82077
hdfs://spark-nn.eemcs.utwente.nl/user/s1934538/clickstream/clickstream-enwiki-2020-01.tsv.gz,Indian_Premier_League,24438,100216,182,124836,78413
hdfs://spark-nn.eemcs.utwente.nl/user/s1934538/clickstream/clickstream-enwiki-2020-01.tsv.gz,Mulan_(2020_film),50209,151756,2721,204686,188985
hdfs://spark-nn.eemcs.utwente.nl/user/s1934538/clickstream/clickstream-enwiki-2020-01.tsv.gz,JSON_Web_Token,904,27895,31,28830,2445
hdfs://spark-nn.eemcs.utwente.nl/user/s1934538/clickstream/clickstream-enwiki-2020-01.tsv.gz,Vladimir_Putin,127057,374802,5953,507812,306789
hdfs://spark-nn.eemcs.utwente.nl/user/s1934538/clickstream/clickstream-enwiki-2020-01.tsv.gz,Loki_(TV_series),8544,1067,15,9626,350
hdfs://spark-nn.eemcs.utwente.nl/user/s1934538/clickstream/clickstream-enwiki-2020-01.tsv.gz,Nipsey_Hussle,56382,651946,4259,712587,165047
hdfs://spark-nn.eemcs.utwente.nl/user/s1934538/clickstream/clickstream-enwiki-2020-01.tsv.gz,Juneteenth,1319,35617,58,36994,2757
hdfs://spark-nn.eemcs.utwente.nl/user/s1934538/clickstream/clickstream-enwiki-2020-01.tsv.gz,Betty_White,82004,678549,7920,768473,247170
hdfs://spark-nn.eemcs.utwente.nl/user/s1934538/clickstream/clickstream-enwiki-2020-01.tsv.gz,Keanu_Reeves,98803,490298,5504,594605,327893
hdfs://spark-nn.eemcs.utwente.nl/user/s1934538/clickstream/clickstream-enwiki-2020-01.tsv.gz,Wonder_Woman_1984,87909,93040,3220,184169,127701
hdfs://spark-nn.eemcs.utwente.nl/user/s1934538/clickstream/clickstream-enwiki-2020-01.tsv.gz,Joaquin_Phoenix,444370,1469758,10272,1924400,1496417
hdfs://spark-nn.eemcs.utwente.nl/user/s1934538/clickstream/clickstream-enwiki-2020-01.tsv.gz,Saaho,36142,174555,847,211544,59069
hdfs://spark-nn.eemcs.utwente.nl/user/s1934538/clickstream/clickstream-enwiki-2020-01.tsv.gz,Kelly_Preston,74138,37767,141,112046,30911
hdfs://spark-nn.eemcs.utwente.nl/user/s1934538/clickstream/clickstream-enwiki-2020-01.tsv.gz,Afghanistan,64237,175065,2291,241593,116268
hdfs://spark-nn.eemcs.utwente.nl/user/s1934538/clickstream/clickstream-enwiki-2020-01.tsv.gz,Chadwick_Boseman,29788,82648,751,113187,33919
hdfs://spark-nn.eemcs.utwente.nl/user/s1934538/clickstream/clickstream-enwiki-2020-01.tsv.gz,Antifa_(United_States),7562,102113,167,109842,16451
hdfs://spark-nn.eemcs.utwente.nl/user/s1934538/clickstream/clickstream-enwiki-2020-01.tsv.gz,Kobe_Bryant_sexual_assault_case,256912,3547580,2628,3807120,223385
hdfs://spark-nn.eemcs.utwente.nl/user/s1934538/clickstream/clickstream-enwiki-2020-01.tsv.gz,Aaron_Carter,23501,98866,705,123072,36691
hdfs://spark-nn.eemcs.utwente.nl/user/s1934538/clickstream/clickstream-enwiki-2020-01.tsv.gz,Naya_Rivera,26077,32156,79,58312,11677
hdfs://spark-nn.eemcs.utwente.nl/user/s1934538/clickstream/clickstream-enwiki-2020-01.tsv.gz,XXXTentacion,75135,533368,6168,614671,108129
hdfs://spark-nn.eemcs.utwente.nl/user/s1934538/clickstream/clickstream-enwiki-2020-01.tsv.gz,Sylvester_Stallone,92798,366621,2494,461913,305912
hdfs://spark-nn.eemcs.utwente.nl/user/s1934538/clickstream/clickstream-enwiki-2020-01.tsv.gz,Avicii,22187,229641,2032,253860,115826
hdfs://spark-nn.eemcs.utwente.nl/user/s1934538/clickstream/clickstream-enwiki-2020-01.tsv.gz,Lance_Reddick,38388,30286,122,68796,13052
hdfs://spark-nn.eemcs.utwente.nl/user/s1934538/clickstream/clickstream-enwiki-2020-01.tsv.gz,Ghislaine_Maxwell,65707,219817,868,286392,119026
hdfs://spark-nn.eemcs.utwente.nl/user/s1934538/clickstream/clickstream-enwiki-2020-01.tsv.gz,Kamala_Harris,26606,73737,497,100840,33051
hdfs://spark-nn.eemcs.utwente.nl/user/s1934538/clickstream/clickstream-enwiki-2020-01.tsv.gz,Donald_Trump,339564,2182048,14915,2536527,987357
hdfs://spark-nn.eemcs.utwente.nl/user/s1934538/clickstream/clickstream-enwiki-2020-01.tsv.gz,Chernobyl_disaster,78360,667163,5568,751091,276462
hdfs://spark-nn.eemcs.utwente.nl/user/s1934538/clickstream/clickstream-enwiki-2020-01.tsv.gz,John_McCain,41712,88464,963,131139,62516
hdfs://spark-nn.eemcs.utwente.nl/user/s1934538/clickstream/clickstream-enwiki-2020-01.tsv.gz,Elizabeth_II,1096392,1706998,10055,2813445,2467055
hdfs://spark-nn.eemcs.utwente.nl/user/s1934538/clickstream/clickstream-enwiki-2020-01.tsv.gz,George_H._W._Bush,148230,129462,985,278677,161920
hdfs://spark-nn.eemcs.utwente.nl/user/s1934538/clickstream/clickstream-enwiki-2020-01.tsv.gz,Mötley_Crüe,32148,114951,1680,148779,178538
hdfs://spark-nn.eemcs.utwente.nl/user/s1934538/clickstream/clickstream-enwiki-2020-01.tsv.gz,Cricket_World_Cup,8511,73828,286,82625,35430
hdfs://spark-nn.eemcs.utwente.nl/user/s1934538/clickstream/clickstream-enwiki-2020-01.tsv.gz,Game_of_Thrones,79314,264919,8591,352824,233138
hdfs://spark-nn.eemcs.utwente.nl/user/s1934538/clickstream/clickstream-enwiki-2020-01.tsv.gz,Sidharth_Shukla,45773,408024,2344,456141,53328
hdfs://spark-nn.eemcs.utwente.nl/user/s1934538/clickstream/clickstream-enwiki-2020-01.tsv.gz,Rihanna,73633,257182,3929,334744,166225
hdfs://spark-nn.eemcs.utwente.nl/user/s1934538/clickstream/clickstream-enwiki-2020-01.tsv.gz,Sridevi,26496,91471,248,118215,38503
hdfs://spark-nn.eemcs.utwente.nl/user/s1934538/clickstream/clickstream-enwiki-2020-01.tsv.gz,Stan_Lee,38619,133799,1259,173677,48640
hdfs://spark-nn.eemcs.utwente.nl/user/s1934538/clickstream/clickstream-enwiki-2020-01.tsv.gz,Cecil_Hotel_(Los_Angeles),4585,18444,60,23089,8774
hdfs://spark-nn.eemcs.utwente.nl/user/s1934538/clickstream/clickstream-enwiki-2020-01.tsv.gz,Michael_Jordan,191875,980994,7514,1180383,365681
hdfs://spark-nn.eemcs.utwente.nl/user/s1934538/clickstream/clickstream-enwiki-2020-01.tsv.gz,Greta_Thunberg,29320,723164,6941,759425,197104
hdfs://spark-nn.eemcs.utwente.nl/user/s1934538/clickstream/clickstream-enwiki-2020-01.tsv.gz,Juice_Wrld,60508,556031,8358,624897,203837
hdfs://spark-nn.eemcs.utwente.nl/user/s1934538/clickstream/clickstream-enwiki-2020-01.tsv.gz,The_Falcon_and_the_Winter_Soldier,60413,54125,749,115287,70318
hdfs://spark-nn.eemcs.utwente.nl/user/s1934538/clickstream/clickstream-enwiki-2020-01.tsv.gz,Anna_Sorokin,11564,48618,217,60399,15150
hdfs://spark-nn.eemcs.utwente.nl/user/s1934538/clickstream/clickstream-enwiki-2020-01.tsv.gz,Deadpool_2,54884,81852,1503,138239,84015
hdfs://spark-nn.eemcs.utwente.nl/user/s1934538/clickstream/clickstream-enwiki-2020-01.tsv.gz,Dark_Phoenix_(film),64182,125509,2067,191758,94251
hdfs://spark-nn.eemcs.utwente.nl/user/s1934538/clickstream/clickstream-enwiki-2020-01.tsv.gz,ICC_Men's_T20_World_Cup,24485,195591,406,220482,90066
hdfs://spark-nn.eemcs.utwente.nl/user/s1934538/clickstream/clickstream-enwiki-2020-01.tsv.gz,Queen_(band),63105,290900,2822,356827,262959
hdfs://spark-nn.eemcs.utwente.nl/user/s1934538/clickstream/clickstream-enwiki-2020-01.tsv.gz,Fantastic_Beasts:_The_Crimes_of_Grindelwald,66312,105383,1322,173017,95185
hdfs://spark-nn.eemcs.utwente.nl/user/s1934538/clickstream/clickstream-enwiki-2020-01.tsv.gz,Watts_family_murders,7362,338165,633,346160,71262
hdfs://spark-nn.eemcs.utwente.nl/user/s1934538/clickstream/clickstream-enwiki-2020-01.tsv.gz,Jeffrey_Epstein,75982,1067691,6868,1150541,361145
hdfs://spark-nn.eemcs.utwente.nl/user/s1934538/clickstream/clickstream-enwiki-2020-01.tsv.gz,Media,56,8440303,357,8440716,1781
hdfs://spark-nn.eemcs.utwente.nl/user/s1934538/clickstream/clickstream-enwiki-2020-01.tsv.gz,Once_Upon_a_Time_in_Hollywood,334287,1504491,25057,1863835,1973056
hdfs://spark-nn.eemcs.utwente.nl/user/s1934538/clickstream/clickstream-enwiki-2020-01.tsv.gz,"Diana,_Princess_of_Wales",452576,790478,5264,1248318,839661
hdfs://spark-nn.eemcs.utwente.nl/user/s1934538/clickstream/clickstream-enwiki-2020-01.tsv.gz,2018_Winter_Olympics,36044,33302,339,69685,44281
hdfs://spark-nn.eemcs.utwente.nl/user/s1934538/clickstream/clickstream-enwiki-2020-01.tsv.gz,Simone_Biles,11290,69561,376,81227,18805
hdfs://spark-nn.eemcs.utwente.nl/user/s1934538/clickstream/clickstream-enwiki-2020-01.tsv.gz,Sinéad_O'Connor,14602,79580,681,94863,25715
hdfs://spark-nn.eemcs.utwente.nl/user/s1934538/clickstream/clickstream-enwiki-2020-01.tsv.gz,Christopher_Scarver,58545,24157,23,82725,28153
hdfs://spark-nn.eemcs.utwente.nl/user/s1934538/clickstream/clickstream-enwiki-2020-01.tsv.gz,Hamilton_(musical),33761,273844,1569,309174,142309
hdfs://spark-nn.eemcs.utwente.nl/user/s1934538/clickstream/clickstream-enwiki-2020-01.tsv.gz,"Meghan,_Duchess_of_Sussex",405787,2015895,19310,2440992,1515520
hdfs://spark-nn.eemcs.utwente.nl/user/s1934538/clickstream/clickstream-enwiki-2020-01.tsv.gz,XHamster,9215,66323,2757,78295,13656
hdfs://spark-nn.eemcs.utwente.nl/user/s1934538/clickstream/clickstream-enwiki-2020-01.tsv.gz,The_Lion_King_(2019_film),88521,259335,2464,350320,185305
hdfs://spark-nn.eemcs.utwente.nl/user/s1934538/clickstream/clickstream-enwiki-2020-01.tsv.gz,2018_FIFA_World_Cup,61426,105693,921,168040,87118
hdfs://spark-nn.eemcs.utwente.nl/user/s1934538/clickstream/clickstream-enwiki-2020-01.tsv.gz,Luke_Perry,93861,317687,1733,413281,94056
hdfs://spark-nn.eemcs.utwente.nl/user/s1934538/clickstream/clickstream-enwiki-2020-01.tsv.gz,Lionel_Messi,74532,413902,5264,493698,100787
hdfs://spark-nn.eemcs.utwente.nl/user/s1934538/clickstream/clickstream-enwiki-2020-01.tsv.gz,Death_of_Elisa_Lam,8042,64666,578,73286,19212
hdfs://spark-nn.eemcs.utwente.nl/user/s1934538/clickstream/clickstream-enwiki-2020-01.tsv.gz,The_Shape_of_Water,35330,79495,1108,115933,50751
hdfs://spark-nn.eemcs.utwente.nl/user/s1934538/clickstream/clickstream-enwiki-2020-01.tsv.gz,Amy_Coney_Barrett,1248,4742,72,6062,1364
hdfs://spark-nn.eemcs.utwente.nl/user/s1934538/clickstream/clickstream-enwiki-2020-01.tsv.gz,Richard_Jewell,100783,731937,4906,837626,263708
hdfs://spark-nn.eemcs.utwente.nl/user/s1934538/clickstream/clickstream-enwiki-2020-01.tsv.gz,Bonnie_and_Clyde,26287,300271,1893,328451,70681
hdfs://spark-nn.eemcs.utwente.nl/user/s1934538/clickstream/clickstream-enwiki-2020-01.tsv.gz,"Prince_Philip,_Duke_of_Edinburgh",625121,802411,21259,1448791,942358
hdfs://spark-nn.eemcs.utwente.nl/user/s1934538/clickstream/clickstream-enwiki-2020-01.tsv.gz,"Princess_Margaret,_Countess_of_Snowdon",353152,1377848,9063,1740063,1039708
hdfs://spark-nn.eemcs.utwente.nl/user/s1934538/clickstream/clickstream-enwiki-2020-01.tsv.gz,YouTube,141728,1019005,7758,1168491,137557
hdfs://spark-nn.eemcs.utwente.nl/user/s1934538/clickstream/clickstream-enwiki-2020-01.tsv.gz,Bird_Box_(film),22623,112131,1362,136116,43819
hdfs://spark-nn.eemcs.utwente.nl/user/s1934538/clickstream/clickstream-enwiki-2020-01.tsv.gz,K.G.F:_Chapter_2,32106,165711,230,198047,73726
hdfs://spark-nn.eemcs.utwente.nl/user/s1934538/clickstream/clickstream-enwiki-2020-01.tsv.gz,Us_(2019_film),54388,345185,1840,401413,132389
hdfs://spark-nn.eemcs.utwente.nl/user/s1934538/clickstream/clickstream-enwiki-2020-01.tsv.gz,List_of_James_Bond_films,69356,343975,800,414131,276647
hdfs://spark-nn.eemcs.utwente.nl/user/s1934538/clickstream/clickstream-enwiki-2020-01.tsv.gz,Jeffrey_Dahmer,31713,325201,3215,360129,155485
hdfs://spark-nn.eemcs.utwente.nl/user/s1934538/clickstream/clickstream-enwiki-2020-01.tsv.gz,Irrfan_Khan,26932,52658,119,79709,31088
hdfs://spark-nn.eemcs.utwente.nl/user/s1934538/clickstream/clickstream-enwiki-2020-01.tsv.gz,Brett_Kavanaugh,33024,43781,215,77020,26014
hdfs://spark-nn.eemcs.utwente.nl/user/s1934538/clickstream/clickstream-enwiki-2020-01.tsv.gz,1234,57,1662,17,1736,236
hdfs://spark-nn.eemcs.utwente.nl/user/s1934538/clickstream/clickstream-enwiki-2020-01.tsv.gz,Sushma_Swaraj,8457,30448,39,38944,8624
hdfs://spark-nn.eemcs.utwente.nl/user/s1934538/clickstream/clickstream-enwiki-2020-01.tsv.gz,2018_Asian_Games,6192,12243,59,18494,12734
hdfs://spark-nn.eemcs.utwente.nl/user/s1934538/clickstream/clickstream-enwiki-2020-01.tsv.gz,Anne_Heche,45451,68563,380,114394,32625
hdfs://spark-nn.eemcs.utwente.nl/user/s1934538/clickstream/clickstream-enwiki-2020-01.tsv.gz,Bible,18610,403231,1536,423377,38118
hdfs://spark-nn.eemcs.utwente.nl/user/s1934538/clickstream/clickstream-enwiki-2020-01.tsv.gz,1917_(2019_film),328631,3374297,62657,3765585,2114933
hdfs://spark-nn.eemcs.utwente.nl/user/s1934538/clickstream/clickstream-enwiki-2020-01.tsv.gz,Joker_(2019_film),250847,1863232,30970,2145049,923268
hdfs://spark-nn.eemcs.utwente.nl/user/s1934538/clickstream/clickstream-enwiki-2020-01.tsv.gz,Black_Panther_(film),52943,125193,2791,180927,109591
hdfs://spark-nn.eemcs.utwente.nl/user/s1934538/clickstream/clickstream-enwiki-2020-01.tsv.gz,When_They_See_Us,27797,152355,795,180947,92702
hdfs://spark-nn.eemcs.utwente.nl/user/s1934538/clickstream/clickstream-enwiki-2020-01.tsv.gz,NATO,63283,218147,2303,283733,83355
hdfs://spark-nn.eemcs.utwente.nl/user/s1934538/clickstream/clickstream-enwiki-2020-01.tsv.gz,2023_Cricket_World_Cup,13664,32091,77,45832,12534
hdfs://spark-nn.eemcs.utwente.nl/user/s1934538/clickstream/clickstream-enwiki-2020-01.tsv.gz,QAnon,8675,206366,1009,216050,44744
hdfs://spark-nn.eemcs.utwente.nl/user/s1934538/clickstream/clickstream-enwiki-2020-01.tsv.gz,The_Batman_(film),158391,127149,1987,287527,317486
hdfs://spark-nn.eemcs.utwente.nl/user/s1934538/clickstream/clickstream-enwiki-2020-01.tsv.gz,Adele,26720,274436,3936,305092,84503
hdfs://spark-nn.eemcs.utwente.nl/user/s1934538/clickstream/clickstream-enwiki-2020-01.tsv.gz,The_Witcher_(TV_series),285815,2919465,48645,3253925,2372085
hdfs://spark-nn.eemcs.utwente.nl/user/s1934538/clickstream/clickstream-enwiki-2020-01.tsv.gz,No_Time_to_Die,204700,237262,5827,447789,350649
hdfs://spark-nn.eemcs.utwente.nl/user/s1934538/clickstream/clickstream-enwiki-2020-01.tsv.gz,Pelé,23051,101187,928,125166,36400
hdfs://spark-nn.eemcs.utwente.nl/user/s1934538/clickstream/clickstream-enwiki-2020-01.tsv.gz,Fyre_Festival,13996,117663,794,132453,68376
hdfs://spark-nn.eemcs.utwente.nl/user/s1934538/clickstream/clickstream-enwiki-2020-01.tsv.gz,Spanish_flu,129848,632607,8721,771176,191009
hdfs://spark-nn.eemcs.utwente.nl/user/s1934538/clickstream/clickstream-enwiki-2020-01.tsv.gz,A_Star_Is_Born_(2018_film),53621,224035,1259,278915,129051
hdfs://spark-nn.eemcs.utwente.nl/user/s1934538/clickstream/clickstream-enwiki-2020-01.tsv.gz,Naomi_Osaka,39344,183960,876,224180,58296
hdfs://spark-nn.eemcs.utwente.nl/user/s1934538/clickstream/clickstream-enwiki-2020-01.tsv.gz,Mortal_Kombat_(2021_film),32635,62461,249,95345,148483
hdfs://spark-nn.eemcs.utwente.nl/user/s1934538/clickstream/clickstream-enwiki-2020-01.tsv.gz,Critical_race_theory,1759,16266,43,18068,3692
hdfs://spark-nn.eemcs.utwente.nl/user/s1934538/clickstream/clickstream-enwiki-2020-01.tsv.gz,FIFA_World_Cup,31903,135322,1798,169023,118693
hdfs://spark-nn.eemcs.utwente.nl/user/s1934538/clickstream/clickstream-enwiki-2020-01.tsv.gz,Henry_V_of_England,136497,331900,1283,469680,322371
hdfs://spark-nn.eemcs.utwente.nl/user/s1934538/clickstream/clickstream-enwiki-2020-01.tsv.gz,Central_Park_jogger_case,52306,205045,412,257763,31692
hdfs://spark-nn.eemcs.utwente.nl/user/s1934538/clickstream/clickstream-enwiki-2020-01.tsv.gz,A_Quiet_Place_(film),69262,440679,4200,514141,189239
hdfs://spark-nn.eemcs.utwente.nl/user/s1934538/clickstream/clickstream-enwiki-2020-01.tsv.gz,Jason_Momoa,196408,480138,2746,679292,300697
hdfs://spark-nn.eemcs.utwente.nl/user/s1934538/clickstream/clickstream-enwiki-2020-01.tsv.gz,Darth_Vader,105730,412944,1447,520121,236403
hdfs://spark-nn.eemcs.utwente.nl/user/s1934538/clickstream/clickstream-enwiki-2020-01.tsv.gz,Lists_of_deaths_by_year,41930,646043,4099,692072,572537
hdfs://spark-nn.eemcs.utwente.nl/user/s1934538/clickstream/clickstream-enwiki-2020-01.tsv.gz,Deion_Sanders,20739,146141,910,167790,52892
hdfs://spark-nn.eemcs.utwente.nl/user/s1934538/clickstream/clickstream-enwiki-2020-01.tsv.gz,Kate_Spade,57000,76679,344,134023,40903
hdfs://spark-nn.eemcs.utwente.nl/user/s1934538/clickstream/clickstream-enwiki-2020-01.tsv.gz,Tina_Turner,22102,197692,1837,221631,61938
hdfs://spark-nn.eemcs.utwente.nl/user/s1934538/clickstream/clickstream-enwiki-2020-01.tsv.gz,UEFA_Euro_2020,48297,331110,4184,383591,120085
hdfs://spark-nn.eemcs.utwente.nl/user/s1934538/clickstream/clickstream-enwiki-2020-01.tsv.gz,Tenet_(film),131415,205714,2968,340097,228642
hdfs://spark-nn.eemcs.utwente.nl/user/s1934538/clickstream/clickstream-enwiki-2020-01.tsv.gz,Jimmy_Buffett,8276,46165,525,54966,18693
hdfs://spark-nn.eemcs.utwente.nl/user/s1934538/clickstream/clickstream-enwiki-2020-01.tsv.gz,Article_370_of_the_Constitution_of_India,6054,192650,293,198997,15279
hdfs://spark-nn.eemcs.utwente.nl/user/s1934538/clickstream/clickstream-enwiki-2020-01.tsv.gz,Joe_Biden,83524,305191,4799,393514,142179
hdfs://spark-nn.eemcs.utwente.nl/user/s1934538/clickstream/clickstream-enwiki-2020-01.tsv.gz,Crazy_Rich_Asians_(film),60181,135441,1348,196970,178227
hdfs://spark-nn.eemcs.utwente.nl/user/s1934538/clickstream/clickstream-enwiki-2020-01.tsv.gz,Salman_Rushdie,36032,78104,510,114646,51666
hdfs://spark-nn.eemcs.utwente.nl/user/s1934538/clickstream/clickstream-enwiki-2020-01.tsv.gz,The_Haunting_of_Bly_Manor,80090,33011,31,113132,89604
hdfs://spark-nn.eemcs.utwente.nl/user/s1934538/clickstream/clickstream-enwiki-2020-01.tsv.gz,Alexander_Hamilton,69447,281749,2106,353302,159309
hdfs://spark-nn.eemcs.utwente.nl/user/s1934538/clickstream/clickstream-enwiki-2020-01.tsv.gz,Grover,1510,6120,48,7678,1436
hdfs://spark-nn.eemcs.utwente.nl/user/s1934538/clickstream/clickstream-enwiki-2020-01.tsv.gz,Royal_Rumble_(2018),51671,25705,450,77826,54821
hdfs://spark-nn.eemcs.utwente.nl/user/s1934538/clickstream/clickstream-enwiki-2020-01.tsv.gz,Roe_v._Wade,14932,119467,696,135095,38349
hdfs://spark-nn.eemcs.utwente.nl/user/s1934538/clickstream/clickstream-enwiki-2020-01.tsv.gz,Eddie_Van_Halen,41130,71722,850,113702,49750
hdfs://spark-nn.eemcs.utwente.nl/user/s1934538/clickstream/clickstream-enwiki-2020-01.tsv.gz,Stranger_Things_(season_3),19513,70980,1011,91504,59892
hdfs://spark-nn.eemcs.utwente.nl/user/s1934538/clickstream/clickstream-enwiki-2022-01.tsv.gz,Wikipedia,244722,811594,1427,1057743,283312
hdfs://spark-nn.eemcs.utwente.nl/user/s1934538/clickstream/clickstream-enwiki-2022-01.tsv.gz,FIFA_World_Cup,54810,216670,4610,276090,184871
hdfs://spark-nn.eemcs.utwente.nl/user/s1934538/clickstream/clickstream-enwiki-2022-01.tsv.gz,Shang-Chi_and_the_Legend_of_the_Ten_Rings,158585,435745,8032,602362,442816
hdfs://spark-nn.eemcs.utwente.nl/user/s1934538/clickstream/clickstream-enwiki-2022-01.tsv.gz,XXXTentacion,86142,783044,7211,876397,137512
hdfs://spark-nn.eemcs.utwente.nl/user/s1934538/clickstream/clickstream-enwiki-2022-01.tsv.gz,Tasuku_Honjo,1136,1110848,313,1112297,33999
hdfs://spark-nn.eemcs.utwente.nl/user/s1934538/clickstream/clickstream-enwiki-2022-01.tsv.gz,WandaVision,85563,229396,3779,318738,167007
hdfs://spark-nn.eemcs.utwente.nl/user/s1934538/clickstream/clickstream-enwiki-2022-01.tsv.gz,The_Sandman_(TV_series),24486,35553,428,60467,44743
hdfs://spark-nn.eemcs.utwente.nl/user/s1934538/clickstream/clickstream-enwiki-2022-01.tsv.gz,Bonnie_and_Clyde,24603,254286,1702,280591,73598
hdfs://spark-nn.eemcs.utwente.nl/user/s1934538/clickstream/clickstream-enwiki-2022-01.tsv.gz,Deadpool_2,74360,86730,2504,163594,119673
hdfs://spark-nn.eemcs.utwente.nl/user/s1934538/clickstream/clickstream-enwiki-2022-01.tsv.gz,Ray_Liotta,39354,63708,576,103638,37964
hdfs://spark-nn.eemcs.utwente.nl/user/s1934538/clickstream/clickstream-enwiki-2022-01.tsv.gz,2018_FIFA_World_Cup,85806,84399,966,171171,106966
hdfs://spark-nn.eemcs.utwente.nl/user/s1934538/clickstream/clickstream-enwiki-2022-01.tsv.gz,September_11_attacks,90970,229803,3353,324126,165939
hdfs://spark-nn.eemcs.utwente.nl/user/s1934538/clickstream/clickstream-enwiki-2022-01.tsv.gz,List_of_James_Bond_films,101588,754849,2024,858461,489913
hdfs://spark-nn.eemcs.utwente.nl/user/s1934538/clickstream/clickstream-enwiki-2022-01.tsv.gz,Sridevi,39932,89054,367,129353,62887
hdfs://spark-nn.eemcs.utwente.nl/user/s1934538/clickstream/clickstream-enwiki-2022-01.tsv.gz,"Citizenship_(Amendment)_Act,_2019",3492,21066,71,24629,2983
hdfs://spark-nn.eemcs.utwente.nl/user/s1934538/clickstream/clickstream-enwiki-2022-01.tsv.gz,Nipsey_Hussle,21270,74065,627,95962,30274
hdfs://spark-nn.eemcs.utwente.nl/user/s1934538/clickstream/clickstream-enwiki-2022-01.tsv.gz,Jenna_Ortega,195048,207436,1573,404057,145245
hdfs://spark-nn.eemcs.utwente.nl/user/s1934538/clickstream/clickstream-enwiki-2022-01.tsv.gz,Game_of_Thrones,87578,313002,7675,408255,283362
hdfs://spark-nn.eemcs.utwente.nl/user/s1934538/clickstream/clickstream-enwiki-2022-01.tsv.gz,Grover,1938,5529,54,7521,1766
hdfs://spark-nn.eemcs.utwente.nl/user/s1934538/clickstream/clickstream-enwiki-2022-01.tsv.gz,Kelly_Preston,91504,133077,593,225174,65691
hdfs://spark-nn.eemcs.utwente.nl/user/s1934538/clickstream/clickstream-enwiki-2022-01.tsv.gz,Rihanna,134122,448356,5910,588388,307333
hdfs://spark-nn.eemcs.utwente.nl/user/s1934538/clickstream/clickstream-enwiki-2022-01.tsv.gz,Mac_Miller,38213,298220,22621,359054,103558
hdfs://spark-nn.eemcs.utwente.nl/user/s1934538/clickstream/clickstream-enwiki-2022-01.tsv.gz,The_Queen's_Gambit_(miniseries),31617,151860,1724,185201,103199
hdfs://spark-nn.eemcs.utwente.nl/user/s1934538/clickstream/clickstream-enwiki-2022-01.tsv.gz,Ukraine,139154,1089782,26970,1255906,561743
hdfs://spark-nn.eemcs.utwente.nl/user/s1934538/clickstream/clickstream-enwiki-2022-01.tsv.gz,Stranger_Things_(season_3),18023,32318,384,50725,28277
hdfs://spark-nn.eemcs.utwente.nl/user/s1934538/clickstream/clickstream-enwiki-2022-01.tsv.gz,Naya_Rivera,56638,113887,555,171080,64691
hdfs://spark-nn.eemcs.utwente.nl/user/s1934538/clickstream/clickstream-enwiki-2022-01.tsv.gz,Donald_Trump,227883,472558,8968,709409,417534
hdfs://spark-nn.eemcs.utwente.nl/user/s1934538/clickstream/clickstream-enwiki-2022-01.tsv.gz,Cardi_B,34140,221997,3917,260054,89034
hdfs://spark-nn.eemcs.utwente.nl/user/s1934538/clickstream/clickstream-enwiki-2022-01.tsv.gz,Tonya_Harding,32101,116733,9755,158589,43942
hdfs://spark-nn.eemcs.utwente.nl/user/s1934538/clickstream/clickstream-enwiki-2022-01.tsv.gz,Aretha_Franklin,38179,274574,1849,314602,147579
hdfs://spark-nn.eemcs.utwente.nl/user/s1934538/clickstream/clickstream-enwiki-2022-01.tsv.gz,Michael_Jordan,89382,454523,4901,548806,177895
hdfs://spark-nn.eemcs.utwente.nl/user/s1934538/clickstream/clickstream-enwiki-2022-01.tsv.gz,Bipin_Rawat,14998,102389,204,117591,35708
hdfs://spark-nn.eemcs.utwente.nl/user/s1934538/clickstream/clickstream-enwiki-2022-01.tsv.gz,Aaron_Hernandez,16152,175856,2531,194539,71412
hdfs://spark-nn.eemcs.utwente.nl/user/s1934538/clickstream/clickstream-enwiki-2022-01.tsv.gz,Parasite_(2019_film),44351,181183,2237,227771,109396
hdfs://spark-nn.eemcs.utwente.nl/user/s1934538/clickstream/clickstream-enwiki-2022-01.tsv.gz,Jurassic_World_Dominion,107520,109721,2388,219629,146434
hdfs://spark-nn.eemcs.utwente.nl/user/s1934538/clickstream/clickstream-enwiki-2022-01.tsv.gz,Article_370_of_the_Constitution_of_India,2373,36958,21,39352,2442
hdfs://spark-nn.eemcs.utwente.nl/user/s1934538/clickstream/clickstream-enwiki-2022-01.tsv.gz,Rishi_Sunak,29412,277158,1738,308308,135439
hdfs://spark-nn.eemcs.utwente.nl/user/s1934538/clickstream/clickstream-enwiki-2022-01.tsv.gz,Ruth_Bader_Ginsburg,33775,135727,981,170483,56460
hdfs://spark-nn.eemcs.utwente.nl/user/s1934538/clickstream/clickstream-enwiki-2022-01.tsv.gz,Crazy_Rich_Asians_(film),41196,85887,1334,128417,113712
hdfs://spark-nn.eemcs.utwente.nl/user/s1934538/clickstream/clickstream-enwiki-2022-01.tsv.gz,Charles_Sobhraj,19291,87664,209,107164,19658
hdfs://spark-nn.eemcs.utwente.nl/user/s1934538/clickstream/clickstream-enwiki-2022-01.tsv.gz,Bob_Saget,185972,6495571,97385,6778928,1612917
hdfs://spark-nn.eemcs.utwente.nl/user/s1934538/clickstream/clickstream-enwiki-2022-01.tsv.gz,Star_Wars:_The_Rise_of_Skywalker,104179,91220,2194,197593,112072
hdfs://spark-nn.eemcs.utwente.nl/user/s1934538/clickstream/clickstream-enwiki-2022-01.tsv.gz,Top_Gun:_Maverick,73180,86290,3639,163109,94925
hdfs://spark-nn.eemcs.utwente.nl/user/s1934538/clickstream/clickstream-enwiki-2022-01.tsv.gz,Richard_Ramirez,21100,224947,1530,247577,59589
hdfs://spark-nn.eemcs.utwente.nl/user/s1934538/clickstream/clickstream-enwiki-2022-01.tsv.gz,Elliot_Page,77840,236840,1525,316205,130532
hdfs://spark-nn.eemcs.utwente.nl/user/s1934538/clickstream/clickstream-enwiki-2022-01.tsv.gz,The_Last_of_Us_(TV_series),46318,67914,499,114731,90327
hdfs://spark-nn.eemcs.utwente.nl/user/s1934538/clickstream/clickstream-enwiki-2022-01.tsv.gz,2018_Asian_Games,10312,6981,62,17355,16033
hdfs://spark-nn.eemcs.utwente.nl/user/s1934538/clickstream/clickstream-enwiki-2022-01.tsv.gz,Donald_Glover,50368,133069,872,184309,75682
hdfs://spark-nn.eemcs.utwente.nl/user/s1934538/clickstream/clickstream-enwiki-2022-01.tsv.gz,Chadwick_Boseman,72486,242345,1417,316248,95556
hdfs://spark-nn.eemcs.utwente.nl/user/s1934538/clickstream/clickstream-enwiki-2022-01.tsv.gz,Critical_race_theory,13296,358123,2378,373797,40866
hdfs://spark-nn.eemcs.utwente.nl/user/s1934538/clickstream/clickstream-enwiki-2022-01.tsv.gz,Greta_Thunberg,14417,131728,1252,147397,32830
hdfs://spark-nn.eemcs.utwente.nl/user/s1934538/clickstream/clickstream-enwiki-2022-01.tsv.gz,Venom_(2018_film),51866,217306,2559,271731,136551
hdfs://spark-nn.eemcs.utwente.nl/user/s1934538/clickstream/clickstream-enwiki-2022-01.tsv.gz,Asia_Cup,2046,19054,117,21217,11607
hdfs://spark-nn.eemcs.utwente.nl/user/s1934538/clickstream/clickstream-enwiki-2022-01.tsv.gz,Anthony_Bourdain,23995,200939,1621,226555,75648
hdfs://spark-nn.eemcs.utwente.nl/user/s1934538/clickstream/clickstream-enwiki-2022-01.tsv.gz,Mortal_Kombat_(2021_film),30828,134036,2713,167577,171628
hdfs://spark-nn.eemcs.utwente.nl/user/s1934538/clickstream/clickstream-enwiki-2022-01.tsv.gz,Bird_Box_(film),28454,81556,961,110971,39543
hdfs://spark-nn.eemcs.utwente.nl/user/s1934538/clickstream/clickstream-enwiki-2022-01.tsv.gz,Joaquin_Phoenix,160388,190548,1379,352315,221066
hdfs://spark-nn.eemcs.utwente.nl/user/s1934538/clickstream/clickstream-enwiki-2022-01.tsv.gz,Elizabeth_II,624908,961057,8048,1594013,1204408
hdfs://spark-nn.eemcs.utwente.nl/user/s1934538/clickstream/clickstream-enwiki-2022-01.tsv.gz,Richard_Jewell,17995,111706,667,130368,46240
hdfs://spark-nn.eemcs.utwente.nl/user/s1934538/clickstream/clickstream-enwiki-2022-01.tsv.gz,21_Savage,13436,77466,1041,91943,33068
hdfs://spark-nn.eemcs.utwente.nl/user/s1934538/clickstream/clickstream-enwiki-2022-01.tsv.gz,Google_logo,672,24165,14,24851,984
hdfs://spark-nn.eemcs.utwente.nl/user/s1934538/clickstream/clickstream-enwiki-2022-01.tsv.gz,List_of_FIFA_World_Cup_finals,2873,53162,55,56090,16906
hdfs://spark-nn.eemcs.utwente.nl/user/s1934538/clickstream/clickstream-enwiki-2022-01.tsv.gz,2.0_(film),37230,40072,120,77422,24219
hdfs://spark-nn.eemcs.utwente.nl/user/s1934538/clickstream/clickstream-enwiki-2022-01.tsv.gz,Tina_Turner,29710,243112,2855,275677,93270
hdfs://spark-nn.eemcs.utwente.nl/user/s1934538/clickstream/clickstream-enwiki-2022-01.tsv.gz,Michael_Bloomberg,45774,34026,198,79998,38888
hdfs://spark-nn.eemcs.utwente.nl/user/s1934538/clickstream/clickstream-enwiki-2022-01.tsv.gz,Qasem_Soleimani,16406,72920,367,89693,45378
hdfs://spark-nn.eemcs.utwente.nl/user/s1934538/clickstream/clickstream-enwiki-2022-01.tsv.gz,Royal_Rumble_(2018),34109,17561,269,51939,37097
hdfs://spark-nn.eemcs.utwente.nl/user/s1934538/clickstream/clickstream-enwiki-2022-01.tsv.gz,Laal_Singh_Chaddha,61380,79455,202,141037,78149
hdfs://spark-nn.eemcs.utwente.nl/user/s1934538/clickstream/clickstream-enwiki-2022-01.tsv.gz,2020_United_States_presidential_election,144351,208753,5077,358181,334242
hdfs://spark-nn.eemcs.utwente.nl/user/s1934538/clickstream/clickstream-enwiki-2022-01.tsv.gz,War_(2019_film),28488,54200,54,82742,23036
hdfs://spark-nn.eemcs.utwente.nl/user/s1934538/clickstream/clickstream-enwiki-2022-01.tsv.gz,QAnon,50104,271399,2317,323820,80865
hdfs://spark-nn.eemcs.utwente.nl/user/s1934538/clickstream/clickstream-enwiki-2022-01.tsv.gz,Cameron_Boyce,26913,141880,540,169333,44623
hdfs://spark-nn.eemcs.utwente.nl/user/s1934538/clickstream/clickstream-enwiki-2022-01.tsv.gz,The_Shape_of_Water,34488,57256,673,92417,41895
hdfs://spark-nn.eemcs.utwente.nl/user/s1934538/clickstream/clickstream-enwiki-2022-01.tsv.gz,Saaho,35402,53603,258,89263,27482
hdfs://spark-nn.eemcs.utwente.nl/user/s1934538/clickstream/clickstream-enwiki-2022-01.tsv.gz,Charles_III,86,175,51,312,323
hdfs://spark-nn.eemcs.utwente.nl/user/s1934538/clickstream/clickstream-enwiki-2022-01.tsv.gz,Black_Panther_(film),64836,134096,2611,201543,129565
hdfs://spark-nn.eemcs.utwente.nl/user/s1934538/clickstream/clickstream-enwiki-2022-01.tsv.gz,Stranger_Things,67872,209248,5160,282280,215177
hdfs://spark-nn.eemcs.utwente.nl/user/s1934538/clickstream/clickstream-enwiki-2022-01.tsv.gz,"Prince_Philip,_Duke_of_Edinburgh",245677,231725,2674,480076,283626
hdfs://spark-nn.eemcs.utwente.nl/user/s1934538/clickstream/clickstream-enwiki-2022-01.tsv.gz,XHamster,7311,511767,6218,525296,63709
hdfs://spark-nn.eemcs.utwente.nl/user/s1934538/clickstream/clickstream-enwiki-2022-01.tsv.gz,Aaron_Carter,23297,63942,456,87695,41415
hdfs://spark-nn.eemcs.utwente.nl/user/s1934538/clickstream/clickstream-enwiki-2022-01.tsv.gz,Juice_Wrld,46709,300447,3794,350950,141928
hdfs://spark-nn.eemcs.utwente.nl/user/s1934538/clickstream/clickstream-enwiki-2022-01.tsv.gz,Vivek_Ramaswamy,828,13175,32,14035,2423
hdfs://spark-nn.eemcs.utwente.nl/user/s1934538/clickstream/clickstream-enwiki-2022-01.tsv.gz,Eternals_(film),425737,3031525,61591,3518853,4195694
hdfs://spark-nn.eemcs.utwente.nl/user/s1934538/clickstream/clickstream-enwiki-2022-01.tsv.gz,List_of_awards_and_nominations_received_by_Meryl_Streep,18302,13367,357,32026,13308
hdfs://spark-nn.eemcs.utwente.nl/user/s1934538/clickstream/clickstream-enwiki-2022-01.tsv.gz,The_Kashmir_Files,4812,20814,4161,29787,10578
hdfs://spark-nn.eemcs.utwente.nl/user/s1934538/clickstream/clickstream-enwiki-2022-01.tsv.gz,Antifa_(United_States),9724,67916,396,78036,14038
hdfs://spark-nn.eemcs.utwente.nl/user/s1934538/clickstream/clickstream-enwiki-2022-01.tsv.gz,Stan_Lee,97069,361828,1608,460505,109401
hdfs://spark-nn.eemcs.utwente.nl/user/s1934538/clickstream/clickstream-enwiki-2022-01.tsv.gz,The_Mandalorian,175386,362980,7395,545761,426980
hdfs://spark-nn.eemcs.utwente.nl/user/s1934538/clickstream/clickstream-enwiki-2022-01.tsv.gz,HTTP_cookie,2899,416095,121,419115,25049
hdfs://spark-nn.eemcs.utwente.nl/user/s1934538/clickstream/clickstream-enwiki-2022-01.tsv.gz,Hyphen-minus,1059,6261319,20026,6282404,791
hdfs://spark-nn.eemcs.utwente.nl/user/s1934538/clickstream/clickstream-enwiki-2022-01.tsv.gz,List_of_Queen_of_the_South_episodes,9905,6494,181,16580,391
hdfs://spark-nn.eemcs.utwente.nl/user/s1934538/clickstream/clickstream-enwiki-2022-01.tsv.gz,Keanu_Reeves,151894,873540,6852,1032286,658747
hdfs://spark-nn.eemcs.utwente.nl/user/s1934538/clickstream/clickstream-enwiki-2022-01.tsv.gz,Thor:_Love_and_Thunder,235921,173692,2598,412211,302948
hdfs://spark-nn.eemcs.utwente.nl/user/s1934538/clickstream/clickstream-enwiki-2022-01.tsv.gz,2020_Summer_Olympics,71325,86221,2203,159749,126828
hdfs://spark-nn.eemcs.utwente.nl/user/s1934538/clickstream/clickstream-enwiki-2022-01.tsv.gz,Jeffrey_Epstein,154316,676222,5295,835833,393701
hdfs://spark-nn.eemcs.utwente.nl/user/s1934538/clickstream/clickstream-enwiki-2022-01.tsv.gz,Guardians_of_the_Galaxy_Vol._3,135403,64051,671,200125,135750
hdfs://spark-nn.eemcs.utwente.nl/user/s1934538/clickstream/clickstream-enwiki-2022-01.tsv.gz,Shakira,23924,173243,1722,198889,91006
hdfs://spark-nn.eemcs.utwente.nl/user/s1934538/clickstream/clickstream-enwiki-2022-01.tsv.gz,Army_of_the_Dead,79937,100666,1181,181784,100809
hdfs://spark-nn.eemcs.utwente.nl/user/s1934538/clickstream/clickstream-enwiki-2022-01.tsv.gz,The_Lion_King_(2019_film),77535,60217,896,138648,64858
hdfs://spark-nn.eemcs.utwente.nl/user/s1934538/clickstream/clickstream-enwiki-2022-01.tsv.gz,Simple_Mail_Transfer_Protocol,3276,34351,100,37727,3505
hdfs://spark-nn.eemcs.utwente.nl/user/s1934538/clickstream/clickstream-enwiki-2022-01.tsv.gz,United_States_Electoral_College,12061,39171,99,51331,8410
hdfs://spark-nn.eemcs.utwente.nl/user/s1934538/clickstream/clickstream-enwiki-2022-01.tsv.gz,Vikram_(2022_film),43852,27018,819,71689,41389
hdfs://spark-nn.eemcs.utwente.nl/user/s1934538/clickstream/clickstream-enwiki-2022-01.tsv.gz,Kenosha_unrest_shooting,7573,119169,3641,130383,24343
hdfs://spark-nn.eemcs.utwente.nl/user/s1934538/clickstream/clickstream-enwiki-2022-01.tsv.gz,Darth_Vader,33904,65784,735,100423,65005
hdfs://spark-nn.eemcs.utwente.nl/user/s1934538/clickstream/clickstream-enwiki-2022-01.tsv.gz,Anne_Heche,27305,44540,258,72103,22609
hdfs://spark-nn.eemcs.utwente.nl/user/s1934538/clickstream/clickstream-enwiki-2022-01.tsv.gz,Everything_Everywhere_All_at_Once,20109,22558,349,43016,16207
hdfs://spark-nn.eemcs.utwente.nl/user/s1934538/clickstream/clickstream-enwiki-2022-01.tsv.gz,2022_FIFA_World_Cup,132682,466357,10939,609978,317052
hdfs://spark-nn.eemcs.utwente.nl/user/s1934538/clickstream/clickstream-enwiki-2022-01.tsv.gz,Spider-Man:_Far_From_Home,216108,312606,4355,533069,270928
hdfs://spark-nn.eemcs.utwente.nl/user/s1934538/clickstream/clickstream-enwiki-2022-01.tsv.gz,David_Beckham,43826,191173,1725,236724,86089
hdfs://spark-nn.eemcs.utwente.nl/user/s1934538/clickstream/clickstream-enwiki-2022-01.tsv.gz,Valentine's_Day,6809,244628,1243,252680,16416
hdfs://spark-nn.eemcs.utwente.nl/user/s1934538/clickstream/clickstream-enwiki-2022-01.tsv.gz,ICC_Men's_T20_World_Cup,18800,105102,533,124435,55118
hdfs://spark-nn.eemcs.utwente.nl/user/s1934538/clickstream/clickstream-enwiki-2022-01.tsv.gz,Black_Adam_(film),89588,59966,3771,153325,108356
hdfs://spark-nn.eemcs.utwente.nl/user/s1934538/clickstream/clickstream-enwiki-2022-01.tsv.gz,List_of_highest-grossing_films,642854,1067161,4880,1714895,694561
hdfs://spark-nn.eemcs.utwente.nl/user/s1934538/clickstream/clickstream-enwiki-2022-01.tsv.gz,Brie_Larson,91171,179081,1537,271789,114253
hdfs://spark-nn.eemcs.utwente.nl/user/s1934538/clickstream/clickstream-enwiki-2022-01.tsv.gz,Deion_Sanders,19688,157651,1041,178380,59118
hdfs://spark-nn.eemcs.utwente.nl/user/s1934538/clickstream/clickstream-enwiki-2022-01.tsv.gz,Grimes_(musician),147700,139412,991,288103,99210
hdfs://spark-nn.eemcs.utwente.nl/user/s1934538/clickstream/clickstream-enwiki-2022-01.tsv.gz,1917_(2019_film),36346,97070,2323,135739,79213
hdfs://spark-nn.eemcs.utwente.nl/user/s1934538/clickstream/clickstream-enwiki-2022-01.tsv.gz,UEFA_Euro_2020,41344,70842,1674,113860,63474
hdfs://spark-nn.eemcs.utwente.nl/user/s1934538/clickstream/clickstream-enwiki-2022-01.tsv.gz,Deaths_in_2022,1888352,2212980,15513,4116845,2770520
hdfs://spark-nn.eemcs.utwente.nl/user/s1934538/clickstream/clickstream-enwiki-2022-01.tsv.gz,Afghanistan,169359,265583,7573,442515,313585
hdfs://spark-nn.eemcs.utwente.nl/user/s1934538/clickstream/clickstream-enwiki-2022-01.tsv.gz,Lisa_Marie_Presley,151717,86034,300,238051,141360
hdfs://spark-nn.eemcs.utwente.nl/user/s1934538/clickstream/clickstream-enwiki-2022-01.tsv.gz,Emma_Raducanu,30433,282737,2502,315672,85057
hdfs://spark-nn.eemcs.utwente.nl/user/s1934538/clickstream/clickstream-enwiki-2022-01.tsv.gz,The_Idol_(TV_series),25954,9735,169,35858,25460
hdfs://spark-nn.eemcs.utwente.nl/user/s1934538/clickstream/clickstream-enwiki-2022-01.tsv.gz,Sushma_Swaraj,6375,17096,39,23510,6153
hdfs://spark-nn.eemcs.utwente.nl/user/s1934538/clickstream/clickstream-enwiki-2022-01.tsv.gz,JSON_Web_Token,709,27889,52,28650,1974
hdfs://spark-nn.eemcs.utwente.nl/user/s1934538/clickstream/clickstream-enwiki-2022-01.tsv.gz,K.G.F:_Chapter_2,45173,161433,1225,207831,84509
hdfs://spark-nn.eemcs.utwente.nl/user/s1934538/clickstream/clickstream-enwiki-2022-01.tsv.gz,Dune_(2021_film),147196,580190,15641,743027,487851
hdfs://spark-nn.eemcs.utwente.nl/user/s1934538/clickstream/clickstream-enwiki-2022-01.tsv.gz,The_Batman_(film),189336,430318,13517,633171,480088
hdfs://spark-nn.eemcs.utwente.nl/user/s1934538/clickstream/clickstream-enwiki-2022-01.tsv.gz,Meat_Loaf,258297,3613044,57558,3928899,1237146
hdfs://spark-nn.eemcs.utwente.nl/user/s1934538/clickstream/clickstream-enwiki-2022-01.tsv.gz,Taliban,47588,87463,1198,136249,90826
hdfs://spark-nn.eemcs.utwente.nl/user/s1934538/clickstream/clickstream-enwiki-2022-01.tsv.gz,The_Weeknd,127526,563842,10564,701932,479480
hdfs://spark-nn.eemcs.utwente.nl/user/s1934538/clickstream/clickstream-enwiki-2022-01.tsv.gz,J._Robert_Oppenheimer,34163,104967,366,139496,50195
hdfs://spark-nn.eemcs.utwente.nl/user/s1934538/clickstream/clickstream-enwiki-2022-01.tsv.gz,Kylian_Mbappé,26995,184937,1984,213916,41841
hdfs://spark-nn.eemcs.utwente.nl/user/s1934538/clickstream/clickstream-enwiki-2022-01.tsv.gz,Betty_White,479465,5166632,217537,5863634,1852015
hdfs://spark-nn.eemcs.utwente.nl/user/s1934538/clickstream/clickstream-enwiki-2022-01.tsv.gz,Louis_Tomlinson,28475,49768,221,78464,22969
hdfs://spark-nn.eemcs.utwente.nl/user/s1934538/clickstream/clickstream-enwiki-2022-01.tsv.gz,Joe_Biden,196269,474884,16980,688133,316264
hdfs://spark-nn.eemcs.utwente.nl/user/s1934538/clickstream/clickstream-enwiki-2022-01.tsv.gz,Ghislaine_Maxwell,135625,493122,4333,633080,311898
hdfs://spark-nn.eemcs.utwente.nl/user/s1934538/clickstream/clickstream-enwiki-2022-01.tsv.gz,Once_Upon_a_Time_in_Hollywood,122216,205732,4569,332517,348357
hdfs://spark-nn.eemcs.utwente.nl/user/s1934538/clickstream/clickstream-enwiki-2022-01.tsv.gz,Indian_Premier_League,34477,139708,295,174480,115291
hdfs://spark-nn.eemcs.utwente.nl/user/s1934538/clickstream/clickstream-enwiki-2022-01.tsv.gz,Sidharth_Shukla,17926,82656,188,100770,21747
hdfs://spark-nn.eemcs.utwente.nl/user/s1934538/clickstream/clickstream-enwiki-2022-01.tsv.gz,Ant-Man_and_the_Wasp:_Quantumania,113316,41861,325,155502,105759
hdfs://spark-nn.eemcs.utwente.nl/user/s1934538/clickstream/clickstream-enwiki-2022-01.tsv.gz,Cecil_Hotel_(Los_Angeles),10531,126615,216,137362,33237
hdfs://spark-nn.eemcs.utwente.nl/user/s1934538/clickstream/clickstream-enwiki-2022-01.tsv.gz,2018_Winter_Olympics,58371,51207,692,110270,78105
hdfs://spark-nn.eemcs.utwente.nl/user/s1934538/clickstream/clickstream-enwiki-2022-01.tsv.gz,Queen_(band),55675,183377,2855,241907,223118
hdfs://spark-nn.eemcs.utwente.nl/user/s1934538/clickstream/clickstream-enwiki-2022-01.tsv.gz,Kobe_Bryant_sexual_assault_case,8203,46845,295,55343,4435
hdfs://spark-nn.eemcs.utwente.nl/user/s1934538/clickstream/clickstream-enwiki-2022-01.tsv.gz,Cook's_Country,501,3831,35,4367,1157
hdfs://spark-nn.eemcs.utwente.nl/user/s1934538/clickstream/clickstream-enwiki-2022-01.tsv.gz,It_Chapter_Two,26749,36458,441,63648,38254
hdfs://spark-nn.eemcs.utwente.nl/user/s1934538/clickstream/clickstream-enwiki-2022-01.tsv.gz,Roe_v._Wade,13014,115901,817,129732,37609
hdfs://spark-nn.eemcs.utwente.nl/user/s1934538/clickstream/clickstream-enwiki-2022-01.tsv.gz,Jimmy_Hoffa,31590,131387,1053,164030,60706
hdfs://spark-nn.eemcs.utwente.nl/user/s1934538/clickstream/clickstream-enwiki-2022-01.tsv.gz,The_Matrix_Resurrections,322596,1179860,30556,1533012,687480
hdfs://spark-nn.eemcs.utwente.nl/user/s1934538/clickstream/clickstream-enwiki-2022-01.tsv.gz,Freddie_Mercury,77575,425887,4076,507538,201077
hdfs://spark-nn.eemcs.utwente.nl/user/s1934538/clickstream/clickstream-enwiki-2022-01.tsv.gz,"Meghan,_Duchess_of_Sussex",86089,201054,1242,288385,156303
hdfs://spark-nn.eemcs.utwente.nl/user/s1934538/clickstream/clickstream-enwiki-2022-01.tsv.gz,2023_Cricket_World_Cup,18611,52065,97,70773,21516
hdfs://spark-nn.eemcs.utwente.nl/user/s1934538/clickstream/clickstream-enwiki-2022-01.tsv.gz,Juneteenth,6843,101653,413,108909,7643
hdfs://spark-nn.eemcs.utwente.nl/user/s1934538/clickstream/clickstream-enwiki-2022-01.tsv.gz,Fyre_Festival,17494,109756,793,128043,73169
hdfs://spark-nn.eemcs.utwente.nl/user/s1934538/clickstream/clickstream-enwiki-2022-01.tsv.gz,2016_United_States_presidential_election,101343,77811,988,180142,149394
hdfs://spark-nn.eemcs.utwente.nl/user/s1934538/clickstream/clickstream-enwiki-2022-01.tsv.gz,Gaza_Strip,15527,35670,227,51424,18361
hdfs://spark-nn.eemcs.utwente.nl/user/s1934538/clickstream/clickstream-enwiki-2022-01.tsv.gz,Murder_of_Dee_Dee_Blanchard,13489,111925,376,125790,26709
hdfs://spark-nn.eemcs.utwente.nl/user/s1934538/clickstream/clickstream-enwiki-2022-01.tsv.gz,Amy_Coney_Barrett,62973,88151,1447,152571,48540
hdfs://spark-nn.eemcs.utwente.nl/user/s1934538/clickstream/clickstream-enwiki-2022-01.tsv.gz,Kate_Spade,29186,57265,352,86803,31906
hdfs://spark-nn.eemcs.utwente.nl/user/s1934538/clickstream/clickstream-enwiki-2022-01.tsv.gz,John_Wick:_Chapter_4,68797,93626,773,163196,86435
hdfs://spark-nn.eemcs.utwente.nl/user/s1934538/clickstream/clickstream-enwiki-2022-01.tsv.gz,Adipurush,59445,32278,70,91793,68117
hdfs://spark-nn.eemcs.utwente.nl/user/s1934538/clickstream/clickstream-enwiki-2022-01.tsv.gz,Johnny_Depp,151672,321455,5880,479007,301856
hdfs://spark-nn.eemcs.utwente.nl/user/s1934538/clickstream/clickstream-enwiki-2022-01.tsv.gz,Joker_(2019_film),65981,171852,2436,240269,113913
hdfs://spark-nn.eemcs.utwente.nl/user/s1934538/clickstream/clickstream-enwiki-2022-01.tsv.gz,Manti_Te'o,5443,64616,236,70295,8829
hdfs://spark-nn.eemcs.utwente.nl/user/s1934538/clickstream/clickstream-enwiki-2022-01.tsv.gz,Glass_(2019_film),37659,46593,359,84611,30853
hdfs://spark-nn.eemcs.utwente.nl/user/s1934538/clickstream/clickstream-enwiki-2022-01.tsv.gz,Priyanka_Chopra,160794,575232,2642,738668,257082
hdfs://spark-nn.eemcs.utwente.nl/user/s1934538/clickstream/clickstream-enwiki-2022-01.tsv.gz,Stranger_Things_(season_4),29789,215738,1221,246748,129866
hdfs://spark-nn.eemcs.utwente.nl/user/s1934538/clickstream/clickstream-enwiki-2022-01.tsv.gz,Godzilla_vs._Kong,57886,103999,2063,163948,88659
hdfs://spark-nn.eemcs.utwente.nl/user/s1934538/clickstream/clickstream-enwiki-2022-01.tsv.gz,YouTube,162359,2677302,10882,2850543,150709
hdfs://spark-nn.eemcs.utwente.nl/user/s1934538/clickstream/clickstream-enwiki-2022-01.tsv.gz,Spider-Man:_No_Way_Home,803138,3485607,71057,4359802,2428081
hdfs://spark-nn.eemcs.utwente.nl/user/s1934538/clickstream/clickstream-enwiki-2022-01.tsv.gz,Olivia_Newton-John,29625,88409,1059,119093,53029
hdfs://spark-nn.eemcs.utwente.nl/user/s1934538/clickstream/clickstream-enwiki-2022-01.tsv.gz,Eddie_Van_Halen,67991,180229,1960,250180,89936
hdfs://spark-nn.eemcs.utwente.nl/user/s1934538/clickstream/clickstream-enwiki-2022-01.tsv.gz,Cleopatra,67521,4052020,2818,4122359,339000
hdfs://spark-nn.eemcs.utwente.nl/user/s1934538/clickstream/clickstream-enwiki-2022-01.tsv.gz,Death_of_Elisa_Lam,22635,115807,379,138821,36030
hdfs://spark-nn.eemcs.utwente.nl/user/s1934538/clickstream/clickstream-enwiki-2022-04.tsv.gz,Aquaman_(film),93858,142747,2397,239002,117903
hdfs://spark-nn.eemcs.utwente.nl/user/s1934538/clickstream/clickstream-enwiki-2022-04.tsv.gz,Dark_Phoenix_(film),40113,43026,661,83800,49368
hdfs://spark-nn.eemcs.utwente.nl/user/s1934538/clickstream/clickstream-enwiki-2022-04.tsv.gz,Death_of_Elisa_Lam,22597,112583,443,135623,38781
hdfs://spark-nn.eemcs.utwente.nl/user/s1934538/clickstream/clickstream-enwiki-2022-04.tsv.gz,XXXTentacion,85086,563963,6171,655220,106175
hdfs://spark-nn.eemcs.utwente.nl/user/s1934538/clickstream/clickstream-enwiki-2022-04.tsv.gz,Rishi_Sunak,38512,421582,3887,463981,264046
hdfs://spark-nn.eemcs.utwente.nl/user/s1934538/clickstream/clickstream-enwiki-2022-04.tsv.gz,Kate_Spade,40275,58466,358,99099,36101
hdfs://spark-nn.eemcs.utwente.nl/user/s1934538/clickstream/clickstream-enwiki-2022-04.tsv.gz,Jimmy_Buffett,10311,60316,742,71369,26107
hdfs://spark-nn.eemcs.utwente.nl/user/s1934538/clickstream/clickstream-enwiki-2022-04.tsv.gz,The_Flash_(film),126574,92149,2573,221296,145909
hdfs://spark-nn.eemcs.utwente.nl/user/s1934538/clickstream/clickstream-enwiki-2022-04.tsv.gz,Atal_Bihari_Vajpayee,29109,52485,94,81688,30146
hdfs://spark-nn.eemcs.utwente.nl/user/s1934538/clickstream/clickstream-enwiki-2022-04.tsv.gz,Adipurush,98700,69071,18016,185787,152082
hdfs://spark-nn.eemcs.utwente.nl/user/s1934538/clickstream/clickstream-enwiki-2022-04.tsv.gz,Shang-Chi_and_the_Legend_of_the_Ten_Rings,95957,149032,2641,247630,150496
hdfs://spark-nn.eemcs.utwente.nl/user/s1934538/clickstream/clickstream-enwiki-2022-04.tsv.gz,Ted_Bundy,45603,403036,6504,455143,121377
hdfs://spark-nn.eemcs.utwente.nl/user/s1934538/clickstream/clickstream-enwiki-2022-04.tsv.gz,Ponniyin_Selvan:_I,63582,98639,25534,187755,180215
hdfs://spark-nn.eemcs.utwente.nl/user/s1934538/clickstream/clickstream-enwiki-2022-04.tsv.gz,Sridevi,26984,60740,186,87910,44738
hdfs://spark-nn.eemcs.utwente.nl/user/s1934538/clickstream/clickstream-enwiki-2022-04.tsv.gz,Bob_Saget,31259,146947,1762,179968,40149
hdfs://spark-nn.eemcs.utwente.nl/user/s1934538/clickstream/clickstream-enwiki-2022-04.tsv.gz,Sylvester_Stallone,77850,202040,2111,282001,201999
hdfs://spark-nn.eemcs.utwente.nl/user/s1934538/clickstream/clickstream-enwiki-2022-04.tsv.gz,Area_51,17011,136301,1692,155004,53987
hdfs://spark-nn.eemcs.utwente.nl/user/s1934538/clickstream/clickstream-enwiki-2022-04.tsv.gz,Mac_Miller,31099,198840,1644,231583,74561
hdfs://spark-nn.eemcs.utwente.nl/user/s1934538/clickstream/clickstream-enwiki-2022-04.tsv.gz,"Prince_Philip,_Duke_of_Edinburgh",155095,181606,2019,338720,191439
hdfs://spark-nn.eemcs.utwente.nl/user/s1934538/clickstream/clickstream-enwiki-2022-04.tsv.gz,Deion_Sanders,9372,75302,460,85134,26577
hdfs://spark-nn.eemcs.utwente.nl/user/s1934538/clickstream/clickstream-enwiki-2022-04.tsv.gz,Rami_Malek,77387,168860,926,247173,108416
hdfs://spark-nn.eemcs.utwente.nl/user/s1934538/clickstream/clickstream-enwiki-2022-04.tsv.gz,United_States_Electoral_College,10775,30341,85,41201,6819
hdfs://spark-nn.eemcs.utwente.nl/user/s1934538/clickstream/clickstream-enwiki-2022-04.tsv.gz,Manti_Te'o,3334,14480,62,17876,1813
hdfs://spark-nn.eemcs.utwente.nl/user/s1934538/clickstream/clickstream-enwiki-2022-04.tsv.gz,Vladimir_Putin,228772,1037988,18538,1285298,640670
hdfs://spark-nn.eemcs.utwente.nl/user/s1934538/clickstream/clickstream-enwiki-2022-04.tsv.gz,Laal_Singh_Chaddha,58160,87179,1086,146425,87898
hdfs://spark-nn.eemcs.utwente.nl/user/s1934538/clickstream/clickstream-enwiki-2022-04.tsv.gz,Richard_Jewell,10084,45305,265,55654,20137
hdfs://spark-nn.eemcs.utwente.nl/user/s1934538/clickstream/clickstream-enwiki-2022-04.tsv.gz,Lists_of_deaths_by_year,3056,233884,1079,238019,261067
hdfs://spark-nn.eemcs.utwente.nl/user/s1934538/clickstream/clickstream-enwiki-2022-04.tsv.gz,Lisa_Marie_Presley,158711,75719,276,234706,137235
hdfs://spark-nn.eemcs.utwente.nl/user/s1934538/clickstream/clickstream-enwiki-2022-04.tsv.gz,Bipin_Rawat,13741,42076,27,55844,21435
hdfs://spark-nn.eemcs.utwente.nl/user/s1934538/clickstream/clickstream-enwiki-2022-04.tsv.gz,Irrfan_Khan,44523,55321,118,99962,41507
hdfs://spark-nn.eemcs.utwente.nl/user/s1934538/clickstream/clickstream-enwiki-2022-04.tsv.gz,Brett_Kavanaugh,33824,47406,751,81981,26613
hdfs://spark-nn.eemcs.utwente.nl/user/s1934538/clickstream/clickstream-enwiki-2022-04.tsv.gz,Taliban,39812,63700,803,104315,73514
hdfs://spark-nn.eemcs.utwente.nl/user/s1934538/clickstream/clickstream-enwiki-2022-04.tsv.gz,Mission:_Impossible_–_Dead_Reckoning_Part_One,58681,36461,483,95625,16430
hdfs://spark-nn.eemcs.utwente.nl/user/s1934538/clickstream/clickstream-enwiki-2022-04.tsv.gz,IPv4,10583,37954,172,48709,9196
hdfs://spark-nn.eemcs.utwente.nl/user/s1934538/clickstream/clickstream-enwiki-2022-04.tsv.gz,Carlos_Alcaraz,20242,173438,1353,195033,57558
hdfs://spark-nn.eemcs.utwente.nl/user/s1934538/clickstream/clickstream-enwiki-2022-04.tsv.gz,Aretha_Franklin,25553,144728,1211,171492,73516
hdfs://spark-nn.eemcs.utwente.nl/user/s1934538/clickstream/clickstream-enwiki-2022-04.tsv.gz,United_States_Senate,50387,60321,863,111571,49885
hdfs://spark-nn.eemcs.utwente.nl/user/s1934538/clickstream/clickstream-enwiki-2022-04.tsv.gz,Venom_(2018_film),38857,97624,1390,137871,66068
hdfs://spark-nn.eemcs.utwente.nl/user/s1934538/clickstream/clickstream-enwiki-2022-04.tsv.gz,2.0_(film),76110,54057,266,130433,35223
hdfs://spark-nn.eemcs.utwente.nl/user/s1934538/clickstream/clickstream-enwiki-2022-04.tsv.gz,QAnon,38656,193100,5338,237094,64674
hdfs://spark-nn.eemcs.utwente.nl/user/s1934538/clickstream/clickstream-enwiki-2022-04.tsv.gz,WandaVision,52613,132721,2395,187729,93351
hdfs://spark-nn.eemcs.utwente.nl/user/s1934538/clickstream/clickstream-enwiki-2022-04.tsv.gz,Tenet_(film),63007,137150,1683,201840,99346
hdfs://spark-nn.eemcs.utwente.nl/user/s1934538/clickstream/clickstream-enwiki-2022-04.tsv.gz,Once_Upon_a_Time_in_Hollywood,86481,147434,3422,237337,256732
hdfs://spark-nn.eemcs.utwente.nl/user/s1934538/clickstream/clickstream-enwiki-2022-04.tsv.gz,Leave_the_World_Behind_(film),10785,1341,11,12137,5295
hdfs://spark-nn.eemcs.utwente.nl/user/s1934538/clickstream/clickstream-enwiki-2022-04.tsv.gz,Anne_Heche,24696,39468,340,64504,22415
hdfs://spark-nn.eemcs.utwente.nl/user/s1934538/clickstream/clickstream-enwiki-2022-04.tsv.gz,Volodymyr_Zelenskyy,225916,649385,9100,884401,408200
hdfs://spark-nn.eemcs.utwente.nl/user/s1934538/clickstream/clickstream-enwiki-2022-04.tsv.gz,2018_Winter_Olympics,7699,8722,93,16514,9999
hdfs://spark-nn.eemcs.utwente.nl/user/s1934538/clickstream/clickstream-enwiki-2022-04.tsv.gz,Barbie_(film),116002,46186,1251,163439,144793
hdfs://spark-nn.eemcs.utwente.nl/user/s1934538/clickstream/clickstream-enwiki-2022-04.tsv.gz,Kelly_Preston,97793,129538,658,227989,71292
hdfs://spark-nn.eemcs.utwente.nl/user/s1934538/clickstream/clickstream-enwiki-2022-04.tsv.gz,Crazy_Rich_Asians_(film),34489,62869,1067,98425,80007
hdfs://spark-nn.eemcs.utwente.nl/user/s1934538/clickstream/clickstream-enwiki-2022-04.tsv.gz,Watts_family_murders,13536,133466,448,147450,43251
hdfs://spark-nn.eemcs.utwente.nl/user/s1934538/clickstream/clickstream-enwiki-2022-04.tsv.gz,List_of_Queen_of_the_South_episodes,40645,20752,152,61549,1591
hdfs://spark-nn.eemcs.utwente.nl/user/s1934538/clickstream/clickstream-enwiki-2022-04.tsv.gz,George_VI,297567,121658,736,419961,304090
hdfs://spark-nn.eemcs.utwente.nl/user/s1934538/clickstream/clickstream-enwiki-2022-04.tsv.gz,Johnny_Depp,909607,5481895,50502,6442004,4422222
hdfs://spark-nn.eemcs.utwente.nl/user/s1934538/clickstream/clickstream-enwiki-2022-04.tsv.gz,Tunnel,4709,7567,166,12442,3237
hdfs://spark-nn.eemcs.utwente.nl/user/s1934538/clickstream/clickstream-enwiki-2022-04.tsv.gz,Parasite_(2019_film),32352,127999,1409,161760,66527
hdfs://spark-nn.eemcs.utwente.nl/user/s1934538/clickstream/clickstream-enwiki-2022-04.tsv.gz,Media,69,3555,346,3970,1358
hdfs://spark-nn.eemcs.utwente.nl/user/s1934538/clickstream/clickstream-enwiki-2022-04.tsv.gz,Ukraine,239896,1004548,37015,1281459,676222
hdfs://spark-nn.eemcs.utwente.nl/user/s1934538/clickstream/clickstream-enwiki-2022-04.tsv.gz,Amy_Coney_Barrett,45616,73532,1028,120176,36277
hdfs://spark-nn.eemcs.utwente.nl/user/s1934538/clickstream/clickstream-enwiki-2022-04.tsv.gz,Joaquin_Phoenix,142120,206014,1109,349243,234981
hdfs://spark-nn.eemcs.utwente.nl/user/s1934538/clickstream/clickstream-enwiki-2022-04.tsv.gz,Everything_Everywhere_All_at_Once,148782,1468800,23572,1641154,804274
hdfs://spark-nn.eemcs.utwente.nl/user/s1934538/clickstream/clickstream-enwiki-2022-04.tsv.gz,Bonnie_and_Clyde,24532,232457,1740,258729,71086
hdfs://spark-nn.eemcs.utwente.nl/user/s1934538/clickstream/clickstream-enwiki-2022-04.tsv.gz,The_Suicide_Squad_(film),87654,98870,2255,188779,127799
hdfs://spark-nn.eemcs.utwente.nl/user/s1934538/clickstream/clickstream-enwiki-2022-04.tsv.gz,XHamster,5501,296339,5382,307222,27066
hdfs://spark-nn.eemcs.utwente.nl/user/s1934538/clickstream/clickstream-enwiki-2022-04.tsv.gz,Naomi_Osaka,16770,77717,576,95063,25914
hdfs://spark-nn.eemcs.utwente.nl/user/s1934538/clickstream/clickstream-enwiki-2022-04.tsv.gz,Mötley_Crüe,44178,128778,1342,174298,195218
hdfs://spark-nn.eemcs.utwente.nl/user/s1934538/clickstream/clickstream-enwiki-2022-04.tsv.gz,FIFA_World_Cup,73030,300535,6833,380398,217343
hdfs://spark-nn.eemcs.utwente.nl/user/s1934538/clickstream/clickstream-enwiki-2022-04.tsv.gz,JSON_Web_Token,695,26172,34,26901,1900
hdfs://spark-nn.eemcs.utwente.nl/user/s1934538/clickstream/clickstream-enwiki-2022-04.tsv.gz,Eternals_(film),100528,278888,6054,385470,353016
hdfs://spark-nn.eemcs.utwente.nl/user/s1934538/clickstream/clickstream-enwiki-2022-04.tsv.gz,Black_Panther_(film),39775,85824,1864,127463,73777
hdfs://spark-nn.eemcs.utwente.nl/user/s1934538/clickstream/clickstream-enwiki-2022-04.tsv.gz,Simone_Biles,9331,60210,503,70044,20252
hdfs://spark-nn.eemcs.utwente.nl/user/s1934538/clickstream/clickstream-enwiki-2022-04.tsv.gz,Ant-Man_and_the_Wasp:_Quantumania,76012,25600,254,101866,62644
hdfs://spark-nn.eemcs.utwente.nl/user/s1934538/clickstream/clickstream-enwiki-2022-04.tsv.gz,Tom_Brady,51502,245647,3335,300484,107784
hdfs://spark-nn.eemcs.utwente.nl/user/s1934538/clickstream/clickstream-enwiki-2022-04.tsv.gz,"Meghan,_Duchess_of_Sussex",72207,177904,1203,251314,142358
hdfs://spark-nn.eemcs.utwente.nl/user/s1934538/clickstream/clickstream-enwiki-2022-04.tsv.gz,Afghanistan,136112,211211,6226,353549,243532
hdfs://spark-nn.eemcs.utwente.nl/user/s1934538/clickstream/clickstream-enwiki-2022-04.tsv.gz,Spider-Man:_Across_the_Spider-Verse,78462,68505,6283,153250,26938
hdfs://spark-nn.eemcs.utwente.nl/user/s1934538/clickstream/clickstream-enwiki-2022-04.tsv.gz,Stranger_Things_(season_4),45488,420863,3633,469984,215451
hdfs://spark-nn.eemcs.utwente.nl/user/s1934538/clickstream/clickstream-enwiki-2022-04.tsv.gz,Darth_Vader,34160,69904,1016,105080,70225
hdfs://spark-nn.eemcs.utwente.nl/user/s1934538/clickstream/clickstream-enwiki-2022-04.tsv.gz,Deaths_in_2022,1462900,2270090,17341,3750331,2202006
hdfs://spark-nn.eemcs.utwente.nl/user/s1934538/clickstream/clickstream-enwiki-2022-04.tsv.gz,Priyanka_Chopra,76802,224924,833,302559,111648
hdfs://spark-nn.eemcs.utwente.nl/user/s1934538/clickstream/clickstream-enwiki-2022-04.tsv.gz,Rihanna,102673,469693,5435,577801,334286
hdfs://spark-nn.eemcs.utwente.nl/user/s1934538/clickstream/clickstream-enwiki-2022-04.tsv.gz,J._Robert_Oppenheimer,73600,154256,480,228336,79338
hdfs://spark-nn.eemcs.utwente.nl/user/s1934538/clickstream/clickstream-enwiki-2022-04.tsv.gz,Sushma_Swaraj,10884,17068,75,28027,9012
hdfs://spark-nn.eemcs.utwente.nl/user/s1934538/clickstream/clickstream-enwiki-2022-04.tsv.gz,Avicii,21555,213241,1672,236468,72993
hdfs://spark-nn.eemcs.utwente.nl/user/s1934538/clickstream/clickstream-enwiki-2022-04.tsv.gz,Amber_Heard,986008,6144111,42605,7172724,2747926
hdfs://spark-nn.eemcs.utwente.nl/user/s1934538/clickstream/clickstream-enwiki-2022-04.tsv.gz,Kobe_Bryant_sexual_assault_case,6837,26257,207,33301,3464
hdfs://spark-nn.eemcs.utwente.nl/user/s1934538/clickstream/clickstream-enwiki-2022-04.tsv.gz,Queen_(band),57421,189569,3470,250460,239979
hdfs://spark-nn.eemcs.utwente.nl/user/s1934538/clickstream/clickstream-enwiki-2022-04.tsv.gz,George_H._W._Bush,142165,105387,875,248427,149999
hdfs://spark-nn.eemcs.utwente.nl/user/s1934538/clickstream/clickstream-enwiki-2022-04.tsv.gz,The_Falcon_and_the_Winter_Soldier,30317,55002,1213,86532,50713
hdfs://spark-nn.eemcs.utwente.nl/user/s1934538/clickstream/clickstream-enwiki-2022-04.tsv.gz,UEFA_Euro_2020,47524,86530,1410,135464,71717
hdfs://spark-nn.eemcs.utwente.nl/user/s1934538/clickstream/clickstream-enwiki-2022-04.tsv.gz,Jason_Momoa,121071,318630,2534,442235,169698
hdfs://spark-nn.eemcs.utwente.nl/user/s1934538/clickstream/clickstream-enwiki-2022-04.tsv.gz,Cecil_Hotel_(Los_Angeles),9495,121620,259,131374,36112
hdfs://spark-nn.eemcs.utwente.nl/user/s1934538/clickstream/clickstream-enwiki-2022-04.tsv.gz,Charles_Sobhraj,10542,49276,140,59958,11463
hdfs://spark-nn.eemcs.utwente.nl/user/s1934538/clickstream/clickstream-enwiki-2022-04.tsv.gz,Antifa_(United_States),8150,51171,309,59630,10734
hdfs://spark-nn.eemcs.utwente.nl/user/s1934538/clickstream/clickstream-enwiki-2022-04.tsv.gz,Jeffrey_Epstein,52140,185417,1752,239309,111084
hdfs://spark-nn.eemcs.utwente.nl/user/s1934538/clickstream/clickstream-enwiki-2022-04.tsv.gz,Roe_v._Wade,11730,101662,757,114149,33418
hdfs://spark-nn.eemcs.utwente.nl/user/s1934538/clickstream/clickstream-enwiki-2022-04.tsv.gz,"Diana,_Princess_of_Wales",126577,334373,4324,465274,298783
hdfs://spark-nn.eemcs.utwente.nl/user/s1934538/clickstream/clickstream-enwiki-2022-04.tsv.gz,Vivek_Ramaswamy,424,12351,38,12813,1997
hdfs://spark-nn.eemcs.utwente.nl/user/s1934538/clickstream/clickstream-enwiki-2022-04.tsv.gz,Hamas,27910,36858,253,65021,30064
hdfs://spark-nn.eemcs.utwente.nl/user/s1934538/clickstream/clickstream-enwiki-2022-04.tsv.gz,Stranger_Things_(season_3),36074,50860,822,87756,46896
hdfs://spark-nn.eemcs.utwente.nl/user/s1934538/clickstream/clickstream-enwiki-2022-04.tsv.gz,HTTP_cookie,2994,268989,117,272100,24429
hdfs://spark-nn.eemcs.utwente.nl/user/s1934538/clickstream/clickstream-enwiki-2022-04.tsv.gz,Burt_Reynolds,48746,109768,1018,159532,75676
hdfs://spark-nn.eemcs.utwente.nl/user/s1934538/clickstream/clickstream-enwiki-2022-04.tsv.gz,The_Umbrella_Academy_(TV_series),31561,121331,2440,155332,91030
hdfs://spark-nn.eemcs.utwente.nl/user/s1934538/clickstream/clickstream-enwiki-2022-04.tsv.gz,WrestleMania_34,53319,24610,210,78139,52005
hdfs://spark-nn.eemcs.utwente.nl/user/s1934538/clickstream/clickstream-enwiki-2022-04.tsv.gz,Coronavirus,8266,62543,1370,72179,20546
hdfs://spark-nn.eemcs.utwente.nl/user/s1934538/clickstream/clickstream-enwiki-2022-04.tsv.gz,COVID-19_pandemic_by_country_and_territory,34774,87962,1937,124673,64465
hdfs://spark-nn.eemcs.utwente.nl/user/s1934538/clickstream/clickstream-enwiki-2022-04.tsv.gz,List_of_James_Bond_films,79169,440452,2371,521992,310967
hdfs://spark-nn.eemcs.utwente.nl/user/s1934538/clickstream/clickstream-enwiki-2022-04.tsv.gz,"Citizenship_(Amendment)_Act,_2019",3819,17805,14,21638,2878
hdfs://spark-nn.eemcs.utwente.nl/user/s1934538/clickstream/clickstream-enwiki-2022-04.tsv.gz,Juneteenth,6377,123258,489,130124,8308
hdfs://spark-nn.eemcs.utwente.nl/user/s1934538/clickstream/clickstream-enwiki-2022-04.tsv.gz,Cricket_World_Cup,14509,89249,495,104253,86458
hdfs://spark-nn.eemcs.utwente.nl/user/s1934538/clickstream/clickstream-enwiki-2022-04.tsv.gz,Ruth_Bader_Ginsburg,29110,107056,995,137161,52120
hdfs://spark-nn.eemcs.utwente.nl/user/s1934538/clickstream/clickstream-enwiki-2022-04.tsv.gz,Saaho,58261,59923,393,118577,29763
hdfs://spark-nn.eemcs.utwente.nl/user/s1934538/clickstream/clickstream-enwiki-2022-04.tsv.gz,Henry_V_of_England,93375,119673,1136,214184,154116
hdfs://spark-nn.eemcs.utwente.nl/user/s1934538/clickstream/clickstream-enwiki-2022-04.tsv.gz,Notre-Dame_de_Paris,13976,101417,1164,116557,27106
hdfs://spark-nn.eemcs.utwente.nl/user/s1934538/clickstream/clickstream-enwiki-2022-04.tsv.gz,Spanish_flu,19628,91632,1214,112474,29574
hdfs://spark-nn.eemcs.utwente.nl/user/s1934538/clickstream/clickstream-enwiki-2022-04.tsv.gz,Joker_(2019_film),59763,231106,3299,294168,148981
hdfs://spark-nn.eemcs.utwente.nl/user/s1934538/clickstream/clickstream-enwiki-2022-04.tsv.gz,Hamilton_(musical),30226,170429,1710,202365,127191
hdfs://spark-nn.eemcs.utwente.nl/user/s1934538/clickstream/clickstream-enwiki-2022-04.tsv.gz,Stan_Lee,45812,154529,1165,201506,48632
hdfs://spark-nn.eemcs.utwente.nl/user/s1934538/clickstream/clickstream-enwiki-2022-04.tsv.gz,Simple_Mail_Transfer_Protocol,2894,35789,116,38799,3335
hdfs://spark-nn.eemcs.utwente.nl/user/s1934538/clickstream/clickstream-enwiki-2022-04.tsv.gz,Glass_(2019_film),52889,57867,614,111370,38176
hdfs://spark-nn.eemcs.utwente.nl/user/s1934538/clickstream/clickstream-enwiki-2022-04.tsv.gz,Main_Page,83864,139710501,5153373,144947738,35551634
hdfs://spark-nn.eemcs.utwente.nl/user/s1934538/clickstream/clickstream-enwiki-2022-04.tsv.gz,Tina_Turner,20245,157862,1567,179674,60374
hdfs://spark-nn.eemcs.utwente.nl/user/s1934538/clickstream/clickstream-enwiki-2022-04.tsv.gz,Critical_race_theory,13499,420894,3112,437505,40736
hdfs://spark-nn.eemcs.utwente.nl/user/s1934538/clickstream/clickstream-enwiki-2022-04.tsv.gz,Jeffrey_Dahmer,29148,317228,4253,350629,158118
hdfs://spark-nn.eemcs.utwente.nl/user/s1934538/clickstream/clickstream-enwiki-2022-04.tsv.gz,Stephen_Hawking,26701,266243,2105,295049,114404
hdfs://spark-nn.eemcs.utwente.nl/user/s1934538/clickstream/clickstream-enwiki-2022-04.tsv.gz,Donald_Glover,57445,202327,1782,261554,117696
hdfs://spark-nn.eemcs.utwente.nl/user/s1934538/clickstream/clickstream-enwiki-2022-04.tsv.gz,Indian_Premier_League,47544,696218,807,744569,288551
hdfs://spark-nn.eemcs.utwente.nl/user/s1934538/clickstream/clickstream-enwiki-2022-04.tsv.gz,Jurassic_World_Dominion,102396,162359,5478,270233,178043
hdfs://spark-nn.eemcs.utwente.nl/user/s1934538/clickstream/clickstream-enwiki-2022-04.tsv.gz,2018_Asian_Games,8640,6237,81,14958,15350
hdfs://spark-nn.eemcs.utwente.nl/user/s1934538/clickstream/clickstream-enwiki-2022-04.tsv.gz,Alexander_Hamilton,62970,210629,2041,275640,137981
hdfs://spark-nn.eemcs.utwente.nl/user/s1934538/clickstream/clickstream-enwiki-2022-04.tsv.gz,YouTube,135501,2733199,9871,2878571,123965
hdfs://spark-nn.eemcs.utwente.nl/user/s1934538/clickstream/clickstream-enwiki-2022-04.tsv.gz,2022_FIFA_World_Cup,316146,1475090,35202,1826438,1164153
hdfs://spark-nn.eemcs.utwente.nl/user/s1934538/clickstream/clickstream-enwiki-2022-04.tsv.gz,Hyphen-minus,794,5718438,20791,5740023,648
hdfs://spark-nn.eemcs.utwente.nl/user/s1934538/clickstream/clickstream-enwiki-2022-04.tsv.gz,Central_Park_jogger_case,14504,56746,218,71468,9444
hdfs://spark-nn.eemcs.utwente.nl/user/s1934538/clickstream/clickstream-enwiki-2022-04.tsv.gz,Wikipedia,233484,1028676,1246,1263406,436705
hdfs://spark-nn.eemcs.utwente.nl/user/s1934538/clickstream/clickstream-enwiki-2022-04.tsv.gz,Army_of_the_Dead,54437,56127,1064,111628,64623
hdfs://spark-nn.eemcs.utwente.nl/user/s1934538/clickstream/clickstream-enwiki-2022-04.tsv.gz,Adele,30145,158800,2482,191427,76570
hdfs://spark-nn.eemcs.utwente.nl/user/s1934538/clickstream/clickstream-enwiki-2022-04.tsv.gz,It_Chapter_Two,27802,42551,554,70907,46320
hdfs://spark-nn.eemcs.utwente.nl/user/s1934538/clickstream/clickstream-enwiki-2022-04.tsv.gz,Christopher_Scarver,55996,13626,24,69646,19991
hdfs://spark-nn.eemcs.utwente.nl/user/s1934538/clickstream/clickstream-enwiki-2022-04.tsv.gz,Game_of_Thrones,69106,216416,6230,291752,201110
hdfs://spark-nn.eemcs.utwente.nl/user/s1934538/clickstream/clickstream-enwiki-2022-04.tsv.gz,Spider-Man:_Far_From_Home,72037,96503,1438,169978,80704
hdfs://spark-nn.eemcs.utwente.nl/user/s1934538/clickstream/clickstream-enwiki-2022-04.tsv.gz,Jimmy_Hoffa,28235,124600,1136,153971,58584
hdfs://spark-nn.eemcs.utwente.nl/user/s1934538/clickstream/clickstream-enwiki-2022-04.tsv.gz,Cardi_B,36564,244811,3535,284910,94680
hdfs://spark-nn.eemcs.utwente.nl/user/s1934538/clickstream/clickstream-enwiki-2022-04.tsv.gz,1917_(2019_film),20522,97664,2055,120241,68668
hdfs://spark-nn.eemcs.utwente.nl/user/s1934538/clickstream/clickstream-enwiki-2022-04.tsv.gz,The_Idol_(TV_series),16330,6377,199,22906,14191
hdfs://spark-nn.eemcs.utwente.nl/user/s1934538/clickstream/clickstream-enwiki-2022-04.tsv.gz,Donald_Trump,198095,392954,7236,598285,347600
hdfs://spark-nn.eemcs.utwente.nl/user/s1934538/clickstream/clickstream-enwiki-2022-04.tsv.gz,Fantastic_Beasts:_The_Crimes_of_Grindelwald,368243,398871,6387,773501,428171
hdfs://spark-nn.eemcs.utwente.nl/user/s1934538/clickstream/clickstream-enwiki-2022-04.tsv.gz,Wonder_Woman_1984,40931,54184,1176,96291,46705
hdfs://spark-nn.eemcs.utwente.nl/user/s1934538/clickstream/clickstream-enwiki-2022-04.tsv.gz,List_of_highest-grossing_films,162205,517124,3149,682478,291631
hdfs://spark-nn.eemcs.utwente.nl/user/s1934538/clickstream/clickstream-enwiki-2022-04.tsv.gz,Chernobyl_(miniseries),25084,81266,2045,108395,112677
hdfs://spark-nn.eemcs.utwente.nl/user/s1934538/clickstream/clickstream-enwiki-2022-05.tsv.gz,Lionel_Messi,113720,559143,6563,679426,158609
hdfs://spark-nn.eemcs.utwente.nl/user/s1934538/clickstream/clickstream-enwiki-2022-05.tsv.gz,List_of_James_Bond_films,80812,412348,2603,495763,288431
hdfs://spark-nn.eemcs.utwente.nl/user/s1934538/clickstream/clickstream-enwiki-2022-05.tsv.gz,COVID-19_pandemic,190661,261634,2265,454560,172867
hdfs://spark-nn.eemcs.utwente.nl/user/s1934538/clickstream/clickstream-enwiki-2022-05.tsv.gz,George_VI,347350,179902,1082,528334,360176
hdfs://spark-nn.eemcs.utwente.nl/user/s1934538/clickstream/clickstream-enwiki-2022-05.tsv.gz,Emma_Raducanu,24600,170065,1515,196180,37738
hdfs://spark-nn.eemcs.utwente.nl/user/s1934538/clickstream/clickstream-enwiki-2022-05.tsv.gz,Kenosha_unrest_shooting,6729,106290,959,113978,18203
hdfs://spark-nn.eemcs.utwente.nl/user/s1934538/clickstream/clickstream-enwiki-2022-05.tsv.gz,2016_United_States_presidential_election,100737,91979,1229,193945,150076
hdfs://spark-nn.eemcs.utwente.nl/user/s1934538/clickstream/clickstream-enwiki-2022-05.tsv.gz,Gaza_Strip,19367,30150,194,49711,19664
hdfs://spark-nn.eemcs.utwente.nl/user/s1934538/clickstream/clickstream-enwiki-2022-05.tsv.gz,Charles_III,141,231,80,452,375
hdfs://spark-nn.eemcs.utwente.nl/user/s1934538/clickstream/clickstream-enwiki-2022-05.tsv.gz,Kylian_Mbappé,47931,463362,4816,516109,123508
hdfs://spark-nn.eemcs.utwente.nl/user/s1934538/clickstream/clickstream-enwiki-2022-05.tsv.gz,Jimmy_Buffett,10078,65521,981,76580,28792
hdfs://spark-nn.eemcs.utwente.nl/user/s1934538/clickstream/clickstream-enwiki-2022-05.tsv.gz,Black_Adam_(film),76227,73387,1076,150690,96582
hdfs://spark-nn.eemcs.utwente.nl/user/s1934538/clickstream/clickstream-enwiki-2022-05.tsv.gz,Brett_Kavanaugh,52938,74654,580,128172,45627
hdfs://spark-nn.eemcs.utwente.nl/user/s1934538/clickstream/clickstream-enwiki-2022-05.tsv.gz,J._Robert_Oppenheimer,57029,113741,379,171149,58173
hdfs://spark-nn.eemcs.utwente.nl/user/s1934538/clickstream/clickstream-enwiki-2022-05.tsv.gz,Naomi_Osaka,19062,91180,833,111075,28451
hdfs://spark-nn.eemcs.utwente.nl/user/s1934538/clickstream/clickstream-enwiki-2022-05.tsv.gz,List_of_highest-grossing_films,188595,662733,7221,858549,356117
hdfs://spark-nn.eemcs.utwente.nl/user/s1934538/clickstream/clickstream-enwiki-2022-05.tsv.gz,Stranger_Things_(season_4),402804,2860738,55959,3319501,2287512
hdfs://spark-nn.eemcs.utwente.nl/user/s1934538/clickstream/clickstream-enwiki-2022-05.tsv.gz,Mortal_Kombat_(2021_film),24090,64117,1349,89556,78480
hdfs://spark-nn.eemcs.utwente.nl/user/s1934538/clickstream/clickstream-enwiki-2022-05.tsv.gz,The_Mandalorian,86676,176594,3617,266887,193293
hdfs://spark-nn.eemcs.utwente.nl/user/s1934538/clickstream/clickstream-enwiki-2022-05.tsv.gz,The_Weeknd,63540,164999,2412,230951,107292
hdfs://spark-nn.eemcs.utwente.nl/user/s1934538/clickstream/clickstream-enwiki-2022-05.tsv.gz,George_H._W._Bush,157308,118935,941,277184,165707
hdfs://spark-nn.eemcs.utwente.nl/user/s1934538/clickstream/clickstream-enwiki-2022-05.tsv.gz,Kobe_Bryant_sexual_assault_case,8425,24534,51,33010,3287
hdfs://spark-nn.eemcs.utwente.nl/user/s1934538/clickstream/clickstream-enwiki-2022-05.tsv.gz,Tina_Turner,20998,160608,1809,183415,62966
hdfs://spark-nn.eemcs.utwente.nl/user/s1934538/clickstream/clickstream-enwiki-2022-05.tsv.gz,The_Shape_of_Water,19192,45593,502,65287,31720
hdfs://spark-nn.eemcs.utwente.nl/user/s1934538/clickstream/clickstream-enwiki-2022-05.tsv.gz,Cleopatra,57262,3406028,2558,3465848,317256
hdfs://spark-nn.eemcs.utwente.nl/user/s1934538/clickstream/clickstream-enwiki-2022-05.tsv.gz,Chadwick_Boseman,67221,217549,1612,286382,86044
hdfs://spark-nn.eemcs.utwente.nl/user/s1934538/clickstream/clickstream-enwiki-2022-05.tsv.gz,Michael_Jordan,103563,467578,5659,576800,195270
hdfs://spark-nn.eemcs.utwente.nl/user/s1934538/clickstream/clickstream-enwiki-2022-05.tsv.gz,September_11_attacks,92781,254324,4236,351341,196032
hdfs://spark-nn.eemcs.utwente.nl/user/s1934538/clickstream/clickstream-enwiki-2022-05.tsv.gz,Aaron_Hernandez,6897,83549,451,90897,31774
hdfs://spark-nn.eemcs.utwente.nl/user/s1934538/clickstream/clickstream-enwiki-2022-05.tsv.gz,Royal_Rumble_(2018),6076,4783,44,10903,6799
hdfs://spark-nn.eemcs.utwente.nl/user/s1934538/clickstream/clickstream-enwiki-2022-05.tsv.gz,Black_Panther_(film),51048,98452,2252,151752,86538
hdfs://spark-nn.eemcs.utwente.nl/user/s1934538/clickstream/clickstream-enwiki-2022-05.tsv.gz,Amber_Heard,848542,6052121,52811,6953474,3408976
hdfs://spark-nn.eemcs.utwente.nl/user/s1934538/clickstream/clickstream-enwiki-2022-05.tsv.gz,Kim_Jong-un,62436,151986,1683,216105,123654
hdfs://spark-nn.eemcs.utwente.nl/user/s1934538/clickstream/clickstream-enwiki-2022-05.tsv.gz,Fyre_Festival,11453,78546,708,90707,52220
hdfs://spark-nn.eemcs.utwente.nl/user/s1934538/clickstream/clickstream-enwiki-2022-05.tsv.gz,Sushant_Singh_Rajput,19438,88791,250,108479,53182
hdfs://spark-nn.eemcs.utwente.nl/user/s1934538/clickstream/clickstream-enwiki-2022-05.tsv.gz,Stranger_Things_(season_3),161172,217061,2708,380941,198848
hdfs://spark-nn.eemcs.utwente.nl/user/s1934538/clickstream/clickstream-enwiki-2022-05.tsv.gz,Khabib_Nurmagomedov,63949,181399,1457,246805,130913
hdfs://spark-nn.eemcs.utwente.nl/user/s1934538/clickstream/clickstream-enwiki-2022-05.tsv.gz,Jeffrey_Epstein,39568,139827,1408,180803,85874
hdfs://spark-nn.eemcs.utwente.nl/user/s1934538/clickstream/clickstream-enwiki-2022-05.tsv.gz,Juice_Wrld,39073,191492,3319,233884,100307
hdfs://spark-nn.eemcs.utwente.nl/user/s1934538/clickstream/clickstream-enwiki-2022-05.tsv.gz,Army_of_the_Dead,49938,44678,525,95141,51648
hdfs://spark-nn.eemcs.utwente.nl/user/s1934538/clickstream/clickstream-enwiki-2022-05.tsv.gz,The_Lion_King_(2019_film),45629,49558,946,96133,49313
hdfs://spark-nn.eemcs.utwente.nl/user/s1934538/clickstream/clickstream-enwiki-2022-05.tsv.gz,Bipin_Rawat,10633,28503,25,39161,16058
hdfs://spark-nn.eemcs.utwente.nl/user/s1934538/clickstream/clickstream-enwiki-2022-05.tsv.gz,List_of_Queen_of_the_South_episodes,17544,9731,116,27391,739
hdfs://spark-nn.eemcs.utwente.nl/user/s1934538/clickstream/clickstream-enwiki-2022-05.tsv.gz,Nipsey_Hussle,30685,184259,1560,216504,70462
hdfs://spark-nn.eemcs.utwente.nl/user/s1934538/clickstream/clickstream-enwiki-2022-05.tsv.gz,Simone_Biles,7518,51182,326,59026,16258
hdfs://spark-nn.eemcs.utwente.nl/user/s1934538/clickstream/clickstream-enwiki-2022-05.tsv.gz,Irrfan_Khan,33977,54153,120,88250,39010
hdfs://spark-nn.eemcs.utwente.nl/user/s1934538/clickstream/clickstream-enwiki-2022-05.tsv.gz,2020_United_States_presidential_election,135015,195303,4712,335030,314367
hdfs://spark-nn.eemcs.utwente.nl/user/s1934538/clickstream/clickstream-enwiki-2022-05.tsv.gz,Israel,93207,276110,6879,376196,182295
hdfs://spark-nn.eemcs.utwente.nl/user/s1934538/clickstream/clickstream-enwiki-2022-05.tsv.gz,Amy_Coney_Barrett,71914,134297,1258,207469,62915
hdfs://spark-nn.eemcs.utwente.nl/user/s1934538/clickstream/clickstream-enwiki-2022-05.tsv.gz,Sidharth_Shukla,8418,54444,483,63345,13229
hdfs://spark-nn.eemcs.utwente.nl/user/s1934538/clickstream/clickstream-enwiki-2022-05.tsv.gz,Lists_of_deaths_by_year,3311,219207,872,223390,244811
hdfs://spark-nn.eemcs.utwente.nl/user/s1934538/clickstream/clickstream-enwiki-2022-05.tsv.gz,When_They_See_Us,9355,21465,156,30976,15295
hdfs://spark-nn.eemcs.utwente.nl/user/s1934538/clickstream/clickstream-enwiki-2022-05.tsv.gz,Kate_Spade,52451,357403,1603,411457,128859
hdfs://spark-nn.eemcs.utwente.nl/user/s1934538/clickstream/clickstream-enwiki-2022-05.tsv.gz,Henry_V_of_England,80436,101722,422,182580,133294
hdfs://spark-nn.eemcs.utwente.nl/user/s1934538/clickstream/clickstream-enwiki-2022-05.tsv.gz,Johnny_Depp,951547,5188597,46512,6186656,4068155
hdfs://spark-nn.eemcs.utwente.nl/user/s1934538/clickstream/clickstream-enwiki-2022-05.tsv.gz,Anthony_Bourdain,28029,187493,1946,217468,76262
hdfs://spark-nn.eemcs.utwente.nl/user/s1934538/clickstream/clickstream-enwiki-2022-05.tsv.gz,Michael_Bloomberg,28565,31045,161,59771,27652
hdfs://spark-nn.eemcs.utwente.nl/user/s1934538/clickstream/clickstream-enwiki-2022-05.tsv.gz,The_Witcher_(TV_series),23021,138990,3327,165338,93867
hdfs://spark-nn.eemcs.utwente.nl/user/s1934538/clickstream/clickstream-enwiki-2022-05.tsv.gz,Volodymyr_Zelenskyy,144712,357065,5041,506818,231949
hdfs://spark-nn.eemcs.utwente.nl/user/s1934538/clickstream/clickstream-enwiki-2022-05.tsv.gz,Pelé,33428,115238,1266,149932,57179
hdfs://spark-nn.eemcs.utwente.nl/user/s1934538/clickstream/clickstream-enwiki-2022-05.tsv.gz,Jason_Momoa,123652,493813,6867,624332,259870
hdfs://spark-nn.eemcs.utwente.nl/user/s1934538/clickstream/clickstream-enwiki-2022-05.tsv.gz,John_Wick:_Chapter_4,50354,59723,796,110873,60880
hdfs://spark-nn.eemcs.utwente.nl/user/s1934538/clickstream/clickstream-enwiki-2022-05.tsv.gz,Afghanistan,127042,222594,5650,355286,250905
hdfs://spark-nn.eemcs.utwente.nl/user/s1934538/clickstream/clickstream-enwiki-2022-05.tsv.gz,Oppenheimer_(film),145704,77888,1434,225026,226905
hdfs://spark-nn.eemcs.utwente.nl/user/s1934538/clickstream/clickstream-enwiki-2022-05.tsv.gz,Spanish_flu,21227,90995,1134,113356,29012
hdfs://spark-nn.eemcs.utwente.nl/user/s1934538/clickstream/clickstream-enwiki-2022-05.tsv.gz,"Meghan,_Duchess_of_Sussex",66198,185895,3591,255684,138847
hdfs://spark-nn.eemcs.utwente.nl/user/s1934538/clickstream/clickstream-enwiki-2022-05.tsv.gz,Cameron_Boyce,24744,157276,687,182707,49800
hdfs://spark-nn.eemcs.utwente.nl/user/s1934538/clickstream/clickstream-enwiki-2022-05.tsv.gz,ICC_Men's_T20_World_Cup,11452,91006,416,102874,60181
hdfs://spark-nn.eemcs.utwente.nl/user/s1934538/clickstream/clickstream-enwiki-2022-05.tsv.gz,List_of_highest-grossing_Indian_films,511046,2349943,1781,2862770,930991
hdfs://spark-nn.eemcs.utwente.nl/user/s1934538/clickstream/clickstream-enwiki-2022-05.tsv.gz,Charles_Sobhraj,10556,50064,136,60756,11747
hdfs://spark-nn.eemcs.utwente.nl/user/s1934538/clickstream/clickstream-enwiki-2022-05.tsv.gz,Eddie_Van_Halen,37402,74361,779,112542,42373
hdfs://spark-nn.eemcs.utwente.nl/user/s1934538/clickstream/clickstream-enwiki-2022-05.tsv.gz,Ray_Liotta,154595,3794259,72416,4021270,899046
hdfs://spark-nn.eemcs.utwente.nl/user/s1934538/clickstream/clickstream-enwiki-2022-05.tsv.gz,Sushma_Swaraj,5681,13620,39,19340,5738
hdfs://spark-nn.eemcs.utwente.nl/user/s1934538/clickstream/clickstream-enwiki-2022-05.tsv.gz,2022_Russian_invasion_of_Ukraine,1483548,2623357,11031,4117936,1892893
hdfs://spark-nn.eemcs.utwente.nl/user/s1934538/clickstream/clickstream-enwiki-2022-05.tsv.gz,Indian_Premier_League,45741,600373,133,646247,270260
hdfs://spark-nn.eemcs.utwente.nl/user/s1934538/clickstream/clickstream-enwiki-2022-05.tsv.gz,Jimmy_Hoffa,29174,172460,1521,203155,71110
hdfs://spark-nn.eemcs.utwente.nl/user/s1934538/clickstream/clickstream-enwiki-2022-05.tsv.gz,Joaquin_Phoenix,111483,140021,876,252380,159994
hdfs://spark-nn.eemcs.utwente.nl/user/s1934538/clickstream/clickstream-enwiki-2022-05.tsv.gz,Deadpool_2,78445,56507,1422,136374,88754
hdfs://spark-nn.eemcs.utwente.nl/user/s1934538/clickstream/clickstream-enwiki-2022-05.tsv.gz,Black_Panther:_Wakanda_Forever,196290,140364,1828,338482,267867
hdfs://spark-nn.eemcs.utwente.nl/user/s1934538/clickstream/clickstream-enwiki-2022-05.tsv.gz,List_of_awards_and_nominations_received_by_Meryl_Streep,6224,8495,14,14733,5956
hdfs://spark-nn.eemcs.utwente.nl/user/s1934538/clickstream/clickstream-enwiki-2022-05.tsv.gz,Salman_Rushdie,25197,55987,360,81544,33529
hdfs://spark-nn.eemcs.utwente.nl/user/s1934538/clickstream/clickstream-enwiki-2022-05.tsv.gz,Crazy_Rich_Asians_(film),41080,104829,2182,148091,130186
hdfs://spark-nn.eemcs.utwente.nl/user/s1934538/clickstream/clickstream-enwiki-2022-05.tsv.gz,Louis_Tomlinson,41867,47991,250,90108,26039
hdfs://spark-nn.eemcs.utwente.nl/user/s1934538/clickstream/clickstream-enwiki-2022-05.tsv.gz,Brie_Larson,76653,134307,1593,212553,83330
hdfs://spark-nn.eemcs.utwente.nl/user/s1934538/clickstream/clickstream-enwiki-2022-05.tsv.gz,Fantastic_Beasts:_The_Crimes_of_Grindelwald,189963,170731,1953,362647,180738
hdfs://spark-nn.eemcs.utwente.nl/user/s1934538/clickstream/clickstream-enwiki-2022-05.tsv.gz,UEFA_Euro_2020,44862,69033,1166,115061,64484
hdfs://spark-nn.eemcs.utwente.nl/user/s1934538/clickstream/clickstream-enwiki-2022-05.tsv.gz,Taliban,41426,69756,1125,112307,82852
hdfs://spark-nn.eemcs.utwente.nl/user/s1934538/clickstream/clickstream-enwiki-2022-05.tsv.gz,The_Suicide_Squad_(film),79962,114641,1833,196436,139025
hdfs://spark-nn.eemcs.utwente.nl/user/s1934538/clickstream/clickstream-enwiki-2022-05.tsv.gz,Croatia,53565,180273,2691,236529,79229
hdfs://spark-nn.eemcs.utwente.nl/user/s1934538/clickstream/clickstream-enwiki-2022-05.tsv.gz,Spider-Man:_Across_the_Spider-Verse,77609,36899,8125,122633,51902
hdfs://spark-nn.eemcs.utwente.nl/user/s1934538/clickstream/clickstream-enwiki-2022-05.tsv.gz,Elizabeth_II,468991,1034601,7020,1510612,932667
hdfs://spark-nn.eemcs.utwente.nl/user/s1934538/clickstream/clickstream-enwiki-2022-05.tsv.gz,Bible,17229,1946678,1943,1965850,30981
hdfs://spark-nn.eemcs.utwente.nl/user/s1934538/clickstream/clickstream-enwiki-2022-05.tsv.gz,Cardi_B,33387,231194,3388,267969,82284
hdfs://spark-nn.eemcs.utwente.nl/user/s1934538/clickstream/clickstream-enwiki-2022-05.tsv.gz,Jeffrey_Dahmer,29399,304464,4028,337891,153377
hdfs://spark-nn.eemcs.utwente.nl/user/s1934538/clickstream/clickstream-enwiki-2022-05.tsv.gz,Adele,32113,193258,2550,227921,84322
hdfs://spark-nn.eemcs.utwente.nl/user/s1934538/clickstream/clickstream-enwiki-2022-05.tsv.gz,Venom_(2018_film),27904,90941,1177,120022,57255
hdfs://spark-nn.eemcs.utwente.nl/user/s1934538/clickstream/clickstream-enwiki-2022-05.tsv.gz,RRR_(film),234377,1653608,9213,1897198,842000
hdfs://spark-nn.eemcs.utwente.nl/user/s1934538/clickstream/clickstream-enwiki-2022-05.tsv.gz,Once_Upon_a_Time_in_Hollywood,91953,163310,3560,258823,271897
hdfs://spark-nn.eemcs.utwente.nl/user/s1934538/clickstream/clickstream-enwiki-2022-05.tsv.gz,The_Queen's_Gambit_(miniseries),30307,78224,925,109456,53508
hdfs://spark-nn.eemcs.utwente.nl/user/s1934538/clickstream/clickstream-enwiki-2022-05.tsv.gz,The_Haunting_of_Bly_Manor,19135,38181,375,57691,29783
hdfs://spark-nn.eemcs.utwente.nl/user/s1934538/clickstream/clickstream-enwiki-2022-05.tsv.gz,David_Beckham,58686,281983,2027,342696,141528
hdfs://spark-nn.eemcs.utwente.nl/user/s1934538/clickstream/clickstream-enwiki-2022-05.tsv.gz,"Princess_Margaret,_Countess_of_Snowdon",89987,178039,1466,269492,148281
hdfs://spark-nn.eemcs.utwente.nl/user/s1934538/clickstream/clickstream-enwiki-2022-05.tsv.gz,XHamster,6132,332205,5801,344138,33747
hdfs://spark-nn.eemcs.utwente.nl/user/s1934538/clickstream/clickstream-enwiki-2022-05.tsv.gz,United_States_Senate,62864,77438,1372,141674,63482
hdfs://spark-nn.eemcs.utwente.nl/user/s1934538/clickstream/clickstream-enwiki-2022-05.tsv.gz,Spider-Man:_No_Way_Home,247079,522288,9806,779173,421997
hdfs://spark-nn.eemcs.utwente.nl/user/s1934538/clickstream/clickstream-enwiki-2022-05.tsv.gz,Area_51,16488,122010,1273,139771,44236
hdfs://spark-nn.eemcs.utwente.nl/user/s1934538/clickstream/clickstream-enwiki-2022-05.tsv.gz,Star_Wars:_The_Rise_of_Skywalker,107451,80053,2170,189674,106963
hdfs://spark-nn.eemcs.utwente.nl/user/s1934538/clickstream/clickstream-enwiki-2022-05.tsv.gz,Elliot_Page,62831,244386,1196,308413,136385
hdfs://spark-nn.eemcs.utwente.nl/user/s1934538/clickstream/clickstream-enwiki-2022-05.tsv.gz,Loki_(TV_series),61992,158518,3328,223838,119729
hdfs://spark-nn.eemcs.utwente.nl/user/s1934538/clickstream/clickstream-enwiki-2022-05.tsv.gz,Lisa_Marie_Presley,210780,177831,1137,389748,246267
hdfs://spark-nn.eemcs.utwente.nl/user/s1934538/clickstream/clickstream-enwiki-2022-05.tsv.gz,Article_370_of_the_Constitution_of_India,7326,135825,129,143280,6800
hdfs://spark-nn.eemcs.utwente.nl/user/s1934538/clickstream/clickstream-enwiki-2022-05.tsv.gz,Bridgerton,61488,458536,8675,528699,468478
hdfs://spark-nn.eemcs.utwente.nl/user/s1934538/clickstream/clickstream-enwiki-2022-05.tsv.gz,2018_Asian_Games,22629,15483,143,38255,44540
hdfs://spark-nn.eemcs.utwente.nl/user/s1934538/clickstream/clickstream-enwiki-2022-05.tsv.gz,The_Last_of_Us_(TV_series),27028,46316,221,73565,55246
hdfs://spark-nn.eemcs.utwente.nl/user/s1934538/clickstream/clickstream-enwiki-2022-05.tsv.gz,Cecil_Hotel_(Los_Angeles),7442,79479,207,87128,20529
hdfs://spark-nn.eemcs.utwente.nl/user/s1934538/clickstream/clickstream-enwiki-2022-05.tsv.gz,Shakira,28200,237125,2571,267896,121652
hdfs://spark-nn.eemcs.utwente.nl/user/s1934538/clickstream/clickstream-enwiki-2022-05.tsv.gz,Greta_Thunberg,8043,102272,837,111152,22735
hdfs://spark-nn.eemcs.utwente.nl/user/s1934538/clickstream/clickstream-enwiki-2022-05.tsv.gz,Kelly_Preston,76326,138467,719,215512,65180
hdfs://spark-nn.eemcs.utwente.nl/user/s1934538/clickstream/clickstream-enwiki-2022-05.tsv.gz,It_Chapter_Two,31922,42248,476,74646,47824
hdfs://spark-nn.eemcs.utwente.nl/user/s1934538/clickstream/clickstream-enwiki-2022-05.tsv.gz,Deion_Sanders,8518,72600,569,81687,24180
hdfs://spark-nn.eemcs.utwente.nl/user/s1934538/clickstream/clickstream-enwiki-2022-05.tsv.gz,Asia_Cup,5155,17401,90,22646,15054
hdfs://spark-nn.eemcs.utwente.nl/user/s1934538/clickstream/clickstream-enwiki-2022-05.tsv.gz,Tenet_(film),51297,114563,1594,167454,81010
hdfs://spark-nn.eemcs.utwente.nl/user/s1934538/clickstream/clickstream-enwiki-2022-05.tsv.gz,Wonder_Woman_1984,35089,51447,1151,87687,42099
hdfs://spark-nn.eemcs.utwente.nl/user/s1934538/clickstream/clickstream-enwiki-2022-05.tsv.gz,Shang-Chi_and_the_Legend_of_the_Ten_Rings,115369,169467,2792,287628,172704
hdfs://spark-nn.eemcs.utwente.nl/user/s1934538/clickstream/clickstream-enwiki-2022-05.tsv.gz,Stephen_Hawking,26402,262322,1968,290692,109932
hdfs://spark-nn.eemcs.utwente.nl/user/s1934538/clickstream/clickstream-enwiki-2022-05.tsv.gz,Main_Page,87335,140294256,5318437,145700028,36737862
hdfs://spark-nn.eemcs.utwente.nl/user/s1934538/clickstream/clickstream-enwiki-2022-05.tsv.gz,Eternals_(film),117837,263413,5215,386465,339207
hdfs://spark-nn.eemcs.utwente.nl/user/s1934538/clickstream/clickstream-enwiki-2022-05.tsv.gz,"Diana,_Princess_of_Wales",109964,252386,2581,364931,222907
hdfs://spark-nn.eemcs.utwente.nl/user/s1934538/clickstream/clickstream-enwiki-2022-05.tsv.gz,The_Nun_(2018_film),16889,42496,367,59752,39536
hdfs://spark-nn.eemcs.utwente.nl/user/s1934538/clickstream/clickstream-enwiki-2022-05.tsv.gz,Media,65,4131,652,4848,1556
hdfs://spark-nn.eemcs.utwente.nl/user/s1934538/clickstream/clickstream-enwiki-2022-05.tsv.gz,The_Sandman_(TV_series),25430,46015,773,72218,59305
hdfs://spark-nn.eemcs.utwente.nl/user/s1934538/clickstream/clickstream-enwiki-2022-05.tsv.gz,Joe_Exotic,14531,70085,384,85000,34769
hdfs://spark-nn.eemcs.utwente.nl/user/s1934538/clickstream/clickstream-enwiki-2022-05.tsv.gz,Mac_Miller,26371,157843,1837,186051,59966
hdfs://spark-nn.eemcs.utwente.nl/user/s1934538/clickstream/clickstream-enwiki-2022-05.tsv.gz,Notre-Dame_de_Paris,11117,85575,844,97536,19571
hdfs://spark-nn.eemcs.utwente.nl/user/s1934538/clickstream/clickstream-enwiki-2022-05.tsv.gz,Atal_Bihari_Vajpayee,26136,42384,107,68627,24938
hdfs://spark-nn.eemcs.utwente.nl/user/s1934538/clickstream/clickstream-enwiki-2022-05.tsv.gz,The_Batman_(film),216936,957531,23859,1198326,683880
hdfs://spark-nn.eemcs.utwente.nl/user/s1934538/clickstream/clickstream-enwiki-2022-05.tsv.gz,Aquaman_(film),146910,380356,4914,532180,259681
hdfs://spark-nn.eemcs.utwente.nl/user/s1934538/clickstream/clickstream-enwiki-2022-05.tsv.gz,Keanu_Reeves,80810,412334,3197,496341,296899
hdfs://spark-nn.eemcs.utwente.nl/user/s1934538/clickstream/clickstream-enwiki-2022-05.tsv.gz,21_Savage,11246,47639,644,59529,21838
hdfs://spark-nn.eemcs.utwente.nl/user/s1934538/clickstream/clickstream-enwiki-2022-05.tsv.gz,"Prince_Philip,_Duke_of_Edinburgh",166003,163223,1493,330719,183912
hdfs://spark-nn.eemcs.utwente.nl/user/s1934538/clickstream/clickstream-enwiki-2022-05.tsv.gz,Tonya_Harding,14770,49651,276,64697,16795
hdfs://spark-nn.eemcs.utwente.nl/user/s1934538/clickstream/clickstream-enwiki-2022-05.tsv.gz,Wikipedia,251743,1372706,1444,1625893,677773
hdfs://spark-nn.eemcs.utwente.nl/user/s1934538/clickstream/clickstream-enwiki-2022-05.tsv.gz,List_of_Marvel_Cinematic_Universe_films,389150,969332,3572,1362054,879143
hdfs://spark-nn.eemcs.utwente.nl/user/s1934538/clickstream/clickstream-enwiki-2022-05.tsv.gz,Priyanka_Chopra,87261,226400,987,314648,117695
hdfs://spark-nn.eemcs.utwente.nl/user/s1934538/clickstream/clickstream-enwiki-2022-05.tsv.gz,Cristiano_Ronaldo,138735,931067,6426,1076228,250656
hdfs://spark-nn.eemcs.utwente.nl/user/s1934538/clickstream/clickstream-enwiki-2022-05.tsv.gz,List_of_FIFA_World_Cup_finals,4362,61871,66,66299,19326
hdfs://spark-nn.eemcs.utwente.nl/user/s1934538/clickstream/clickstream-enwiki-2022-05.tsv.gz,Barbie_(film),111472,70652,807,182931,159482
hdfs://spark-nn.eemcs.utwente.nl/user/s1934538/clickstream/clickstream-enwiki-2022-05.tsv.gz,Stranger_Things,427661,1608890,41156,2077707,2047415
hdfs://spark-nn.eemcs.utwente.nl/user/s1934538/clickstream/clickstream-enwiki-2022-05.tsv.gz,Ted_Bundy,38488,392373,6110,436971,113706
hdfs://spark-nn.eemcs.utwente.nl/user/s1934538/clickstream/clickstream-enwiki-2022-05.tsv.gz,Deaths_in_2022,1511031,2386009,17319,3914359,2362190
hdfs://spark-nn.eemcs.utwente.nl/user/s1934538/clickstream/clickstream-enwiki-2022-05.tsv.gz,Mission:_Impossible_–_Dead_Reckoning_Part_One,175140,165515,3734,344389,342232
hdfs://spark-nn.eemcs.utwente.nl/user/s1934538/clickstream/clickstream-enwiki-2022-05.tsv.gz,Chernobyl_(miniseries),21583,65845,1594,89022,92277
hdfs://spark-nn.eemcs.utwente.nl/user/s1934538/clickstream/clickstream-enwiki-2022-05.tsv.gz,Central_Park_jogger_case,11303,44404,221,55928,7736
hdfs://spark-nn.eemcs.utwente.nl/user/s1934538/clickstream/clickstream-enwiki-2022-05.tsv.gz,Ukraine,171612,657562,23457,852631,439845
hdfs://spark-nn.eemcs.utwente.nl/user/s1934538/clickstream/clickstream-enwiki-2022-05.tsv.gz,Adipurush,59984,32140,1413,93537,76202
hdfs://spark-nn.eemcs.utwente.nl/user/s1934538/clickstream/clickstream-enwiki-2022-05.tsv.gz,R._Kelly,24476,168432,2090,194998,98791
hdfs://spark-nn.eemcs.utwente.nl/user/s1934538/clickstream/clickstream-enwiki-2022-05.tsv.gz,Aaron_Carter,18739,52395,1028,72162,32033
hdfs://spark-nn.eemcs.utwente.nl/user/s1934538/clickstream/clickstream-enwiki-2022-05.tsv.gz,2.0_(film),40799,34601,91,75491,19655
hdfs://spark-nn.eemcs.utwente.nl/user/s1934538/clickstream/clickstream-enwiki-2022-05.tsv.gz,2023_Cricket_World_Cup,20405,57922,69,78396,20544
hdfs://spark-nn.eemcs.utwente.nl/user/s1934538/clickstream/clickstream-enwiki-2022-05.tsv.gz,Dune_(2021_film),127105,351682,9176,487963,344477
hdfs://spark-nn.eemcs.utwente.nl/user/s1934538/clickstream/clickstream-enwiki-2022-05.tsv.gz,Dennis_Nilsen,8704,61867,461,71032,18186
hdfs://spark-nn.eemcs.utwente.nl/user/s1934538/clickstream/clickstream-enwiki-2022-05.tsv.gz,Bird_Box_(film),21354,61598,788,83740,32532
hdfs://spark-nn.eemcs.utwente.nl/user/s1934538/clickstream/clickstream-enwiki-2022-05.tsv.gz,Matthew_Perry,41947,104393,886,147226,99784
hdfs://spark-nn.eemcs.utwente.nl/user/s1934538/clickstream/clickstream-enwiki-2022-09.tsv.gz,Aaron_Carter,17160,78718,739,96617,38390
hdfs://spark-nn.eemcs.utwente.nl/user/s1934538/clickstream/clickstream-enwiki-2022-09.tsv.gz,Afghanistan,125402,232932,4515,362849,253315
hdfs://spark-nn.eemcs.utwente.nl/user/s1934538/clickstream/clickstream-enwiki-2022-09.tsv.gz,No_Time_to_Die,103603,191707,2968,298278,178300
hdfs://spark-nn.eemcs.utwente.nl/user/s1934538/clickstream/clickstream-enwiki-2022-09.tsv.gz,Jeffrey_Dahmer,539981,23558148,91596,24189725,9913634
hdfs://spark-nn.eemcs.utwente.nl/user/s1934538/clickstream/clickstream-enwiki-2022-09.tsv.gz,Mötley_Crüe,34707,118790,1613,155110,179653
hdfs://spark-nn.eemcs.utwente.nl/user/s1934538/clickstream/clickstream-enwiki-2022-09.tsv.gz,Queen_(band),58346,334596,3049,395991,254325
hdfs://spark-nn.eemcs.utwente.nl/user/s1934538/clickstream/clickstream-enwiki-2022-09.tsv.gz,Black_Widow_(2021_film),49785,92990,1116,143891,67677
hdfs://spark-nn.eemcs.utwente.nl/user/s1934538/clickstream/clickstream-enwiki-2022-09.tsv.gz,Stan_Lee,39660,138652,944,179256,41128
hdfs://spark-nn.eemcs.utwente.nl/user/s1934538/clickstream/clickstream-enwiki-2022-09.tsv.gz,Jeffrey_Epstein,141372,281530,2066,424968,204386
hdfs://spark-nn.eemcs.utwente.nl/user/s1934538/clickstream/clickstream-enwiki-2022-09.tsv.gz,Betty_White,46888,222345,2627,271860,52380
hdfs://spark-nn.eemcs.utwente.nl/user/s1934538/clickstream/clickstream-enwiki-2022-09.tsv.gz,2018_Asian_Games,6508,5596,35,12139,12120
hdfs://spark-nn.eemcs.utwente.nl/user/s1934538/clickstream/clickstream-enwiki-2022-09.tsv.gz,Bible,17893,1782831,1513,1802237,29922
hdfs://spark-nn.eemcs.utwente.nl/user/s1934538/clickstream/clickstream-enwiki-2022-09.tsv.gz,Charles_Sobhraj,11693,58484,110,70287,12735
hdfs://spark-nn.eemcs.utwente.nl/user/s1934538/clickstream/clickstream-enwiki-2022-09.tsv.gz,Brett_Kavanaugh,13883,22461,132,36476,11326
hdfs://spark-nn.eemcs.utwente.nl/user/s1934538/clickstream/clickstream-enwiki-2022-09.tsv.gz,Stranger_Things,89517,532264,9197,630978,505104
hdfs://spark-nn.eemcs.utwente.nl/user/s1934538/clickstream/clickstream-enwiki-2022-09.tsv.gz,The_Weeknd,59854,212827,2229,274910,124241
hdfs://spark-nn.eemcs.utwente.nl/user/s1934538/clickstream/clickstream-enwiki-2022-09.tsv.gz,List_of_highest-grossing_Indian_films,123492,332680,3739,459911,265364
hdfs://spark-nn.eemcs.utwente.nl/user/s1934538/clickstream/clickstream-enwiki-2022-09.tsv.gz,Sidharth_Shukla,8066,64666,85,72817,12544
hdfs://spark-nn.eemcs.utwente.nl/user/s1934538/clickstream/clickstream-enwiki-2022-09.tsv.gz,List_of_James_Bond_films,63497,299732,1660,364889,218017
hdfs://spark-nn.eemcs.utwente.nl/user/s1934538/clickstream/clickstream-enwiki-2022-09.tsv.gz,Tom_Brady,108061,718044,6985,833090,296491
hdfs://spark-nn.eemcs.utwente.nl/user/s1934538/clickstream/clickstream-enwiki-2022-09.tsv.gz,Dark_Phoenix_(film),41353,37488,370,79211,40386
hdfs://spark-nn.eemcs.utwente.nl/user/s1934538/clickstream/clickstream-enwiki-2022-09.tsv.gz,Dune_(2021_film),67076,265160,4366,336602,229802
hdfs://spark-nn.eemcs.utwente.nl/user/s1934538/clickstream/clickstream-enwiki-2022-09.tsv.gz,The_Irishman,35411,71457,1203,108071,85938
hdfs://spark-nn.eemcs.utwente.nl/user/s1934538/clickstream/clickstream-enwiki-2022-09.tsv.gz,2020_United_States_presidential_election,114403,172659,4515,291577,272116
hdfs://spark-nn.eemcs.utwente.nl/user/s1934538/clickstream/clickstream-enwiki-2022-09.tsv.gz,Kenosha_unrest_shooting,8475,29567,72,38114,7348
hdfs://spark-nn.eemcs.utwente.nl/user/s1934538/clickstream/clickstream-enwiki-2022-09.tsv.gz,Brie_Larson,53893,158139,261,212293,79211
hdfs://spark-nn.eemcs.utwente.nl/user/s1934538/clickstream/clickstream-enwiki-2022-09.tsv.gz,NATO,75642,234009,6779,316430,142587
hdfs://spark-nn.eemcs.utwente.nl/user/s1934538/clickstream/clickstream-enwiki-2022-09.tsv.gz,Valentine's_Day,2837,35439,194,38470,2898
hdfs://spark-nn.eemcs.utwente.nl/user/s1934538/clickstream/clickstream-enwiki-2022-09.tsv.gz,COVID-19_pandemic,90174,204337,13949,308460,107710
hdfs://spark-nn.eemcs.utwente.nl/user/s1934538/clickstream/clickstream-enwiki-2022-09.tsv.gz,The_Batman_(film),70324,235096,4372,309792,159829
hdfs://spark-nn.eemcs.utwente.nl/user/s1934538/clickstream/clickstream-enwiki-2022-09.tsv.gz,House_of_the_Dragon,455387,4523163,119204,5097754,3537801
hdfs://spark-nn.eemcs.utwente.nl/user/s1934538/clickstream/clickstream-enwiki-2022-09.tsv.gz,Indian_Premier_League,16063,65636,233,81932,55205
hdfs://spark-nn.eemcs.utwente.nl/user/s1934538/clickstream/clickstream-enwiki-2022-09.tsv.gz,Vladimir_Putin,158188,572251,8282,738721,380147
hdfs://spark-nn.eemcs.utwente.nl/user/s1934538/clickstream/clickstream-enwiki-2022-09.tsv.gz,It_Chapter_Two,28728,51374,414,80516,47604
hdfs://spark-nn.eemcs.utwente.nl/user/s1934538/clickstream/clickstream-enwiki-2022-09.tsv.gz,The_Umbrella_Academy_(TV_series),30911,168945,3390,203246,132121
hdfs://spark-nn.eemcs.utwente.nl/user/s1934538/clickstream/clickstream-enwiki-2022-09.tsv.gz,WandaVision,54236,77748,1257,133241,51296
hdfs://spark-nn.eemcs.utwente.nl/user/s1934538/clickstream/clickstream-enwiki-2022-09.tsv.gz,Greta_Thunberg,9922,122425,952,133299,26864
hdfs://spark-nn.eemcs.utwente.nl/user/s1934538/clickstream/clickstream-enwiki-2022-09.tsv.gz,Cecil_Hotel_(Los_Angeles),7790,66963,145,74898,17440
hdfs://spark-nn.eemcs.utwente.nl/user/s1934538/clickstream/clickstream-enwiki-2022-09.tsv.gz,2018_Winter_Olympics,6970,6008,66,13044,8977
hdfs://spark-nn.eemcs.utwente.nl/user/s1934538/clickstream/clickstream-enwiki-2022-09.tsv.gz,2020_Summer_Olympics,44987,43632,1155,89774,76829
hdfs://spark-nn.eemcs.utwente.nl/user/s1934538/clickstream/clickstream-enwiki-2022-09.tsv.gz,David_Beckham,43814,318327,2406,364547,140664
hdfs://spark-nn.eemcs.utwente.nl/user/s1934538/clickstream/clickstream-enwiki-2022-09.tsv.gz,Black_Adam_(film),115062,364349,6910,486321,331783
hdfs://spark-nn.eemcs.utwente.nl/user/s1934538/clickstream/clickstream-enwiki-2022-09.tsv.gz,Spider-Man:_No_Way_Home,119198,388601,10228,518027,208794
hdfs://spark-nn.eemcs.utwente.nl/user/s1934538/clickstream/clickstream-enwiki-2022-09.tsv.gz,Everything_Everywhere_All_at_Once,66582,450856,6471,523909,260002
hdfs://spark-nn.eemcs.utwente.nl/user/s1934538/clickstream/clickstream-enwiki-2022-09.tsv.gz,Lists_of_deaths_by_year,2766,151277,984,155027,175053
hdfs://spark-nn.eemcs.utwente.nl/user/s1934538/clickstream/clickstream-enwiki-2022-09.tsv.gz,Emma_Raducanu,33536,152087,1984,187607,37189
hdfs://spark-nn.eemcs.utwente.nl/user/s1934538/clickstream/clickstream-enwiki-2022-09.tsv.gz,Rishi_Sunak,94557,364659,2411,461627,218246
hdfs://spark-nn.eemcs.utwente.nl/user/s1934538/clickstream/clickstream-enwiki-2022-09.tsv.gz,Eternals_(film),73750,143238,1914,218902,157284
hdfs://spark-nn.eemcs.utwente.nl/user/s1934538/clickstream/clickstream-enwiki-2022-09.tsv.gz,Volodymyr_Zelenskyy,125537,245547,2926,374010,201622
hdfs://spark-nn.eemcs.utwente.nl/user/s1934538/clickstream/clickstream-enwiki-2022-09.tsv.gz,Game_of_Thrones_(season_8),39250,88444,1093,128787,50435
hdfs://spark-nn.eemcs.utwente.nl/user/s1934538/clickstream/clickstream-enwiki-2022-09.tsv.gz,Amy_Coney_Barrett,16556,22440,162,39158,11580
hdfs://spark-nn.eemcs.utwente.nl/user/s1934538/clickstream/clickstream-enwiki-2022-09.tsv.gz,Gadar_2,31057,83910,63,115030,56247
hdfs://spark-nn.eemcs.utwente.nl/user/s1934538/clickstream/clickstream-enwiki-2022-09.tsv.gz,List_of_Marvel_Cinematic_Universe_films,226896,563972,5137,796005,493075
hdfs://spark-nn.eemcs.utwente.nl/user/s1934538/clickstream/clickstream-enwiki-2022-09.tsv.gz,"Prince_Philip,_Duke_of_Edinburgh",2744343,3231189,30123,6005655,3287593
hdfs://spark-nn.eemcs.utwente.nl/user/s1934538/clickstream/clickstream-enwiki-2022-09.tsv.gz,Spanish_flu,17133,57689,1283,76105,21102
hdfs://spark-nn.eemcs.utwente.nl/user/s1934538/clickstream/clickstream-enwiki-2022-09.tsv.gz,Spider-Man:_Across_the_Spider-Verse,54776,51783,388,106947,45612
hdfs://spark-nn.eemcs.utwente.nl/user/s1934538/clickstream/clickstream-enwiki-2022-09.tsv.gz,Irrfan_Khan,26737,47996,51,74784,30843
hdfs://spark-nn.eemcs.utwente.nl/user/s1934538/clickstream/clickstream-enwiki-2022-09.tsv.gz,Captain_Marvel_(film),26588,68148,893,95629,43583
hdfs://spark-nn.eemcs.utwente.nl/user/s1934538/clickstream/clickstream-enwiki-2022-09.tsv.gz,Stranger_Things_(season_4),58644,248070,3674,310388,169890
hdfs://spark-nn.eemcs.utwente.nl/user/s1934538/clickstream/clickstream-enwiki-2022-09.tsv.gz,George_VI,5359122,2706093,15867,8081082,6175711
hdfs://spark-nn.eemcs.utwente.nl/user/s1934538/clickstream/clickstream-enwiki-2022-09.tsv.gz,FIFA_World_Cup,64139,390911,4754,459804,358154
hdfs://spark-nn.eemcs.utwente.nl/user/s1934538/clickstream/clickstream-enwiki-2022-09.tsv.gz,Leave_the_World_Behind_(film),11372,2477,10,13859,5612
hdfs://spark-nn.eemcs.utwente.nl/user/s1934538/clickstream/clickstream-enwiki-2022-09.tsv.gz,Spider-Man:_Far_From_Home,38720,51562,375,90657,34842
hdfs://spark-nn.eemcs.utwente.nl/user/s1934538/clickstream/clickstream-enwiki-2022-09.tsv.gz,Media,38,2202,255,2495,1153
hdfs://spark-nn.eemcs.utwente.nl/user/s1934538/clickstream/clickstream-enwiki-2022-09.tsv.gz,Deadpool_2,103824,85348,4129,193301,107697
hdfs://spark-nn.eemcs.utwente.nl/user/s1934538/clickstream/clickstream-enwiki-2022-09.tsv.gz,Chernobyl_(miniseries),19907,66080,1529,87516,89759
hdfs://spark-nn.eemcs.utwente.nl/user/s1934538/clickstream/clickstream-enwiki-2022-09.tsv.gz,Ukraine,150800,603257,17042,771099,383694
hdfs://spark-nn.eemcs.utwente.nl/user/s1934538/clickstream/clickstream-enwiki-2022-09.tsv.gz,Star_Wars:_The_Rise_of_Skywalker,56193,51304,973,108470,53873
hdfs://spark-nn.eemcs.utwente.nl/user/s1934538/clickstream/clickstream-enwiki-2022-09.tsv.gz,William_Murdoch,649,1015,13,1677,342
hdfs://spark-nn.eemcs.utwente.nl/user/s1934538/clickstream/clickstream-enwiki-2022-09.tsv.gz,Oppenheimer_(film),126810,116415,1444,244669,190822
hdfs://spark-nn.eemcs.utwente.nl/user/s1934538/clickstream/clickstream-enwiki-2022-09.tsv.gz,Deaths_in_2022,1366535,2360469,16671,3743675,2164688
hdfs://spark-nn.eemcs.utwente.nl/user/s1934538/clickstream/clickstream-enwiki-2022-09.tsv.gz,Michael_Bloomberg,24433,30231,142,54806,24705
hdfs://spark-nn.eemcs.utwente.nl/user/s1934538/clickstream/clickstream-enwiki-2022-09.tsv.gz,IPv4,10287,39052,144,49483,9214
hdfs://spark-nn.eemcs.utwente.nl/user/s1934538/clickstream/clickstream-enwiki-2022-09.tsv.gz,The_Suicide_Squad_(film),54637,63035,759,118431,65187
hdfs://spark-nn.eemcs.utwente.nl/user/s1934538/clickstream/clickstream-enwiki-2022-09.tsv.gz,Vivek_Ramaswamy,740,53023,273,54036,7603
hdfs://spark-nn.eemcs.utwente.nl/user/s1934538/clickstream/clickstream-enwiki-2022-09.tsv.gz,Atal_Bihari_Vajpayee,27949,53870,35,81854,24627
hdfs://spark-nn.eemcs.utwente.nl/user/s1934538/clickstream/clickstream-enwiki-2022-09.tsv.gz,Amber_Heard,55347,176759,1275,233381,88991
hdfs://spark-nn.eemcs.utwente.nl/user/s1934538/clickstream/clickstream-enwiki-2022-09.tsv.gz,Hamas,20415,23639,227,44281,20463
hdfs://spark-nn.eemcs.utwente.nl/user/s1934538/clickstream/clickstream-enwiki-2022-09.tsv.gz,Royal_Rumble_(2018),6105,3525,53,9683,7392
hdfs://spark-nn.eemcs.utwente.nl/user/s1934538/clickstream/clickstream-enwiki-2022-09.tsv.gz,WrestleMania_34,11820,6309,62,18191,12157
hdfs://spark-nn.eemcs.utwente.nl/user/s1934538/clickstream/clickstream-enwiki-2022-09.tsv.gz,Khabib_Nurmagomedov,69814,261362,2160,333336,177353
hdfs://spark-nn.eemcs.utwente.nl/user/s1934538/clickstream/clickstream-enwiki-2022-09.tsv.gz,XHamster,5292,227579,4933,237804,25369
hdfs://spark-nn.eemcs.utwente.nl/user/s1934538/clickstream/clickstream-enwiki-2022-09.tsv.gz,The_Mandalorian,52966,134288,3624,190878,126600
hdfs://spark-nn.eemcs.utwente.nl/user/s1934538/clickstream/clickstream-enwiki-2022-09.tsv.gz,The_Sandman_(TV_series),84512,759137,12286,855935,594086
hdfs://spark-nn.eemcs.utwente.nl/user/s1934538/clickstream/clickstream-enwiki-2022-09.tsv.gz,Kate_Spade,21706,62981,323,85010,30359
hdfs://spark-nn.eemcs.utwente.nl/user/s1934538/clickstream/clickstream-enwiki-2022-09.tsv.gz,Article_370_of_the_Constitution_of_India,2393,51262,48,53703,2792
hdfs://spark-nn.eemcs.utwente.nl/user/s1934538/clickstream/clickstream-enwiki-2022-09.tsv.gz,1917_(2019_film),22788,83506,1456,107750,53851
hdfs://spark-nn.eemcs.utwente.nl/user/s1934538/clickstream/clickstream-enwiki-2022-09.tsv.gz,Kelly_Preston,76895,92547,292,169734,48253
hdfs://spark-nn.eemcs.utwente.nl/user/s1934538/clickstream/clickstream-enwiki-2022-09.tsv.gz,John_McCain,29218,54652,660,84530,39975
hdfs://spark-nn.eemcs.utwente.nl/user/s1934538/clickstream/clickstream-enwiki-2022-09.tsv.gz,Avicii,17149,197193,1393,215735,58855
hdfs://spark-nn.eemcs.utwente.nl/user/s1934538/clickstream/clickstream-enwiki-2022-09.tsv.gz,Jimmy_Hoffa,24814,86343,690,111847,42719
hdfs://spark-nn.eemcs.utwente.nl/user/s1934538/clickstream/clickstream-enwiki-2022-09.tsv.gz,Avengers:_Endgame,172177,151983,4321,328481,127877
hdfs://spark-nn.eemcs.utwente.nl/user/s1934538/clickstream/clickstream-enwiki-2022-09.tsv.gz,The_Haunting_of_Bly_Manor,26116,61952,363,88431,42374
hdfs://spark-nn.eemcs.utwente.nl/user/s1934538/clickstream/clickstream-enwiki-2022-09.tsv.gz,COVID-19_pandemic_by_country_and_territory,13325,38597,1405,53327,25268
hdfs://spark-nn.eemcs.utwente.nl/user/s1934538/clickstream/clickstream-enwiki-2022-09.tsv.gz,Kamala_Harris,67583,135029,1271,203883,88376
hdfs://spark-nn.eemcs.utwente.nl/user/s1934538/clickstream/clickstream-enwiki-2022-09.tsv.gz,Mortal_Kombat_(2021_film),17700,65396,708,83804,67838
hdfs://spark-nn.eemcs.utwente.nl/user/s1934538/clickstream/clickstream-enwiki-2022-09.tsv.gz,Tina_Turner,19394,170663,1465,191522,56260
hdfs://spark-nn.eemcs.utwente.nl/user/s1934538/clickstream/clickstream-enwiki-2022-09.tsv.gz,Bipin_Rawat,15362,36609,20,51991,19752
hdfs://spark-nn.eemcs.utwente.nl/user/s1934538/clickstream/clickstream-enwiki-2022-09.tsv.gz,21_Savage,10188,57321,501,68010,24332
hdfs://spark-nn.eemcs.utwente.nl/user/s1934538/clickstream/clickstream-enwiki-2022-09.tsv.gz,"Citizenship_(Amendment)_Act,_2019",2490,17281,14,19785,2075
hdfs://spark-nn.eemcs.utwente.nl/user/s1934538/clickstream/clickstream-enwiki-2022-09.tsv.gz,War_(2019_film),31744,49111,55,80910,19458
hdfs://spark-nn.eemcs.utwente.nl/user/s1934538/clickstream/clickstream-enwiki-2022-09.tsv.gz,The_Lion_King_(2019_film),67101,63444,1144,131689,61107
hdfs://spark-nn.eemcs.utwente.nl/user/s1934538/clickstream/clickstream-enwiki-2022-09.tsv.gz,Michael_Jordan,62702,396173,3606,462481,144579
hdfs://spark-nn.eemcs.utwente.nl/user/s1934538/clickstream/clickstream-enwiki-2022-09.tsv.gz,Carlos_Alcaraz,123795,908949,4587,1037331,268793
hdfs://spark-nn.eemcs.utwente.nl/user/s1934538/clickstream/clickstream-enwiki-2022-09.tsv.gz,Kobe_Bryant_sexual_assault_case,6779,32689,33,39501,3082
hdfs://spark-nn.eemcs.utwente.nl/user/s1934538/clickstream/clickstream-enwiki-2022-09.tsv.gz,Avengers:_Infinity_War,38985,69459,859,109303,53936
hdfs://spark-nn.eemcs.utwente.nl/user/s1934538/clickstream/clickstream-enwiki-2022-09.tsv.gz,Cook's_Country,360,1803,16,2179,534
hdfs://spark-nn.eemcs.utwente.nl/user/s1934538/clickstream/clickstream-enwiki-2022-09.tsv.gz,John_Wick:_Chapter_4,54992,73993,775,129760,70506
hdfs://spark-nn.eemcs.utwente.nl/user/s1934538/clickstream/clickstream-enwiki-2022-09.tsv.gz,Glass_(2019_film),35229,58341,394,93964,30148
hdfs://spark-nn.eemcs.utwente.nl/user/s1934538/clickstream/clickstream-enwiki-2022-09.tsv.gz,Us_(2019_film),48269,110678,452,159399,47588
hdfs://spark-nn.eemcs.utwente.nl/user/s1934538/clickstream/clickstream-enwiki-2022-09.tsv.gz,Simone_Biles,11438,47561,340,59339,18717
hdfs://spark-nn.eemcs.utwente.nl/user/s1934538/clickstream/clickstream-enwiki-2022-09.tsv.gz,Olivia_Newton-John,33731,239425,2929,276085,106054
hdfs://spark-nn.eemcs.utwente.nl/user/s1934538/clickstream/clickstream-enwiki-2022-09.tsv.gz,Elon_Musk,90611,850612,11613,952836,432572
hdfs://spark-nn.eemcs.utwente.nl/user/s1934538/clickstream/clickstream-enwiki-2022-09.tsv.gz,Microsoft_Office,6955,803000,553,810508,17937
hdfs://spark-nn.eemcs.utwente.nl/user/s1934538/clickstream/clickstream-enwiki-2022-09.tsv.gz,Christopher_Scarver,3864674,1340851,419,5205944,1224273
hdfs://spark-nn.eemcs.utwente.nl/user/s1934538/clickstream/clickstream-enwiki-2022-09.tsv.gz,Murder_of_Dee_Dee_Blanchard,17501,123214,371,141086,30774
hdfs://spark-nn.eemcs.utwente.nl/user/s1934538/clickstream/clickstream-enwiki-2022-09.tsv.gz,Squid_Game,40508,243620,4519,288647,126021
hdfs://spark-nn.eemcs.utwente.nl/user/s1934538/clickstream/clickstream-enwiki-2022-09.tsv.gz,Juice_Wrld,32084,190081,2321,224486,83585
hdfs://spark-nn.eemcs.utwente.nl/user/s1934538/clickstream/clickstream-enwiki-2022-09.tsv.gz,Chadwick_Boseman,44734,167428,975,213137,55913
hdfs://spark-nn.eemcs.utwente.nl/user/s1934538/clickstream/clickstream-enwiki-2022-09.tsv.gz,Joe_Exotic,12171,48679,199,61049,26024
hdfs://spark-nn.eemcs.utwente.nl/user/s1934538/clickstream/clickstream-enwiki-2022-09.tsv.gz,YouTube,116964,3247094,8651,3372709,108830
hdfs://spark-nn.eemcs.utwente.nl/user/s1934538/clickstream/clickstream-enwiki-2022-09.tsv.gz,Saaho,33060,43717,113,76890,19470
hdfs://spark-nn.eemcs.utwente.nl/user/s1934538/clickstream/clickstream-enwiki-2022-09.tsv.gz,Wonder_Woman_1984,28365,43575,765,72705,33584
hdfs://spark-nn.eemcs.utwente.nl/user/s1934538/clickstream/clickstream-enwiki-2022-09.tsv.gz,Naya_Rivera,47426,64684,196,112306,46114
hdfs://spark-nn.eemcs.utwente.nl/user/s1934538/clickstream/clickstream-enwiki-2022-09.tsv.gz,QAnon,41530,426460,2318,470308,100252
hdfs://spark-nn.eemcs.utwente.nl/user/s1934538/clickstream/clickstream-enwiki-2022-09.tsv.gz,Kylian_Mbappé,45458,351695,2461,399614,78517
hdfs://spark-nn.eemcs.utwente.nl/user/s1934538/clickstream/clickstream-enwiki-2022-09.tsv.gz,List_of_FIFA_World_Cup_finals,3782,109752,83,113617,27171
hdfs://spark-nn.eemcs.utwente.nl/user/s1934538/clickstream/clickstream-enwiki-2022-09.tsv.gz,Alexander_Hamilton,61114,181588,1514,244216,127118
hdfs://spark-nn.eemcs.utwente.nl/user/s1934538/clickstream/clickstream-enwiki-2022-09.tsv.gz,Mission:_Impossible_–_Dead_Reckoning_Part_One,64645,38812,501,103958,83304
hdfs://spark-nn.eemcs.utwente.nl/user/s1934538/clickstream/clickstream-enwiki-2022-09.tsv.gz,Joker_(2019_film),53856,138351,1805,194012,84305
hdfs://spark-nn.eemcs.utwente.nl/user/s1934538/clickstream/clickstream-enwiki-2022-09.tsv.gz,Crazy_Rich_Asians_(film),27412,56066,643,84121,65311
hdfs://spark-nn.eemcs.utwente.nl/user/s1934538/clickstream/clickstream-enwiki-2022-09.tsv.gz,Ponniyin_Selvan:_I,163460,1938146,6883,2108489,1409020
hdfs://spark-nn.eemcs.utwente.nl/user/s1934538/clickstream/clickstream-enwiki-2022-09.tsv.gz,George_H._W._Bush,150105,103499,1149,254753,153613
hdfs://spark-nn.eemcs.utwente.nl/user/s1934538/clickstream/clickstream-enwiki-2022-09.tsv.gz,R._Kelly,28471,232582,2660,263713,144415
hdfs://spark-nn.eemcs.utwente.nl/user/s1934538/clickstream/clickstream-enwiki-2022-09.tsv.gz,Lance_Reddick,25978,29505,129,55612,11790
hdfs://spark-nn.eemcs.utwente.nl/user/s1934538/clickstream/clickstream-enwiki-2022-09.tsv.gz,Tenet_(film),44752,141132,1635,187519,90784
hdfs://spark-nn.eemcs.utwente.nl/user/s1934538/clickstream/clickstream-enwiki-2022-09.tsv.gz,The_Queen's_Gambit_(miniseries),21210,98643,938,120791,55086
hdfs://spark-nn.eemcs.utwente.nl/user/s1934538/clickstream/clickstream-enwiki-2022-09.tsv.gz,XXX:_Return_of_Xander_Cage,50412,598654,1165,650231,51146
hdfs://spark-nn.eemcs.utwente.nl/user/s1934538/clickstream/clickstream-enwiki-2022-09.tsv.gz,Aquaman_(film),18007,54466,615,73088,32870
hdfs://spark-nn.eemcs.utwente.nl/user/s1934538/clickstream/clickstream-enwiki-2022-09.tsv.gz,Anne_Heche,52423,393226,3222,448871,152146
hdfs://spark-nn.eemcs.utwente.nl/user/s1934538/clickstream/clickstream-enwiki-2022-09.tsv.gz,Elliot_Page,53382,232124,1002,286508,103995
hdfs://spark-nn.eemcs.utwente.nl/user/s1934538/clickstream/clickstream-enwiki-2022-09.tsv.gz,Pornhub,42718,384354,12003,439075,75045
hdfs://spark-nn.eemcs.utwente.nl/user/s1934538/clickstream/clickstream-enwiki-2022-09.tsv.gz,Richard_Jewell,8687,31638,143,40468,14908
hdfs://spark-nn.eemcs.utwente.nl/user/s1934538/clickstream/clickstream-enwiki-2022-09.tsv.gz,The_Witcher_(TV_series),25716,168989,3655,198360,104464
hdfs://spark-nn.eemcs.utwente.nl/user/s1934538/clickstream/clickstream-enwiki-2022-09.tsv.gz,2023_Cricket_World_Cup,39098,174812,163,214073,46622
hdfs://spark-nn.eemcs.utwente.nl/user/s1934538/clickstream/clickstream-enwiki-2022-09.tsv.gz,The_Last_of_Us_(TV_series),63865,143811,2497,210173,197355
hdfs://spark-nn.eemcs.utwente.nl/user/s1934538/clickstream/clickstream-enwiki-2022-09.tsv.gz,Joaquin_Phoenix,100170,138039,715,238924,141149
hdfs://spark-nn.eemcs.utwente.nl/user/s1934538/clickstream/clickstream-enwiki-2022-09.tsv.gz,The_Kashmir_Files,37685,82771,582,121038,45562
hdfs://spark-nn.eemcs.utwente.nl/user/s1934538/clickstream/clickstream-enwiki-2022-09.tsv.gz,Chernobyl_disaster,43335,286619,2732,332686,138582
hdfs://spark-nn.eemcs.utwente.nl/user/s1934538/clickstream/clickstream-enwiki-2022-09.tsv.gz,Cricket_World_Cup,16004,145689,445,162138,102160
hdfs://spark-nn.eemcs.utwente.nl/user/s1934538/clickstream/clickstream-enwiki-2022-09.tsv.gz,Thor:_Love_and_Thunder,198856,1724675,32608,1956139,1197389
hdfs://spark-nn.eemcs.utwente.nl/user/s1934538/clickstream/clickstream-enwiki-2022-09.tsv.gz,Google_logo,756,23943,11,24710,1488
hdfs://spark-nn.eemcs.utwente.nl/user/s1934538/clickstream/clickstream-enwiki-2022-09.tsv.gz,State_of_Palestine,44461,102994,117,147572,66954
hdfs://spark-nn.eemcs.utwente.nl/user/s1934538/clickstream/clickstream-enwiki-2022-09.tsv.gz,XXXTentacion,77976,819105,5777,902858,105754
hdfs://spark-nn.eemcs.utwente.nl/user/s1934538/clickstream/clickstream-enwiki-2022-09.tsv.gz,Anthony_Bourdain,28469,278468,2147,309084,108751
hdfs://spark-nn.eemcs.utwente.nl/user/s1934538/clickstream/clickstream-enwiki-2022-09.tsv.gz,Roe_v._Wade,16104,156337,982,173423,49247
hdfs://spark-nn.eemcs.utwente.nl/user/s1934538/clickstream/clickstream-enwiki-2022-09.tsv.gz,Cristiano_Ronaldo,116762,946788,4609,1068159,198188
hdfs://spark-nn.eemcs.utwente.nl/user/s1934538/clickstream/clickstream-enwiki-2022-09.tsv.gz,Israel,80757,232064,4478,317299,159670
hdfs://spark-nn.eemcs.utwente.nl/user/s1934538/clickstream/clickstream-enwiki-2022-09.tsv.gz,Shinzo_Abe,58213,205673,3168,267054,147553
hdfs://spark-nn.eemcs.utwente.nl/user/s1934538/clickstream/clickstream-enwiki-2022-09.tsv.gz,Fyre_Festival,8874,55760,431,65065,34690
hdfs://spark-nn.eemcs.utwente.nl/user/s1934538/clickstream/clickstream-enwiki-2022-09.tsv.gz,"Princess_Margaret,_Countess_of_Snowdon",1732352,3268856,15325,5016533,2943566
hdfs://spark-nn.eemcs.utwente.nl/user/s1934538/clickstream/clickstream-enwiki-2022-09.tsv.gz,XNXX,18199,1611054,7957,1637210,134740
hdfs://spark-nn.eemcs.utwente.nl/user/s1934538/clickstream/clickstream-enwiki-2022-09.tsv.gz,Sylvester_Stallone,106655,432300,3652,542607,348417
hdfs://spark-nn.eemcs.utwente.nl/user/s1934538/clickstream/clickstream-enwiki-2022-09.tsv.gz,Donald_Trump,199505,461082,7613,668200,378299
hdfs://spark-nn.eemcs.utwente.nl/user/s1934538/clickstream/clickstream-enwiki-2022-09.tsv.gz,Dennis_Nilsen,20239,127712,718,148669,32563
hdfs://spark-nn.eemcs.utwente.nl/user/s1934538/clickstream/clickstream-enwiki-2022-09.tsv.gz,HTTP_cookie,2539,389237,71,391847,23045
hdfs://spark-nn.eemcs.utwente.nl/user/s1934538/clickstream/clickstream-enwiki-2022-09.tsv.gz,K.G.F:_Chapter_2,70653,405239,1505,477397,125064
hdfs://spark-nn.eemcs.utwente.nl/user/s1934538/clickstream/clickstream-enwiki-2022-09.tsv.gz,The_Shape_of_Water,23786,46232,452,70470,30880
hdfs://spark-nn.eemcs.utwente.nl/user/s1934538/clickstream/clickstream-enwiki-2022-09.tsv.gz,Barbie_(film),69598,46949,588,117135,79957
hdfs://spark-nn.eemcs.utwente.nl/user/s1934538/clickstream/clickstream-enwiki-2022-09.tsv.gz,Anna_Sorokin,28996,217835,815,247646,98489
hdfs://spark-nn.eemcs.utwente.nl/user/s1934538/clickstream/clickstream-enwiki-2022-10.tsv.gz,Deadpool_2,125442,84235,2404,212081,127668
hdfs://spark-nn.eemcs.utwente.nl/user/s1934538/clickstream/clickstream-enwiki-2022-10.tsv.gz,Article_370_of_the_Constitution_of_India,2201,45049,17,47267,2516
hdfs://spark-nn.eemcs.utwente.nl/user/s1934538/clickstream/clickstream-enwiki-2022-10.tsv.gz,Stan_Lee,38692,143670,647,183009,44313
hdfs://spark-nn.eemcs.utwente.nl/user/s1934538/clickstream/clickstream-enwiki-2022-10.tsv.gz,Israel,93572,263816,5512,362900,191063
hdfs://spark-nn.eemcs.utwente.nl/user/s1934538/clickstream/clickstream-enwiki-2022-10.tsv.gz,Aretha_Franklin,24556,136475,1022,162053,73379
hdfs://spark-nn.eemcs.utwente.nl/user/s1934538/clickstream/clickstream-enwiki-2022-10.tsv.gz,Key_frame,602,3514,16,4132,318
hdfs://spark-nn.eemcs.utwente.nl/user/s1934538/clickstream/clickstream-enwiki-2022-10.tsv.gz,Rihanna,75810,340318,5376,421504,245042
hdfs://spark-nn.eemcs.utwente.nl/user/s1934538/clickstream/clickstream-enwiki-2022-10.tsv.gz,Area_51,14969,116759,952,132680,41135
hdfs://spark-nn.eemcs.utwente.nl/user/s1934538/clickstream/clickstream-enwiki-2022-10.tsv.gz,Kelly_Preston,80243,112362,510,193115,54890
hdfs://spark-nn.eemcs.utwente.nl/user/s1934538/clickstream/clickstream-enwiki-2022-10.tsv.gz,Laal_Singh_Chaddha,50030,801973,3321,855324,307534
hdfs://spark-nn.eemcs.utwente.nl/user/s1934538/clickstream/clickstream-enwiki-2022-10.tsv.gz,When_They_See_Us,12467,21799,146,34412,14162
hdfs://spark-nn.eemcs.utwente.nl/user/s1934538/clickstream/clickstream-enwiki-2022-10.tsv.gz,Brahmāstra:_Part_One_–_Shiva,122167,998001,7722,1127890,227541
hdfs://spark-nn.eemcs.utwente.nl/user/s1934538/clickstream/clickstream-enwiki-2022-10.tsv.gz,Dune_(2021_film),57391,182281,3771,243443,159065
hdfs://spark-nn.eemcs.utwente.nl/user/s1934538/clickstream/clickstream-enwiki-2022-10.tsv.gz,Captain_Marvel_(film),23353,57207,737,81297,34004
hdfs://spark-nn.eemcs.utwente.nl/user/s1934538/clickstream/clickstream-enwiki-2022-10.tsv.gz,Luke_Perry,32775,147295,844,180914,69370
hdfs://spark-nn.eemcs.utwente.nl/user/s1934538/clickstream/clickstream-enwiki-2022-10.tsv.gz,ICC_Men's_T20_World_Cup,44427,3278485,6423,3329335,474964
hdfs://spark-nn.eemcs.utwente.nl/user/s1934538/clickstream/clickstream-enwiki-2022-10.tsv.gz,Main_Page,78785,152730328,5265540,158074653,34152295
hdfs://spark-nn.eemcs.utwente.nl/user/s1934538/clickstream/clickstream-enwiki-2022-10.tsv.gz,Sinéad_O'Connor,21809,242572,2005,266386,86410
hdfs://spark-nn.eemcs.utwente.nl/user/s1934538/clickstream/clickstream-enwiki-2022-10.tsv.gz,Brett_Kavanaugh,16829,27199,929,44957,13480
hdfs://spark-nn.eemcs.utwente.nl/user/s1934538/clickstream/clickstream-enwiki-2022-10.tsv.gz,Jeffrey_Epstein,45334,206733,2156,254223,109253
hdfs://spark-nn.eemcs.utwente.nl/user/s1934538/clickstream/clickstream-enwiki-2022-10.tsv.gz,Sridevi,33141,80118,177,113436,51130
hdfs://spark-nn.eemcs.utwente.nl/user/s1934538/clickstream/clickstream-enwiki-2022-10.tsv.gz,Avatar:_The_Way_of_Water,108701,370264,7877,486842,206437
hdfs://spark-nn.eemcs.utwente.nl/user/s1934538/clickstream/clickstream-enwiki-2022-10.tsv.gz,Spanish_flu,21400,57717,525,79642,22201
hdfs://spark-nn.eemcs.utwente.nl/user/s1934538/clickstream/clickstream-enwiki-2022-10.tsv.gz,Black_Panther:_Wakanda_Forever,270810,744950,20787,1036547,766424
hdfs://spark-nn.eemcs.utwente.nl/user/s1934538/clickstream/clickstream-enwiki-2022-10.tsv.gz,List_of_awards_and_nominations_received_by_Meryl_Streep,5781,7701,29,13511,5525
hdfs://spark-nn.eemcs.utwente.nl/user/s1934538/clickstream/clickstream-enwiki-2022-10.tsv.gz,Doctor_Strange_in_the_Multiverse_of_Madness,79915,175974,4064,259953,135060
hdfs://spark-nn.eemcs.utwente.nl/user/s1934538/clickstream/clickstream-enwiki-2022-10.tsv.gz,Afghanistan,120535,208173,4834,333542,237772
hdfs://spark-nn.eemcs.utwente.nl/user/s1934538/clickstream/clickstream-enwiki-2022-10.tsv.gz,Once_Upon_a_Time_in_Hollywood,90035,135146,2580,227761,234327
hdfs://spark-nn.eemcs.utwente.nl/user/s1934538/clickstream/clickstream-enwiki-2022-10.tsv.gz,Eddie_Van_Halen,53905,127969,1333,183207,72711
hdfs://spark-nn.eemcs.utwente.nl/user/s1934538/clickstream/clickstream-enwiki-2022-10.tsv.gz,XXX:_Return_of_Xander_Cage,74986,2633268,1443,2709697,224532
hdfs://spark-nn.eemcs.utwente.nl/user/s1934538/clickstream/clickstream-enwiki-2022-10.tsv.gz,Bipin_Rawat,10523,26150,117,36790,12896
hdfs://spark-nn.eemcs.utwente.nl/user/s1934538/clickstream/clickstream-enwiki-2022-10.tsv.gz,Media,35,2102,224,2361,1046
hdfs://spark-nn.eemcs.utwente.nl/user/s1934538/clickstream/clickstream-enwiki-2022-10.tsv.gz,Ruth_Bader_Ginsburg,15837,69674,551,86062,26529
hdfs://spark-nn.eemcs.utwente.nl/user/s1934538/clickstream/clickstream-enwiki-2022-10.tsv.gz,Richard_Ramirez,33423,566884,4887,605194,160634
hdfs://spark-nn.eemcs.utwente.nl/user/s1934538/clickstream/clickstream-enwiki-2022-10.tsv.gz,Irrfan_Khan,24712,46205,68,70985,29871
hdfs://spark-nn.eemcs.utwente.nl/user/s1934538/clickstream/clickstream-enwiki-2022-10.tsv.gz,Adipurush,96300,773610,11264,881174,679452
hdfs://spark-nn.eemcs.utwente.nl/user/s1934538/clickstream/clickstream-enwiki-2022-10.tsv.gz,Barbie_(film),71265,31888,620,103773,71279
hdfs://spark-nn.eemcs.utwente.nl/user/s1934538/clickstream/clickstream-enwiki-2022-10.tsv.gz,Ghislaine_Maxwell,39724,123790,664,164178,65180
hdfs://spark-nn.eemcs.utwente.nl/user/s1934538/clickstream/clickstream-enwiki-2022-10.tsv.gz,Kate_Spade,21738,51237,247,73222,25257
hdfs://spark-nn.eemcs.utwente.nl/user/s1934538/clickstream/clickstream-enwiki-2022-10.tsv.gz,Stranger_Things,68516,360836,7104,436456,332157
hdfs://spark-nn.eemcs.utwente.nl/user/s1934538/clickstream/clickstream-enwiki-2022-10.tsv.gz,Squid_Game,24280,180122,3112,207514,84486
hdfs://spark-nn.eemcs.utwente.nl/user/s1934538/clickstream/clickstream-enwiki-2022-10.tsv.gz,September_11_attacks,99147,249477,1326,349950,210298
hdfs://spark-nn.eemcs.utwente.nl/user/s1934538/clickstream/clickstream-enwiki-2022-10.tsv.gz,Sushma_Swaraj,9164,14194,25,23383,6828
hdfs://spark-nn.eemcs.utwente.nl/user/s1934538/clickstream/clickstream-enwiki-2022-10.tsv.gz,Stephen_Hawking,29661,348416,1925,380002,130808
hdfs://spark-nn.eemcs.utwente.nl/user/s1934538/clickstream/clickstream-enwiki-2022-10.tsv.gz,Jason_Momoa,68342,280509,1458,350309,180201
hdfs://spark-nn.eemcs.utwente.nl/user/s1934538/clickstream/clickstream-enwiki-2022-10.tsv.gz,Kenosha_unrest_shooting,9948,32649,128,42725,9749
hdfs://spark-nn.eemcs.utwente.nl/user/s1934538/clickstream/clickstream-enwiki-2022-10.tsv.gz,Cardi_B,40450,215951,2996,259397,77920
hdfs://spark-nn.eemcs.utwente.nl/user/s1934538/clickstream/clickstream-enwiki-2022-10.tsv.gz,Brie_Larson,51710,102241,8004,161955,63451
hdfs://spark-nn.eemcs.utwente.nl/user/s1934538/clickstream/clickstream-enwiki-2022-10.tsv.gz,Qasem_Soleimani,19373,45516,206,65095,35522
hdfs://spark-nn.eemcs.utwente.nl/user/s1934538/clickstream/clickstream-enwiki-2022-10.tsv.gz,Charles_III,832228,636101,11321,1479650,1014981
hdfs://spark-nn.eemcs.utwente.nl/user/s1934538/clickstream/clickstream-enwiki-2022-10.tsv.gz,Meat_Loaf,31110,142277,1374,174761,58293
hdfs://spark-nn.eemcs.utwente.nl/user/s1934538/clickstream/clickstream-enwiki-2022-10.tsv.gz,Oppenheimer_(film),122678,91076,997,214751,184756
hdfs://spark-nn.eemcs.utwente.nl/user/s1934538/clickstream/clickstream-enwiki-2022-10.tsv.gz,YouTube,124053,3840908,9731,3974692,119069
hdfs://spark-nn.eemcs.utwente.nl/user/s1934538/clickstream/clickstream-enwiki-2022-10.tsv.gz,Sidharth_Shukla,11375,49829,300,61504,13499
hdfs://spark-nn.eemcs.utwente.nl/user/s1934538/clickstream/clickstream-enwiki-2022-10.tsv.gz,Betty_White,38773,115455,1194,155422,36988
hdfs://spark-nn.eemcs.utwente.nl/user/s1934538/clickstream/clickstream-enwiki-2022-10.tsv.gz,Aaron_Carter,15767,43827,233,59827,23965
hdfs://spark-nn.eemcs.utwente.nl/user/s1934538/clickstream/clickstream-enwiki-2022-10.tsv.gz,Pelé,42107,176000,1271,219378,75324
hdfs://spark-nn.eemcs.utwente.nl/user/s1934538/clickstream/clickstream-enwiki-2022-10.tsv.gz,Jenna_Ortega,121310,172761,1482,295553,90599
hdfs://spark-nn.eemcs.utwente.nl/user/s1934538/clickstream/clickstream-enwiki-2022-10.tsv.gz,List_of_James_Bond_films,91666,482948,5381,579995,337208
hdfs://spark-nn.eemcs.utwente.nl/user/s1934538/clickstream/clickstream-enwiki-2022-10.tsv.gz,Bird_Box_(film),12563,55577,505,68645,22995
hdfs://spark-nn.eemcs.utwente.nl/user/s1934538/clickstream/clickstream-enwiki-2022-10.tsv.gz,XXXTentacion,69134,929171,6241,1004546,104797
hdfs://spark-nn.eemcs.utwente.nl/user/s1934538/clickstream/clickstream-enwiki-2022-10.tsv.gz,Johnny_Depp,108973,336716,2608,448297,217433
hdfs://spark-nn.eemcs.utwente.nl/user/s1934538/clickstream/clickstream-enwiki-2022-10.tsv.gz,Kylian_Mbappé,49770,351878,2578,404226,75898
hdfs://spark-nn.eemcs.utwente.nl/user/s1934538/clickstream/clickstream-enwiki-2022-10.tsv.gz,Tom_Brady,142614,986547,10801,1139962,451074
hdfs://spark-nn.eemcs.utwente.nl/user/s1934538/clickstream/clickstream-enwiki-2022-10.tsv.gz,Salman_Rushdie,28628,149120,1719,179467,81357
hdfs://spark-nn.eemcs.utwente.nl/user/s1934538/clickstream/clickstream-enwiki-2022-10.tsv.gz,Mulan_(2020_film),14714,43961,396,59071,28382
hdfs://spark-nn.eemcs.utwente.nl/user/s1934538/clickstream/clickstream-enwiki-2022-10.tsv.gz,Godzilla_vs._Kong,32312,53142,842,86296,44805
hdfs://spark-nn.eemcs.utwente.nl/user/s1934538/clickstream/clickstream-enwiki-2022-10.tsv.gz,John_Wick:_Chapter_4,62286,82091,825,145202,82954
hdfs://spark-nn.eemcs.utwente.nl/user/s1934538/clickstream/clickstream-enwiki-2022-10.tsv.gz,The_Nun_(2018_film),31183,77241,602,109026,58376
hdfs://spark-nn.eemcs.utwente.nl/user/s1934538/clickstream/clickstream-enwiki-2022-10.tsv.gz,Venom_(2018_film),13906,60383,844,75133,30784
hdfs://spark-nn.eemcs.utwente.nl/user/s1934538/clickstream/clickstream-enwiki-2022-10.tsv.gz,Star_Wars:_The_Rise_of_Skywalker,70260,76391,1820,148471,88759
hdfs://spark-nn.eemcs.utwente.nl/user/s1934538/clickstream/clickstream-enwiki-2022-10.tsv.gz,Sushant_Singh_Rajput,17540,82223,193,99956,45778
hdfs://spark-nn.eemcs.utwente.nl/user/s1934538/clickstream/clickstream-enwiki-2022-10.tsv.gz,RRR_(film),75272,497795,3449,576516,264780
hdfs://spark-nn.eemcs.utwente.nl/user/s1934538/clickstream/clickstream-enwiki-2022-10.tsv.gz,Fyre_Festival,9183,54859,369,64411,36527
hdfs://spark-nn.eemcs.utwente.nl/user/s1934538/clickstream/clickstream-enwiki-2022-10.tsv.gz,Shinzo_Abe,46273,78908,1180,126361,79960
hdfs://spark-nn.eemcs.utwente.nl/user/s1934538/clickstream/clickstream-enwiki-2022-10.tsv.gz,2023_Cricket_World_Cup,45820,313387,332,359539,89203
hdfs://spark-nn.eemcs.utwente.nl/user/s1934538/clickstream/clickstream-enwiki-2022-10.tsv.gz,Anna_Sorokin,24388,418566,1993,444947,160844
hdfs://spark-nn.eemcs.utwente.nl/user/s1934538/clickstream/clickstream-enwiki-2022-10.tsv.gz,Dennis_Nilsen,23675,257347,1272,282294,59402
hdfs://spark-nn.eemcs.utwente.nl/user/s1934538/clickstream/clickstream-enwiki-2022-10.tsv.gz,Atal_Bihari_Vajpayee,28545,45249,32,73826,24410
hdfs://spark-nn.eemcs.utwente.nl/user/s1934538/clickstream/clickstream-enwiki-2022-10.tsv.gz,Rami_Malek,52366,130936,716,184018,75433
hdfs://spark-nn.eemcs.utwente.nl/user/s1934538/clickstream/clickstream-enwiki-2022-10.tsv.gz,Stranger_Things_(season_3),18343,37773,436,56552,29018
hdfs://spark-nn.eemcs.utwente.nl/user/s1934538/clickstream/clickstream-enwiki-2022-10.tsv.gz,Cleopatra,57383,5824479,1765,5883627,487217
hdfs://spark-nn.eemcs.utwente.nl/user/s1934538/clickstream/clickstream-enwiki-2022-10.tsv.gz,Valentine's_Day,3720,39232,174,43126,3750
hdfs://spark-nn.eemcs.utwente.nl/user/s1934538/clickstream/clickstream-enwiki-2022-10.tsv.gz,War_(2019_film),36328,48592,90,85010,21420
hdfs://spark-nn.eemcs.utwente.nl/user/s1934538/clickstream/clickstream-enwiki-2022-10.tsv.gz,Glass_(2019_film),39984,49261,353,89598,29254
hdfs://spark-nn.eemcs.utwente.nl/user/s1934538/clickstream/clickstream-enwiki-2022-10.tsv.gz,Aquaman_(film),26507,63918,871,91296,41275
hdfs://spark-nn.eemcs.utwente.nl/user/s1934538/clickstream/clickstream-enwiki-2022-10.tsv.gz,The_Last_of_Us_(TV_series),43084,85363,1058,129505,99544
hdfs://spark-nn.eemcs.utwente.nl/user/s1934538/clickstream/clickstream-enwiki-2022-10.tsv.gz,David_Beckham,51349,207347,1373,260069,98504
hdfs://spark-nn.eemcs.utwente.nl/user/s1934538/clickstream/clickstream-enwiki-2022-10.tsv.gz,Cricket_World_Cup,24897,169186,794,194877,111501
hdfs://spark-nn.eemcs.utwente.nl/user/s1934538/clickstream/clickstream-enwiki-2022-10.tsv.gz,Eternals_(film),65074,116134,1853,183061,129045
hdfs://spark-nn.eemcs.utwente.nl/user/s1934538/clickstream/clickstream-enwiki-2022-10.tsv.gz,Anne_Heche,53746,237345,1563,292654,101227
hdfs://spark-nn.eemcs.utwente.nl/user/s1934538/clickstream/clickstream-enwiki-2022-10.tsv.gz,Coronavirus,6010,34274,808,41092,12281
hdfs://spark-nn.eemcs.utwente.nl/user/s1934538/clickstream/clickstream-enwiki-2022-10.tsv.gz,Michael_Bloomberg,26713,33968,237,60918,27668
hdfs://spark-nn.eemcs.utwente.nl/user/s1934538/clickstream/clickstream-enwiki-2022-10.tsv.gz,Bonnie_and_Clyde,17899,202237,1128,221264,46428
hdfs://spark-nn.eemcs.utwente.nl/user/s1934538/clickstream/clickstream-enwiki-2022-10.tsv.gz,Russo-Ukrainian_War,213699,730815,13338,957852,523362
hdfs://spark-nn.eemcs.utwente.nl/user/s1934538/clickstream/clickstream-enwiki-2022-10.tsv.gz,Mac_Miller,21857,146362,1063,169282,48222
hdfs://spark-nn.eemcs.utwente.nl/user/s1934538/clickstream/clickstream-enwiki-2022-10.tsv.gz,Joker_(2019_film),70429,148915,1863,221207,95236
hdfs://spark-nn.eemcs.utwente.nl/user/s1934538/clickstream/clickstream-enwiki-2022-10.tsv.gz,2.0_(film),51767,56373,109,108249,26867
hdfs://spark-nn.eemcs.utwente.nl/user/s1934538/clickstream/clickstream-enwiki-2022-10.tsv.gz,"Citizenship_(Amendment)_Act,_2019",2378,14777,25,17180,2037
hdfs://spark-nn.eemcs.utwente.nl/user/s1934538/clickstream/clickstream-enwiki-2022-10.tsv.gz,Bible,18796,1862340,1681,1882817,31796
hdfs://spark-nn.eemcs.utwente.nl/user/s1934538/clickstream/clickstream-enwiki-2022-10.tsv.gz,Donald_Trump,200401,447454,5974,653829,359219
hdfs://spark-nn.eemcs.utwente.nl/user/s1934538/clickstream/clickstream-enwiki-2022-10.tsv.gz,Hyphen-minus,721,5929274,21425,5951420,754
hdfs://spark-nn.eemcs.utwente.nl/user/s1934538/clickstream/clickstream-enwiki-2022-10.tsv.gz,IPv4,10787,40798,140,51725,9691
hdfs://spark-nn.eemcs.utwente.nl/user/s1934538/clickstream/clickstream-enwiki-2022-10.tsv.gz,A_Star_Is_Born_(2018_film),18916,59454,412,78782,33314
hdfs://spark-nn.eemcs.utwente.nl/user/s1934538/clickstream/clickstream-enwiki-2022-10.tsv.gz,Elizabeth_II,679023,1179644,14847,1873514,1199016
hdfs://spark-nn.eemcs.utwente.nl/user/s1934538/clickstream/clickstream-enwiki-2022-10.tsv.gz,Everything_Everywhere_All_at_Once,62446,327368,5315,395129,181373
hdfs://spark-nn.eemcs.utwente.nl/user/s1934538/clickstream/clickstream-enwiki-2022-10.tsv.gz,Sylvester_Stallone,90711,331778,2773,425262,282800
hdfs://spark-nn.eemcs.utwente.nl/user/s1934538/clickstream/clickstream-enwiki-2022-10.tsv.gz,Antifa_(United_States),9321,64003,273,73597,12694
hdfs://spark-nn.eemcs.utwente.nl/user/s1934538/clickstream/clickstream-enwiki-2022-10.tsv.gz,William_Murdoch,598,1250,11,1859,321
hdfs://spark-nn.eemcs.utwente.nl/user/s1934538/clickstream/clickstream-enwiki-2022-10.tsv.gz,K.G.F:_Chapter_2,97380,307588,4064,409032,119721
hdfs://spark-nn.eemcs.utwente.nl/user/s1934538/clickstream/clickstream-enwiki-2022-10.tsv.gz,Game_of_Thrones,144008,685437,9824,839269,463285
hdfs://spark-nn.eemcs.utwente.nl/user/s1934538/clickstream/clickstream-enwiki-2022-10.tsv.gz,Greta_Thunberg,11223,204403,1787,217413,47970
hdfs://spark-nn.eemcs.utwente.nl/user/s1934538/clickstream/clickstream-enwiki-2022-10.tsv.gz,2018_Asian_Games,6134,4742,27,10903,9777
hdfs://spark-nn.eemcs.utwente.nl/user/s1934538/clickstream/clickstream-enwiki-2022-10.tsv.gz,Mötley_Crüe,40989,123895,2200,167084,194842
hdfs://spark-nn.eemcs.utwente.nl/user/s1934538/clickstream/clickstream-enwiki-2022-10.tsv.gz,Roe_v._Wade,17370,161503,1321,180194,51829
hdfs://spark-nn.eemcs.utwente.nl/user/s1934538/clickstream/clickstream-enwiki-2022-10.tsv.gz,Jawan_(film),77561,50239,307,128107,81533
hdfs://spark-nn.eemcs.utwente.nl/user/s1934538/clickstream/clickstream-enwiki-2022-10.tsv.gz,The_Mandalorian,47067,112331,2393,161791,105690
hdfs://spark-nn.eemcs.utwente.nl/user/s1934538/clickstream/clickstream-enwiki-2022-10.tsv.gz,List_of_Queen_of_the_South_episodes,4193,3821,60,8074,145
hdfs://spark-nn.eemcs.utwente.nl/user/s1934538/clickstream/clickstream-enwiki-2022-10.tsv.gz,Amy_Coney_Barrett,20205,34709,264,55178,16030
hdfs://spark-nn.eemcs.utwente.nl/user/s1934538/clickstream/clickstream-enwiki-2022-10.tsv.gz,"Diana,_Princess_of_Wales",230833,521433,4612,756878,450013
hdfs://spark-nn.eemcs.utwente.nl/user/s1934538/clickstream/clickstream-enwiki-2022-10.tsv.gz,Simone_Biles,10628,48710,498,59836,17731
hdfs://spark-nn.eemcs.utwente.nl/user/s1934538/clickstream/clickstream-enwiki-2022-10.tsv.gz,Cook's_Country,459,1716,38,2213,590
hdfs://spark-nn.eemcs.utwente.nl/user/s1934538/clickstream/clickstream-enwiki-2022-10.tsv.gz,Kobe_Bryant_sexual_assault_case,8158,32509,45,40712,3551
hdfs://spark-nn.eemcs.utwente.nl/user/s1934538/clickstream/clickstream-enwiki-2022-10.tsv.gz,Black_Widow_(2021_film),41930,80040,1164,123134,53259
hdfs://spark-nn.eemcs.utwente.nl/user/s1934538/clickstream/clickstream-enwiki-2022-10.tsv.gz,Charles_Sobhraj,13171,66427,159,79757,14227
hdfs://spark-nn.eemcs.utwente.nl/user/s1934538/clickstream/clickstream-enwiki-2022-10.tsv.gz,Priyanka_Chopra,66259,216293,481,283033,91243
hdfs://spark-nn.eemcs.utwente.nl/user/s1934538/clickstream/clickstream-enwiki-2022-10.tsv.gz,Top_Gun:_Maverick,182254,605003,14414,801671,550042
hdfs://spark-nn.eemcs.utwente.nl/user/s1934538/clickstream/clickstream-enwiki-2022-10.tsv.gz,WrestleMania_34,11702,5598,85,17385,11600
hdfs://spark-nn.eemcs.utwente.nl/user/s1934538/clickstream/clickstream-enwiki-2022-10.tsv.gz,Elon_Musk,236864,2033133,21003,2291000,1310859
hdfs://spark-nn.eemcs.utwente.nl/user/s1934538/clickstream/clickstream-enwiki-2022-10.tsv.gz,Chernobyl_(miniseries),18251,60511,1407,80169,80500
hdfs://spark-nn.eemcs.utwente.nl/user/s1934538/clickstream/clickstream-enwiki-2022-10.tsv.gz,Jeffrey_Dahmer,524471,23413123,121272,24058866,9170557
hdfs://spark-nn.eemcs.utwente.nl/user/s1934538/clickstream/clickstream-enwiki-2022-10.tsv.gz,Hamilton_(musical),24903,159067,1535,185505,107621
hdfs://spark-nn.eemcs.utwente.nl/user/s1934538/clickstream/clickstream-enwiki-2022-10.tsv.gz,Ted_Bundy,123807,1207905,21470,1353182,304228
hdfs://spark-nn.eemcs.utwente.nl/user/s1934538/clickstream/clickstream-enwiki-2022-10.tsv.gz,Tonya_Harding,16872,73505,330,90707,23958
hdfs://spark-nn.eemcs.utwente.nl/user/s1934538/clickstream/clickstream-enwiki-2022-10.tsv.gz,Alexander_Hamilton,62727,182144,7090,251961,130044
hdfs://spark-nn.eemcs.utwente.nl/user/s1934538/clickstream/clickstream-enwiki-2022-10.tsv.gz,Avengers:_Endgame,187085,148670,2014,337769,129781
hdfs://spark-nn.eemcs.utwente.nl/user/s1934538/clickstream/clickstream-enwiki-2022-10.tsv.gz,2018_FIFA_World_Cup,141878,158133,1114,301125,167431
hdfs://spark-nn.eemcs.utwente.nl/user/s1934538/clickstream/clickstream-enwiki-2022-10.tsv.gz,Kantara_(film),208242,3798786,12825,4019853,1372314
hdfs://spark-nn.eemcs.utwente.nl/user/s1934538/clickstream/clickstream-enwiki-2022-10.tsv.gz,The_Queen's_Gambit_(miniseries),21412,81121,654,103187,49692
hdfs://spark-nn.eemcs.utwente.nl/user/s1934538/clickstream/clickstream-enwiki-2022-10.tsv.gz,Ray_Liotta,53373,206185,1717,261275,55751
hdfs://spark-nn.eemcs.utwente.nl/user/s1934538/clickstream/clickstream-enwiki-2022-10.tsv.gz,COVID-19_pandemic_by_country_and_territory,12203,45185,1169,58557,22905
hdfs://spark-nn.eemcs.utwente.nl/user/s1934538/clickstream/clickstream-enwiki-2022-10.tsv.gz,Grover,1244,6246,29,7519,1323
hdfs://spark-nn.eemcs.utwente.nl/user/s1934538/clickstream/clickstream-enwiki-2022-10.tsv.gz,Naya_Rivera,62858,76879,259,139996,53744
hdfs://spark-nn.eemcs.utwente.nl/user/s1934538/clickstream/clickstream-enwiki-2022-10.tsv.gz,Jurassic_World_Dominion,86861,225274,4354,316489,208179
hdfs://spark-nn.eemcs.utwente.nl/user/s1934538/clickstream/clickstream-enwiki-2022-10.tsv.gz,Taliban,37665,59678,1080,98423,71583
hdfs://spark-nn.eemcs.utwente.nl/user/s1934538/clickstream/clickstream-enwiki-2022-10.tsv.gz,Olivia_Newton-John,34080,205836,2146,242062,93880
hdfs://spark-nn.eemcs.utwente.nl/user/s1934538/clickstream/clickstream-enwiki-2022-10.tsv.gz,Spider-Man:_No_Way_Home,98425,234134,3741,336300,138827
hdfs://spark-nn.eemcs.utwente.nl/user/s1934538/clickstream/clickstream-enwiki-2022-10.tsv.gz,List_of_highest-grossing_Indian_films,186602,552874,1502,740978,406504
hdfs://spark-nn.eemcs.utwente.nl/user/s1934538/clickstream/clickstream-enwiki-2022-10.tsv.gz,21_Savage,14230,65742,603,80575,32376
hdfs://spark-nn.eemcs.utwente.nl/user/s1934538/clickstream/clickstream-enwiki-2022-10.tsv.gz,Us_(2019_film),36244,114670,584,151498,48364
hdfs://spark-nn.eemcs.utwente.nl/user/s1934538/clickstream/clickstream-enwiki-2022-10.tsv.gz,Black_Adam_(film),413475,3734868,86048,4234391,2172882
hdfs://spark-nn.eemcs.utwente.nl/user/s1934538/clickstream/clickstream-enwiki-2022-10.tsv.gz,R._Kelly,31352,149866,1443,182661,98273
hdfs://spark-nn.eemcs.utwente.nl/user/s1934538/clickstream/clickstream-enwiki-2022-10.tsv.gz,The_Falcon_and_the_Winter_Soldier,20857,30587,526,51970,30050
hdfs://spark-nn.eemcs.utwente.nl/user/s1934538/clickstream/clickstream-enwiki-2022-10.tsv.gz,Richard_Jewell,7305,25072,138,32515,12170
hdfs://spark-nn.eemcs.utwente.nl/user/s1934538/clickstream/clickstream-enwiki-2022-10.tsv.gz,The_Super_Mario_Bros._Movie,186827,559752,12906,759485,610426
hdfs://spark-nn.eemcs.utwente.nl/user/s1934538/clickstream/clickstream-enwiki-2022-10.tsv.gz,John_McCain,28465,52583,532,81580,39206
hdfs://spark-nn.eemcs.utwente.nl/user/s1934538/clickstream/clickstream-enwiki-2022-10.tsv.gz,Queen_(band),49045,188445,3189,240679,215541
hdfs://spark-nn.eemcs.utwente.nl/user/s1934538/clickstream/clickstream-enwiki-2022-10.tsv.gz,Keanu_Reeves,77267,565964,4294,647525,389675
hdfs://spark-nn.eemcs.utwente.nl/user/s1934538/clickstream/clickstream-enwiki-2022-10.tsv.gz,Watts_family_murders,8090,170225,250,178565,46052
hdfs://spark-nn.eemcs.utwente.nl/user/s1934538/clickstream/clickstream-enwiki-2022-10.tsv.gz,Croatia,48967,174586,2237,225790,74963
hdfs://spark-nn.eemcs.utwente.nl/user/s1934538/clickstream/clickstream-enwiki-2022-10.tsv.gz,Joaquin_Phoenix,117788,156783,892,275463,162584
hdfs://spark-nn.eemcs.utwente.nl/user/s1934538/clickstream/clickstream-enwiki-2022-10.tsv.gz,Michael_Jordan,69674,404442,3413,477529,139940
hdfs://spark-nn.eemcs.utwente.nl/user/s1934538/clickstream/clickstream-enwiki-2022-10.tsv.gz,XHamster,7217,217063,5631,229911,23507
hdfs://spark-nn.eemcs.utwente.nl/user/s1934538/clickstream/clickstream-enwiki-2022-10.tsv.gz,Kim_Jong-un,72831,186590,1413,260834,140253
hdfs://spark-nn.eemcs.utwente.nl/user/s1934538/clickstream/clickstream-enwiki-2022-10.tsv.gz,Parasite_(2019_film),25977,159392,1856,187225,74098
hdfs://spark-nn.eemcs.utwente.nl/user/s1934538/clickstream/clickstream-enwiki-2022-10.tsv.gz,"Prince_Philip,_Duke_of_Edinburgh",252892,347285,3303,603480,409945
hdfs://spark-nn.eemcs.utwente.nl/user/s1934538/clickstream/clickstream-enwiki-2022-10.tsv.gz,"Meghan,_Duchess_of_Sussex",96573,341730,2184,440487,219325
hdfs://spark-nn.eemcs.utwente.nl/user/s1934538/clickstream/clickstream-enwiki-2022-10.tsv.gz,2022_Russian_invasion_of_Ukraine,1078820,1510382,12120,2601322,1353333
hdfs://spark-nn.eemcs.utwente.nl/user/s1934538/clickstream/clickstream-enwiki-2022-10.tsv.gz,Carlos_Alcaraz,21464,66140,324,87928,20057
hdfs://spark-nn.eemcs.utwente.nl/user/s1934538/clickstream/clickstream-enwiki-2023-01.tsv.gz,Avengers:_Infinity_War,68815,65447,1214,135476,59249
hdfs://spark-nn.eemcs.utwente.nl/user/s1934538/clickstream/clickstream-enwiki-2023-01.tsv.gz,Cardi_B,40364,175327,1951,217642,64470
hdfs://spark-nn.eemcs.utwente.nl/user/s1934538/clickstream/clickstream-enwiki-2023-01.tsv.gz,ChatGPT,62165,5254151,15507,5331823,600981
hdfs://spark-nn.eemcs.utwente.nl/user/s1934538/clickstream/clickstream-enwiki-2023-01.tsv.gz,Atal_Bihari_Vajpayee,34089,53338,71,87498,33015
hdfs://spark-nn.eemcs.utwente.nl/user/s1934538/clickstream/clickstream-enwiki-2023-01.tsv.gz,The_Witcher_(TV_series),58248,249815,5272,313335,186031
hdfs://spark-nn.eemcs.utwente.nl/user/s1934538/clickstream/clickstream-enwiki-2023-01.tsv.gz,Christopher_Scarver,128074,58637,39,186750,56881
hdfs://spark-nn.eemcs.utwente.nl/user/s1934538/clickstream/clickstream-enwiki-2023-01.tsv.gz,Shang-Chi_and_the_Legend_of_the_Ten_Rings,62040,88548,1193,151781,87893
hdfs://spark-nn.eemcs.utwente.nl/user/s1934538/clickstream/clickstream-enwiki-2023-01.tsv.gz,Index_(statistics),160,20502298,29,20502487,1027
hdfs://spark-nn.eemcs.utwente.nl/user/s1934538/clickstream/clickstream-enwiki-2023-01.tsv.gz,Media,47,2770,318,3135,1347
hdfs://spark-nn.eemcs.utwente.nl/user/s1934538/clickstream/clickstream-enwiki-2023-01.tsv.gz,Avengers:_Endgame,292943,172316,2740,467999,187111
hdfs://spark-nn.eemcs.utwente.nl/user/s1934538/clickstream/clickstream-enwiki-2023-01.tsv.gz,The_Shape_of_Water,38337,46033,588,84958,36368
hdfs://spark-nn.eemcs.utwente.nl/user/s1934538/clickstream/clickstream-enwiki-2023-01.tsv.gz,"Meghan,_Duchess_of_Sussex",180450,682171,4392,867013,540854
hdfs://spark-nn.eemcs.utwente.nl/user/s1934538/clickstream/clickstream-enwiki-2023-01.tsv.gz,Adipurush,52987,107001,252,160240,60077
hdfs://spark-nn.eemcs.utwente.nl/user/s1934538/clickstream/clickstream-enwiki-2023-01.tsv.gz,The_Sandman_(TV_series),42963,135968,2613,181544,128627
hdfs://spark-nn.eemcs.utwente.nl/user/s1934538/clickstream/clickstream-enwiki-2023-01.tsv.gz,List_of_highest-grossing_Indian_films,297425,807165,2065,1106655,593284
hdfs://spark-nn.eemcs.utwente.nl/user/s1934538/clickstream/clickstream-enwiki-2023-01.tsv.gz,Joker_(2019_film),52857,128817,1740,183414,91831
hdfs://spark-nn.eemcs.utwente.nl/user/s1934538/clickstream/clickstream-enwiki-2023-01.tsv.gz,Article_370_of_the_Constitution_of_India,13280,71834,37,85151,4584
hdfs://spark-nn.eemcs.utwente.nl/user/s1934538/clickstream/clickstream-enwiki-2023-01.tsv.gz,Michael_Jordan,98705,529259,5051,633015,201330
hdfs://spark-nn.eemcs.utwente.nl/user/s1934538/clickstream/clickstream-enwiki-2023-01.tsv.gz,2020_Summer_Olympics,48600,42932,1244,92776,80167
hdfs://spark-nn.eemcs.utwente.nl/user/s1934538/clickstream/clickstream-enwiki-2023-01.tsv.gz,1234,51,1836,26,1913,329
hdfs://spark-nn.eemcs.utwente.nl/user/s1934538/clickstream/clickstream-enwiki-2023-01.tsv.gz,Parasite_(2019_film),39684,154704,1433,195821,84736
hdfs://spark-nn.eemcs.utwente.nl/user/s1934538/clickstream/clickstream-enwiki-2023-01.tsv.gz,Kantara_(film),35388,443006,1812,480206,161237
hdfs://spark-nn.eemcs.utwente.nl/user/s1934538/clickstream/clickstream-enwiki-2023-01.tsv.gz,William_Murdoch,703,1591,28,2322,528
hdfs://spark-nn.eemcs.utwente.nl/user/s1934538/clickstream/clickstream-enwiki-2023-01.tsv.gz,Charles_III,641849,409306,6319,1057474,738513
hdfs://spark-nn.eemcs.utwente.nl/user/s1934538/clickstream/clickstream-enwiki-2023-01.tsv.gz,Grover,1461,5080,39,6580,1305
hdfs://spark-nn.eemcs.utwente.nl/user/s1934538/clickstream/clickstream-enwiki-2023-01.tsv.gz,Donald_Trump,195507,370725,6062,572294,329952
hdfs://spark-nn.eemcs.utwente.nl/user/s1934538/clickstream/clickstream-enwiki-2023-01.tsv.gz,Hamilton_(musical),27355,157265,1422,186042,122680
hdfs://spark-nn.eemcs.utwente.nl/user/s1934538/clickstream/clickstream-enwiki-2023-01.tsv.gz,JSON_Web_Token,778,24001,47,24826,2288
hdfs://spark-nn.eemcs.utwente.nl/user/s1934538/clickstream/clickstream-enwiki-2023-01.tsv.gz,Black_Adam_(film),98452,424235,9264,531951,289777
hdfs://spark-nn.eemcs.utwente.nl/user/s1934538/clickstream/clickstream-enwiki-2023-01.tsv.gz,Lionel_Messi,202311,1338659,13527,1554497,423731
hdfs://spark-nn.eemcs.utwente.nl/user/s1934538/clickstream/clickstream-enwiki-2023-01.tsv.gz,Jawan_(film),198348,193420,30185,421953,307619
hdfs://spark-nn.eemcs.utwente.nl/user/s1934538/clickstream/clickstream-enwiki-2023-01.tsv.gz,Bob_Saget,30363,162927,1703,194993,35888
hdfs://spark-nn.eemcs.utwente.nl/user/s1934538/clickstream/clickstream-enwiki-2023-01.tsv.gz,Us_(2019_film),34501,72291,400,107192,34439
hdfs://spark-nn.eemcs.utwente.nl/user/s1934538/clickstream/clickstream-enwiki-2023-01.tsv.gz,Israel,101970,312706,6352,421028,228964
hdfs://spark-nn.eemcs.utwente.nl/user/s1934538/clickstream/clickstream-enwiki-2023-01.tsv.gz,Microsoft_Office,7451,167632,604,175687,19730
hdfs://spark-nn.eemcs.utwente.nl/user/s1934538/clickstream/clickstream-enwiki-2023-01.tsv.gz,Burt_Reynolds,73928,155926,1218,231072,113758
hdfs://spark-nn.eemcs.utwente.nl/user/s1934538/clickstream/clickstream-enwiki-2023-01.tsv.gz,Amber_Heard,71371,162927,1073,235371,98974
hdfs://spark-nn.eemcs.utwente.nl/user/s1934538/clickstream/clickstream-enwiki-2023-01.tsv.gz,Jimmy_Buffett,8728,44198,442,53368,20115
hdfs://spark-nn.eemcs.utwente.nl/user/s1934538/clickstream/clickstream-enwiki-2023-01.tsv.gz,Leave_the_World_Behind_(film),16902,14919,195,32016,12898
hdfs://spark-nn.eemcs.utwente.nl/user/s1934538/clickstream/clickstream-enwiki-2023-01.tsv.gz,Kamala_Harris,81692,163829,1231,246752,107924
hdfs://spark-nn.eemcs.utwente.nl/user/s1934538/clickstream/clickstream-enwiki-2023-01.tsv.gz,George_H._W._Bush,144777,92213,794,237784,147763
hdfs://spark-nn.eemcs.utwente.nl/user/s1934538/clickstream/clickstream-enwiki-2023-01.tsv.gz,Central_Park_jogger_case,10854,43981,178,55013,8032
hdfs://spark-nn.eemcs.utwente.nl/user/s1934538/clickstream/clickstream-enwiki-2023-01.tsv.gz,Jeffrey_Dahmer,53770,920866,8641,983277,403790
hdfs://spark-nn.eemcs.utwente.nl/user/s1934538/clickstream/clickstream-enwiki-2023-01.tsv.gz,Coronavirus,6308,34283,863,41454,13031
hdfs://spark-nn.eemcs.utwente.nl/user/s1934538/clickstream/clickstream-enwiki-2023-01.tsv.gz,Hamas,34330,38913,589,73832,42467
hdfs://spark-nn.eemcs.utwente.nl/user/s1934538/clickstream/clickstream-enwiki-2023-01.tsv.gz,Pathaan_(film),308511,6583712,32393,6924616,1971589
hdfs://spark-nn.eemcs.utwente.nl/user/s1934538/clickstream/clickstream-enwiki-2023-01.tsv.gz,Area_51,17742,131152,1209,150103,50124
hdfs://spark-nn.eemcs.utwente.nl/user/s1934538/clickstream/clickstream-enwiki-2023-01.tsv.gz,Once_Upon_a_Time_in_Hollywood,130045,203649,3523,337217,384693
hdfs://spark-nn.eemcs.utwente.nl/user/s1934538/clickstream/clickstream-enwiki-2023-01.tsv.gz,Stranger_Things,91484,297968,7883,397335,369641
hdfs://spark-nn.eemcs.utwente.nl/user/s1934538/clickstream/clickstream-enwiki-2023-01.tsv.gz,Dark_Phoenix_(film),35573,30223,333,66129,35733
hdfs://spark-nn.eemcs.utwente.nl/user/s1934538/clickstream/clickstream-enwiki-2023-01.tsv.gz,YouTube,138935,2410013,11187,2560135,124499
hdfs://spark-nn.eemcs.utwente.nl/user/s1934538/clickstream/clickstream-enwiki-2023-01.tsv.gz,Aaron_Hernandez,13797,179920,834,194551,70535
hdfs://spark-nn.eemcs.utwente.nl/user/s1934538/clickstream/clickstream-enwiki-2023-01.tsv.gz,Kim_Jong-un,67793,157184,1523,226500,131336
hdfs://spark-nn.eemcs.utwente.nl/user/s1934538/clickstream/clickstream-enwiki-2023-01.tsv.gz,The_Lion_King_(2019_film),87626,73767,720,162113,65672
hdfs://spark-nn.eemcs.utwente.nl/user/s1934538/clickstream/clickstream-enwiki-2023-01.tsv.gz,Venom_(2018_film),14325,52838,556,67719,28067
hdfs://spark-nn.eemcs.utwente.nl/user/s1934538/clickstream/clickstream-enwiki-2023-01.tsv.gz,Game_of_Thrones,91931,283135,6197,381263,236127
hdfs://spark-nn.eemcs.utwente.nl/user/s1934538/clickstream/clickstream-enwiki-2023-01.tsv.gz,2018_Winter_Olympics,12872,8898,106,21876,15389
hdfs://spark-nn.eemcs.utwente.nl/user/s1934538/clickstream/clickstream-enwiki-2023-01.tsv.gz,Matthew_Perry,56859,192540,6395,255794,138933
hdfs://spark-nn.eemcs.utwente.nl/user/s1934538/clickstream/clickstream-enwiki-2023-01.tsv.gz,Anthony_Bourdain,25222,227113,1590,253925,116197
hdfs://spark-nn.eemcs.utwente.nl/user/s1934538/clickstream/clickstream-enwiki-2023-01.tsv.gz,Cristiano_Ronaldo,263738,2090347,13804,2367889,789412
hdfs://spark-nn.eemcs.utwente.nl/user/s1934538/clickstream/clickstream-enwiki-2023-01.tsv.gz,Everything_Everywhere_All_at_Once,417089,1470897,26347,1914333,990595
hdfs://spark-nn.eemcs.utwente.nl/user/s1934538/clickstream/clickstream-enwiki-2023-01.tsv.gz,Joe_Exotic,32050,86964,336,119350,63903
hdfs://spark-nn.eemcs.utwente.nl/user/s1934538/clickstream/clickstream-enwiki-2023-01.tsv.gz,Tasuku_Honjo,787,133978,29,134794,5320
hdfs://spark-nn.eemcs.utwente.nl/user/s1934538/clickstream/clickstream-enwiki-2023-01.tsv.gz,Cecil_Hotel_(Los_Angeles),6406,45134,146,51686,13857
hdfs://spark-nn.eemcs.utwente.nl/user/s1934538/clickstream/clickstream-enwiki-2023-01.tsv.gz,Henry_V_of_England,85497,90542,368,176407,124746
hdfs://spark-nn.eemcs.utwente.nl/user/s1934538/clickstream/clickstream-enwiki-2023-01.tsv.gz,Jurassic_World_Dominion,123090,288708,5938,417736,333234
hdfs://spark-nn.eemcs.utwente.nl/user/s1934538/clickstream/clickstream-enwiki-2023-01.tsv.gz,Sushma_Swaraj,9002,24529,75,33606,9476
hdfs://spark-nn.eemcs.utwente.nl/user/s1934538/clickstream/clickstream-enwiki-2023-01.tsv.gz,Simone_Biles,12399,54699,333,67431,20263
hdfs://spark-nn.eemcs.utwente.nl/user/s1934538/clickstream/clickstream-enwiki-2023-01.tsv.gz,It_Chapter_Two,24276,30351,302,54929,31912
hdfs://spark-nn.eemcs.utwente.nl/user/s1934538/clickstream/clickstream-enwiki-2023-01.tsv.gz,List_of_FIFA_World_Cup_finals,7291,146347,149,153787,43224
hdfs://spark-nn.eemcs.utwente.nl/user/s1934538/clickstream/clickstream-enwiki-2023-01.tsv.gz,2023_Cricket_World_Cup,56524,710004,628,767156,147523
hdfs://spark-nn.eemcs.utwente.nl/user/s1934538/clickstream/clickstream-enwiki-2023-01.tsv.gz,Louis_Tomlinson,29116,50380,252,79748,23128
hdfs://spark-nn.eemcs.utwente.nl/user/s1934538/clickstream/clickstream-enwiki-2023-01.tsv.gz,Ukraine,126459,368975,11764,507198,261536
hdfs://spark-nn.eemcs.utwente.nl/user/s1934538/clickstream/clickstream-enwiki-2023-01.tsv.gz,Johnny_Depp,109701,304476,2554,416731,233915
hdfs://spark-nn.eemcs.utwente.nl/user/s1934538/clickstream/clickstream-enwiki-2023-01.tsv.gz,Asia_Cup,3144,45020,243,48407,29362
hdfs://spark-nn.eemcs.utwente.nl/user/s1934538/clickstream/clickstream-enwiki-2023-01.tsv.gz,Cricket_World_Cup,20165,128766,570,149501,88334
hdfs://spark-nn.eemcs.utwente.nl/user/s1934538/clickstream/clickstream-enwiki-2023-01.tsv.gz,Bible,21338,91565,1865,114768,40698
hdfs://spark-nn.eemcs.utwente.nl/user/s1934538/clickstream/clickstream-enwiki-2023-01.tsv.gz,Juneteenth,7404,76887,291,84582,7927
hdfs://spark-nn.eemcs.utwente.nl/user/s1934538/clickstream/clickstream-enwiki-2023-01.tsv.gz,Russo-Ukrainian_War,156206,484218,6224,646648,406317
hdfs://spark-nn.eemcs.utwente.nl/user/s1934538/clickstream/clickstream-enwiki-2023-01.tsv.gz,Aquaman_(film),26906,57138,840,84884,41467
hdfs://spark-nn.eemcs.utwente.nl/user/s1934538/clickstream/clickstream-enwiki-2023-01.tsv.gz,Simple_Mail_Transfer_Protocol,2775,27597,115,30487,3078
hdfs://spark-nn.eemcs.utwente.nl/user/s1934538/clickstream/clickstream-enwiki-2023-01.tsv.gz,The_Umbrella_Academy_(TV_series),25838,101733,2076,129647,81071
hdfs://spark-nn.eemcs.utwente.nl/user/s1934538/clickstream/clickstream-enwiki-2023-01.tsv.gz,Crazy_Rich_Asians_(film),49037,93072,1402,143511,131207
hdfs://spark-nn.eemcs.utwente.nl/user/s1934538/clickstream/clickstream-enwiki-2023-01.tsv.gz,Volodymyr_Zelenskyy,113254,213176,2804,329234,181026
hdfs://spark-nn.eemcs.utwente.nl/user/s1934538/clickstream/clickstream-enwiki-2023-01.tsv.gz,Eternals_(film),68637,109082,1799,179518,140981
hdfs://spark-nn.eemcs.utwente.nl/user/s1934538/clickstream/clickstream-enwiki-2023-01.tsv.gz,Keanu_Reeves,90601,528927,2869,622397,386086
hdfs://spark-nn.eemcs.utwente.nl/user/s1934538/clickstream/clickstream-enwiki-2023-01.tsv.gz,State_of_Palestine,66854,170379,171,237404,101910
hdfs://spark-nn.eemcs.utwente.nl/user/s1934538/clickstream/clickstream-enwiki-2023-01.tsv.gz,Oppenheimer_(film),155702,253654,4786,414142,352237
hdfs://spark-nn.eemcs.utwente.nl/user/s1934538/clickstream/clickstream-enwiki-2023-01.tsv.gz,Animal_(2023_film),86133,20088,375,106596,55117
hdfs://spark-nn.eemcs.utwente.nl/user/s1934538/clickstream/clickstream-enwiki-2023-01.tsv.gz,Ted_Bundy,36654,349804,22032,408490,100398
hdfs://spark-nn.eemcs.utwente.nl/user/s1934538/clickstream/clickstream-enwiki-2023-01.tsv.gz,2016_United_States_presidential_election,87684,55790,1228,144702,132456
hdfs://spark-nn.eemcs.utwente.nl/user/s1934538/clickstream/clickstream-enwiki-2023-01.tsv.gz,Cleopatra,68305,5127075,2545,5197925,458712
hdfs://spark-nn.eemcs.utwente.nl/user/s1934538/clickstream/clickstream-enwiki-2023-01.tsv.gz,2023_Indian_Premier_League,21889,108494,443,130826,64041
hdfs://spark-nn.eemcs.utwente.nl/user/s1934538/clickstream/clickstream-enwiki-2023-01.tsv.gz,September_11_attacks,106402,258501,4071,368974,229126
hdfs://spark-nn.eemcs.utwente.nl/user/s1934538/clickstream/clickstream-enwiki-2023-01.tsv.gz,Vladimir_Putin,125823,345305,5840,476968,278669
hdfs://spark-nn.eemcs.utwente.nl/user/s1934538/clickstream/clickstream-enwiki-2023-01.tsv.gz,List_of_Marvel_Cinematic_Universe_films,185063,479414,3498,667975,449705
hdfs://spark-nn.eemcs.utwente.nl/user/s1934538/clickstream/clickstream-enwiki-2023-01.tsv.gz,Naomi_Osaka,52168,427316,3125,482609,186729
hdfs://spark-nn.eemcs.utwente.nl/user/s1934538/clickstream/clickstream-enwiki-2023-01.tsv.gz,XHamster,6553,236178,5918,248649,26460
hdfs://spark-nn.eemcs.utwente.nl/user/s1934538/clickstream/clickstream-enwiki-2023-01.tsv.gz,Eddie_Van_Halen,48717,97526,1097,147340,60126
hdfs://spark-nn.eemcs.utwente.nl/user/s1934538/clickstream/clickstream-enwiki-2023-01.tsv.gz,Avatar:_The_Way_of_Water,826950,5564375,109215,6500540,3448642
hdfs://spark-nn.eemcs.utwente.nl/user/s1934538/clickstream/clickstream-enwiki-2023-01.tsv.gz,Meat_Loaf,26783,133642,1797,162222,54568
hdfs://spark-nn.eemcs.utwente.nl/user/s1934538/clickstream/clickstream-enwiki-2023-01.tsv.gz,HTTP_cookie,2857,367657,168,370682,17744
hdfs://spark-nn.eemcs.utwente.nl/user/s1934538/clickstream/clickstream-enwiki-2023-01.tsv.gz,Bipin_Rawat,9402,21738,42,31182,13478
hdfs://spark-nn.eemcs.utwente.nl/user/s1934538/clickstream/clickstream-enwiki-2023-01.tsv.gz,Kate_Spade,26134,51474,287,77895,26606
hdfs://spark-nn.eemcs.utwente.nl/user/s1934538/clickstream/clickstream-enwiki-2023-01.tsv.gz,Pelé,81415,965068,83905,1130388,435343
hdfs://spark-nn.eemcs.utwente.nl/user/s1934538/clickstream/clickstream-enwiki-2023-01.tsv.gz,Deaths_in_2023,2089663,2450828,15768,4556259,3041466
hdfs://spark-nn.eemcs.utwente.nl/user/s1934538/clickstream/clickstream-enwiki-2023-01.tsv.gz,R._Kelly,45677,250333,2472,298482,161801
hdfs://spark-nn.eemcs.utwente.nl/user/s1934538/clickstream/clickstream-enwiki-2023-01.tsv.gz,QAnon,44704,137046,948,182698,59956
hdfs://spark-nn.eemcs.utwente.nl/user/s1934538/clickstream/clickstream-enwiki-2023-01.tsv.gz,Qasem_Soleimani,15114,55554,303,70971,32975
hdfs://spark-nn.eemcs.utwente.nl/user/s1934538/clickstream/clickstream-enwiki-2023-01.tsv.gz,Charles_Sobhraj,16436,147795,280,164511,29000
hdfs://spark-nn.eemcs.utwente.nl/user/s1934538/clickstream/clickstream-enwiki-2023-01.tsv.gz,Sridevi,44526,88470,189,133185,63103
hdfs://spark-nn.eemcs.utwente.nl/user/s1934538/clickstream/clickstream-enwiki-2023-01.tsv.gz,Stranger_Things_(season_4),36447,112569,1513,150529,92005
hdfs://spark-nn.eemcs.utwente.nl/user/s1934538/clickstream/clickstream-enwiki-2023-01.tsv.gz,Notre-Dame_de_Paris,13521,81098,834,95453,20549
hdfs://spark-nn.eemcs.utwente.nl/user/s1934538/clickstream/clickstream-enwiki-2023-01.tsv.gz,Stranger_Things_(season_3),15975,28276,267,44518,25671
hdfs://spark-nn.eemcs.utwente.nl/user/s1934538/clickstream/clickstream-enwiki-2023-01.tsv.gz,Chadwick_Boseman,56032,203320,971,260323,63714
hdfs://spark-nn.eemcs.utwente.nl/user/s1934538/clickstream/clickstream-enwiki-2023-01.tsv.gz,Shakira,107886,1025701,8073,1141660,573428
hdfs://spark-nn.eemcs.utwente.nl/user/s1934538/clickstream/clickstream-enwiki-2023-01.tsv.gz,Kylian_Mbappé,79967,620251,5405,705623,152238
hdfs://spark-nn.eemcs.utwente.nl/user/s1934538/clickstream/clickstream-enwiki-2023-01.tsv.gz,Jeffrey_Epstein,68889,309559,3626,382074,183176
hdfs://spark-nn.eemcs.utwente.nl/user/s1934538/clickstream/clickstream-enwiki-2023-01.tsv.gz,The_Super_Mario_Bros._Movie,86535,164620,4179,255334,145144
hdfs://spark-nn.eemcs.utwente.nl/user/s1934538/clickstream/clickstream-enwiki-2023-01.tsv.gz,Deion_Sanders,39742,431333,2126,473201,139040
hdfs://spark-nn.eemcs.utwente.nl/user/s1934538/clickstream/clickstream-enwiki-2023-01.tsv.gz,2018_Asian_Games,8014,6433,77,14524,13669
hdfs://spark-nn.eemcs.utwente.nl/user/s1934538/clickstream/clickstream-enwiki-2023-01.tsv.gz,J._Robert_Oppenheimer,88326,364346,752,453424,150391
hdfs://spark-nn.eemcs.utwente.nl/user/s1934538/clickstream/clickstream-enwiki-2023-01.tsv.gz,Chernobyl_disaster,53410,407414,3192,464016,204775
hdfs://spark-nn.eemcs.utwente.nl/user/s1934538/clickstream/clickstream-enwiki-2023-01.tsv.gz,WandaVision,29813,61504,1318,92635,44505
hdfs://spark-nn.eemcs.utwente.nl/user/s1934538/clickstream/clickstream-enwiki-2023-01.tsv.gz,Doctor_Strange_in_the_Multiverse_of_Madness,86767,130206,2672,219645,118577
hdfs://spark-nn.eemcs.utwente.nl/user/s1934538/clickstream/clickstream-enwiki-2023-01.tsv.gz,K.G.F:_Chapter_2,71454,296004,1446,368904,105649
hdfs://spark-nn.eemcs.utwente.nl/user/s1934538/clickstream/clickstream-enwiki-2023-01.tsv.gz,Freddie_Mercury,91349,528894,4008,624251,243421
hdfs://spark-nn.eemcs.utwente.nl/user/s1934538/clickstream/clickstream-enwiki-2023-01.tsv.gz,Cook's_Country,501,2179,43,2723,564
hdfs://spark-nn.eemcs.utwente.nl/user/s1934538/clickstream/clickstream-enwiki-2023-01.tsv.gz,Joe_Biden,194195,486687,8680,689562,338047
hdfs://spark-nn.eemcs.utwente.nl/user/s1934538/clickstream/clickstream-enwiki-2023-01.tsv.gz,Croatia,79918,232094,5688,317700,124367
hdfs://spark-nn.eemcs.utwente.nl/user/s1934538/clickstream/clickstream-enwiki-2023-01.tsv.gz,Black_Panther_(film),54649,169065,1546,225260,109866
hdfs://spark-nn.eemcs.utwente.nl/user/s1934538/clickstream/clickstream-enwiki-2023-01.tsv.gz,Dune_(2021_film),75723,206836,4742,287301,200323
hdfs://spark-nn.eemcs.utwente.nl/user/s1934538/clickstream/clickstream-enwiki-2023-01.tsv.gz,Spider-Man:_Far_From_Home,41701,49922,425,92048,37691
hdfs://spark-nn.eemcs.utwente.nl/user/s1934538/clickstream/clickstream-enwiki-2023-01.tsv.gz,The_Suicide_Squad_(film),76251,84573,1112,161936,99883
hdfs://spark-nn.eemcs.utwente.nl/user/s1934538/clickstream/clickstream-enwiki-2023-01.tsv.gz,Luke_Perry,42967,127409,623,170999,67622
hdfs://spark-nn.eemcs.utwente.nl/user/s1934538/clickstream/clickstream-enwiki-2023-01.tsv.gz,21_Savage,17782,87425,753,105960,38435
hdfs://spark-nn.eemcs.utwente.nl/user/s1934538/clickstream/clickstream-enwiki-2023-01.tsv.gz,Black_Panther:_Wakanda_Forever,192357,546161,14009,752527,385164
hdfs://spark-nn.eemcs.utwente.nl/user/s1934538/clickstream/clickstream-enwiki-2023-01.tsv.gz,Ray_Liotta,75300,306189,3480,384969,88259
hdfs://spark-nn.eemcs.utwente.nl/user/s1934538/clickstream/clickstream-enwiki-2023-01.tsv.gz,Adele,31558,206170,2253,239981,89220
hdfs://spark-nn.eemcs.utwente.nl/user/s1934538/clickstream/clickstream-enwiki-2023-01.tsv.gz,Murder_of_Dee_Dee_Blanchard,11634,74645,274,86553,19783
hdfs://spark-nn.eemcs.utwente.nl/user/s1934538/clickstream/clickstream-enwiki-2023-01.tsv.gz,Squid_Game,21464,148305,3240,173009,81875
hdfs://spark-nn.eemcs.utwente.nl/user/s1934538/clickstream/clickstream-enwiki-2023-01.tsv.gz,Sidharth_Shukla,11341,58222,426,69989,15434
hdfs://spark-nn.eemcs.utwente.nl/user/s1934538/clickstream/clickstream-enwiki-2023-01.tsv.gz,2023_Asia_Cup,17544,29426,86,47056,7821
hdfs://spark-nn.eemcs.utwente.nl/user/s1934538/clickstream/clickstream-enwiki-2023-01.tsv.gz,Guardians_of_the_Galaxy_Vol._3,115571,87077,2023,204671,135851
hdfs://spark-nn.eemcs.utwente.nl/user/s1934538/clickstream/clickstream-enwiki-2023-01.tsv.gz,United_States_Electoral_College,12997,29685,67,42749,7725
hdfs://spark-nn.eemcs.utwente.nl/user/s1934538/clickstream/clickstream-enwiki-2023-01.tsv.gz,Saaho,35351,35925,84,71360,19518
hdfs://spark-nn.eemcs.utwente.nl/user/s1934538/clickstream/clickstream-enwiki-2023-01.tsv.gz,Richard_Jewell,9617,34629,190,44436,16906
hdfs://spark-nn.eemcs.utwente.nl/user/s1934538/clickstream/clickstream-enwiki-2023-01.tsv.gz,Watts_family_murders,7490,169163,356,177009,47810
hdfs://spark-nn.eemcs.utwente.nl/user/s1934538/clickstream/clickstream-enwiki-2023-01.tsv.gz,Sushant_Singh_Rajput,17618,132231,213,150062,55101
hdfs://spark-nn.eemcs.utwente.nl/user/s1934538/clickstream/clickstream-enwiki-2023-01.tsv.gz,Sinéad_O'Connor,19510,130623,1046,151179,46161
hdfs://spark-nn.eemcs.utwente.nl/user/s1934538/clickstream/clickstream-enwiki-2023-01.tsv.gz,The_Queen's_Gambit_(miniseries),47138,139659,1270,188067,92216
hdfs://spark-nn.eemcs.utwente.nl/user/s1934538/clickstream/clickstream-enwiki-2023-01.tsv.gz,Hyphen-minus,821,5363445,21916,5386182,850
hdfs://spark-nn.eemcs.utwente.nl/user/s1934538/clickstream/clickstream-enwiki-2023-01.tsv.gz,The_Batman_(film),113616,262813,5615,382044,214765
hdfs://spark-nn.eemcs.utwente.nl/user/s1934538/clickstream/clickstream-enwiki-2023-01.tsv.gz,The_Falcon_and_the_Winter_Soldier,21616,29948,518,52082,31738
hdfs://spark-nn.eemcs.utwente.nl/user/s1934538/clickstream/clickstream-enwiki-2023-01.tsv.gz,Taliban,43840,83066,1039,127945,93428
hdfs://spark-nn.eemcs.utwente.nl/user/s1934538/clickstream/clickstream-enwiki-2023-01.tsv.gz,Rami_Malek,96855,175100,809,272764,112900
hdfs://spark-nn.eemcs.utwente.nl/user/s1934538/clickstream/clickstream-enwiki-2023-01.tsv.gz,2018_FIFA_World_Cup,122932,78696,983,202611,144939
hdfs://spark-nn.eemcs.utwente.nl/user/s1934538/clickstream/clickstream-enwiki-2023-01.tsv.gz,Ponniyin_Selvan:_I,76373,223659,893,300925,168779
hdfs://spark-nn.eemcs.utwente.nl/user/s1934538/clickstream/clickstream-enwiki-2023-01.tsv.gz,David_Beckham,73738,314858,2078,390674,181813
hdfs://spark-nn.eemcs.utwente.nl/user/s1934538/clickstream/clickstream-enwiki-2023-01.tsv.gz,Dennis_Nilsen,9413,60093,356,69862,17293
hdfs://spark-nn.eemcs.utwente.nl/user/s1934538/clickstream/clickstream-enwiki-2023-01.tsv.gz,ICC_Men's_T20_World_Cup,16889,87698,544,105131,41958
hdfs://spark-nn.eemcs.utwente.nl/user/s1934538/clickstream/clickstream-enwiki-2023-01.tsv.gz,Wikipedia,245831,1537153,1703,1784687,827151
hdfs://spark-nn.eemcs.utwente.nl/user/s1934538/clickstream/clickstream-enwiki-2023-01.tsv.gz,Mission:_Impossible_–_Dead_Reckoning_Part_One,101652,73279,1147,176078,144822
hdfs://spark-nn.eemcs.utwente.nl/user/s1934538/clickstream/clickstream-enwiki-2023-01.tsv.gz,Cameron_Boyce,23790,125339,402,149531,41402
hdfs://spark-nn.eemcs.utwente.nl/user/s1934538/clickstream/clickstream-enwiki-2023-01.tsv.gz,WrestleMania_34,21696,9911,58,31665,21722
hdfs://spark-nn.eemcs.utwente.nl/user/s1934538/clickstream/clickstream-enwiki-2023-01.tsv.gz,Jason_Momoa,87820,299756,1813,389389,176466
hdfs://spark-nn.eemcs.utwente.nl/user/s1934538/clickstream/clickstream-enwiki-2023-01.tsv.gz,Salman_Rushdie,27012,90212,847,118071,54611
hdfs://spark-nn.eemcs.utwente.nl/user/s1934538/clickstream/clickstream-enwiki-2023-01.tsv.gz,Laal_Singh_Chaddha,38811,123985,625,163421,51540
hdfs://spark-nn.eemcs.utwente.nl/user/s1934538/clickstream/clickstream-enwiki-2023-01.tsv.gz,Puneeth_Rajkumar,19836,68459,361,88656,35929
hdfs://spark-nn.eemcs.utwente.nl/user/s1934538/clickstream/clickstream-enwiki-2023-01.tsv.gz,Shinzo_Abe,46788,81892,1282,129962,89193
hdfs://spark-nn.eemcs.utwente.nl/user/s1934538/clickstream/clickstream-enwiki-2023-01.tsv.gz,Pornhub,43691,511416,13538,568645,86771
hdfs://spark-nn.eemcs.utwente.nl/user/s1934538/clickstream/clickstream-enwiki-2023-01.tsv.gz,Nipsey_Hussle,129162,190543,726,320431,69566
hdfs://spark-nn.eemcs.utwente.nl/user/s1934538/clickstream/clickstream-enwiki-2023-02.tsv.gz,COVID-19_pandemic_by_country_and_territory,8634,26791,867,36292,13559
hdfs://spark-nn.eemcs.utwente.nl/user/s1934538/clickstream/clickstream-enwiki-2023-02.tsv.gz,Chadwick_Boseman,110496,789462,2267,902225,182988
hdfs://spark-nn.eemcs.utwente.nl/user/s1934538/clickstream/clickstream-enwiki-2023-02.tsv.gz,Jason_Momoa,89670,302412,1713,393795,171752
hdfs://spark-nn.eemcs.utwente.nl/user/s1934538/clickstream/clickstream-enwiki-2023-02.tsv.gz,Simple_Mail_Transfer_Protocol,2596,27715,136,30447,2917
hdfs://spark-nn.eemcs.utwente.nl/user/s1934538/clickstream/clickstream-enwiki-2023-02.tsv.gz,Roe_v._Wade,12442,88081,684,101207,30467
hdfs://spark-nn.eemcs.utwente.nl/user/s1934538/clickstream/clickstream-enwiki-2023-02.tsv.gz,Anthony_Bourdain,20319,199707,1399,221425,96793
hdfs://spark-nn.eemcs.utwente.nl/user/s1934538/clickstream/clickstream-enwiki-2023-02.tsv.gz,The_Flash_(film),150789,518355,14725,683869,596887
hdfs://spark-nn.eemcs.utwente.nl/user/s1934538/clickstream/clickstream-enwiki-2023-02.tsv.gz,Cricket_World_Cup,13780,90430,471,104681,55340
hdfs://spark-nn.eemcs.utwente.nl/user/s1934538/clickstream/clickstream-enwiki-2023-02.tsv.gz,Eternals_(film),77869,117110,1777,196756,136486
hdfs://spark-nn.eemcs.utwente.nl/user/s1934538/clickstream/clickstream-enwiki-2023-02.tsv.gz,Donald_Glover,43836,158868,1063,203767,84744
hdfs://spark-nn.eemcs.utwente.nl/user/s1934538/clickstream/clickstream-enwiki-2023-02.tsv.gz,The_Nun_(2018_film),16384,47973,310,64667,35437
hdfs://spark-nn.eemcs.utwente.nl/user/s1934538/clickstream/clickstream-enwiki-2023-02.tsv.gz,List_of_FIFA_World_Cup_finals,3487,58457,67,62011,16682
hdfs://spark-nn.eemcs.utwente.nl/user/s1934538/clickstream/clickstream-enwiki-2023-02.tsv.gz,2.0_(film),38974,38137,66,77177,17181
hdfs://spark-nn.eemcs.utwente.nl/user/s1934538/clickstream/clickstream-enwiki-2023-02.tsv.gz,Stan_Lee,35312,116565,664,152541,41167
hdfs://spark-nn.eemcs.utwente.nl/user/s1934538/clickstream/clickstream-enwiki-2023-02.tsv.gz,Kim_Jong-un,82449,220364,2480,305293,201167
hdfs://spark-nn.eemcs.utwente.nl/user/s1934538/clickstream/clickstream-enwiki-2023-02.tsv.gz,R._Kelly,36534,311046,3017,350597,183653
hdfs://spark-nn.eemcs.utwente.nl/user/s1934538/clickstream/clickstream-enwiki-2023-02.tsv.gz,XHamster,5541,161123,5264,171928,19903
hdfs://spark-nn.eemcs.utwente.nl/user/s1934538/clickstream/clickstream-enwiki-2023-02.tsv.gz,Richard_Ramirez,11260,114497,1050,126807,35434
hdfs://spark-nn.eemcs.utwente.nl/user/s1934538/clickstream/clickstream-enwiki-2023-02.tsv.gz,Media,27,1828,266,2121,986
hdfs://spark-nn.eemcs.utwente.nl/user/s1934538/clickstream/clickstream-enwiki-2023-02.tsv.gz,Rami_Malek,48636,141214,596,190446,78113
hdfs://spark-nn.eemcs.utwente.nl/user/s1934538/clickstream/clickstream-enwiki-2023-02.tsv.gz,Lisa_Marie_Presley,267430,398460,2893,668783,346102
hdfs://spark-nn.eemcs.utwente.nl/user/s1934538/clickstream/clickstream-enwiki-2023-02.tsv.gz,Saaho,35060,34734,64,69858,18349
hdfs://spark-nn.eemcs.utwente.nl/user/s1934538/clickstream/clickstream-enwiki-2023-02.tsv.gz,Sidharth_Shukla,11287,66153,214,77654,15516
hdfs://spark-nn.eemcs.utwente.nl/user/s1934538/clickstream/clickstream-enwiki-2023-02.tsv.gz,Stranger_Things_(season_3),11706,21508,241,33455,18446
hdfs://spark-nn.eemcs.utwente.nl/user/s1934538/clickstream/clickstream-enwiki-2023-02.tsv.gz,The_Batman_(film),100949,219285,4597,324831,159388
hdfs://spark-nn.eemcs.utwente.nl/user/s1934538/clickstream/clickstream-enwiki-2023-02.tsv.gz,Kobe_Bryant,86454,496509,4128,587091,158182
hdfs://spark-nn.eemcs.utwente.nl/user/s1934538/clickstream/clickstream-enwiki-2023-02.tsv.gz,Carlos_Alcaraz,18809,89303,326,108438,26835
hdfs://spark-nn.eemcs.utwente.nl/user/s1934538/clickstream/clickstream-enwiki-2023-02.tsv.gz,Murder_of_Dee_Dee_Blanchard,15181,76205,272,91658,21341
hdfs://spark-nn.eemcs.utwente.nl/user/s1934538/clickstream/clickstream-enwiki-2023-02.tsv.gz,Kobe_Bryant_sexual_assault_case,8662,38671,49,47382,4219
hdfs://spark-nn.eemcs.utwente.nl/user/s1934538/clickstream/clickstream-enwiki-2023-02.tsv.gz,Shang-Chi_and_the_Legend_of_the_Ten_Rings,58861,84512,1013,144386,77837
hdfs://spark-nn.eemcs.utwente.nl/user/s1934538/clickstream/clickstream-enwiki-2023-02.tsv.gz,Rishi_Sunak,111680,263591,2501,377772,193420
hdfs://spark-nn.eemcs.utwente.nl/user/s1934538/clickstream/clickstream-enwiki-2023-02.tsv.gz,Queen_(band),41590,147857,2589,192036,173866
hdfs://spark-nn.eemcs.utwente.nl/user/s1934538/clickstream/clickstream-enwiki-2023-02.tsv.gz,Tom_Brady,162713,1249129,12162,1424004,639003
hdfs://spark-nn.eemcs.utwente.nl/user/s1934538/clickstream/clickstream-enwiki-2023-02.tsv.gz,Deadpool_2,88369,54298,4905,147572,87118
hdfs://spark-nn.eemcs.utwente.nl/user/s1934538/clickstream/clickstream-enwiki-2023-02.tsv.gz,Key_frame,602,3260,14,3876,243
hdfs://spark-nn.eemcs.utwente.nl/user/s1934538/clickstream/clickstream-enwiki-2023-02.tsv.gz,Joaquin_Phoenix,125012,162511,869,288392,182807
hdfs://spark-nn.eemcs.utwente.nl/user/s1934538/clickstream/clickstream-enwiki-2023-02.tsv.gz,Aaron_Carter,26088,103494,1062,130644,50144
hdfs://spark-nn.eemcs.utwente.nl/user/s1934538/clickstream/clickstream-enwiki-2023-02.tsv.gz,Hyphen-minus,789,4291879,18818,4311486,728
hdfs://spark-nn.eemcs.utwente.nl/user/s1934538/clickstream/clickstream-enwiki-2023-02.tsv.gz,Juice_Wrld,28614,161849,1785,192248,73912
hdfs://spark-nn.eemcs.utwente.nl/user/s1934538/clickstream/clickstream-enwiki-2023-02.tsv.gz,Jenna_Ortega,164237,883543,8811,1056591,266697
hdfs://spark-nn.eemcs.utwente.nl/user/s1934538/clickstream/clickstream-enwiki-2023-02.tsv.gz,List_of_highest-grossing_films,519289,994174,5579,1519042,525762
hdfs://spark-nn.eemcs.utwente.nl/user/s1934538/clickstream/clickstream-enwiki-2023-02.tsv.gz,Cardi_B,43478,233805,1753,279036,80369
hdfs://spark-nn.eemcs.utwente.nl/user/s1934538/clickstream/clickstream-enwiki-2023-02.tsv.gz,Manti_Te'o,3543,53158,137,56838,7297
hdfs://spark-nn.eemcs.utwente.nl/user/s1934538/clickstream/clickstream-enwiki-2023-02.tsv.gz,Aaron_Hernandez,11180,159934,745,171859,64913
hdfs://spark-nn.eemcs.utwente.nl/user/s1934538/clickstream/clickstream-enwiki-2023-02.tsv.gz,Croatia,44464,139124,1883,185471,63010
hdfs://spark-nn.eemcs.utwente.nl/user/s1934538/clickstream/clickstream-enwiki-2023-02.tsv.gz,Microsoft_Office,6717,165567,545,172829,18153
hdfs://spark-nn.eemcs.utwente.nl/user/s1934538/clickstream/clickstream-enwiki-2023-02.tsv.gz,Bonnie_and_Clyde,18606,164827,1063,184496,46699
hdfs://spark-nn.eemcs.utwente.nl/user/s1934538/clickstream/clickstream-enwiki-2023-02.tsv.gz,United_States_Senate,51879,44287,842,97008,48790
hdfs://spark-nn.eemcs.utwente.nl/user/s1934538/clickstream/clickstream-enwiki-2023-02.tsv.gz,JSON_Web_Token,742,23279,48,24069,1950
hdfs://spark-nn.eemcs.utwente.nl/user/s1934538/clickstream/clickstream-enwiki-2023-02.tsv.gz,Freddie_Mercury,58923,347567,2761,409251,164148
hdfs://spark-nn.eemcs.utwente.nl/user/s1934538/clickstream/clickstream-enwiki-2023-02.tsv.gz,Richard_Jewell,7041,33736,150,40927,14818
hdfs://spark-nn.eemcs.utwente.nl/user/s1934538/clickstream/clickstream-enwiki-2023-02.tsv.gz,Avengers:_Infinity_War,47319,67860,926,116105,54325
hdfs://spark-nn.eemcs.utwente.nl/user/s1934538/clickstream/clickstream-enwiki-2023-02.tsv.gz,Jawan_(film),143716,222365,31437,397518,326258
hdfs://spark-nn.eemcs.utwente.nl/user/s1934538/clickstream/clickstream-enwiki-2023-02.tsv.gz,Sridevi,39735,112820,1202,153757,77371
hdfs://spark-nn.eemcs.utwente.nl/user/s1934538/clickstream/clickstream-enwiki-2023-02.tsv.gz,Pathaan_(film),394598,6310619,40595,6745812,2119536
hdfs://spark-nn.eemcs.utwente.nl/user/s1934538/clickstream/clickstream-enwiki-2023-02.tsv.gz,Jimmy_Hoffa,26679,103423,886,130988,51520
hdfs://spark-nn.eemcs.utwente.nl/user/s1934538/clickstream/clickstream-enwiki-2023-02.tsv.gz,The_Weeknd,66073,302556,2729,371358,151067
hdfs://spark-nn.eemcs.utwente.nl/user/s1934538/clickstream/clickstream-enwiki-2023-02.tsv.gz,Johnny_Depp,93638,262691,1838,358167,217632
hdfs://spark-nn.eemcs.utwente.nl/user/s1934538/clickstream/clickstream-enwiki-2023-02.tsv.gz,A_Star_Is_Born_(2018_film),24923,91637,621,117181,58329
hdfs://spark-nn.eemcs.utwente.nl/user/s1934538/clickstream/clickstream-enwiki-2023-02.tsv.gz,The_Witcher_(TV_series),28130,127884,2706,158720,82833
hdfs://spark-nn.eemcs.utwente.nl/user/s1934538/clickstream/clickstream-enwiki-2023-02.tsv.gz,Ghislaine_Maxwell,51141,103315,544,155000,62638
hdfs://spark-nn.eemcs.utwente.nl/user/s1934538/clickstream/clickstream-enwiki-2023-02.tsv.gz,XNXX,11170,406569,6575,424314,27627
hdfs://spark-nn.eemcs.utwente.nl/user/s1934538/clickstream/clickstream-enwiki-2023-02.tsv.gz,2018_Asian_Games,5646,5143,28,10817,10169
hdfs://spark-nn.eemcs.utwente.nl/user/s1934538/clickstream/clickstream-enwiki-2023-02.tsv.gz,Saltburn_(film),20306,8510,33,28849,13087
hdfs://spark-nn.eemcs.utwente.nl/user/s1934538/clickstream/clickstream-enwiki-2023-02.tsv.gz,Spider-Man:_No_Way_Home,97242,174195,2505,273942,114343
hdfs://spark-nn.eemcs.utwente.nl/user/s1934538/clickstream/clickstream-enwiki-2023-02.tsv.gz,Irrfan_Khan,25715,63642,77,89434,32667
hdfs://spark-nn.eemcs.utwente.nl/user/s1934538/clickstream/clickstream-enwiki-2023-02.tsv.gz,Vivek_Ramaswamy,15444,482467,2195,500106,80833
hdfs://spark-nn.eemcs.utwente.nl/user/s1934538/clickstream/clickstream-enwiki-2023-02.tsv.gz,Doctor_Strange_in_the_Multiverse_of_Madness,76540,125351,2214,204105,102367
hdfs://spark-nn.eemcs.utwente.nl/user/s1934538/clickstream/clickstream-enwiki-2023-02.tsv.gz,The_Kashmir_Files,19700,52948,222,72870,28260
hdfs://spark-nn.eemcs.utwente.nl/user/s1934538/clickstream/clickstream-enwiki-2023-02.tsv.gz,Joe_Exotic,11119,47342,237,58698,29737
hdfs://spark-nn.eemcs.utwente.nl/user/s1934538/clickstream/clickstream-enwiki-2023-02.tsv.gz,Kelly_Preston,127495,135871,502,263868,72656
hdfs://spark-nn.eemcs.utwente.nl/user/s1934538/clickstream/clickstream-enwiki-2023-02.tsv.gz,Pelé,30314,217661,2378,250353,73783
hdfs://spark-nn.eemcs.utwente.nl/user/s1934538/clickstream/clickstream-enwiki-2023-02.tsv.gz,Bipin_Rawat,6541,18481,63,25085,10232
hdfs://spark-nn.eemcs.utwente.nl/user/s1934538/clickstream/clickstream-enwiki-2023-02.tsv.gz,George_H._W._Bush,179571,121476,1156,302203,185704
hdfs://spark-nn.eemcs.utwente.nl/user/s1934538/clickstream/clickstream-enwiki-2023-02.tsv.gz,Grover,1085,4348,35,5468,1178
hdfs://spark-nn.eemcs.utwente.nl/user/s1934538/clickstream/clickstream-enwiki-2023-02.tsv.gz,Parasite_(2019_film),26160,122620,1223,150003,59322
hdfs://spark-nn.eemcs.utwente.nl/user/s1934538/clickstream/clickstream-enwiki-2023-02.tsv.gz,Cook's_Country,484,1943,40,2467,526
hdfs://spark-nn.eemcs.utwente.nl/user/s1934538/clickstream/clickstream-enwiki-2023-02.tsv.gz,XXXTentacion,66099,1577992,5473,1649564,148699
hdfs://spark-nn.eemcs.utwente.nl/user/s1934538/clickstream/clickstream-enwiki-2023-02.tsv.gz,Mission:_Impossible_–_Dead_Reckoning_Part_One,77835,62913,815,141563,103441
hdfs://spark-nn.eemcs.utwente.nl/user/s1934538/clickstream/clickstream-enwiki-2023-02.tsv.gz,"Prince_Philip,_Duke_of_Edinburgh",110460,113848,1129,225437,137313
hdfs://spark-nn.eemcs.utwente.nl/user/s1934538/clickstream/clickstream-enwiki-2023-02.tsv.gz,XXX:_Return_of_Xander_Cage,49328,1830175,1469,1880972,83270
hdfs://spark-nn.eemcs.utwente.nl/user/s1934538/clickstream/clickstream-enwiki-2023-02.tsv.gz,Dark_Phoenix_(film),32838,30508,314,63660,32376
hdfs://spark-nn.eemcs.utwente.nl/user/s1934538/clickstream/clickstream-enwiki-2023-02.tsv.gz,Hamas,31083,35301,360,66744,37618
hdfs://spark-nn.eemcs.utwente.nl/user/s1934538/clickstream/clickstream-enwiki-2023-02.tsv.gz,Wikipedia,184799,1139795,1319,1325913,549306
hdfs://spark-nn.eemcs.utwente.nl/user/s1934538/clickstream/clickstream-enwiki-2023-02.tsv.gz,Sinéad_O'Connor,17360,118177,835,136372,37365
hdfs://spark-nn.eemcs.utwente.nl/user/s1934538/clickstream/clickstream-enwiki-2023-02.tsv.gz,Kantara_(film),22324,215792,851,238967,69044
hdfs://spark-nn.eemcs.utwente.nl/user/s1934538/clickstream/clickstream-enwiki-2023-02.tsv.gz,Meat_Loaf,21159,103925,1106,126190,43232
hdfs://spark-nn.eemcs.utwente.nl/user/s1934538/clickstream/clickstream-enwiki-2023-02.tsv.gz,Salman_Rushdie,26649,169652,2066,198367,123340
hdfs://spark-nn.eemcs.utwente.nl/user/s1934538/clickstream/clickstream-enwiki-2023-02.tsv.gz,Jimmy_Buffett,8008,52737,543,61288,21705
hdfs://spark-nn.eemcs.utwente.nl/user/s1934538/clickstream/clickstream-enwiki-2023-02.tsv.gz,Eddie_Van_Halen,43483,74155,624,118262,49939
hdfs://spark-nn.eemcs.utwente.nl/user/s1934538/clickstream/clickstream-enwiki-2023-02.tsv.gz,QAnon,33099,94181,4202,131482,42698
hdfs://spark-nn.eemcs.utwente.nl/user/s1934538/clickstream/clickstream-enwiki-2023-02.tsv.gz,Elon_Musk,102477,915502,7470,1025449,439261
hdfs://spark-nn.eemcs.utwente.nl/user/s1934538/clickstream/clickstream-enwiki-2023-02.tsv.gz,Army_of_the_Dead,47662,41459,427,89548,45214
hdfs://spark-nn.eemcs.utwente.nl/user/s1934538/clickstream/clickstream-enwiki-2023-02.tsv.gz,Main_Page,59848,126901989,4343475,131305312,30746445
hdfs://spark-nn.eemcs.utwente.nl/user/s1934538/clickstream/clickstream-enwiki-2023-02.tsv.gz,Line_shaft,313,764,23,1100,65
hdfs://spark-nn.eemcs.utwente.nl/user/s1934538/clickstream/clickstream-enwiki-2023-02.tsv.gz,Bible,19143,90576,1715,111434,34379
hdfs://spark-nn.eemcs.utwente.nl/user/s1934538/clickstream/clickstream-enwiki-2023-02.tsv.gz,The_Last_of_Us_(TV_series),600295,5620190,112390,6332875,2998797
hdfs://spark-nn.eemcs.utwente.nl/user/s1934538/clickstream/clickstream-enwiki-2023-02.tsv.gz,Pornhub,42284,291311,12602,346197,69550
hdfs://spark-nn.eemcs.utwente.nl/user/s1934538/clickstream/clickstream-enwiki-2023-02.tsv.gz,The_Mandalorian,103455,264606,6122,374183,237594
hdfs://spark-nn.eemcs.utwente.nl/user/s1934538/clickstream/clickstream-enwiki-2023-02.tsv.gz,Mötley_Crüe,57337,137119,2065,196521,220913
hdfs://spark-nn.eemcs.utwente.nl/user/s1934538/clickstream/clickstream-enwiki-2023-02.tsv.gz,Spanish_flu,19113,49771,485,69369,19381
hdfs://spark-nn.eemcs.utwente.nl/user/s1934538/clickstream/clickstream-enwiki-2023-02.tsv.gz,WandaVision,26846,54704,814,82364,37529
hdfs://spark-nn.eemcs.utwente.nl/user/s1934538/clickstream/clickstream-enwiki-2023-02.tsv.gz,Simone_Biles,12056,85745,627,98428,22846
hdfs://spark-nn.eemcs.utwente.nl/user/s1934538/clickstream/clickstream-enwiki-2023-02.tsv.gz,Charles_Sobhraj,7359,57285,127,64771,10380
hdfs://spark-nn.eemcs.utwente.nl/user/s1934538/clickstream/clickstream-enwiki-2023-02.tsv.gz,Mac_Miller,21060,130043,850,151953,46398
hdfs://spark-nn.eemcs.utwente.nl/user/s1934538/clickstream/clickstream-enwiki-2023-02.tsv.gz,Puneeth_Rajkumar,19345,79965,253,99563,38227
hdfs://spark-nn.eemcs.utwente.nl/user/s1934538/clickstream/clickstream-enwiki-2023-02.tsv.gz,Chernobyl_(miniseries),38225,103480,2060,143765,154629
hdfs://spark-nn.eemcs.utwente.nl/user/s1934538/clickstream/clickstream-enwiki-2023-02.tsv.gz,United_States_Electoral_College,10721,23192,77,33990,6014
hdfs://spark-nn.eemcs.utwente.nl/user/s1934538/clickstream/clickstream-enwiki-2023-02.tsv.gz,Top_Gun:_Maverick,158886,393389,8618,560893,420122
hdfs://spark-nn.eemcs.utwente.nl/user/s1934538/clickstream/clickstream-enwiki-2023-02.tsv.gz,Fyre_Festival,8481,40490,269,49240,27235
hdfs://spark-nn.eemcs.utwente.nl/user/s1934538/clickstream/clickstream-enwiki-2023-02.tsv.gz,WrestleMania_34,28404,13204,118,41726,29485
hdfs://spark-nn.eemcs.utwente.nl/user/s1934538/clickstream/clickstream-enwiki-2023-02.tsv.gz,September_11_attacks,97862,245859,4070,347791,213282
hdfs://spark-nn.eemcs.utwente.nl/user/s1934538/clickstream/clickstream-enwiki-2023-02.tsv.gz,Black_Adam_(film),66722,244282,4729,315733,157986
hdfs://spark-nn.eemcs.utwente.nl/user/s1934538/clickstream/clickstream-enwiki-2023-02.tsv.gz,Avengers:_Endgame,355773,166837,31250,553860,190851
hdfs://spark-nn.eemcs.utwente.nl/user/s1934538/clickstream/clickstream-enwiki-2023-02.tsv.gz,It_Chapter_Two,25249,35330,264,60843,31428
hdfs://spark-nn.eemcs.utwente.nl/user/s1934538/clickstream/clickstream-enwiki-2023-02.tsv.gz,ICC_Men's_T20_World_Cup,14990,105434,433,120857,35785
hdfs://spark-nn.eemcs.utwente.nl/user/s1934538/clickstream/clickstream-enwiki-2023-02.tsv.gz,Donald_Trump,188862,371653,4959,565474,312546
hdfs://spark-nn.eemcs.utwente.nl/user/s1934538/clickstream/clickstream-enwiki-2023-02.tsv.gz,Brahmāstra:_Part_One_–_Shiva,54680,134383,692,189755,45257
hdfs://spark-nn.eemcs.utwente.nl/user/s1934538/clickstream/clickstream-enwiki-2023-02.tsv.gz,Adele,51613,364204,3856,419673,167686
hdfs://spark-nn.eemcs.utwente.nl/user/s1934538/clickstream/clickstream-enwiki-2023-02.tsv.gz,21_Savage,19205,105933,660,125798,37384
hdfs://spark-nn.eemcs.utwente.nl/user/s1934538/clickstream/clickstream-enwiki-2023-02.tsv.gz,Critical_race_theory,19220,233800,1328,254348,24812
hdfs://spark-nn.eemcs.utwente.nl/user/s1934538/clickstream/clickstream-enwiki-2023-02.tsv.gz,Bird_Box_(film),14413,62120,702,77235,28211
hdfs://spark-nn.eemcs.utwente.nl/user/s1934538/clickstream/clickstream-enwiki-2023-02.tsv.gz,The_Super_Mario_Bros._Movie,80379,212006,7122,299507,158860
hdfs://spark-nn.eemcs.utwente.nl/user/s1934538/clickstream/clickstream-enwiki-2023-02.tsv.gz,Godzilla_vs._Kong,32683,63926,924,97533,55242
hdfs://spark-nn.eemcs.utwente.nl/user/s1934538/clickstream/clickstream-enwiki-2023-02.tsv.gz,1234,51,2245,575,2871,624
hdfs://spark-nn.eemcs.utwente.nl/user/s1934538/clickstream/clickstream-enwiki-2023-02.tsv.gz,The_Shape_of_Water,23529,51485,484,75498,32826
hdfs://spark-nn.eemcs.utwente.nl/user/s1934538/clickstream/clickstream-enwiki-2023-02.tsv.gz,List_of_Queen_of_the_South_episodes,4007,3211,54,7272,175
hdfs://spark-nn.eemcs.utwente.nl/user/s1934538/clickstream/clickstream-enwiki-2023-02.tsv.gz,State_of_Palestine,60476,157782,332,218590,89003
hdfs://spark-nn.eemcs.utwente.nl/user/s1934538/clickstream/clickstream-enwiki-2023-02.tsv.gz,Stephen_Hawking,22386,311410,1676,335472,122339
hdfs://spark-nn.eemcs.utwente.nl/user/s1934538/clickstream/clickstream-enwiki-2023-02.tsv.gz,2018_FIFA_World_Cup,66043,65024,480,131547,84069
hdfs://spark-nn.eemcs.utwente.nl/user/s1934538/clickstream/clickstream-enwiki-2023-02.tsv.gz,Ponniyin_Selvan:_I,63381,139752,475,203608,105669
hdfs://spark-nn.eemcs.utwente.nl/user/s1934538/clickstream/clickstream-enwiki-2023-02.tsv.gz,Game_of_Thrones_(season_8),12546,30035,458,43039,17881
hdfs://spark-nn.eemcs.utwente.nl/user/s1934538/clickstream/clickstream-enwiki-2023-02.tsv.gz,Nipsey_Hussle,155659,244561,1127,401347,99916
hdfs://spark-nn.eemcs.utwente.nl/user/s1934538/clickstream/clickstream-enwiki-2023-02.tsv.gz,Once_Upon_a_Time_in_Hollywood,95652,139823,2414,237889,244946
hdfs://spark-nn.eemcs.utwente.nl/user/s1934538/clickstream/clickstream-enwiki-2023-02.tsv.gz,Black_Widow_(2021_film),43888,71226,871,115985,51140
hdfs://spark-nn.eemcs.utwente.nl/user/s1934538/clickstream/clickstream-enwiki-2023-02.tsv.gz,Anne_Heche,45617,151652,1084,198353,69202
hdfs://spark-nn.eemcs.utwente.nl/user/s1934538/clickstream/clickstream-enwiki-2023-02.tsv.gz,List_of_awards_and_nominations_received_by_Meryl_Streep,8811,10807,46,19664,8922
hdfs://spark-nn.eemcs.utwente.nl/user/s1934538/clickstream/clickstream-enwiki-2023-02.tsv.gz,Vladimir_Putin,125946,398401,6028,530375,295384
hdfs://spark-nn.eemcs.utwente.nl/user/s1934538/clickstream/clickstream-enwiki-2023-02.tsv.gz,Volodymyr_Zelenskyy,108959,293544,3688,406191,209097
hdfs://spark-nn.eemcs.utwente.nl/user/s1934538/clickstream/clickstream-enwiki-2023-02.tsv.gz,UEFA_Euro_2020,34232,35728,2412,72372,45491
hdfs://spark-nn.eemcs.utwente.nl/user/s1934538/clickstream/clickstream-enwiki-2023-02.tsv.gz,Stranger_Things,64165,233479,5345,302989,246621
hdfs://spark-nn.eemcs.utwente.nl/user/s1934538/clickstream/clickstream-enwiki-2023-02.tsv.gz,Anna_Sorokin,17112,171552,422,189086,65364
hdfs://spark-nn.eemcs.utwente.nl/user/s1934538/clickstream/clickstream-enwiki-2023-02.tsv.gz,Thor:_Love_and_Thunder,77702,143629,2445,223776,109662
hdfs://spark-nn.eemcs.utwente.nl/user/s1934538/clickstream/clickstream-enwiki-2023-02.tsv.gz,Spider-Man:_Across_the_Spider-Verse,59101,74322,1395,134818,61702
hdfs://spark-nn.eemcs.utwente.nl/user/s1934538/clickstream/clickstream-enwiki-2023-02.tsv.gz,Atal_Bihari_Vajpayee,28517,40156,81,68754,26216
hdfs://spark-nn.eemcs.utwente.nl/user/s1934538/clickstream/clickstream-enwiki-2023-02.tsv.gz,Wonder_Woman_1984,40014,49297,1123,90434,42207
hdfs://spark-nn.eemcs.utwente.nl/user/s1934538/clickstream/clickstream-enwiki-2023-02.tsv.gz,Khabib_Nurmagomedov,70913,230800,1714,303427,175978
hdfs://spark-nn.eemcs.utwente.nl/user/s1934538/clickstream/clickstream-enwiki-2023-02.tsv.gz,"Princess_Margaret,_Countess_of_Snowdon",72899,223848,11816,308563,166819
hdfs://spark-nn.eemcs.utwente.nl/user/s1934538/clickstream/clickstream-enwiki-2023-02.tsv.gz,Star_Wars:_The_Rise_of_Skywalker,57449,46769,952,105170,56320
hdfs://spark-nn.eemcs.utwente.nl/user/s1934538/clickstream/clickstream-enwiki-2023-02.tsv.gz,Michael_Bloomberg,24974,26538,217,51729,23241
hdfs://spark-nn.eemcs.utwente.nl/user/s1934538/clickstream/clickstream-enwiki-2023-02.tsv.gz,Emma_Raducanu,3701,41853,322,45876,7920
hdfs://spark-nn.eemcs.utwente.nl/user/s1934538/clickstream/clickstream-enwiki-2023-02.tsv.gz,Guardians_of_the_Galaxy_Vol._3,149787,172761,4513,327061,208459
hdfs://spark-nn.eemcs.utwente.nl/user/s1934538/clickstream/clickstream-enwiki-2023-02.tsv.gz,Zack_Snyder's_Justice_League,48887,73431,927,123245,51499
hdfs://spark-nn.eemcs.utwente.nl/user/s1934538/clickstream/clickstream-enwiki-2023-02.tsv.gz,Jeffrey_Dahmer,33151,564807,4906,602864,235408
hdfs://spark-nn.eemcs.utwente.nl/user/s1934538/clickstream/clickstream-enwiki-2023-02.tsv.gz,Article_370_of_the_Constitution_of_India,8140,60901,33,69074,3746
hdfs://spark-nn.eemcs.utwente.nl/user/s1934538/clickstream/clickstream-enwiki-2023-02.tsv.gz,Kamala_Harris,80201,235863,2305,318369,128530
hdfs://spark-nn.eemcs.utwente.nl/user/s1934538/clickstream/clickstream-enwiki-2023-02.tsv.gz,Amy_Coney_Barrett,16260,18928,101,35289,11458
hdfs://spark-nn.eemcs.utwente.nl/user/s1934538/clickstream/clickstream-enwiki-2023-02.tsv.gz,John_McCain,28812,51713,553,81078,42216
hdfs://spark-nn.eemcs.utwente.nl/user/s1934538/clickstream/clickstream-enwiki-2023-02.tsv.gz,Rihanna,348018,4925810,33711,5307539,2704843
hdfs://spark-nn.eemcs.utwente.nl/user/s1934538/clickstream/clickstream-enwiki-2023-02.tsv.gz,Leave_the_World_Behind_(film),12130,4908,21,17059,5379
hdfs://spark-nn.eemcs.utwente.nl/user/s1934538/clickstream/clickstream-enwiki-2023-02.tsv.gz,The_Idol_(TV_series),26444,43920,202,70566,41921
hdfs://spark-nn.eemcs.utwente.nl/user/s1934538/clickstream/clickstream-enwiki-2023-02.tsv.gz,When_They_See_Us,13946,19799,149,33894,13541
hdfs://spark-nn.eemcs.utwente.nl/user/s1934538/clickstream/clickstream-enwiki-2023-02.tsv.gz,Kylian_Mbappé,50745,421226,2810,474781,84075
hdfs://spark-nn.eemcs.utwente.nl/user/s1934538/clickstream/clickstream-enwiki-2023-02.tsv.gz,Valentine's_Day,34315,3428777,15266,3478358,195168
